year,GEOID,NAME,B25001_001E,B25002_003E,B25032_001E,B25032_013E,B25008_003E,B25119_003E,B25037_003E,B25039_003E,B25064_001E,B25071_001E,B25013_011E,B25003H_003E,B25003B_003E,B25003D_003E,B25003I_003E,B17017_001E,B17017_002E
2012,36005000100,"Census Tract 1, Bronx County, New York",0,0,0,0,0,NA,NA,NA,NA,NA,0,0,0,0,0,0,0
2013,36005000100,"Census Tract 1, Bronx County, New York",0,0,0,0,0,NA,NA,NA,NA,NA,0,0,0,0,0,0,0
2014,36005000100,"Census Tract 1, Bronx County, New York",0,0,0,0,0,NA,NA,NA,NA,NA,0,0,0,0,0,0,0
2015,36005000100,"Census Tract 1, Bronx County, New York",0,0,0,0,0,NA,NA,NA,NA,NA,0,0,0,0,0,0,0
2016,36005000100,"Census Tract 1, Bronx County, New York",0,0,0,0,0,NA,NA,NA,NA,NA,0,0,0,0,0,0,0
2017,36005000100,"Census Tract 1, Bronx County, New York",0,0,0,0,0,NA,NA,NA,NA,NA,0,0,0,0,0,0,0
2018,36005000100,"Census Tract 1, Bronx County, New York",0,0,0,0,0,NA,NA,NA,NA,NA,0,0,0,0,0,0,0
2019,36005000100,"Census Tract 1, Bronx County, New York",0,0,0,0,0,NA,NA,NA,NA,NA,0,0,0,0,0,0,0
2020,36005000100,"Census Tract 1, Bronx County, New York",0,0,0,0,0,NA,NA,NA,NA,NA,0,0,0,0,0,0,0
2012,36005000200,"Census Tract 2, Bronx County, New York",1460,157,1303,478,1760,50786,1944,2005,1339,24.4,14,0,81,25,375,1303,203
2013,36005000200,"Census Tract 2, Bronx County, New York",1476,129,1347,549,1765,25885,1954,2006,1264,45,34,0,113,25,430,1347,278
2014,36005000200,"Census Tract 2, Bronx County, New York",1475,96,1379,577,1906,25341,1961,2006,1282,46.6,38,0,123,42,447,1379,294
2015,36005000200,"Census Tract 2, Bronx County, New York",1492,113,1379,683,2408,42566,1963,2008,1358,42,143,0,144,0,581,1379,254
2016,36005000200,"Census Tract 2, Bronx County, New York",1486,155,1331,617,2175,42917,1968,2010,1237,42.2,144,0,164,0,535,1331,176
2017,36005000200,"Census Tract 2, Bronx County, New York",1465,144,1321,677,2421,40679,1978,2011,1250,48.8,134,0,190,0,572,1321,300
2018,36005000200,"Census Tract 2, Bronx County, New York",1486,158,1328,631,2344,44390,1968,2011,1615,42,154,0,176,0,518,1328,207
2019,36005000200,"Census Tract 2, Bronx County, New York",1499,157,1342,638,2173,40592,1966,2012,1559,47.2,231,0,183,0,557,1342,229
2020,36005000200,"Census Tract 2, Bronx County, New York",1462,122,1340,564,1502,41667,1984,2009,1701,42.4,253,0,128,0,529,1340,215
2012,36005000400,"Census Tract 4, Bronx County, New York",1849,167,1682,484,1522,39022,1965,2005,1569,37,120,13,141,13,340,1682,129
2013,36005000400,"Census Tract 4, Bronx County, New York",1912,159,1753,487,1566,39803,1963,2006,1413,36.2,114,23,142,13,329,1753,153
2014,36005000400,"Census Tract 4, Bronx County, New York",1995,176,1819,507,1563,38393,1968,2007,1491,35.6,128,14,170,15,343,1819,159
2015,36005000400,"Census Tract 4, Bronx County, New York",2129,208,1921,518,1600,27500,1972,2007,1448,39.2,74,30,129,19,368,1921,232
2016,36005000400,"Census Tract 4, Bronx County, New York",2130,204,1926,507,1593,37674,1978,2007,1390,39.5,101,35,116,23,366,1926,243
2017,36005000400,"Census Tract 4, Bronx County, New York",2118,183,1935,453,1362,38393,1987,2009,1278,40.6,94,38,102,21,313,1935,239
2018,36005000400,"Census Tract 4, Bronx County, New York",2115,152,1963,464,1217,50313,1998,2011,1481,29.5,107,35,133,23,308,1963,207
2019,36005000400,"Census Tract 4, Bronx County, New York",2183,141,2042,428,952,41989,1990,2012,1314,43.1,91,37,184,0,223,2042,219
2020,36005000400,"Census Tract 4, Bronx County, New York",2198,88,2110,561,1103,66298,2000,2016,1580,23.1,99,14,194,0,385,2110,110
2012,36005001600,"Census Tract 16, Bronx County, New York",2063,123,1940,1527,3395,27188,1970,2001,856,33.4,126,25,618,0,933,1940,363
2013,36005001600,"Census Tract 16, Bronx County, New York",2043,98,1945,1567,3470,26306,1973,2001,863,33.3,133,12,605,0,1026,1945,415
2014,36005001600,"Census Tract 16, Bronx County, New York",2038,126,1912,1537,3729,28845,1973,2001,920,31.6,177,20,575,0,994,1912,400
2015,36005001600,"Census Tract 16, Bronx County, New York",2046,82,1964,1618,4419,27653,1974,2003,950,31.3,158,21,611,0,1071,1964,550
2016,36005001600,"Census Tract 16, Bronx County, New York",2049,79,1970,1665,4794,28569,1975,2004,945,32,133,28,631,0,1136,1970,615
2017,36005001600,"Census Tract 16, Bronx County, New York",2045,83,1962,1713,5009,31250,1974,2005,989,32,215,29,626,0,1198,1962,557
2018,36005001600,"Census Tract 16, Bronx County, New York",2069,87,1982,1699,4814,33419,1973,2006,1065,32,251,37,658,0,1134,1982,443
2019,36005001600,"Census Tract 16, Bronx County, New York",2016,45,1971,1726,4823,32810,1974,2006,1030,32.2,255,42,716,0,1117,1971,569
2020,36005001600,"Census Tract 16, Bronx County, New York",2175,22,2153,1894,4839,33142,1974,2004,954,30.8,233,45,702,0,1066,2153,517
2012,36005001900,"Census Tract 19, Bronx County, New York",805,60,745,686,1940,28704,1976,2005,1152,40,124,87,237,0,431,745,285
2013,36005001900,"Census Tract 19, Bronx County, New York",891,60,831,771,2000,34179,1980,2007,1092,35.3,207,117,212,6,479,831,289
2014,36005001900,"Census Tract 19, Bronx County, New York",895,61,834,772,1944,35227,1989,2011,1126,35.6,211,111,247,6,425,834,275
2015,36005001900,"Census Tract 19, Bronx County, New York",947,46,901,816,1890,36554,1991,2011,1140,34.3,234,113,302,9,422,901,269
2016,36005001900,"Census Tract 19, Bronx County, New York",1011,49,962,874,1938,38007,2002,2012,1134,33.7,254,88,365,9,437,962,301
2017,36005001900,"Census Tract 19, Bronx County, New York",1017,48,969,869,2034,38701,2002,NA,1181,33.9,287,108,337,26,426,969,282
2018,36005001900,"Census Tract 19, Bronx County, New York",1002,73,929,831,1962,40025,2002,2012,1270,34.8,241,122,344,30,379,929,281
2019,36005001900,"Census Tract 19, Bronx County, New York",1170,91,1079,965,2291,39978,2000,2013,1344,35.8,325,151,425,34,462,1079,298
2020,36005001901,"Census Tract 19.01, Bronx County, New York",843,59,784,776,1888,61447,2005,NA,1284,28.7,337,140,381,0,334,784,214
2020,36005001902,"Census Tract 19.02, Bronx County, New York",369,40,329,269,670,48661,0,2015,1536,33.6,92,59,87,24,145,329,68
2020,36005001903,"Census Tract 19.03, Bronx County, New York",0,0,0,0,0,NA,NA,NA,NA,NA,0,0,0,0,0,0,0
2020,36005001904,"Census Tract 19.04, Bronx County, New York",0,0,0,0,0,NA,NA,NA,NA,NA,0,0,0,0,0,0,0
2012,36005002000,"Census Tract 20, Bronx County, New York",3162,153,3009,2599,7097,19213,1956,2000,537,29.3,224,11,1046,0,1674,3009,1102
2013,36005002000,"Census Tract 20, Bronx County, New York",3161,181,2980,2662,7422,17235,1957,2001,472,29.7,211,11,1167,13,1623,2980,1276
2014,36005002000,"Census Tract 20, Bronx County, New York",3169,189,2980,2482,7340,17917,1956,2002,601,31.8,231,45,1069,34,1546,2980,1203
2015,36005002000,"Census Tract 20, Bronx County, New York",3170,217,2953,2477,6908,NA,1955,2003,664,37.6,131,43,1021,29,1602,2953,1562
2016,36005002000,"Census Tract 20, Bronx County, New York",3190,182,3008,2497,7340,14701,1955,2004,610,36.2,219,34,1059,29,1615,3008,1656
2017,36005002000,"Census Tract 20, Bronx County, New York",3201,127,3074,2520,7879,15516,1954,2005,607,35.2,275,38,1156,24,1584,3074,1625
2018,36005002000,"Census Tract 20, Bronx County, New York",3215,64,3151,2563,7536,18119,1952,2006,658,32,316,39,1203,14,1625,3151,1431
2019,36005002000,"Census Tract 20, Bronx County, New York",3351,82,3269,2852,7727,17473,1955,2007,527,30.5,214,0,1275,0,1791,3269,1683
2020,36005002001,"Census Tract 20.01, Bronx County, New York",1658,4,1654,1654,4837,16534,1955,2005,382,28.3,75,0,980,0,832,1654,937
2020,36005002002,"Census Tract 20.02, Bronx County, New York",1993,128,1865,1289,3161,NA,1962,2011,NA,23.4,174,0,442,0,943,1865,667
2012,36005002300,"Census Tract 23, Bronx County, New York",1991,71,1920,1912,4766,13470,1963,2001,349,31.2,79,19,636,0,1493,1920,1050
2013,36005002300,"Census Tract 23, Bronx County, New York",1933,98,1835,1818,4641,13910,1962,2001,350,31,72,19,678,0,1357,1835,999
2014,36005002300,"Census Tract 23, Bronx County, New York",1960,77,1883,1866,4830,14298,1961,2002,398,31.5,60,18,711,0,1321,1883,1064
2015,36005002300,"Census Tract 23, Bronx County, New York",2004,67,1937,1919,4743,14479,1957,2002,405,31.2,91,9,660,0,1320,1937,1081
2016,36005002300,"Census Tract 23, Bronx County, New York",2011,51,1960,1945,4796,16495,1956,2003,417,30.5,105,9,707,0,1293,1960,964
2017,36005002300,"Census Tract 23, Bronx County, New York",2036,54,1982,1974,4712,17516,1956,2004,438,31,61,10,754,0,1202,1982,993
2018,36005002300,"Census Tract 23, Bronx County, New York",2009,9,2000,2000,4595,18032,1959,2004,469,31.6,81,0,927,0,1174,2000,932
2019,36005002300,"Census Tract 23, Bronx County, New York",1914,0,1914,1914,4297,18688,1960,2003,444,31.8,127,0,821,0,1293,1914,865
2020,36005002300,"Census Tract 23, Bronx County, New York",1874,0,1874,1874,4512,24474,1962,2004,479,30.7,98,6,736,0,1315,1874,820
2012,36005002400,"Census Tract 24, Bronx County, New York",0,0,0,0,0,NA,NA,NA,NA,NA,0,0,0,0,0,0,0
2013,36005002400,"Census Tract 24, Bronx County, New York",0,0,0,0,0,NA,NA,NA,NA,NA,0,0,0,0,0,0,0
2014,36005002400,"Census Tract 24, Bronx County, New York",0,0,0,0,0,NA,NA,NA,NA,NA,0,0,0,0,0,0,0
2015,36005002400,"Census Tract 24, Bronx County, New York",30,0,30,30,150,NA,NA,NA,NA,NA,30,0,30,0,0,30,0
2016,36005002400,"Census Tract 24, Bronx County, New York",26,0,26,26,123,NA,NA,NA,NA,NA,26,0,26,0,0,26,0
2017,36005002400,"Census Tract 24, Bronx County, New York",28,0,28,28,130,NA,NA,NA,NA,NA,28,0,28,0,0,28,0
2018,36005002400,"Census Tract 24, Bronx County, New York",43,0,43,43,172,NA,NA,NA,NA,NA,38,0,38,0,0,43,0
2019,36005002400,"Census Tract 24, Bronx County, New York",38,0,38,38,155,NA,NA,NA,NA,NA,38,0,38,0,0,38,0
2020,36005002400,"Census Tract 24, Bronx County, New York",0,0,0,0,0,NA,NA,NA,NA,NA,0,0,0,0,0,0,0
2012,36005002500,"Census Tract 25, Bronx County, New York",2083,257,1826,1785,4714,14612,1956,2001,543,34.7,27,59,428,23,1405,1826,1023
2013,36005002500,"Census Tract 25, Bronx County, New York",2063,249,1814,1791,5059,14619,1952,2003,594,34,91,29,442,54,1430,1814,1057
2014,36005002500,"Census Tract 25, Bronx County, New York",2051,257,1794,1761,5015,15408,1951,2003,585,35.3,134,8,455,54,1346,1794,1035
2015,36005002500,"Census Tract 25, Bronx County, New York",2073,233,1840,1800,5231,17058,1950,2003,549,33.7,177,20,458,41,1387,1840,968
2016,36005002500,"Census Tract 25, Bronx County, New York",2053,236,1817,1745,5440,20027,1945,2004,692,35.9,223,20,403,39,1366,1817,927
2017,36005002500,"Census Tract 25, Bronx County, New York",2065,175,1890,1808,5531,20893,1943,2006,815,35.8,230,30,452,9,1420,1890,948
2018,36005002500,"Census Tract 25, Bronx County, New York",2088,141,1947,1856,5630,23790,1951,2005,830,35.3,189,23,485,9,1430,1947,918
2019,36005002500,"Census Tract 25, Bronx County, New York",2104,127,1977,1905,5385,22560,1954,2006,902,37.3,183,25,573,0,1460,1977,917
2020,36005002500,"Census Tract 25, Bronx County, New York",2031,99,1932,1864,5402,26655,1954,2007,1029,39.7,180,28,568,0,1455,1932,871
2012,36005002701,"Census Tract 27.01, Bronx County, New York",1105,51,1054,1054,3100,26272,1956,2000,608,30,135,0,564,0,610,1054,459
2013,36005002701,"Census Tract 27.01, Bronx County, New York",1105,46,1059,1059,3172,26094,1955,2001,630,31.1,118,0,482,0,659,1059,491
2014,36005002701,"Census Tract 27.01, Bronx County, New York",1117,31,1086,1086,3172,20159,1951,2004,630,33.5,89,0,429,0,749,1086,577
2015,36005002701,"Census Tract 27.01, Bronx County, New York",1130,28,1102,1102,3016,20153,1952,2003,627,31.5,118,0,416,0,758,1102,557
2016,36005002701,"Census Tract 27.01, Bronx County, New York",1092,16,1076,1076,3034,18409,1952,2003,447,31.6,129,0,397,0,732,1076,612
2017,36005002701,"Census Tract 27.01, Bronx County, New York",1090,31,1059,1059,2958,17383,1953,2003,434,31.2,130,0,370,0,729,1059,620
2018,36005002701,"Census Tract 27.01, Bronx County, New York",1092,31,1061,1061,2868,20599,1954,2004,440,30.4,154,0,367,0,751,1061,550
2019,36005002701,"Census Tract 27.01, Bronx County, New York",1086,43,1043,1043,2608,18832,1957,2003,443,31.8,102,0,374,0,757,1043,509
2020,36005002701,"Census Tract 27.01, Bronx County, New York",1091,64,1027,1025,2661,17926,1959,2007,494,38.2,74,5,374,0,722,1027,590
2012,36005002702,"Census Tract 27.02, Bronx County, New York",1488,145,1343,1326,4171,20208,1970,2002,719,34.6,110,5,442,0,991,1343,576
2013,36005002702,"Census Tract 27.02, Bronx County, New York",1465,85,1380,1357,4225,18934,1971,2002,943,43.3,102,10,459,0,922,1380,665
2014,36005002702,"Census Tract 27.02, Bronx County, New York",1423,90,1333,1303,4216,17980,1950,2001,977,40.6,73,21,463,0,876,1333,659
2015,36005002702,"Census Tract 27.02, Bronx County, New York",1452,60,1392,1335,4230,NA,1946,2004,995,47.4,154,9,448,0,918,1392,751
2016,36005002702,"Census Tract 27.02, Bronx County, New York",1476,40,1436,1363,4107,14845,1942,2005,963,49.5,157,0,474,0,962,1436,776
2017,36005002702,"Census Tract 27.02, Bronx County, New York",1513,46,1467,1408,3966,12500,1952,2007,1001,50,151,11,464,0,956,1467,834
2018,36005002702,"Census Tract 27.02, Bronx County, New York",1505,21,1484,1428,4091,13986,1949,2010,856,47.9,90,18,628,0,799,1484,852
2019,36005002702,"Census Tract 27.02, Bronx County, New York",1558,38,1520,1464,3954,12645,1960,2011,921,45.5,116,17,634,0,849,1520,895
2020,36005002702,"Census Tract 27.02, Bronx County, New York",1514,44,1470,1454,4075,13750,1967,2011,1051,46.2,92,10,631,0,841,1470,831
2012,36005002800,"Census Tract 28, Bronx County, New York",2409,110,2299,2054,4915,48362,1965,1996,910,25.2,351,9,1632,0,392,2299,217
2013,36005002800,"Census Tract 28, Bronx County, New York",2427,87,2340,2081,4953,47600,1964,2000,937,26.6,366,0,1575,0,484,2340,179
2014,36005002800,"Census Tract 28, Bronx County, New York",2418,82,2336,2028,4727,49291,1965,1998,951,25.8,446,11,1584,0,430,2336,245
2015,36005002800,"Census Tract 28, Bronx County, New York",2410,76,2334,2003,4200,49735,1965,2000,927,25.8,485,13,1707,0,286,2334,213
2016,36005002800,"Census Tract 28, Bronx County, New York",2435,44,2391,1995,4078,47652,1966,1998,937,27.7,491,38,1519,0,489,2391,194
2017,36005002800,"Census Tract 28, Bronx County, New York",2450,73,2377,1928,4163,50816,1966,1998,983,28.1,390,52,1416,0,489,2377,107
2018,36005002800,"Census Tract 28, Bronx County, New York",2443,134,2309,1851,4048,50931,1968,1998,1025,28.1,362,33,1444,0,415,2309,201
2019,36005002800,"Census Tract 28, Bronx County, New York",2429,124,2305,1975,4370,50292,1968,1996,978,27.8,523,33,1485,0,463,2305,193
2020,36005002800,"Census Tract 28, Bronx County, New York",2563,162,2401,2077,4254,50634,1968,1996,987,26,640,40,1300,0,720,2401,155
2012,36005003100,"Census Tract 31, Bronx County, New York",553,80,473,390,1101,26857,1946,2002,950,34.3,52,0,79,0,310,473,93
2013,36005003100,"Census Tract 31, Bronx County, New York",531,53,478,378,1078,26000,1949,2003,1020,41.5,59,0,130,0,250,478,113
2014,36005003100,"Census Tract 31, Bronx County, New York",545,36,509,385,1250,34432,1945,2004,1014,25.1,29,0,78,11,300,509,87
2015,36005003100,"Census Tract 31, Bronx County, New York",533,26,507,408,1196,34500,1939,2002,959,29.7,17,0,95,10,310,507,101
2016,36005003100,"Census Tract 31, Bronx County, New York",559,0,559,429,1324,41838,1939,2004,1025,29.7,13,0,131,9,306,559,108
2017,36005003100,"Census Tract 31, Bronx County, New York",579,15,564,435,1292,41295,1939,2004,1176,34.9,22,5,153,8,305,564,129
2018,36005003100,"Census Tract 31, Bronx County, New York",612,15,597,472,1312,41304,0,2009,1245,34.8,19,6,208,11,284,597,127
2019,36005003100,"Census Tract 31, Bronx County, New York",709,51,658,512,1180,41111,1946,2012,1187,36.1,66,6,211,17,303,658,122
2020,36005003100,"Census Tract 31, Bronx County, New York",735,48,687,583,1533,35284,1946,2014,1320,38.9,105,7,246,47,367,687,120
2012,36005003300,"Census Tract 33, Bronx County, New York",1234,75,1159,1016,3146,19597,1971,2001,485,36.6,65,14,465,0,675,1159,553
2013,36005003300,"Census Tract 33, Bronx County, New York",1225,69,1156,1048,3557,19865,1962,2002,522,38.6,77,11,439,0,699,1156,572
2014,36005003300,"Census Tract 33, Bronx County, New York",1222,56,1166,1045,3346,19063,1954,2001,479,33.1,74,13,392,0,723,1166,535
2015,36005003300,"Census Tract 33, Bronx County, New York",1239,95,1144,1042,3551,19194,1949,2003,613,36.4,55,10,350,0,724,1144,584
2016,36005003300,"Census Tract 33, Bronx County, New York",1267,84,1183,1058,3354,19300,1939,2004,626,35.3,57,12,276,0,727,1183,569
2017,36005003300,"Census Tract 33, Bronx County, New York",1286,70,1216,1108,3277,18659,1946,2005,661,36.8,60,12,246,0,793,1216,580
2018,36005003300,"Census Tract 33, Bronx County, New York",1251,53,1198,1065,3025,14857,1973,2004,600,38.1,63,16,275,0,757,1198,550
2019,36005003300,"Census Tract 33, Bronx County, New York",1238,55,1183,1068,2858,20299,1977,2005,693,37.2,83,21,297,0,735,1183,493
2020,36005003300,"Census Tract 33, Bronx County, New York",1240,32,1208,1104,2676,20769,1980,2007,948,36.4,127,12,480,0,657,1208,502
2012,36005003500,"Census Tract 35, Bronx County, New York",1336,61,1275,1233,3457,21214,1945,1999,696,37,129,18,367,0,871,1275,481
2013,36005003500,"Census Tract 35, Bronx County, New York",1346,57,1289,1205,3421,21992,1945,2001,736,34.8,120,7,420,0,795,1289,478
2014,36005003500,"Census Tract 35, Bronx County, New York",1383,74,1309,1235,3432,21250,1943,2002,773,34.1,109,8,426,0,853,1309,513
2015,36005003500,"Census Tract 35, Bronx County, New York",1397,80,1317,1227,3569,24704,1939,2001,843,30.4,132,8,389,0,873,1317,466
2016,36005003500,"Census Tract 35, Bronx County, New York",1410,63,1347,1251,3670,23622,1939,2003,880,28.3,129,7,359,0,922,1347,514
2017,36005003500,"Census Tract 35, Bronx County, New York",1399,71,1328,1229,3548,29946,1953,2004,1004,28.7,140,10,371,0,882,1328,493
2018,36005003500,"Census Tract 35, Bronx County, New York",1384,91,1293,1210,3638,29318,1956,2005,1051,29,153,10,389,0,841,1293,462
2019,36005003500,"Census Tract 35, Bronx County, New York",1402,80,1322,1246,3655,29769,1958,2007,1094,35.4,193,11,452,0,851,1322,523
2020,36005003500,"Census Tract 35, Bronx County, New York",1458,84,1374,1307,3523,28701,1966,2007,1132,41.6,158,27,550,0,941,1374,512
2012,36005003700,"Census Tract 37, Bronx County, New York",83,0,83,83,225,26116,1988,2006,988,34.5,0,0,13,0,70,83,29
2013,36005003700,"Census Tract 37, Bronx County, New York",100,0,100,100,242,34000,1967,2004,869,31.3,0,0,39,0,61,100,36
2014,36005003700,"Census Tract 37, Bronx County, New York",96,0,96,96,199,9327,1960,2003,872,34.7,0,9,30,0,57,96,55
2015,36005003700,"Census Tract 37, Bronx County, New York",118,0,118,118,246,NA,1961,2004,907,34.9,0,9,34,0,75,118,58
2016,36005003700,"Census Tract 37, Bronx County, New York",145,0,145,145,279,NA,1960,2008,930,37.5,4,8,49,0,88,145,60
2017,36005003700,"Census Tract 37, Bronx County, New York",143,0,143,143,292,NA,1960,2006,1035,38.5,4,8,57,0,78,143,55
2018,36005003700,"Census Tract 37, Bronx County, New York",148,0,148,148,269,NA,1943,2008,1076,38.3,20,8,54,0,97,148,70
2019,36005003700,"Census Tract 37, Bronx County, New York",145,0,145,145,250,NA,1961,2011,1074,35.9,21,0,78,0,78,145,63
2020,36005003700,"Census Tract 37, Bronx County, New York",145,0,145,145,222,NA,1966,2010,982,29.9,48,0,105,0,79,145,57
2012,36005003800,"Census Tract 38, Bronx County, New York",443,36,407,241,913,20871,1965,1999,818,37.8,12,15,114,0,112,407,145
2013,36005003800,"Census Tract 38, Bronx County, New York",441,44,397,243,846,16616,1963,1999,853,39.9,8,9,106,0,128,397,148
2014,36005003800,"Census Tract 38, Bronx County, New York",427,58,369,229,756,21292,1965,2001,1056,38.6,18,9,130,0,90,369,107
2015,36005003800,"Census Tract 38, Bronx County, New York",433,63,370,221,612,NA,1964,1998,873,34.9,29,9,134,0,78,370,114
2016,36005003800,"Census Tract 38, Bronx County, New York",433,49,384,283,802,15865,1971,2000,911,33.3,24,6,143,0,134,384,149
2017,36005003800,"Census Tract 38, Bronx County, New York",445,39,406,294,886,26607,1973,2002,1019,30.6,25,6,131,0,157,406,113
2018,36005003800,"Census Tract 38, Bronx County, New York",440,29,411,284,861,34000,1975,2004,1029,28.9,25,0,123,0,161,411,104
2019,36005003800,"Census Tract 38, Bronx County, New York",446,31,415,271,804,28563,1976,2006,990,30.6,22,0,83,0,195,415,110
2020,36005003800,"Census Tract 38, Bronx County, New York",359,26,333,188,593,NA,1976,2009,1114,28.8,16,0,43,0,154,333,87
2012,36005003900,"Census Tract 39, Bronx County, New York",2278,322,1956,1784,6153,22012,1970,2004,894,34.8,156,0,414,78,1369,1956,833
2013,36005003900,"Census Tract 39, Bronx County, New York",2205,311,1894,1765,5622,24546,1963,2004,892,33.9,206,0,454,24,1357,1894,699
2014,36005003900,"Census Tract 39, Bronx County, New York",2228,283,1945,1801,6187,25510,1955,2006,930,35.4,214,0,392,25,1429,1945,679
2015,36005003900,"Census Tract 39, Bronx County, New York",2250,348,1902,1791,6336,NA,1944,2008,954,38,160,0,385,0,1459,1902,666
2016,36005003900,"Census Tract 39, Bronx County, New York",2251,338,1913,1808,6237,26763,1940,2008,1067,39.1,148,36,314,0,1470,1913,644
2017,36005003900,"Census Tract 39, Bronx County, New York",2264,278,1986,1881,6209,28532,1941,2010,1149,37.6,188,94,392,0,1422,1986,651
2018,36005003900,"Census Tract 39, Bronx County, New York",2300,253,2047,1930,6378,24068,1954,2010,1175,40.5,94,63,389,0,1506,2047,798
2019,36005003900,"Census Tract 39, Bronx County, New York",2340,236,2104,1987,5896,22430,1947,2010,1278,40.4,332,80,374,0,1580,2104,831
2020,36005003900,"Census Tract 39, Bronx County, New York",2430,189,2241,2188,6460,20843,1948,2011,1204,34.3,423,67,394,0,1770,2241,1107
2012,36005004001,"Census Tract 40.01, Bronx County, New York",577,74,503,241,660,44135,1951,2003,991,32.9,30,26,48,49,98,503,56
2013,36005004001,"Census Tract 40.01, Bronx County, New York",564,74,490,250,813,42857,1955,2006,965,33.1,33,30,42,49,111,490,77
2014,36005004001,"Census Tract 40.01, Bronx County, New York",565,62,503,255,829,36513,1957,2005,970,33.3,34,52,42,46,97,503,72
2015,36005004001,"Census Tract 40.01, Bronx County, New York",549,59,490,254,804,44868,1959,2001,959,33.4,38,36,30,54,137,490,58
2016,36005004001,"Census Tract 40.01, Bronx County, New York",547,41,506,253,760,47878,1959,2003,1057,33.9,46,44,33,36,159,506,71
2017,36005004001,"Census Tract 40.01, Bronx County, New York",559,65,494,236,635,29056,1962,2005,1095,41.9,21,32,36,17,170,494,71
2018,36005004001,"Census Tract 40.01, Bronx County, New York",552,68,484,215,604,30982,1963,2006,1161,37.1,16,35,41,4,153,484,77
2019,36005004001,"Census Tract 40.01, Bronx County, New York",551,53,498,257,682,50450,1960,2010,1244,35.1,41,20,72,6,168,498,72
2020,36005004001,"Census Tract 40.01, Bronx County, New York",535,46,489,288,754,55000,1960,2011,1264,27.7,63,20,65,13,188,489,69
2012,36005004100,"Census Tract 41, Bronx County, New York",2181,203,1978,1898,5831,17902,1965,2000,514,29.7,164,0,763,21,1369,1978,862
2013,36005004100,"Census Tract 41, Bronx County, New York",2189,164,2025,1866,5439,16649,1964,2000,574,31.7,172,0,671,14,1458,2025,915
2014,36005004100,"Census Tract 41, Bronx County, New York",2145,127,2018,1865,5745,17457,1960,2001,601,32.6,167,0,613,12,1416,2018,954
2015,36005004100,"Census Tract 41, Bronx County, New York",2184,69,2115,1949,5901,17314,1957,2002,576,33.6,123,0,570,11,1529,2115,1038
2016,36005004100,"Census Tract 41, Bronx County, New York",2186,132,2054,1896,5675,17088,1958,2003,538,32.2,104,1,471,12,1542,2054,953
2017,36005004100,"Census Tract 41, Bronx County, New York",2199,169,2030,1871,5405,18087,1957,2005,548,30.4,85,29,440,19,1453,2030,994
2018,36005004100,"Census Tract 41, Bronx County, New York",2234,178,2056,1951,5110,17921,1958,2008,653,32.3,71,24,526,17,1501,2056,1045
2019,36005004100,"Census Tract 41, Bronx County, New York",2293,105,2188,1914,4913,17593,1961,2010,707,36.5,94,24,621,0,1446,2188,978
2020,36005004100,"Census Tract 41, Bronx County, New York",2420,166,2254,1977,4689,17514,1963,2012,659,31.9,109,51,799,0,1259,2254,1011
2012,36005004200,"Census Tract 42, Bronx County, New York",2810,112,2698,2504,6313,24637,1961,1999,609,26.4,414,11,1160,0,1402,2698,676
2013,36005004200,"Census Tract 42, Bronx County, New York",2797,95,2702,2504,6885,25990,1963,1999,709,25.7,447,18,1180,19,1395,2702,784
2014,36005004200,"Census Tract 42, Bronx County, New York",2796,77,2719,2518,7086,20816,1964,2000,737,28.6,257,31,1378,16,1248,2719,885
2015,36005004200,"Census Tract 42, Bronx County, New York",2810,98,2712,2510,6557,24475,1963,2001,795,27.3,261,28,1368,32,1197,2712,816
2016,36005004200,"Census Tract 42, Bronx County, New York",2792,44,2748,2476,7091,21402,1963,2001,815,28.2,288,50,1335,35,1204,2748,1024
2017,36005004200,"Census Tract 42, Bronx County, New York",2780,73,2707,2390,7045,28194,1962,2001,888,29.1,308,47,1279,36,1118,2707,868
2018,36005004200,"Census Tract 42, Bronx County, New York",2804,68,2736,2410,6491,29747,1960,2003,948,29.8,303,41,1190,17,1256,2736,859
2019,36005004200,"Census Tract 42, Bronx County, New York",2792,66,2726,2368,6921,33945,1959,2004,1055,28.4,420,64,1020,14,1359,2726,734
2020,36005004200,"Census Tract 42, Bronx County, New York",2899,24,2875,2439,6853,53986,1958,2006,1140,24.7,735,47,1234,0,1476,2875,693
2012,36005004300,"Census Tract 43, Bronx County, New York",1938,212,1726,1542,4526,19540,1967,2002,709,31.9,193,7,537,0,1200,1726,762
2013,36005004300,"Census Tract 43, Bronx County, New York",2005,196,1809,1611,4741,19934,1961,2003,675,33.4,148,6,556,0,1243,1809,786
2014,36005004300,"Census Tract 43, Bronx County, New York",2063,140,1923,1745,5240,20638,1953,2007,766,35.7,181,7,477,0,1359,1923,858
2015,36005004300,"Census Tract 43, Bronx County, New York",2153,91,2062,1856,5287,19872,1953,2008,780,36,153,7,487,0,1416,2062,948
2016,36005004300,"Census Tract 43, Bronx County, New York",2151,107,2044,1841,5231,18162,1954,2009,786,37.7,143,8,530,6,1354,2044,1006
2017,36005004300,"Census Tract 43, Bronx County, New York",2155,108,2047,1856,5393,19318,1957,2010,781,36.7,134,0,488,11,1417,2047,1002
2018,36005004300,"Census Tract 43, Bronx County, New York",2185,74,2111,1948,5430,21964,1970,2009,791,34.6,189,23,503,8,1502,2111,924
2019,36005004300,"Census Tract 43, Bronx County, New York",2177,116,2061,1909,4821,19450,1975,2010,773,33.5,177,34,545,10,1414,2061,939
2020,36005004300,"Census Tract 43, Bronx County, New York",2216,87,2129,1962,4672,23145,1973,2010,710,29.4,217,37,542,15,1508,2129,832
2012,36005004400,"Census Tract 44, Bronx County, New York",1731,58,1673,1513,3943,19191,1955,1999,460,27.8,135,11,632,20,993,1673,758
2013,36005004400,"Census Tract 44, Bronx County, New York",1723,55,1668,1520,3955,18737,1955,1999,387,26.9,156,19,657,17,978,1668,752
2014,36005004400,"Census Tract 44, Bronx County, New York",1714,44,1670,1510,4051,20709,1954,1999,448,27.4,169,0,594,14,963,1670,668
2015,36005004400,"Census Tract 44, Bronx County, New York",1711,72,1639,1525,4174,21493,1954,1999,526,27.4,209,12,658,0,922,1639,578
2016,36005004400,"Census Tract 44, Bronx County, New York",1696,61,1635,1520,4244,19591,1953,2000,480,28.5,177,9,647,11,916,1635,637
2017,36005004400,"Census Tract 44, Bronx County, New York",1693,57,1636,1551,4010,18435,1953,2001,438,28.9,209,29,690,14,888,1636,701
2018,36005004400,"Census Tract 44, Bronx County, New York",1701,60,1641,1558,4214,20411,1953,2002,561,30.9,225,32,679,20,866,1641,719
2019,36005004400,"Census Tract 44, Bronx County, New York",1709,61,1648,1579,4035,17226,1954,2005,523,33.7,215,47,645,22,914,1648,853
2020,36005004400,"Census Tract 44, Bronx County, New York",1623,24,1599,1545,4050,15662,1956,2006,493,34.8,140,28,549,22,978,1599,955
2012,36005004600,"Census Tract 46, Bronx County, New York",734,72,662,579,1697,21393,1954,1998,714,29.8,83,9,157,0,408,662,217
2013,36005004600,"Census Tract 46, Bronx County, New York",726,69,657,538,1272,25104,1958,1998,733,29.1,78,11,198,0,321,657,171
2014,36005004600,"Census Tract 46, Bronx County, New York",705,19,686,514,1246,39688,1963,2001,744,27.1,102,11,218,0,261,686,157
2015,36005004600,"Census Tract 46, Bronx County, New York",724,25,699,541,1477,28631,1966,2000,762,29.6,144,0,241,0,288,699,177
2016,36005004600,"Census Tract 46, Bronx County, New York",722,24,698,525,1624,33750,1965,2002,808,31.6,121,0,193,0,310,698,169
2017,36005004600,"Census Tract 46, Bronx County, New York",722,4,718,546,1513,35167,1963,2003,775,30.9,114,0,202,0,332,718,173
2018,36005004600,"Census Tract 46, Bronx County, New York",710,4,706,545,1487,29659,1963,2007,777,32.1,102,0,193,0,336,706,232
2019,36005004600,"Census Tract 46, Bronx County, New York",721,0,721,560,1630,22667,1962,2005,750,32.8,63,0,175,0,400,721,309
2020,36005004600,"Census Tract 46, Bronx County, New York",697,0,697,516,1489,27885,1960,2010,992,32.9,59,0,151,0,362,697,246
2012,36005004800,"Census Tract 48, Bronx County, New York",1409,83,1326,1230,3848,24541,1939,2003,992,38.1,95,19,383,44,893,1326,513
2013,36005004800,"Census Tract 48, Bronx County, New York",1398,164,1234,1142,3531,23413,1939,2003,1049,40.5,86,9,318,49,842,1234,473
2014,36005004800,"Census Tract 48, Bronx County, New York",1412,178,1234,1141,3694,23187,1939,2004,1011,40.8,96,27,290,32,852,1234,474
2015,36005004800,"Census Tract 48, Bronx County, New York",1415,202,1213,1112,3553,27571,1939,2004,1054,40.9,110,23,319,23,813,1213,366
2016,36005004800,"Census Tract 48, Bronx County, New York",1445,117,1328,1232,4066,28433,1949,2005,1095,43.4,121,15,324,0,931,1328,392
2017,36005004800,"Census Tract 48, Bronx County, New York",1445,120,1325,1198,3844,31026,1952,2007,1119,42.8,110,42,309,0,866,1325,320
2018,36005004800,"Census Tract 48, Bronx County, New York",1490,83,1407,1316,4240,31319,1950,2009,1117,42.5,116,49,292,0,935,1407,359
2019,36005004800,"Census Tract 48, Bronx County, New York",1463,57,1406,1287,4006,30809,1943,2010,1160,40.8,96,27,250,0,982,1406,355
2020,36005004800,"Census Tract 48, Bronx County, New York",1485,30,1455,1329,4170,30650,0,2012,1239,38.5,203,21,229,0,1089,1455,433
2012,36005005001,"Census Tract 50.01, Bronx County, New York",1577,117,1460,1254,4114,27554,1939,2004,1197,45,144,0,632,0,749,1460,491
2013,36005005001,"Census Tract 50.01, Bronx County, New York",1573,141,1432,1262,4047,27028,1939,2005,1230,47.7,178,0,592,0,832,1432,469
2014,36005005001,"Census Tract 50.01, Bronx County, New York",1595,139,1456,1246,4104,27744,1939,2006,1236,49.4,152,0,617,0,723,1456,467
2015,36005005001,"Census Tract 50.01, Bronx County, New York",1610,129,1481,1230,3732,25441,1942,2007,1245,50,160,0,463,0,827,1481,457
2016,36005005001,"Census Tract 50.01, Bronx County, New York",1666,64,1602,1372,4045,23796,1954,2008,1291,50,132,24,421,0,989,1602,589
2017,36005005001,"Census Tract 50.01, Bronx County, New York",1653,89,1564,1381,4046,22641,1952,2008,1285,50,142,32,423,0,993,1564,664
2018,36005005001,"Census Tract 50.01, Bronx County, New York",1651,86,1565,1364,3989,22231,1952,2009,1268,51,128,16,333,7,1017,1565,683
2019,36005005001,"Census Tract 50.01, Bronx County, New York",1666,150,1516,1316,3646,24134,1948,2009,1297,51,140,16,329,7,984,1516,568
2020,36005005001,"Census Tract 50.01, Bronx County, New York",1550,171,1379,1208,3645,25577,0,2010,1298,51,146,16,366,8,841,1379,531
2012,36005005002,"Census Tract 50.02, Bronx County, New York",1909,326,1583,1541,5383,29406,1939,2002,963,37.7,66,23,440,14,1136,1583,555
2013,36005005002,"Census Tract 50.02, Bronx County, New York",1936,280,1656,1589,5285,30806,1939,2003,1042,35.5,110,26,374,29,1153,1656,560
2014,36005005002,"Census Tract 50.02, Bronx County, New York",1965,213,1752,1666,5374,27054,1939,2004,1098,44.4,103,0,349,31,1271,1752,701
2015,36005005002,"Census Tract 50.02, Bronx County, New York",1992,233,1759,1691,5363,NA,1939,2005,1106,40.7,134,0,381,0,1274,1759,753
2016,36005005002,"Census Tract 50.02, Bronx County, New York",2038,178,1860,1796,5397,25882,1939,2006,1168,46.9,154,8,458,0,1321,1860,811
2017,36005005002,"Census Tract 50.02, Bronx County, New York",2001,113,1888,1807,5172,24933,1939,2009,1203,47.7,163,33,475,0,1318,1888,833
2018,36005005002,"Census Tract 50.02, Bronx County, New York",1982,111,1871,1826,5191,24318,0,2010,1214,48,213,32,465,0,1419,1871,802
2019,36005005002,"Census Tract 50.02, Bronx County, New York",2030,97,1933,1834,5219,30891,0,2012,1235,44.5,302,36,492,0,1388,1933,691
2020,36005005002,"Census Tract 50.02, Bronx County, New York",2084,90,1994,1847,5736,32221,0,2013,1315,45,230,31,572,0,1309,1994,698
2012,36005005100,"Census Tract 51, Bronx County, New York",2036,77,1959,1959,5384,19558,1954,2001,460,28.1,183,0,927,0,1205,1959,880
2013,36005005100,"Census Tract 51, Bronx County, New York",2029,72,1957,1957,5816,21423,1954,2002,519,27.3,227,0,792,0,1262,1957,788
2014,36005005100,"Census Tract 51, Bronx County, New York",2032,75,1957,1957,5774,20233,1953,2002,494,28.8,207,0,759,0,1303,1957,827
2015,36005005100,"Census Tract 51, Bronx County, New York",2031,71,1960,1960,5615,18633,1951,2002,493,29.2,171,0,744,0,1323,1960,932
2016,36005005100,"Census Tract 51, Bronx County, New York",2069,85,1984,1984,5638,19657,1953,2004,522,29.5,188,0,629,13,1422,1984,904
2017,36005005100,"Census Tract 51, Bronx County, New York",2116,70,2046,2046,5684,18428,1955,2006,482,29.4,185,0,640,16,1425,2046,1026
2018,36005005100,"Census Tract 51, Bronx County, New York",2143,60,2083,2083,5551,16844,1955,2006,450,31.7,165,0,726,15,1446,2083,1123
2019,36005005100,"Census Tract 51, Bronx County, New York",2221,60,2161,2161,5702,19115,1956,2009,483,32.3,181,0,804,17,1449,2161,1107
2020,36005005100,"Census Tract 51, Bronx County, New York",2186,35,2151,2151,5825,20439,1957,2011,489,33.9,291,0,843,20,1408,2151,1015
2012,36005005200,"Census Tract 52, Bronx County, New York",805,97,708,687,1751,25859,1948,1998,690,26.5,53,0,209,0,490,708,316
2013,36005005200,"Census Tract 52, Bronx County, New York",792,47,745,726,1858,16667,1949,1997,675,28.4,76,0,262,0,480,745,358
2014,36005005200,"Census Tract 52, Bronx County, New York",813,47,766,742,2002,16293,1956,1998,555,27.5,82,0,213,0,546,766,389
2015,36005005200,"Census Tract 52, Bronx County, New York",831,18,813,771,2102,17229,1953,1997,663,29.2,76,0,247,0,538,813,405
2016,36005005200,"Census Tract 52, Bronx County, New York",832,0,832,795,2262,18646,1955,2003,660,27.9,77,0,242,0,554,832,409
2017,36005005200,"Census Tract 52, Bronx County, New York",848,23,825,795,2068,17302,1955,2006,774,30.9,87,0,272,0,542,825,389
2018,36005005200,"Census Tract 52, Bronx County, New York",879,45,834,806,2018,20379,1955,2008,815,31.2,70,0,263,0,558,834,328
2019,36005005200,"Census Tract 52, Bronx County, New York",889,76,813,789,1886,20919,1953,2010,833,29.4,42,0,286,0,531,813,337
2020,36005005200,"Census Tract 52, Bronx County, New York",921,93,828,762,1714,19728,1950,2010,856,29.9,39,0,326,0,470,828,389
2012,36005005300,"Census Tract 53, Bronx County, New York",1869,369,1500,1500,3538,16582,NA,2001,808,37.4,229,11,924,0,601,1500,734
2013,36005005300,"Census Tract 53, Bronx County, New York",1617,355,1262,1262,3008,15087,1974,2001,602,41.2,190,10,771,0,519,1262,700
2014,36005005300,"Census Tract 53, Bronx County, New York",1613,311,1302,1302,3305,16173,1974,2002,785,40.6,199,13,724,0,572,1302,684
2015,36005005300,"Census Tract 53, Bronx County, New York",1647,241,1406,1406,3727,17719,1973,2004,813,38.2,226,14,786,0,618,1406,680
2016,36005005300,"Census Tract 53, Bronx County, New York",1712,227,1485,1485,3866,15141,1973,2005,946,47.7,150,4,823,0,668,1485,830
2017,36005005300,"Census Tract 53, Bronx County, New York",1658,150,1508,1508,4167,13519,1973,2006,1005,48.6,151,13,855,0,653,1508,844
2018,36005005300,"Census Tract 53, Bronx County, New York",1694,103,1591,1591,4483,16210,1974,2008,1112,49.7,201,15,936,0,678,1591,834
2019,36005005300,"Census Tract 53, Bronx County, New York",1701,15,1686,1686,4888,16583,1973,2010,1156,51,203,23,1009,0,703,1686,908
2020,36005005300,"Census Tract 53, Bronx County, New York",1800,14,1786,1786,5142,18015,1973,2010,1218,51,162,20,1141,0,680,1786,968
2012,36005005400,"Census Tract 54, Bronx County, New York",1938,323,1615,1357,4902,26966,1939,2003,1080,39.9,82,0,484,0,910,1615,585
2013,36005005400,"Census Tract 54, Bronx County, New York",1930,258,1672,1342,4810,26134,1939,2004,1079,40.8,105,0,403,0,942,1672,570
2014,36005005400,"Census Tract 54, Bronx County, New York",1942,213,1729,1451,5311,29564,1939,2005,1164,37.1,107,0,487,0,1027,1729,613
2015,36005005400,"Census Tract 54, Bronx County, New York",1979,250,1729,1491,5167,24596,1939,2007,1179,44.1,83,0,441,9,1092,1729,722
2016,36005005400,"Census Tract 54, Bronx County, New York",1967,220,1747,1458,5162,26116,1939,2008,1204,47.6,104,18,434,16,1078,1747,678
2017,36005005400,"Census Tract 54, Bronx County, New York",1960,160,1800,1494,5384,30129,1939,2009,1196,46.1,105,18,490,18,1073,1800,664
2018,36005005400,"Census Tract 54, Bronx County, New York",1977,195,1782,1499,5010,31313,0,2010,1260,44.4,86,17,506,27,1053,1782,621
2019,36005005400,"Census Tract 54, Bronx County, New York",1969,297,1672,1410,4413,31981,0,2011,1276,45.5,58,14,428,49,954,1672,532
2020,36005005400,"Census Tract 54, Bronx County, New York",1953,240,1713,1432,4525,33906,0,2010,1350,42.4,172,16,439,56,1006,1713,533
2012,36005005600,"Census Tract 56, Bronx County, New York",1074,165,909,828,2063,20814,1939,2004,961,34.7,94,9,307,10,513,909,327
2013,36005005600,"Census Tract 56, Bronx County, New York",1068,176,892,822,2166,22045,1939,2004,988,34,97,15,245,13,568,892,347
2014,36005005600,"Census Tract 56, Bronx County, New York",1026,142,884,814,2191,16711,1945,2006,1002,38,57,11,240,14,560,884,455
2015,36005005600,"Census Tract 56, Bronx County, New York",1021,150,871,778,2129,14861,1942,2006,1042,39.6,27,12,247,14,528,871,445
2016,36005005600,"Census Tract 56, Bronx County, New York",1022,114,908,779,2157,16890,1944,2007,1056,38.7,35,20,216,15,544,908,435
2017,36005005600,"Census Tract 56, Bronx County, New York",1011,128,883,722,2035,14938,1943,2006,1085,39.5,38,15,171,4,543,883,433
2018,36005005600,"Census Tract 56, Bronx County, New York",1009,137,872,711,1847,15817,1942,2008,1126,42.3,59,15,133,4,587,872,417
2019,36005005600,"Census Tract 56, Bronx County, New York",1025,157,868,702,1723,19474,0,2010,1107,37.6,101,32,106,4,576,868,353
2020,36005005600,"Census Tract 56, Bronx County, New York",1025,139,886,697,1484,23125,0,2012,1152,34.7,119,38,84,4,575,886,341
2012,36005005902,"Census Tract 59.02, Bronx County, New York",1142,113,1029,851,2266,35179,1939,1996,1086,36.4,179,28,191,0,680,1029,311
2013,36005005902,"Census Tract 59.02, Bronx County, New York",1153,77,1076,909,2489,29841,1939,2000,1128,38,146,32,190,0,707,1076,342
2014,36005005902,"Census Tract 59.02, Bronx County, New York",1145,68,1077,891,2504,34728,1939,1999,1135,37.4,127,60,195,0,643,1077,298
2015,36005005902,"Census Tract 59.02, Bronx County, New York",1140,75,1065,876,2749,37532,1939,2001,1217,38.4,152,38,195,0,647,1065,255
2016,36005005902,"Census Tract 59.02, Bronx County, New York",1125,50,1075,864,2379,28272,1939,2005,1256,50,201,39,174,0,658,1075,382
2017,36005005902,"Census Tract 59.02, Bronx County, New York",1103,70,1033,797,2347,28107,1939,2006,1314,50,170,42,198,0,551,1033,327
2018,36005005902,"Census Tract 59.02, Bronx County, New York",1084,67,1017,776,2145,28693,0,2006,1336,51,163,26,189,0,542,1017,317
2019,36005005902,"Census Tract 59.02, Bronx County, New York",1074,23,1051,857,2410,29204,0,2007,1322,51,134,24,261,0,564,1051,316
2020,36005005902,"Census Tract 59.02, Bronx County, New York",1126,17,1109,797,2088,27019,0,2005,1263,51,211,28,230,0,539,1109,264
2012,36005006000,"Census Tract 60, Bronx County, New York",392,34,358,291,1291,40042,1939,2003,1092,35.5,33,3,52,5,261,358,111
2013,36005006000,"Census Tract 60, Bronx County, New York",382,53,329,266,1031,39531,1939,2004,1097,33.5,39,3,53,6,229,329,97
2014,36005006000,"Census Tract 60, Bronx County, New York",375,61,314,281,1031,41369,1939,2004,1081,30.7,70,2,57,4,233,314,92
2015,36005006000,"Census Tract 60, Bronx County, New York",396,50,346,306,1073,NA,1939,2006,1102,34.6,79,3,69,9,224,346,128
2016,36005006000,"Census Tract 60, Bronx County, New York",402,62,340,323,1215,38859,1939,2006,1118,35.5,73,0,70,11,248,340,116
2017,36005006000,"Census Tract 60, Bronx County, New York",406,45,361,341,1254,37607,1939,2006,1171,38.9,85,0,66,10,261,361,130
2018,36005006000,"Census Tract 60, Bronx County, New York",423,38,385,354,1233,32386,0,2006,1169,44.2,89,0,88,6,272,385,150
2019,36005006000,"Census Tract 60, Bronx County, New York",421,45,376,339,1143,34362,1942,2004,1177,43.8,57,0,94,8,270,376,114
2020,36005006000,"Census Tract 60, Bronx County, New York",407,37,370,314,957,37742,0,2006,1194,41.8,62,0,70,0,284,370,86
2012,36005006100,"Census Tract 61, Bronx County, New York",2172,178,1994,882,1544,41934,1965,1987,876,25.2,214,13,785,0,73,1994,234
2013,36005006100,"Census Tract 61, Bronx County, New York",2250,185,2065,940,1679,40923,1965,1986,936,29.2,264,18,765,0,124,2065,345
2014,36005006100,"Census Tract 61, Bronx County, New York",2361,170,2191,870,1621,41750,1965,1987,952,29.2,236,17,744,0,107,2191,322
2015,36005006100,"Census Tract 61, Bronx County, New York",2368,199,2169,954,1635,45500,1964,1992,954,28.5,239,16,765,18,152,2169,285
2016,36005006100,"Census Tract 61, Bronx County, New York",2349,174,2175,956,1846,40373,1963,1988,1011,32.1,202,33,743,20,153,2175,344
2017,36005006100,"Census Tract 61, Bronx County, New York",2353,150,2203,1062,1964,39412,1963,1987,1082,35.4,318,49,808,20,269,2203,343
2018,36005006100,"Census Tract 61, Bronx County, New York",2328,185,2143,1101,1955,45126,1963,1998,1135,33.1,348,44,757,17,322,2143,246
2019,36005006100,"Census Tract 61, Bronx County, New York",2264,201,2063,1295,2253,43092,1963,1998,1159,35.8,379,56,872,16,396,2063,264
2020,36005006100,"Census Tract 61, Bronx County, New York",2188,117,2071,1217,2315,48736,1964,1996,1154,25.3,343,47,992,0,261,2071,245
2012,36005006200,"Census Tract 62, Bronx County, New York",2490,189,2301,2150,6607,24726,1952,2003,715,30.8,241,0,884,0,1532,2301,819
2013,36005006200,"Census Tract 62, Bronx County, New York",2480,136,2344,2247,7292,24191,1953,2003,607,31,169,0,960,16,1453,2344,978
2014,36005006200,"Census Tract 62, Bronx County, New York",2522,134,2388,2299,7322,24122,1954,2003,545,30.8,149,0,852,14,1692,2388,925
2015,36005006200,"Census Tract 62, Bronx County, New York",2542,108,2434,2320,7184,24163,1956,2004,613,28.9,162,0,980,15,1651,2434,882
2016,36005006200,"Census Tract 62, Bronx County, New York",2531,129,2402,2325,7131,24609,1956,2005,703,29.9,130,0,973,37,1610,2402,909
2017,36005006200,"Census Tract 62, Bronx County, New York",2538,107,2431,2331,6933,23868,1957,2005,730,31.5,123,0,1021,36,1562,2431,962
2018,36005006200,"Census Tract 62, Bronx County, New York",2528,166,2362,2286,6881,25954,1957,2006,765,32,128,44,871,32,1469,2362,955
2019,36005006200,"Census Tract 62, Bronx County, New York",2552,134,2418,2341,6949,22467,1957,2007,763,32.8,181,50,985,26,1343,2418,1067
2020,36005006200,"Census Tract 62, Bronx County, New York",2679,173,2506,2420,6669,27967,1957,2006,823,30.7,125,32,568,19,1847,2506,815
2012,36005006300,"Census Tract 63, Bronx County, New York",2082,84,1998,1772,4921,31910,1939,2001,1098,35.6,339,135,643,58,1027,1998,549
2013,36005006300,"Census Tract 63, Bronx County, New York",2034,142,1892,1672,4518,31291,1939,2000,1098,36.3,223,74,558,79,1034,1892,588
2014,36005006300,"Census Tract 63, Bronx County, New York",2002,173,1829,1604,3990,32695,1939,2001,1120,33.8,237,83,549,85,936,1829,573
2015,36005006300,"Census Tract 63, Bronx County, New York",2013,179,1834,1668,4048,31174,1939,2003,1153,35.3,314,78,538,73,1022,1834,539
2016,36005006300,"Census Tract 63, Bronx County, New York",2012,173,1839,1698,3935,30941,1939,2004,1162,43.6,380,75,564,59,1066,1839,522
2017,36005006300,"Census Tract 63, Bronx County, New York",1982,139,1843,1667,3863,28940,1939,2004,1171,46.8,362,88,523,59,1075,1843,543
2018,36005006300,"Census Tract 63, Bronx County, New York",1988,97,1891,1715,4015,34619,0,2005,1233,41.7,396,83,577,35,1070,1891,459
2019,36005006300,"Census Tract 63, Bronx County, New York",2019,101,1918,1757,4118,36042,0,2006,1321,43.5,354,147,561,31,1140,1918,507
2020,36005006301,"Census Tract 63.01, Bronx County, New York",2005,64,1941,1612,4016,41692,0,2008,1338,38.3,289,120,503,36,1136,1941,468
2020,36005006302,"Census Tract 63.02, Bronx County, New York",0,0,0,0,0,NA,NA,NA,NA,NA,0,0,0,0,0,0,0
2012,36005006400,"Census Tract 64, Bronx County, New York",1426,187,1239,1056,3388,29310,1954,2003,1214,34.2,157,0,446,57,616,1239,340
2013,36005006400,"Census Tract 64, Bronx County, New York",1406,177,1229,1122,3593,31019,1954,2004,1305,39.6,182,0,452,59,628,1229,332
2014,36005006400,"Census Tract 64, Bronx County, New York",1449,211,1238,1098,3139,22361,1951,2006,1222,49.2,152,0,437,55,618,1238,460
2015,36005006400,"Census Tract 64, Bronx County, New York",1457,163,1294,1173,3185,26776,1954,2007,1181,47.3,205,0,479,38,694,1294,517
2016,36005006400,"Census Tract 64, Bronx County, New York",1442,158,1284,1097,2699,25612,1951,2009,1203,47.9,152,0,490,47,550,1284,466
2017,36005006400,"Census Tract 64, Bronx County, New York",1400,113,1287,1110,2777,27917,1953,2008,1227,47.1,247,19,548,0,528,1287,443
2018,36005006400,"Census Tract 64, Bronx County, New York",1425,88,1337,1072,2622,27500,1953,2010,1198,42.9,186,22,548,5,533,1337,499
2019,36005006400,"Census Tract 64, Bronx County, New York",1385,114,1271,1004,2774,35044,1957,2009,1260,36.4,180,39,479,14,486,1271,354
2020,36005006400,"Census Tract 64, Bronx County, New York",1494,105,1389,1044,2506,21745,1961,2011,1308,39.1,155,54,380,11,580,1389,551
2012,36005006500,"Census Tract 65, Bronx County, New York",1930,169,1761,1748,5422,20775,1974,2002,915,41.9,121,26,678,42,1113,1761,755
2013,36005006500,"Census Tract 65, Bronx County, New York",1986,145,1841,1832,5600,21494,1974,2003,954,42.8,138,58,712,34,1127,1841,775
2014,36005006500,"Census Tract 65, Bronx County, New York",1998,93,1905,1897,5724,21810,1970,2004,962,41.5,131,53,746,9,1130,1905,779
2015,36005006500,"Census Tract 65, Bronx County, New York",2001,65,1936,1929,5372,21228,1970,2005,983,36.1,224,66,750,17,1120,1936,792
2016,36005006500,"Census Tract 65, Bronx County, New York",1996,69,1927,1895,5438,21750,1971,2005,984,35,196,41,748,19,1144,1927,754
2017,36005006500,"Census Tract 65, Bronx County, New York",1976,76,1900,1871,5321,25049,1969,2007,1025,33.6,219,54,717,16,1131,1900,776
2018,36005006500,"Census Tract 65, Bronx County, New York",2027,79,1948,1903,5116,23145,1972,2008,1019,34,269,59,794,17,1075,1948,830
2019,36005006500,"Census Tract 65, Bronx County, New York",2087,125,1962,1920,5145,25215,1975,2010,1059,34.5,373,80,824,21,1171,1962,729
2020,36005006500,"Census Tract 65, Bronx County, New York",2048,127,1921,1866,5092,22025,1980,2011,1147,38.3,292,62,863,5,1131,1921,764
2012,36005006700,"Census Tract 67, Bronx County, New York",2432,164,2268,2102,7134,18000,1954,2001,573,31.3,114,58,790,19,1551,2268,1045
2013,36005006700,"Census Tract 67, Bronx County, New York",2439,106,2333,2162,7300,17635,1951,2002,652,29.6,161,55,847,19,1513,2333,1150
2014,36005006700,"Census Tract 67, Bronx County, New York",2425,88,2337,2215,7386,20777,1945,2004,712,30.8,123,48,886,14,1478,2337,1111
2015,36005006700,"Census Tract 67, Bronx County, New York",2424,112,2312,2194,7087,NA,1949,2005,708,32.3,148,27,732,0,1527,2312,1114
2016,36005006700,"Census Tract 67, Bronx County, New York",2416,94,2322,2207,7248,20603,1950,2006,696,34.1,159,0,674,0,1582,2322,1080
2017,36005006700,"Census Tract 67, Bronx County, New York",2409,92,2317,2218,7078,20754,1951,2006,662,33.9,147,12,720,0,1570,2317,1025
2018,36005006700,"Census Tract 67, Bronx County, New York",2431,95,2336,2212,6966,22565,1953,2007,815,39.5,143,14,585,0,1663,2336,1016
2019,36005006700,"Census Tract 67, Bronx County, New York",2439,109,2330,2213,6495,19547,1953,2005,723,36.7,126,18,600,0,1687,2330,1076
2020,36005006700,"Census Tract 67, Bronx County, New York",2539,71,2468,2368,6465,17799,1946,2006,845,51,123,19,545,0,1881,2468,1221
2012,36005006800,"Census Tract 68, Bronx County, New York",1135,153,982,800,2301,21419,1963,2003,1195,50,162,0,371,47,397,982,328
2013,36005006800,"Census Tract 68, Bronx County, New York",1103,124,979,784,2215,22007,1960,2004,1196,48.4,120,12,379,37,362,979,274
2014,36005006800,"Census Tract 68, Bronx County, New York",1070,139,931,671,1997,27159,1956,2005,1163,43,129,27,309,20,329,931,224
2015,36005006800,"Census Tract 68, Bronx County, New York",1060,86,974,673,2262,33059,1954,2008,1247,41,111,20,274,15,378,974,208
2016,36005006800,"Census Tract 68, Bronx County, New York",1074,82,992,740,2553,41167,1956,2008,1228,32.7,96,22,317,51,368,992,193
2017,36005006800,"Census Tract 68, Bronx County, New York",1089,66,1023,734,2533,40577,1959,2010,1323,33.8,117,21,316,60,354,1023,173
2018,36005006800,"Census Tract 68, Bronx County, New York",1066,50,1016,720,2409,37222,1961,2011,1403,37.1,102,16,242,56,426,1016,261
2019,36005006800,"Census Tract 68, Bronx County, New York",1086,75,1011,797,2652,47917,1961,2013,1458,37.8,175,0,267,82,488,1011,236
2020,36005006800,"Census Tract 68, Bronx County, New York",1067,89,978,727,2342,33029,1965,2014,1472,44.9,141,0,230,89,454,978,289
2012,36005006900,"Census Tract 69, Bronx County, New York",2607,138,2469,2379,6474,20216,1967,2004,723,29.9,146,12,1208,0,1436,2469,1075
2013,36005006900,"Census Tract 69, Bronx County, New York",2689,81,2608,2523,6974,16610,1963,2004,725,31.2,198,9,1111,38,1549,2608,1259
2014,36005006900,"Census Tract 69, Bronx County, New York",2750,158,2592,2429,7203,17088,1960,2005,712,31.4,385,21,1023,47,1427,2592,1191
2015,36005006900,"Census Tract 69, Bronx County, New York",2792,124,2668,2505,7837,17395,1963,2006,734,31.3,434,40,979,43,1428,2668,1289
2016,36005006900,"Census Tract 69, Bronx County, New York",2741,108,2633,2465,7908,25277,1964,2005,873,30.8,463,81,990,57,1394,2633,1108
2017,36005006900,"Census Tract 69, Bronx County, New York",2788,89,2699,2500,7480,26974,1967,2006,913,31.1,548,99,973,43,1430,2699,996
2018,36005006900,"Census Tract 69, Bronx County, New York",2825,86,2739,2496,7026,29065,1970,2008,1084,32.3,588,94,1053,17,1445,2739,1046
2019,36005006900,"Census Tract 69, Bronx County, New York",2815,15,2800,2600,6878,32961,1977,2008,1160,32.2,433,115,1155,6,1499,2800,1070
2020,36005006900,"Census Tract 69, Bronx County, New York",2874,30,2844,2611,6289,32482,1976,2008,1223,33.3,295,72,851,6,1869,2844,1278
2012,36005007000,"Census Tract 70, Bronx County, New York",1431,163,1268,970,3344,28561,1948,2005,1309,44.8,139,17,309,31,622,1268,344
2013,36005007000,"Census Tract 70, Bronx County, New York",1441,143,1298,980,3695,28438,1951,2005,1365,50,138,19,328,38,624,1298,408
2014,36005007000,"Census Tract 70, Bronx County, New York",1422,120,1302,994,3501,26310,1955,2006,1351,50,204,23,291,63,647,1302,354
2015,36005007000,"Census Tract 70, Bronx County, New York",1476,154,1322,1110,3787,29082,1954,2008,1284,46.4,226,33,312,64,738,1322,384
2016,36005007000,"Census Tract 70, Bronx County, New York",1455,94,1361,1081,3746,29160,1954,2009,1288,48,204,26,329,47,710,1361,341
2017,36005007000,"Census Tract 70, Bronx County, New York",1446,112,1334,1053,3488,33125,1963,2009,1325,45.1,182,34,271,67,644,1334,257
2018,36005007000,"Census Tract 70, Bronx County, New York",1408,112,1296,1012,3266,33750,1974,2011,1364,41.7,202,36,239,83,624,1296,229
2019,36005007000,"Census Tract 70, Bronx County, New York",1428,122,1306,999,3051,36013,1954,2011,1404,36.4,188,39,189,102,632,1306,223
2020,36005007000,"Census Tract 70, Bronx County, New York",1425,140,1285,964,3090,35517,1955,2011,1541,34.3,227,58,150,120,610,1285,241
2012,36005007100,"Census Tract 71, Bronx County, New York",656,81,575,350,1567,33788,1971,2003,817,27,0,0,167,0,241,575,146
2013,36005007100,"Census Tract 71, Bronx County, New York",755,79,676,403,1415,29728,1977,2005,826,33,51,0,194,0,259,676,162
2014,36005007100,"Census Tract 71, Bronx County, New York",844,100,744,459,1433,32120,1974,2008,993,34.5,89,0,219,0,282,744,186
2015,36005007100,"Census Tract 71, Bronx County, New York",933,73,860,535,1612,28199,1977,2010,973,32.9,99,0,217,0,351,860,219
2016,36005007100,"Census Tract 71, Bronx County, New York",999,53,946,585,1537,27896,1987,NA,1011,33.5,99,3,185,15,408,946,234
2017,36005007100,"Census Tract 71, Bronx County, New York",998,16,982,605,1618,28098,1992,2011,1036,34.7,121,4,183,12,439,982,238
2018,36005007100,"Census Tract 71, Bronx County, New York",1008,12,996,621,1641,29321,1988,2011,1057,33.2,101,6,196,21,438,996,238
2019,36005007100,"Census Tract 71, Bronx County, New York",1016,11,1005,639,1722,30393,1994,2011,1122,36.3,62,7,233,24,428,1005,220
2020,36005007100,"Census Tract 71, Bronx County, New York",1084,10,1074,701,1759,27723,1998,2013,1098,39.1,71,8,268,37,435,1074,278
2012,36005007200,"Census Tract 72, Bronx County, New York",1818,74,1744,1354,4482,40232,1939,2004,1103,30.9,237,45,255,220,869,1744,500
2013,36005007200,"Census Tract 72, Bronx County, New York",1862,87,1775,1338,4759,39318,1939,2005,1133,31.6,247,51,242,232,812,1775,519
2014,36005007200,"Census Tract 72, Bronx County, New York",1833,107,1726,1270,4615,36875,1939,2006,1170,33.9,277,54,230,205,790,1726,443
2015,36005007200,"Census Tract 72, Bronx County, New York",1788,125,1663,1245,4535,29495,1939,2007,1131,41.9,193,62,227,209,763,1663,478
2016,36005007200,"Census Tract 72, Bronx County, New York",1760,56,1704,1296,4437,27787,1941,2010,1142,47.2,216,83,226,244,760,1704,537
2017,36005007200,"Census Tract 72, Bronx County, New York",1721,72,1649,1283,4557,28719,1943,2008,1194,46.1,196,48,247,260,771,1649,455
2018,36005007200,"Census Tract 72, Bronx County, New York",1701,68,1633,1340,4602,28354,1944,2009,1195,47,180,96,164,313,801,1633,443
2019,36005007200,"Census Tract 72, Bronx County, New York",1683,51,1632,1261,4331,28844,1944,2010,1201,46.1,146,89,143,281,731,1632,424
2020,36005007200,"Census Tract 72, Bronx County, New York",1780,51,1729,1329,4456,35854,0,2010,1302,39.3,239,103,239,311,673,1729,487
2012,36005007300,"Census Tract 73, Bronx County, New York",1395,100,1295,1243,3632,22513,1945,2004,863,42.1,138,34,396,0,897,1295,489
2013,36005007300,"Census Tract 73, Bronx County, New York",1376,106,1270,1234,3390,22007,1949,2004,883,41.2,104,16,508,0,770,1270,462
2014,36005007300,"Census Tract 73, Bronx County, New York",1412,80,1332,1283,3474,20106,1948,2005,892,47.2,91,0,580,0,746,1332,584
2015,36005007300,"Census Tract 73, Bronx County, New York",1387,96,1291,1275,3664,18052,1944,2005,962,46.7,111,28,568,0,700,1291,636
2016,36005007300,"Census Tract 73, Bronx County, New York",1415,93,1322,1303,3940,19934,1948,2007,964,42,90,26,662,0,627,1322,674
2017,36005007300,"Census Tract 73, Bronx County, New York",1413,54,1359,1340,4036,19898,1951,2007,1021,41.9,116,22,560,0,759,1359,733
2018,36005007300,"Census Tract 73, Bronx County, New York",1478,50,1428,1404,4136,20238,1953,2008,1008,42,122,24,430,0,887,1428,779
2019,36005007300,"Census Tract 73, Bronx County, New York",1422,71,1351,1339,4145,22135,1955,2009,1116,37.4,124,19,416,0,1004,1351,670
2020,36005007300,"Census Tract 73, Bronx County, New York",1478,44,1434,1414,4004,20586,1964,2008,1042,46.6,67,0,405,0,1088,1434,735
2012,36005007400,"Census Tract 74, Bronx County, New York",1448,43,1405,780,2352,40241,1968,2001,1052,32.1,128,0,348,0,462,1405,163
2013,36005007400,"Census Tract 74, Bronx County, New York",1440,22,1418,877,2551,35121,1969,1999,1129,37.5,152,0,454,0,423,1418,270
2014,36005007400,"Census Tract 74, Bronx County, New York",1428,45,1383,878,2477,36579,1969,1999,1156,34.8,146,0,431,0,459,1383,238
2015,36005007400,"Census Tract 74, Bronx County, New York",1410,49,1361,786,2132,35870,1970,2001,1182,37.7,136,0,379,0,425,1361,252
2016,36005007400,"Census Tract 74, Bronx County, New York",1445,62,1383,859,2448,35515,1970,2003,1275,39.1,133,8,439,0,428,1383,314
2017,36005007400,"Census Tract 74, Bronx County, New York",1430,91,1339,870,2232,28750,1971,2005,1285,46.7,110,8,479,0,401,1339,324
2018,36005007400,"Census Tract 74, Bronx County, New York",1427,101,1326,861,1982,32788,1969,2005,1306,43.2,123,7,451,0,425,1326,319
2019,36005007400,"Census Tract 74, Bronx County, New York",1441,93,1348,777,2044,27614,1969,2008,1382,51,49,8,384,0,409,1348,354
2020,36005007400,"Census Tract 74, Bronx County, New York",1423,93,1330,764,2092,26196,1974,2008,1238,48.5,97,15,308,0,413,1330,354
2012,36005007500,"Census Tract 75, Bronx County, New York",1790,149,1641,1321,3407,20891,1957,2002,651,28.6,40,33,589,12,792,1641,415
2013,36005007500,"Census Tract 75, Bronx County, New York",1868,112,1756,1458,3772,19573,1958,2005,655,32.3,122,30,659,13,874,1756,550
2014,36005007500,"Census Tract 75, Bronx County, New York",1976,113,1863,1575,4010,20426,1957,2007,697,33.8,168,21,835,0,894,1863,662
2015,36005007500,"Census Tract 75, Bronx County, New York",2203,168,2035,1740,4647,22797,1956,2010,757,34.7,209,8,1005,0,857,2035,719
2016,36005007500,"Census Tract 75, Bronx County, New York",2387,166,2221,1945,5100,25166,1955,2010,793,34.5,246,7,1063,0,951,2221,777
2017,36005007500,"Census Tract 75, Bronx County, New York",2421,145,2276,2021,5306,25244,1959,2010,867,34,281,7,1046,0,1085,2276,828
2018,36005007500,"Census Tract 75, Bronx County, New York",2456,160,2296,2000,5303,28372,1959,2011,1035,34.4,227,8,997,0,1139,2296,760
2019,36005007500,"Census Tract 75, Bronx County, New York",2457,101,2356,2003,5619,27199,1984,2011,1069,34.6,264,9,981,0,1066,2356,762
2020,36005007500,"Census Tract 75, Bronx County, New York",2314,79,2235,1822,5288,28631,1999,NA,1070,32.8,254,12,745,0,1169,2235,719
2012,36005007600,"Census Tract 76, Bronx County, New York",1844,233,1611,1290,4399,34333,1939,2003,1109,37.8,228,44,399,0,956,1611,492
2013,36005007600,"Census Tract 76, Bronx County, New York",1795,224,1571,1294,4666,33833,1939,2004,1165,38.9,230,36,482,0,855,1571,555
2014,36005007600,"Census Tract 76, Bronx County, New York",1800,176,1624,1294,4587,33264,1939,2006,1285,40.5,165,45,330,12,943,1624,512
2015,36005007600,"Census Tract 76, Bronx County, New York",1749,145,1604,1301,4450,29508,1939,2008,1211,43.5,130,50,346,33,917,1604,578
2016,36005007600,"Census Tract 76, Bronx County, New York",1700,104,1596,1276,3951,31424,1939,2010,1226,43.4,127,43,411,29,891,1596,548
2017,36005007600,"Census Tract 76, Bronx County, New York",1704,142,1562,1219,4032,29375,1946,2010,1260,43.6,133,58,263,56,906,1562,533
2018,36005007600,"Census Tract 76, Bronx County, New York",1770,100,1670,1315,4492,30236,1948,2012,1352,46.8,126,48,322,38,926,1670,559
2019,36005007600,"Census Tract 76, Bronx County, New York",1756,114,1642,1297,4200,37898,1948,2012,1340,39.3,214,51,296,89,924,1642,423
2020,36005007600,"Census Tract 76, Bronx County, New York",1888,108,1780,1312,3802,38382,1947,2012,1329,35.8,185,41,300,61,914,1780,446
2012,36005007700,"Census Tract 77, Bronx County, New York",628,36,592,453,1367,25740,1972,2005,1114,50,29,0,180,0,273,592,177
2013,36005007700,"Census Tract 77, Bronx County, New York",637,43,594,462,1376,20000,1973,2006,1111,50,50,0,132,0,330,594,209
2014,36005007700,"Census Tract 77, Bronx County, New York",636,34,602,455,1352,19452,1950,2007,1160,50,76,0,133,0,322,602,223
2015,36005007700,"Census Tract 77, Bronx County, New York",628,25,603,449,1342,21114,1948,2009,1184,50,56,0,137,0,312,603,230
2016,36005007700,"Census Tract 77, Bronx County, New York",638,9,629,475,1484,21433,1950,2010,1221,50,61,4,125,0,352,629,238
2017,36005007700,"Census Tract 77, Bronx County, New York",636,10,626,467,1544,23393,1945,2011,1265,47.3,88,3,159,0,335,626,213
2018,36005007700,"Census Tract 77, Bronx County, New York",633,28,605,454,1531,27500,1948,2011,1230,45.5,83,7,195,0,306,605,204
2019,36005007700,"Census Tract 77, Bronx County, New York",621,29,592,446,1567,27083,1948,2011,1203,45.6,67,8,192,0,307,592,208
2020,36005007700,"Census Tract 77, Bronx County, New York",610,35,575,402,1595,43636,1962,2011,1107,33.1,60,17,179,0,272,575,149
2012,36005007800,"Census Tract 78, Bronx County, New York",2205,140,2065,1765,5582,33454,1948,2004,1125,35.7,249,57,285,144,1261,2065,506
2013,36005007800,"Census Tract 78, Bronx County, New York",2208,187,2021,1726,5705,28409,1956,2006,1176,44.8,191,56,251,164,1302,2021,685
2014,36005007800,"Census Tract 78, Bronx County, New York",2227,223,2004,1707,5373,29205,1955,2007,1232,43.9,226,68,308,138,1183,2004,666
2015,36005007800,"Census Tract 78, Bronx County, New York",2224,207,2017,1735,5313,25524,1948,2008,1275,50,216,60,337,135,1235,2017,719
2016,36005007800,"Census Tract 78, Bronx County, New York",2196,197,1999,1626,5078,27140,1950,2010,1308,50,267,71,266,73,1285,1999,693
2017,36005007800,"Census Tract 78, Bronx County, New York",2260,148,2112,1703,5290,30250,1953,2011,1394,50,288,80,353,14,1295,2112,718
2018,36005007800,"Census Tract 78, Bronx County, New York",2253,136,2117,1725,5474,33588,1952,2011,1466,48.5,350,34,424,42,1228,2117,683
2019,36005007800,"Census Tract 78, Bronx County, New York",2288,87,2201,1799,6014,45156,1954,2011,1511,44.1,346,22,454,85,1240,2201,442
2020,36005007800,"Census Tract 78, Bronx County, New York",2327,116,2211,1692,5543,58010,1954,2011,1575,38.4,346,16,444,66,1179,2211,275
2012,36005007900,"Census Tract 79, Bronx County, New York",2404,229,2175,2095,5964,15148,1957,2002,590,29.8,146,0,728,0,1674,2175,985
2013,36005007900,"Census Tract 79, Bronx County, New York",2437,202,2235,2176,5847,25112,1953,2002,664,29.1,175,0,655,0,1805,2235,910
2014,36005007900,"Census Tract 79, Bronx County, New York",2465,183,2282,2210,5798,19615,1951,2003,697,30.9,236,0,668,0,1826,2282,983
2015,36005007900,"Census Tract 79, Bronx County, New York",2499,159,2340,2286,6175,23111,1939,2004,642,32.1,223,0,581,0,1856,2340,1138
2016,36005007900,"Census Tract 79, Bronx County, New York",2433,140,2293,2242,6422,24663,1943,2004,703,33.8,228,0,698,0,1661,2293,1174
2017,36005007900,"Census Tract 79, Bronx County, New York",2417,100,2317,2289,6795,26175,1955,2006,731,34.5,163,0,787,0,1641,2317,1209
2018,36005007900,"Census Tract 79, Bronx County, New York",2484,107,2377,2351,6818,25216,1959,2007,853,36,180,0,844,0,1611,2377,1226
2019,36005007900,"Census Tract 79, Bronx County, New York",2541,100,2441,2414,6938,25795,1961,2009,683,34.6,233,0,821,0,1624,2441,1260
2020,36005007900,"Census Tract 79, Bronx County, New York",2457,112,2345,2294,6411,30816,1962,2011,1001,34.6,281,0,790,0,1584,2345,1025
2012,36005008300,"Census Tract 83, Bronx County, New York",2146,201,1945,1795,4934,15865,1950,2002,798,47.2,172,11,555,0,1435,1945,951
2013,36005008300,"Census Tract 83, Bronx County, New York",2161,149,2012,1827,5172,16789,1939,2002,786,38.2,157,19,609,0,1408,2012,904
2014,36005008300,"Census Tract 83, Bronx County, New York",2172,109,2063,1817,5171,17694,1939,2003,792,40.4,186,0,512,0,1550,2063,962
2015,36005008300,"Census Tract 83, Bronx County, New York",2211,68,2143,1910,5958,18457,1939,2005,904,40.9,157,0,491,0,1585,2143,978
2016,36005008300,"Census Tract 83, Bronx County, New York",2198,78,2120,1916,6056,19556,1939,2004,889,39,142,0,359,0,1638,2120,978
2017,36005008300,"Census Tract 83, Bronx County, New York",2196,112,2084,1886,5700,22917,1939,2006,957,40.4,202,6,494,0,1519,2084,875
2018,36005008300,"Census Tract 83, Bronx County, New York",2183,125,2058,1791,5502,22355,0,2007,1071,44.4,186,45,474,0,1373,2058,797
2019,36005008300,"Census Tract 83, Bronx County, New York",2235,83,2152,1869,5921,27371,0,2008,1119,42.3,167,45,504,0,1483,2152,697
2020,36005008300,"Census Tract 83, Bronx County, New York",2251,64,2187,1843,5102,38148,1953,2006,1107,40.8,341,42,510,0,1463,2187,612
2012,36005008400,"Census Tract 84, Bronx County, New York",792,90,702,237,788,50489,1978,2002,1232,27.9,65,0,34,0,185,702,116
2013,36005008400,"Census Tract 84, Bronx County, New York",750,93,657,261,943,51302,1976,2003,1345,26.5,88,0,50,0,219,657,108
2014,36005008400,"Census Tract 84, Bronx County, New York",764,60,704,309,988,40729,1975,2005,1454,35.4,81,0,64,0,256,704,83
2015,36005008400,"Census Tract 84, Bronx County, New York",757,73,684,281,861,41417,1972,2006,1503,37.6,58,0,70,0,224,684,96
2016,36005008400,"Census Tract 84, Bronx County, New York",757,38,719,259,750,47813,1973,2006,1471,38.3,50,0,72,0,220,719,76
2017,36005008400,"Census Tract 84, Bronx County, New York",764,36,728,250,735,37708,1974,2010,1607,44,32,0,71,0,217,728,69
2018,36005008400,"Census Tract 84, Bronx County, New York",788,45,743,238,656,33571,1974,2011,1620,42.5,26,0,47,0,197,743,61
2019,36005008400,"Census Tract 84, Bronx County, New York",793,40,753,199,649,NA,1978,2010,1708,32.7,14,0,50,0,157,753,77
2020,36005008400,"Census Tract 84, Bronx County, New York",1002,20,982,272,809,63534,1973,2012,1491,29.8,72,0,44,0,228,982,74
2012,36005008500,"Census Tract 85, Bronx County, New York",1819,185,1634,1523,4524,19162,1945,2003,955,37.2,191,25,504,19,1170,1634,671
2013,36005008500,"Census Tract 85, Bronx County, New York",1878,178,1700,1577,4903,21676,1943,2003,973,35.6,233,36,385,17,1178,1700,667
2014,36005008500,"Census Tract 85, Bronx County, New York",1924,197,1727,1576,5230,22563,1939,2004,970,35,258,33,382,17,1194,1727,653
2015,36005008500,"Census Tract 85, Bronx County, New York",1944,194,1750,1613,4802,24770,1939,2004,914,34,263,31,347,16,1244,1750,657
2016,36005008500,"Census Tract 85, Bronx County, New York",2017,111,1906,1750,5186,23810,1939,2004,1003,35.1,284,22,401,17,1388,1906,744
2017,36005008500,"Census Tract 85, Bronx County, New York",2028,91,1937,1736,5190,26875,1939,2006,1034,35.2,257,14,391,0,1405,1937,663
2018,36005008500,"Census Tract 85, Bronx County, New York",2018,85,1933,1622,4265,24889,0,2009,1035,37.3,255,10,459,0,1193,1933,654
2019,36005008500,"Census Tract 85, Bronx County, New York",1997,45,1952,1607,3885,25536,0,2009,1066,37.7,201,11,461,0,1151,1952,651
2020,36005008500,"Census Tract 85, Bronx County, New York",2145,17,2128,1793,4017,26250,1960,2010,1093,36,203,15,478,0,1388,2128,584
2012,36005008600,"Census Tract 86, Bronx County, New York",1491,125,1366,1228,3404,16727,1957,1999,440,28.2,116,9,356,0,932,1366,638
2013,36005008600,"Census Tract 86, Bronx County, New York",1471,95,1376,1212,2993,16460,1958,2000,392,28.5,80,7,333,0,916,1376,588
2014,36005008600,"Census Tract 86, Bronx County, New York",1482,97,1385,1231,3405,19489,1958,1999,430,29.1,112,7,454,0,821,1385,609
2015,36005008600,"Census Tract 86, Bronx County, New York",1469,45,1424,1231,3245,NA,1957,2000,402,29.4,127,6,460,0,812,1424,596
2016,36005008600,"Census Tract 86, Bronx County, New York",1465,16,1449,1278,3339,19286,1957,2001,408,29,133,7,485,17,807,1449,597
2017,36005008600,"Census Tract 86, Bronx County, New York",1489,19,1470,1319,3563,20863,1958,2000,506,29.8,115,8,471,20,848,1470,588
2018,36005008600,"Census Tract 86, Bronx County, New York",1485,19,1466,1358,3686,22092,1958,2007,598,29.8,144,0,552,19,816,1466,650
2019,36005008600,"Census Tract 86, Bronx County, New York",1482,22,1460,1342,3585,20036,1958,2005,533,30.9,137,0,626,22,701,1460,697
2020,36005008600,"Census Tract 86, Bronx County, New York",1557,20,1537,1264,3040,18182,1958,2000,650,31.6,110,0,579,22,670,1537,602
2012,36005008700,"Census Tract 87, Bronx County, New York",1911,143,1768,1686,5599,25659,1954,2003,930,36.4,87,35,428,0,1261,1768,656
2013,36005008700,"Census Tract 87, Bronx County, New York",1904,87,1817,1754,5879,28557,1952,2004,971,34,89,31,486,0,1295,1817,623
2014,36005008700,"Census Tract 87, Bronx County, New York",1939,94,1845,1778,5972,28285,1948,2004,967,33.9,136,36,462,0,1335,1845,648
2015,36005008700,"Census Tract 87, Bronx County, New York",2003,114,1889,1836,5690,28814,1951,2005,962,33.5,128,8,516,0,1372,1889,644
2016,36005008700,"Census Tract 87, Bronx County, New York",2054,104,1950,1915,6177,28371,1952,2007,1027,36,149,7,508,0,1424,1950,743
2017,36005008700,"Census Tract 87, Bronx County, New York",2086,85,2001,1931,5797,25448,1952,2008,1065,37.6,181,13,638,4,1294,2001,881
2018,36005008700,"Census Tract 87, Bronx County, New York",2129,92,2037,1976,5877,23594,1952,2010,1102,39,217,23,649,6,1324,2037,896
2019,36005008700,"Census Tract 87, Bronx County, New York",2131,75,2056,2002,5862,22500,1954,2010,1048,38.2,215,17,622,7,1346,2056,935
2020,36005008700,"Census Tract 87, Bronx County, New York",2082,26,2056,1991,5901,22917,1959,2010,1098,40.3,241,28,602,6,1400,2056,907
2012,36005008900,"Census Tract 89, Bronx County, New York",1211,72,1139,1084,2947,15391,1946,2004,663,39.7,61,9,212,10,932,1139,620
2013,36005008900,"Census Tract 89, Bronx County, New York",1227,52,1175,1119,3316,17980,1946,2003,731,38.3,100,8,218,9,953,1175,588
2014,36005008900,"Census Tract 89, Bronx County, New York",1246,57,1189,1137,3445,18254,1942,2004,764,37.5,87,8,233,4,987,1189,599
2015,36005008900,"Census Tract 89, Bronx County, New York",1280,72,1208,1177,3394,20118,1939,2005,723,35.7,100,17,230,14,1015,1208,529
2016,36005008900,"Census Tract 89, Bronx County, New York",1272,112,1160,1093,3214,26283,1939,2006,929,34.3,98,8,256,6,919,1160,436
2017,36005008900,"Census Tract 89, Bronx County, New York",1276,136,1140,1093,3286,25321,1939,2006,934,34.3,93,8,231,3,924,1140,468
2018,36005008900,"Census Tract 89, Bronx County, New York",1284,129,1155,1093,3069,24890,0,2009,980,33.8,37,8,236,1,932,1155,427
2019,36005008900,"Census Tract 89, Bronx County, New York",1290,113,1177,1071,2998,28082,1944,2011,1032,31.9,44,16,219,0,899,1177,365
2020,36005008900,"Census Tract 89, Bronx County, New York",1331,114,1217,1120,2813,24764,1959,2012,992,32.4,53,0,246,0,951,1217,291
2012,36005009000,"Census Tract 90, Bronx County, New York",1235,51,1184,878,2558,19444,1956,1995,432,27.4,36,0,322,26,590,1184,489
2013,36005009000,"Census Tract 90, Bronx County, New York",1238,62,1176,863,2930,21971,1958,1997,561,28.3,30,0,324,19,608,1176,466
2014,36005009000,"Census Tract 90, Bronx County, New York",1225,63,1162,860,2788,19015,1958,1998,480,28.8,30,17,390,19,528,1162,466
2015,36005009000,"Census Tract 90, Bronx County, New York",1221,43,1178,830,2275,16536,1957,1999,435,28,18,17,336,20,532,1178,450
2016,36005009000,"Census Tract 90, Bronx County, New York",1219,36,1183,878,2518,12464,1957,2000,438,30.7,8,17,345,0,606,1183,498
2017,36005009000,"Census Tract 90, Bronx County, New York",1215,41,1174,884,2798,20036,1958,2004,464,29.9,9,21,319,0,603,1174,390
2018,36005009000,"Census Tract 90, Bronx County, New York",1217,20,1197,951,2785,20893,1957,2003,467,30.7,28,23,318,0,693,1197,411
2019,36005009000,"Census Tract 90, Bronx County, New York",1205,41,1164,939,2564,20405,1959,2004,440,31.7,37,0,265,0,736,1164,429
2020,36005009000,"Census Tract 90, Bronx County, New York",1211,33,1178,931,2482,23173,1959,2002,815,31.2,29,5,274,0,724,1178,397
2012,36005009200,"Census Tract 92, Bronx County, New York",1912,229,1683,1328,3973,29863,1939,2003,1222,42.4,202,102,241,108,851,1683,452
2013,36005009200,"Census Tract 92, Bronx County, New York",1891,185,1706,1410,4216,27933,1939,2004,1241,48.8,164,69,247,143,931,1706,528
2014,36005009200,"Census Tract 92, Bronx County, New York",1898,170,1728,1301,3844,31235,1939,2004,1263,43.7,157,27,228,133,896,1728,448
2015,36005009200,"Census Tract 92, Bronx County, New York",1878,100,1778,1370,4024,29681,1947,2005,1304,49.1,159,33,247,159,924,1778,438
2016,36005009200,"Census Tract 92, Bronx County, New York",1892,87,1805,1400,4165,31481,1948,2007,1276,44.3,218,19,287,147,927,1805,428
2017,36005009200,"Census Tract 92, Bronx County, New York",1905,103,1802,1336,3977,31667,1947,2011,1313,45.8,231,10,270,124,903,1802,428
2018,36005009200,"Census Tract 92, Bronx County, New York",1969,136,1833,1371,4159,37170,1951,2012,1387,45.7,281,20,333,140,874,1833,416
2019,36005009200,"Census Tract 92, Bronx County, New York",1983,134,1849,1384,3980,35882,1951,2013,1413,46.1,226,53,313,130,879,1849,449
2020,36005009200,"Census Tract 92, Bronx County, New York",1986,107,1879,1403,4187,38490,1942,2015,1444,43.8,291,38,305,187,869,1879,456
2012,36005009300,"Census Tract 93, Bronx County, New York",1979,225,1754,1602,4805,27865,1964,2002,951,43.4,137,40,342,0,1228,1754,577
2013,36005009300,"Census Tract 93, Bronx County, New York",1942,233,1709,1524,4702,28548,1957,2004,1001,44.8,174,39,384,0,1156,1709,547
2014,36005009300,"Census Tract 93, Bronx County, New York",1941,314,1627,1485,4868,29424,1939,2006,1060,43.8,192,41,362,0,1122,1627,582
2015,36005009300,"Census Tract 93, Bronx County, New York",1971,295,1676,1544,5194,29262,1939,2006,1104,44.8,202,44,401,0,1143,1676,643
2016,36005009300,"Census Tract 93, Bronx County, New York",1991,326,1665,1531,5292,30434,1939,2009,1157,44.5,195,24,430,0,1118,1665,672
2017,36005009300,"Census Tract 93, Bronx County, New York",1938,305,1633,1510,5262,31618,1939,2010,1191,43,195,12,503,0,1049,1633,635
2018,36005009300,"Census Tract 93, Bronx County, New York",1965,272,1693,1555,4845,31475,0,2010,1187,45,203,61,555,0,991,1693,660
2019,36005009300,"Census Tract 93, Bronx County, New York",1984,191,1793,1629,4812,29046,0,2011,1191,47.9,237,66,605,0,1001,1793,704
2020,36005009301,"Census Tract 93.01, Bronx County, New York",1896,212,1684,1570,4680,38162,1950,2012,1228,42.6,172,69,565,0,1006,1684,627
2020,36005009302,"Census Tract 93.02, Bronx County, New York",0,0,0,0,0,NA,NA,NA,NA,NA,0,0,0,0,0,0,0
2012,36005009600,"Census Tract 96, Bronx County, New York",775,117,658,462,1576,47500,1942,2006,1447,37.8,116,8,79,31,334,658,129
2013,36005009600,"Census Tract 96, Bronx County, New York",789,99,690,468,1598,45882,1942,2007,1436,36,80,8,107,36,318,690,133
2014,36005009600,"Census Tract 96, Bronx County, New York",831,104,727,469,1535,30250,1947,2010,1449,37.5,77,0,104,62,303,727,148
2015,36005009600,"Census Tract 96, Bronx County, New York",817,94,723,456,1437,30119,1949,2010,1385,37,84,7,117,56,277,723,156
2016,36005009600,"Census Tract 96, Bronx County, New York",812,65,747,500,1523,26500,1954,2010,1526,38.9,92,21,118,74,305,747,181
2017,36005009600,"Census Tract 96, Bronx County, New York",827,61,766,475,1453,26845,1967,2011,1406,35.4,66,23,140,64,256,766,180
2018,36005009600,"Census Tract 96, Bronx County, New York",824,50,774,513,1562,26680,1962,2011,1536,39.9,79,30,131,82,266,774,173
2019,36005009600,"Census Tract 96, Bronx County, New York",815,50,765,501,1569,29732,1968,2012,1584,39.6,74,28,130,59,267,765,187
2020,36005009600,"Census Tract 96, Bronx County, New York",855,55,800,529,1626,34432,1995,2014,1656,44.5,63,38,137,41,318,800,192
2012,36005009800,"Census Tract 98, Bronx County, New York",1914,201,1713,1008,2473,37642,1957,2002,1165,34.3,202,37,310,13,680,1713,273
2013,36005009800,"Census Tract 98, Bronx County, New York",1873,189,1684,985,2668,34934,1961,2004,1318,40.3,223,28,339,34,625,1684,366
2014,36005009800,"Census Tract 98, Bronx County, New York",1893,210,1683,970,2579,35521,1961,2004,1363,42.6,213,32,336,31,612,1683,346
2015,36005009800,"Census Tract 98, Bronx County, New York",1822,91,1731,1017,2760,37188,1962,2007,1415,34.4,269,0,360,35,666,1731,337
2016,36005009800,"Census Tract 98, Bronx County, New York",1810,55,1755,1009,2806,38698,1965,2006,1386,31.5,241,0,404,41,605,1755,330
2017,36005009800,"Census Tract 98, Bronx County, New York",1829,91,1738,987,2584,43975,1966,2005,1346,29.8,260,0,364,43,577,1738,268
2018,36005009800,"Census Tract 98, Bronx County, New York",1821,139,1682,899,2106,44482,1963,2003,1347,31.7,239,12,313,30,521,1682,196
2019,36005009800,"Census Tract 98, Bronx County, New York",1830,104,1726,1008,2447,46750,1958,2008,1433,33,281,10,294,23,665,1726,265
2020,36005009800,"Census Tract 98, Bronx County, New York",1722,127,1595,922,2276,50486,1966,2007,1442,29,327,11,323,18,535,1595,314
2012,36005011000,"Census Tract 110, Bronx County, New York",63,11,52,52,150,44125,1976,1998,984,27.3,12,0,0,0,52,52,0
2013,36005011000,"Census Tract 110, Bronx County, New York",60,10,50,50,140,46417,1974,1998,983,27.2,12,0,0,0,50,50,8
2014,36005011000,"Census Tract 110, Bronx County, New York",81,10,71,71,205,46573,1972,2004,1051,26.3,11,0,0,0,71,71,16
2015,36005011000,"Census Tract 110, Bronx County, New York",66,11,55,55,153,NA,1939,2012,1411,18.1,25,0,0,0,55,55,16
2016,36005011000,"Census Tract 110, Bronx County, New York",56,0,56,56,151,NA,1939,2012,1406,18.1,25,0,0,0,56,56,17
2017,36005011000,"Census Tract 110, Bronx County, New York",46,0,46,46,113,NA,1939,NA,1382,18.3,15,0,0,0,46,46,17
2018,36005011000,"Census Tract 110, Bronx County, New York",0,0,0,0,0,NA,NA,NA,NA,NA,0,0,0,0,0,0,0
2019,36005011000,"Census Tract 110, Bronx County, New York",0,0,0,0,0,NA,NA,NA,NA,NA,0,0,0,0,0,0,0
2020,36005011000,"Census Tract 110, Bronx County, New York",0,0,0,0,0,NA,NA,NA,NA,NA,0,0,0,0,0,0,0
2012,36005011502,"Census Tract 115.02, Bronx County, New York",1562,117,1445,1401,4246,17455,1977,2003,916,39.6,119,0,467,6,1020,1445,744
2013,36005011502,"Census Tract 115.02, Bronx County, New York",1543,154,1389,1318,4026,19700,1961,2004,931,38.9,154,0,451,3,933,1389,700
2014,36005011502,"Census Tract 115.02, Bronx County, New York",1565,187,1378,1307,3921,19727,1955,2004,896,39.4,155,0,443,5,926,1378,655
2015,36005011502,"Census Tract 115.02, Bronx County, New York",1570,210,1360,1267,3939,20055,1949,2006,889,39.3,162,11,432,9,893,1360,609
2016,36005011502,"Census Tract 115.02, Bronx County, New York",1546,231,1315,1220,4009,19592,1945,2007,998,41.3,146,11,397,10,905,1315,581
2017,36005011502,"Census Tract 115.02, Bronx County, New York",1543,233,1310,1209,3874,19522,1947,2008,1070,44.7,114,14,456,0,813,1310,573
2018,36005011502,"Census Tract 115.02, Bronx County, New York",1482,232,1250,1180,3774,20577,1956,2009,1030,41.3,96,12,488,9,727,1250,574
2019,36005011502,"Census Tract 115.02, Bronx County, New York",1495,191,1304,1217,3918,16074,1954,2009,970,46.4,127,14,534,9,744,1304,741
2020,36005011502,"Census Tract 115.02, Bronx County, New York",1473,125,1348,1270,3840,19615,1957,2008,1151,51,105,0,502,10,822,1348,668
2012,36005011700,"Census Tract 117, Bronx County, New York",620,50,570,556,1580,14600,1961,2003,1005,43.1,59,9,247,19,327,570,291
2013,36005011700,"Census Tract 117, Bronx County, New York",613,55,558,537,1520,19185,1955,2003,991,46.3,79,15,233,18,323,558,258
2014,36005011700,"Census Tract 117, Bronx County, New York",623,40,583,571,1500,25306,1950,2003,986,40.3,87,16,225,19,346,583,217
2015,36005011700,"Census Tract 117, Bronx County, New York",621,44,577,568,1594,25739,1943,2004,1019,39.5,94,13,234,15,343,577,209
2016,36005011700,"Census Tract 117, Bronx County, New York",626,64,562,545,1519,26607,1939,2005,1094,38.4,69,16,215,0,328,562,200
2017,36005011700,"Census Tract 117, Bronx County, New York",624,53,571,557,1602,23042,1939,2007,1108,47.1,97,0,248,0,335,571,231
2018,36005011700,"Census Tract 117, Bronx County, New York",620,75,545,534,1575,22885,0,2010,1193,49.3,80,0,261,0,288,545,240
2019,36005011700,"Census Tract 117, Bronx County, New York",612,86,526,506,1390,21164,1952,2004,1105,51,104,5,269,0,262,526,245
2020,36005011701,"Census Tract 117.01, Bronx County, New York",546,72,474,451,1294,24652,1963,2003,1122,32.3,82,5,255,0,233,474,178
2020,36005011702,"Census Tract 117.02, Bronx County, New York",0,0,0,0,0,NA,NA,NA,NA,NA,0,0,0,0,0,0,0
2012,36005011800,"Census Tract 118, Bronx County, New York",1763,69,1694,513,962,36523,1961,2004,1177,39.1,244,307,0,19,187,1694,164
2013,36005011800,"Census Tract 118, Bronx County, New York",1730,164,1566,382,712,31905,1964,2004,1196,43.1,158,242,0,8,132,1566,196
2014,36005011800,"Census Tract 118, Bronx County, New York",1702,129,1573,499,952,65408,1966,2007,1308,28.8,146,317,0,41,141,1573,175
2015,36005011800,"Census Tract 118, Bronx County, New York",1635,113,1522,404,847,66618,1963,2010,1527,26.3,131,218,0,24,162,1522,188
2016,36005011800,"Census Tract 118, Bronx County, New York",1599,109,1490,400,910,86500,1961,2011,1752,24.7,97,234,9,28,129,1490,169
2017,36005011800,"Census Tract 118, Bronx County, New York",1630,122,1508,374,897,96875,1962,2012,1785,24.3,37,158,42,28,146,1508,165
2018,36005011800,"Census Tract 118, Bronx County, New York",1649,44,1605,491,1230,99531,1964,2013,1754,21.6,54,182,51,41,217,1605,170
2019,36005011800,"Census Tract 118, Bronx County, New York",1654,38,1616,518,1245,94419,1965,2015,1960,23.5,71,150,55,10,303,1616,136
2020,36005011800,"Census Tract 118, Bronx County, New York",1712,116,1596,622,1609,81078,1959,2016,1926,29,80,259,45,19,299,1596,150
2012,36005011900,"Census Tract 119, Bronx County, New York",2065,126,1939,1862,5404,22500,1949,2002,956,41.1,211,0,538,0,1331,1939,785
2013,36005011900,"Census Tract 119, Bronx County, New York",2030,152,1878,1814,5466,22711,1953,2003,950,40.2,204,0,515,0,1340,1878,765
2014,36005011900,"Census Tract 119, Bronx County, New York",2024,115,1909,1856,5362,23147,1953,2004,958,39.9,177,0,553,0,1342,1909,743
2015,36005011900,"Census Tract 119, Bronx County, New York",2074,131,1943,1845,5273,21477,1939,2005,937,38.8,200,0,514,0,1371,1943,804
2016,36005011900,"Census Tract 119, Bronx County, New York",2071,211,1860,1764,4900,22042,1939,2006,941,38.8,90,0,542,14,1243,1860,750
2017,36005011900,"Census Tract 119, Bronx County, New York",2082,205,1877,1800,5232,22472,1939,2008,1046,40.9,101,8,514,12,1318,1877,720
2018,36005011900,"Census Tract 119, Bronx County, New York",2094,174,1920,1813,5210,28159,0,2007,1020,36.6,138,15,470,11,1320,1920,705
2019,36005011900,"Census Tract 119, Bronx County, New York",2119,186,1933,1798,5007,28575,1941,2008,1053,34.7,173,16,402,12,1408,1933,738
2020,36005011900,"Census Tract 119, Bronx County, New York",1914,151,1763,1662,5075,29948,1946,2007,1088,33.8,138,25,431,13,1241,1763,614
2012,36005012101,"Census Tract 121.01, Bronx County, New York",1033,118,915,753,2304,28224,1956,2002,1019,40.2,47,0,170,4,591,915,283
2013,36005012101,"Census Tract 121.01, Bronx County, New York",1011,113,898,800,2712,31371,1940,2003,1026,42.7,67,0,262,5,575,898,328
2014,36005012101,"Census Tract 121.01, Bronx County, New York",998,155,843,703,2430,26956,1939,2003,1006,47.7,58,9,191,4,530,843,288
2015,36005012101,"Census Tract 121.01, Bronx County, New York",1014,145,869,728,2510,26859,1942,2005,1055,47.8,60,23,196,5,540,869,320
2016,36005012101,"Census Tract 121.01, Bronx County, New York",1029,154,875,721,2288,28327,1939,2007,1013,49.3,54,22,190,5,524,875,283
2017,36005012101,"Census Tract 121.01, Bronx County, New York",1018,109,909,729,2391,24750,1939,2009,1044,50,48,35,204,5,497,909,325
2018,36005012101,"Census Tract 121.01, Bronx County, New York",1015,89,926,690,2043,28476,0,2009,1138,49.1,61,33,193,6,466,926,288
2019,36005012101,"Census Tract 121.01, Bronx County, New York",1019,44,975,746,2183,35938,0,2010,1212,39.6,63,24,261,6,482,975,256
2020,36005012101,"Census Tract 121.01, Bronx County, New York",973,32,941,714,2125,36250,0,2012,1251,41.4,46,17,242,5,458,941,251
2012,36005012102,"Census Tract 121.02, Bronx County, New York",532,17,515,507,1447,12412,1957,2001,767,45.6,47,0,95,7,430,515,289
2013,36005012102,"Census Tract 121.02, Bronx County, New York",548,26,522,500,1494,16509,1949,1999,574,39.5,59,0,80,8,427,522,232
2014,36005012102,"Census Tract 121.02, Bronx County, New York",541,33,508,499,1467,17396,1939,2001,572,39.2,43,0,70,6,440,508,246
2015,36005012102,"Census Tract 121.02, Bronx County, New York",544,13,531,522,1818,19688,1939,2002,541,29.5,46,0,97,0,448,531,234
2016,36005012102,"Census Tract 121.02, Bronx County, New York",534,23,511,511,1682,18692,1939,2002,495,29.8,37,0,72,0,452,511,237
2017,36005012102,"Census Tract 121.02, Bronx County, New York",536,25,511,505,1527,20362,1939,2004,537,31.8,38,0,80,0,425,511,244
2018,36005012102,"Census Tract 121.02, Bronx County, New York",538,27,511,507,1489,22257,0,2005,688,32.3,22,0,69,0,437,511,238
2019,36005012102,"Census Tract 121.02, Bronx County, New York",552,29,523,518,1410,23095,0,2006,836,34.9,22,0,97,0,436,523,238
2020,36005012102,"Census Tract 121.02, Bronx County, New York",564,31,533,521,1257,23345,1950,2009,930,36.6,39,0,122,0,417,533,235
2012,36005012300,"Census Tract 123, Bronx County, New York",1445,169,1276,1197,3203,15797,1983,2003,642,37.8,121,27,321,0,833,1276,714
2013,36005012300,"Census Tract 123, Bronx County, New York",1500,210,1290,1184,3318,16588,1983,2004,645,36.1,108,0,355,0,839,1290,662
2014,36005012300,"Census Tract 123, Bronx County, New York",1615,229,1386,1245,3488,16274,1983,2005,631,36.2,127,24,383,0,833,1386,693
2015,36005012300,"Census Tract 123, Bronx County, New York",1697,207,1490,1349,3750,16039,1976,2008,630,34,192,18,388,0,924,1490,741
2016,36005012300,"Census Tract 123, Bronx County, New York",1651,185,1466,1333,3328,20464,1968,2007,663,33.6,207,24,423,9,892,1466,619
2017,36005012300,"Census Tract 123, Bronx County, New York",1634,170,1464,1331,3390,17246,1980,2007,674,31.5,188,20,457,11,914,1464,584
2018,36005012300,"Census Tract 123, Bronx County, New York",1643,144,1499,1386,3380,22857,1987,2007,798,35,189,15,510,8,943,1499,544
2019,36005012300,"Census Tract 123, Bronx County, New York",1709,101,1608,1548,3730,31051,1996,2009,880,35.5,209,0,639,7,1021,1608,481
2020,36005012300,"Census Tract 123, Bronx County, New York",1592,82,1510,1365,3483,31913,1996,2009,929,35.4,118,0,622,7,846,1510,379
2012,36005012500,"Census Tract 125, Bronx County, New York",1292,115,1177,1017,3271,20434,2000,2005,1036,50,192,6,392,0,615,1177,542
2013,36005012500,"Census Tract 125, Bronx County, New York",1376,77,1299,1122,3441,22332,1979,2006,1080,50,158,28,337,0,771,1299,531
2014,36005012500,"Census Tract 125, Bronx County, New York",1432,114,1318,1129,3437,23764,1987,2007,1140,50,201,29,349,10,772,1318,510
2015,36005012500,"Census Tract 125, Bronx County, New York",1460,88,1372,1168,3583,24936,1976,2008,1127,49.7,151,26,295,22,838,1372,522
2016,36005012500,"Census Tract 125, Bronx County, New York",1485,87,1398,1172,3472,24148,1972,2009,1089,46.3,174,21,338,21,810,1398,542
2017,36005012500,"Census Tract 125, Bronx County, New York",1512,110,1402,1140,3510,27747,1958,2010,1171,48.2,194,19,326,34,789,1402,517
2018,36005012500,"Census Tract 125, Bronx County, New York",1489,141,1348,1125,3437,28414,1984,2011,1186,48,265,8,383,40,707,1348,480
2019,36005012500,"Census Tract 125, Bronx County, New York",1497,181,1316,1070,3009,32775,1981,2011,1136,39.9,192,11,364,12,674,1316,440
2020,36005012500,"Census Tract 125, Bronx County, New York",1435,175,1260,955,2909,35013,2001,2011,1199,37.6,141,15,289,0,675,1260,367
2012,36005012701,"Census Tract 127.01, Bronx County, New York",830,29,801,687,1630,13948,1955,2003,556,36.8,10,33,127,0,543,801,364
2013,36005012701,"Census Tract 127.01, Bronx County, New York",833,36,797,723,1959,20130,1952,2003,652,32.3,24,43,127,0,588,797,320
2014,36005012701,"Census Tract 127.01, Bronx County, New York",825,53,772,690,1749,17656,1952,2004,625,33.9,27,17,154,0,565,772,364
2015,36005012701,"Census Tract 127.01, Bronx County, New York",829,69,760,679,1685,NA,1942,2004,726,37,55,19,163,6,539,760,385
2016,36005012701,"Census Tract 127.01, Bronx County, New York",829,90,739,628,1532,14405,1939,2005,733,39.8,49,25,130,4,483,739,376
2017,36005012701,"Census Tract 127.01, Bronx County, New York",850,113,737,609,1514,14188,1939,2007,808,33.7,78,23,140,4,448,737,327
2018,36005012701,"Census Tract 127.01, Bronx County, New York",819,96,723,593,1410,15398,0,2010,805,38.8,44,21,113,9,449,723,340
2019,36005012701,"Census Tract 127.01, Bronx County, New York",826,64,762,610,1480,28929,0,2008,909,33.8,78,10,175,19,385,762,275
2020,36005012701,"Census Tract 127.01, Bronx County, New York",766,34,732,582,1616,33968,0,2008,1029,31.2,53,9,139,8,387,732,194
2012,36005012901,"Census Tract 129.01, Bronx County, New York",1501,141,1360,1302,3007,13032,1992,2005,795,41.9,32,22,478,43,834,1360,737
2013,36005012901,"Census Tract 129.01, Bronx County, New York",1504,119,1385,1331,3298,14092,1992,2005,877,47.3,63,19,585,28,783,1385,709
2014,36005012901,"Census Tract 129.01, Bronx County, New York",1452,116,1336,1292,3456,17365,1993,2006,938,46,79,8,594,32,716,1336,654
2015,36005012901,"Census Tract 129.01, Bronx County, New York",1457,107,1350,1299,3598,NA,1989,2006,966,44.4,116,25,526,23,758,1350,662
2016,36005012901,"Census Tract 129.01, Bronx County, New York",1529,92,1437,1378,3820,20410,1987,2007,942,43,113,26,617,25,733,1437,703
2017,36005012901,"Census Tract 129.01, Bronx County, New York",1555,110,1445,1336,3983,23812,1989,2007,1007,42.8,189,25,564,0,775,1445,584
2018,36005012901,"Census Tract 129.01, Bronx County, New York",1596,109,1487,1386,3654,25550,1992,2008,939,34.5,210,28,506,0,884,1487,525
2019,36005012901,"Census Tract 129.01, Bronx County, New York",1668,131,1537,1407,3788,25831,1994,2009,934,32.3,234,35,471,0,934,1537,606
2020,36005012901,"Census Tract 129.01, Bronx County, New York",1693,103,1590,1500,4176,30446,1993,2013,999,33.7,195,0,591,0,964,1590,526
2012,36005013000,"Census Tract 130, Bronx County, New York",442,0,442,227,494,73438,1966,2004,1189,21.4,35,123,29,0,94,442,50
2013,36005013000,"Census Tract 130, Bronx County, New York",449,0,449,215,492,69940,1968,2006,1277,22.7,21,140,8,0,66,449,17
2014,36005013000,"Census Tract 130, Bronx County, New York",475,0,475,220,564,73750,1962,2007,1327,20.4,14,134,14,0,76,475,25
2015,36005013000,"Census Tract 130, Bronx County, New York",462,0,462,199,550,73250,1959,2010,1384,20,35,102,16,0,79,462,28
2016,36005013000,"Census Tract 130, Bronx County, New York",483,0,483,211,586,75060,1957,2011,1429,20.7,38,88,20,0,105,483,30
2017,36005013000,"Census Tract 130, Bronx County, New York",496,0,496,170,509,76029,1958,2011,1422,23.5,49,68,25,0,90,496,21
2018,36005013000,"Census Tract 130, Bronx County, New York",482,19,463,158,506,103571,1961,2012,1468,25,43,48,27,0,93,463,23
2019,36005013000,"Census Tract 130, Bronx County, New York",481,17,464,150,384,95769,1971,2013,1487,28,39,44,28,0,77,464,23
2020,36005013000,"Census Tract 130, Bronx County, New York",490,29,461,180,532,NA,0,2016,2480,51,17,23,25,0,138,461,97
2012,36005013100,"Census Tract 131, Bronx County, New York",1697,86,1611,1362,3956,19220,1974,2004,836,39,113,30,494,10,831,1611,682
2013,36005013100,"Census Tract 131, Bronx County, New York",1721,138,1583,1315,3763,21453,1977,2005,855,35.6,102,25,504,3,816,1583,580
2014,36005013100,"Census Tract 131, Bronx County, New York",1815,179,1636,1419,4038,21496,1967,2005,899,33.2,116,44,432,0,941,1636,576
2015,36005013100,"Census Tract 131, Bronx County, New York",1790,229,1561,1372,3951,20586,1964,2007,886,34.5,150,30,418,0,935,1561,602
2016,36005013100,"Census Tract 131, Bronx County, New York",1821,194,1627,1430,4284,23372,1962,2008,901,33.7,163,22,501,0,963,1627,581
2017,36005013100,"Census Tract 131, Bronx County, New York",1848,210,1638,1439,4454,31823,1963,2010,1020,30.4,156,13,603,0,914,1638,502
2018,36005013100,"Census Tract 131, Bronx County, New York",1857,189,1668,1440,4249,27184,1969,2011,1069,33.1,188,25,591,0,906,1668,581
2019,36005013100,"Census Tract 131, Bronx County, New York",1889,174,1715,1536,4414,25690,1978,2011,1091,36.1,223,16,628,0,1014,1715,675
2020,36005013100,"Census Tract 131, Bronx County, New York",2202,104,2098,1884,4403,25000,1986,2012,1134,39,269,16,1131,0,1225,2098,817
2012,36005013200,"Census Tract 132, Bronx County, New York",2508,102,2406,784,2205,72879,1961,2005,1531,23.5,169,263,189,0,331,2406,157
2013,36005013200,"Census Tract 132, Bronx County, New York",2552,90,2462,850,2279,74063,1954,2007,1455,23.2,235,236,177,0,437,2462,220
2014,36005013200,"Census Tract 132, Bronx County, New York",2589,71,2518,961,2417,80938,1957,2010,1373,23.6,290,307,187,0,512,2518,171
2015,36005013200,"Census Tract 132, Bronx County, New York",2560,96,2464,870,2179,83077,1957,2011,1371,24.1,366,258,140,0,497,2464,144
2016,36005013200,"Census Tract 132, Bronx County, New York",2547,94,2453,834,2007,86914,1957,2011,1309,24,356,219,190,0,497,2453,88
2017,36005013200,"Census Tract 132, Bronx County, New York",2575,101,2474,823,2021,89366,1957,2011,1379,25.5,339,236,173,0,492,2474,98
2018,36005013200,"Census Tract 132, Bronx County, New York",2541,58,2483,749,2062,93542,1963,2012,1411,25.8,244,244,220,16,374,2483,64
2019,36005013200,"Census Tract 132, Bronx County, New York",2533,52,2481,708,1998,93529,1986,2012,1478,23,258,158,196,16,420,2481,162
2020,36005013200,"Census Tract 132, Bronx County, New York",2596,0,2596,934,2446,75776,1971,2014,1676,24.7,356,124,288,121,521,2596,227
2012,36005013300,"Census Tract 133, Bronx County, New York",2360,120,2240,2017,5985,18581,1956,1998,467,28.5,182,0,1024,10,1116,2240,837
2013,36005013300,"Census Tract 133, Bronx County, New York",2345,157,2188,1979,5717,17905,1955,2000,499,27.4,237,0,910,11,1207,2188,815
2014,36005013300,"Census Tract 133, Bronx County, New York",2361,137,2224,2018,6298,21413,1954,2000,617,28.3,271,22,830,10,1255,2224,718
2015,36005013300,"Census Tract 133, Bronx County, New York",2398,148,2250,2092,6673,21667,1954,2002,706,28.6,266,18,714,0,1428,2250,736
2016,36005013300,"Census Tract 133, Bronx County, New York",2379,129,2250,2108,5617,20817,1954,2004,675,30.6,254,28,804,12,1268,2250,780
2017,36005013300,"Census Tract 133, Bronx County, New York",2387,156,2231,2131,5504,21327,1955,2006,790,32.3,261,19,800,71,1242,2231,803
2018,36005013300,"Census Tract 133, Bronx County, New York",2432,80,2352,2222,5640,21602,1959,2006,750,32,90,14,955,69,1253,2352,869
2019,36005013300,"Census Tract 133, Bronx County, New York",2466,84,2382,2281,5730,22364,1960,2006,802,31.1,161,51,878,70,1355,2382,914
2020,36005013300,"Census Tract 133, Bronx County, New York",2346,70,2276,2109,5386,40013,1963,2009,793,27.6,134,43,709,90,1353,2276,742
2012,36005013500,"Census Tract 135, Bronx County, New York",1433,164,1269,1075,2946,18163,1954,2002,572,30.4,49,8,433,0,657,1269,628
2013,36005013500,"Census Tract 135, Bronx County, New York",1378,177,1201,1043,2876,18413,1954,2003,570,30.7,97,11,498,0,566,1201,583
2014,36005013500,"Census Tract 135, Bronx County, New York",1391,155,1236,1072,3246,20167,1951,2003,545,28.2,79,2,471,0,618,1236,560
2015,36005013500,"Census Tract 135, Bronx County, New York",1415,137,1278,1123,3147,20544,1951,2005,531,28.6,71,12,446,0,667,1278,523
2016,36005013500,"Census Tract 135, Bronx County, New York",1462,123,1339,1215,3353,22401,1951,2005,702,29.9,127,11,489,0,738,1339,516
2017,36005013500,"Census Tract 135, Bronx County, New York",1490,130,1360,1241,3287,20792,1952,2006,750,31.2,145,10,484,0,773,1360,564
2018,36005013500,"Census Tract 135, Bronx County, New York",1533,118,1415,1326,3317,21038,1953,2006,747,31.7,98,0,562,0,795,1415,587
2019,36005013500,"Census Tract 135, Bronx County, New York",1552,110,1442,1320,3298,21188,1954,2007,816,34.8,99,0,619,0,761,1442,577
2020,36005013500,"Census Tract 135, Bronx County, New York",1557,84,1473,1376,3481,24286,1955,2004,940,32.7,149,0,667,0,801,1473,618
2012,36005013800,"Census Tract 138, Bronx County, New York",1420,123,1297,387,884,52614,1974,2004,1458,36.1,79,205,33,10,139,1297,165
2013,36005013800,"Census Tract 138, Bronx County, New York",1368,117,1251,397,945,76106,1974,2004,1460,26.8,106,173,36,5,183,1251,131
2014,36005013800,"Census Tract 138, Bronx County, New York",1384,134,1250,378,905,56667,1970,2005,1370,29.3,39,134,66,14,164,1250,95
2015,36005013800,"Census Tract 138, Bronx County, New York",1347,135,1212,355,696,55871,1967,2004,1262,30.7,65,149,32,17,157,1212,57
2016,36005013800,"Census Tract 138, Bronx County, New York",1337,176,1161,384,753,44231,1961,2004,1273,38.7,71,176,30,17,161,1161,122
2017,36005013800,"Census Tract 138, Bronx County, New York",1215,203,1012,288,664,47174,1948,2005,1340,32.1,35,98,18,25,147,1012,102
2018,36005013800,"Census Tract 138, Bronx County, New York",1208,138,1070,410,873,53621,1957,2008,1407,31.2,53,156,23,29,202,1070,99
2019,36005013800,"Census Tract 138, Bronx County, New York",1239,108,1131,466,1012,53966,1968,2011,1422,32.9,64,194,17,0,267,1131,107
2020,36005013800,"Census Tract 138, Bronx County, New York",1214,62,1152,440,1114,61923,1976,2014,1422,30.1,42,150,58,0,257,1152,150
2012,36005014100,"Census Tract 141, Bronx County, New York",1479,167,1312,1276,3265,28167,1995,2006,879,35.6,172,18,530,12,779,1312,370
2013,36005014100,"Census Tract 141, Bronx County, New York",1720,197,1523,1460,3512,29766,2000,2007,972,35.7,238,31,590,10,907,1523,385
2014,36005014100,"Census Tract 141, Bronx County, New York",1932,203,1729,1607,4181,27264,2001,2010,1025,35.4,310,39,653,8,966,1729,442
2015,36005014100,"Census Tract 141, Bronx County, New York",2139,211,1928,1806,4915,29539,2001,2011,1010,34.1,358,37,716,8,1097,1928,530
2016,36005014100,"Census Tract 141, Bronx County, New York",2193,120,2073,1962,5392,28256,2001,NA,1074,34.6,405,19,747,21,1184,2073,588
2017,36005014100,"Census Tract 141, Bronx County, New York",2248,125,2123,1977,5301,26399,2000,2011,1065,34,408,22,827,17,1129,2123,722
2018,36005014100,"Census Tract 141, Bronx County, New York",2292,110,2182,2037,5411,30584,2001,2011,1054,33.9,394,27,973,14,1041,2182,712
2019,36005014100,"Census Tract 141, Bronx County, New York",2404,102,2302,2189,5432,30647,2002,2012,1087,34.3,436,42,930,12,1255,2302,819
2020,36005014100,"Census Tract 141, Bronx County, New York",2576,49,2527,2384,5162,27155,2004,2012,1207,38.6,486,50,1174,11,939,2527,992
2012,36005014300,"Census Tract 143, Bronx County, New York",351,50,301,301,785,11635,1951,2004,610,45,0,7,121,0,167,301,180
2013,36005014300,"Census Tract 143, Bronx County, New York",364,49,315,311,707,9926,1948,2005,447,37.9,0,22,120,11,146,315,210
2014,36005014300,"Census Tract 143, Bronx County, New York",410,8,402,392,874,12083,1957,2006,423,34.2,9,38,154,15,166,402,275
2015,36005014300,"Census Tract 143, Bronx County, New York",450,8,442,428,879,NA,1968,2007,451,34.8,15,37,186,16,169,442,268
2016,36005014300,"Census Tract 143, Bronx County, New York",483,8,475,444,929,16304,1973,2010,541,33.5,16,36,195,15,173,475,244
2017,36005014300,"Census Tract 143, Bronx County, New York",555,0,555,524,1037,14348,1979,2011,723,33.4,67,43,265,13,196,555,300
2018,36005014300,"Census Tract 143, Bronx County, New York",642,0,642,614,1246,15227,1993,2012,696,35,103,25,356,0,274,642,320
2019,36005014300,"Census Tract 143, Bronx County, New York",675,12,663,641,1325,16875,1998,2012,805,36.4,93,13,402,0,288,663,314
2020,36005014300,"Census Tract 143, Bronx County, New York",661,12,649,634,1518,20500,1996,2012,735,34.4,164,13,355,18,320,649,285
2012,36005014400,"Census Tract 144, Bronx County, New York",2223,221,2002,1850,4865,19614,1959,2001,468,27.4,99,97,687,17,1069,2002,784
2013,36005014400,"Census Tract 144, Bronx County, New York",2230,209,2021,1860,5001,19562,1959,2002,515,27.4,87,129,660,12,1093,2021,800
2014,36005014400,"Census Tract 144, Bronx County, New York",2259,148,2111,1941,5331,18909,1960,2002,537,29.9,74,129,751,26,1077,2111,875
2015,36005014400,"Census Tract 144, Bronx County, New York",2254,93,2161,1918,5173,18010,1960,2002,544,30.5,152,90,906,24,1003,2161,966
2016,36005014400,"Census Tract 144, Bronx County, New York",2269,99,2170,1856,5067,20303,1962,2005,567,27.9,160,92,873,15,1000,2170,827
2017,36005014400,"Census Tract 144, Bronx County, New York",2269,113,2156,1894,4497,19573,1959,2006,558,28.7,154,76,1023,12,948,2156,804
2018,36005014400,"Census Tract 144, Bronx County, New York",2376,87,2289,1978,4254,17670,1960,2006,495,27.3,211,14,975,32,1142,2289,929
2019,36005014400,"Census Tract 144, Bronx County, New York",2405,169,2236,1922,3954,16915,1959,2007,491,26.4,272,0,918,6,1190,2236,1010
2020,36005014400,"Census Tract 144, Bronx County, New York",2500,107,2393,2096,4261,14797,1959,2007,456,28.9,92,10,893,7,1445,2393,1149
2012,36005014500,"Census Tract 145, Bronx County, New York",2092,110,1982,1958,5746,20550,1956,2002,795,33.9,108,10,1065,0,890,1982,883
2013,36005014500,"Census Tract 145, Bronx County, New York",2150,158,1992,1967,5796,20553,1958,2004,785,34.8,136,11,972,0,977,1992,975
2014,36005014500,"Census Tract 145, Bronx County, New York",2225,115,2110,2050,6300,21098,1958,2005,793,34.7,132,11,972,0,1073,2110,1021
2015,36005014500,"Census Tract 145, Bronx County, New York",2300,57,2243,2184,6911,NA,1957,2006,797,34.8,160,0,962,0,1214,2243,1152
2016,36005014500,"Census Tract 145, Bronx County, New York",2348,75,2273,2210,7701,24190,1961,2007,902,34.1,178,0,970,0,1217,2273,1118
2017,36005014500,"Census Tract 145, Bronx County, New York",2353,64,2289,2216,7482,28750,1966,2009,1005,31.8,190,17,1012,0,1211,2289,935
2018,36005014500,"Census Tract 145, Bronx County, New York",2409,29,2380,2290,7519,29167,1966,2009,1034,32.5,148,17,1108,0,1342,2380,889
2019,36005014500,"Census Tract 145, Bronx County, New York",2430,30,2400,2336,7024,30778,1966,2011,1023,35,153,97,1283,0,1267,2400,845
2020,36005014500,"Census Tract 145, Bronx County, New York",2384,29,2355,2330,6810,35047,1986,2013,1043,34.8,108,91,1467,0,1087,2355,940
2012,36005014701,"Census Tract 147.01, Bronx County, New York",2010,23,1987,1987,5709,15538,1956,2000,426,29,123,10,1167,0,846,1987,1085
2013,36005014701,"Census Tract 147.01, Bronx County, New York",2039,0,2039,2039,6607,21106,1957,2001,438,27,114,15,1220,0,833,2039,979
2014,36005014701,"Census Tract 147.01, Bronx County, New York",2053,21,2032,2029,6909,17150,1956,2000,397,28.4,117,13,1078,0,1020,2032,1163
2015,36005014701,"Census Tract 147.01, Bronx County, New York",2054,51,2003,1996,6646,14301,1956,2000,381,29,250,54,1021,0,1046,2003,1198
2016,36005014701,"Census Tract 147.01, Bronx County, New York",2039,43,1996,1991,6776,16104,1955,2001,436,29.5,235,38,1094,0,1004,1996,1128
2017,36005014701,"Census Tract 147.01, Bronx County, New York",2051,61,1990,1984,7251,21361,1955,2003,479,28,220,21,1157,0,995,1990,1126
2018,36005014701,"Census Tract 147.01, Bronx County, New York",2061,77,1984,1976,6759,14894,1955,2004,477,29,278,24,1003,0,1055,1984,1126
2019,36005014701,"Census Tract 147.01, Bronx County, New York",2052,57,1995,1995,6708,17013,1961,2006,595,31.1,278,46,1168,0,859,1995,1171
2020,36005014701,"Census Tract 147.01, Bronx County, New York",2068,42,2026,2026,5906,27625,1963,2004,798,31.7,226,15,1396,0,687,2026,841
2012,36005014702,"Census Tract 147.02, Bronx County, New York",1645,26,1619,1619,5436,16505,1957,1999,452,30.5,60,0,787,0,878,1619,800
2013,36005014702,"Census Tract 147.02, Bronx County, New York",1625,41,1584,1584,5073,17940,1956,1999,440,28.7,77,0,707,0,927,1584,770
2014,36005014702,"Census Tract 147.02, Bronx County, New York",1595,40,1555,1555,5089,17509,1954,2001,433,29.1,82,0,780,0,802,1555,830
2015,36005014702,"Census Tract 147.02, Bronx County, New York",1654,34,1620,1620,5243,17782,1951,2002,477,28.5,149,0,672,0,976,1620,863
2016,36005014702,"Census Tract 147.02, Bronx County, New York",1679,34,1645,1645,5326,18276,1952,2001,500,27.6,164,0,700,0,967,1645,894
2017,36005014702,"Census Tract 147.02, Bronx County, New York",1672,0,1672,1672,5511,19425,1953,2003,513,27.5,191,0,756,0,947,1672,888
2018,36005014702,"Census Tract 147.02, Bronx County, New York",1659,0,1659,1659,5348,21893,1955,2004,503,26.4,139,0,745,0,967,1659,783
2019,36005014702,"Census Tract 147.02, Bronx County, New York",1664,0,1664,1658,5406,21842,1958,2003,499,26.4,158,18,800,0,937,1664,791
2020,36005014702,"Census Tract 147.02, Bronx County, New York",1893,0,1893,1888,5252,30511,1961,2004,480,23,74,17,720,0,1277,1893,737
2012,36005014900,"Census Tract 149, Bronx County, New York",1593,189,1404,1341,4011,22987,1945,2003,862,36.8,148,19,602,0,760,1404,583
2013,36005014900,"Census Tract 149, Bronx County, New York",1588,240,1348,1284,3750,22026,1950,2003,903,43.3,168,19,601,0,684,1348,607
2014,36005014900,"Census Tract 149, Bronx County, New York",1601,179,1422,1356,4139,22957,1939,2005,916,43.6,167,26,697,0,661,1422,649
2015,36005014900,"Census Tract 149, Bronx County, New York",1622,207,1415,1344,3884,24535,1939,2007,958,42.4,213,16,699,0,659,1415,620
2016,36005014900,"Census Tract 149, Bronx County, New York",1656,193,1463,1337,3845,23818,1939,2007,981,42.5,151,34,701,0,649,1463,596
2017,36005014900,"Census Tract 149, Bronx County, New York",1678,144,1534,1410,3760,24244,1939,2008,1065,43,151,28,727,0,697,1534,624
2018,36005014900,"Census Tract 149, Bronx County, New York",1710,87,1623,1468,3979,24867,0,2009,1081,40.9,110,27,680,0,803,1623,610
2019,36005014900,"Census Tract 149, Bronx County, New York",1718,106,1612,1481,3668,25438,1946,2010,1138,43.2,164,28,798,0,711,1612,575
2020,36005014900,"Census Tract 149, Bronx County, New York",1561,77,1484,1331,3868,23060,1954,2011,1146,46.4,99,29,630,0,718,1484,583
2012,36005015100,"Census Tract 151, Bronx County, New York",1974,127,1847,1680,5582,27200,1939,2002,1039,37.2,100,17,863,0,876,1847,695
2013,36005015100,"Census Tract 151, Bronx County, New York",1977,141,1836,1628,5198,26895,1939,2003,1025,35.2,112,14,752,0,901,1836,651
2014,36005015100,"Census Tract 151, Bronx County, New York",1970,178,1792,1569,4841,27175,1939,2004,1046,38.3,120,27,688,0,840,1792,617
2015,36005015100,"Census Tract 151, Bronx County, New York",1980,221,1759,1552,4663,27959,1939,2006,1000,39.4,171,25,663,0,867,1759,561
2016,36005015100,"Census Tract 151, Bronx County, New York",1958,227,1731,1504,4251,26917,1939,2007,1035,36.9,209,39,606,0,858,1731,527
2017,36005015100,"Census Tract 151, Bronx County, New York",1973,234,1739,1464,4092,24786,1939,2009,1082,42.6,222,19,620,0,851,1739,523
2018,36005015100,"Census Tract 151, Bronx County, New York",1938,206,1732,1447,4000,26198,0,2008,1095,39.2,196,20,624,0,862,1732,511
2019,36005015100,"Census Tract 151, Bronx County, New York",1994,154,1840,1600,4527,24286,1944,2009,1109,42.3,226,18,758,0,891,1840,629
2020,36005015100,"Census Tract 151, Bronx County, New York",2191,164,2027,1730,4489,24917,1953,2008,1148,40.6,139,16,1066,0,721,2027,619
2012,36005015200,"Census Tract 152, Bronx County, New York",956,92,864,459,1286,45057,1957,2005,1336,32.8,58,139,36,0,244,864,162
2013,36005015200,"Census Tract 152, Bronx County, New York",960,106,854,407,1199,45438,1953,2006,1290,38,48,138,49,0,230,854,138
2014,36005015200,"Census Tract 152, Bronx County, New York",1010,118,892,397,1320,45703,1948,2007,1331,41.5,69,122,49,11,225,892,181
2015,36005015200,"Census Tract 152, Bronx County, New York",989,118,871,296,961,60833,1952,2007,1337,28.1,76,88,36,10,182,871,148
2016,36005015200,"Census Tract 152, Bronx County, New York",999,109,890,309,932,55694,1955,2010,1399,29.9,75,103,27,11,175,890,148
2017,36005015200,"Census Tract 152, Bronx County, New York",986,86,900,320,971,60000,1955,2011,1377,28.6,76,102,28,24,173,900,141
2018,36005015200,"Census Tract 152, Bronx County, New York",956,46,910,385,1089,55938,1954,2011,1451,29.6,101,129,25,23,215,910,145
2019,36005015200,"Census Tract 152, Bronx County, New York",933,37,896,405,1146,60240,1955,2011,1574,31.3,97,162,46,9,212,896,123
2020,36005015200,"Census Tract 152, Bronx County, New York",1025,63,962,437,1201,57563,1954,2012,1589,35,157,135,53,15,249,962,133
2012,36005015300,"Census Tract 153, Bronx County, New York",1417,43,1374,1051,3110,14909,1972,2004,1056,50,100,0,572,0,508,1374,636
2013,36005015300,"Census Tract 153, Bronx County, New York",1469,50,1419,1108,3153,17816,1960,2004,1073,48.5,116,15,566,0,545,1419,641
2014,36005015300,"Census Tract 153, Bronx County, New York",1488,73,1415,1174,3683,17526,1972,2005,1041,49,127,28,546,0,624,1415,683
2015,36005015300,"Census Tract 153, Bronx County, New York",1544,72,1472,1221,3563,14644,1970,2006,1092,50,127,16,617,0,598,1472,755
2016,36005015300,"Census Tract 153, Bronx County, New York",1658,81,1577,1329,3983,14989,1984,2008,1097,50,152,16,688,0,622,1577,818
2017,36005015300,"Census Tract 153, Bronx County, New York",1686,65,1621,1391,3996,15222,1981,2010,1062,50,140,21,741,0,694,1621,855
2018,36005015300,"Census Tract 153, Bronx County, New York",1685,99,1586,1342,3923,15641,1985,2011,1102,51,137,0,751,12,643,1586,802
2019,36005015300,"Census Tract 153, Bronx County, New York",1622,137,1485,1260,3620,17598,1963,2011,1099,46.7,89,0,726,8,596,1485,738
2020,36005015300,"Census Tract 153, Bronx County, New York",1803,158,1645,1465,3651,29716,1943,2012,1102,43.4,90,0,750,7,847,1645,615
2012,36005015500,"Census Tract 155, Bronx County, New York",1074,27,1047,968,3222,27024,1939,2001,863,31.7,64,12,230,0,743,1047,289
2013,36005015500,"Census Tract 155, Bronx County, New York",1066,26,1040,984,3173,25729,1943,2001,899,31.7,54,8,257,0,751,1040,347
2014,36005015500,"Census Tract 155, Bronx County, New York",1072,12,1060,1009,2933,22846,1939,2002,861,33.1,81,16,281,6,748,1060,442
2015,36005015500,"Census Tract 155, Bronx County, New York",1103,13,1090,1010,2999,20631,1939,2003,760,32.5,108,15,178,7,837,1090,539
2016,36005015500,"Census Tract 155, Bronx County, New York",1126,14,1112,1048,2789,16469,1941,2005,764,37.3,148,8,197,8,875,1112,559
2017,36005015500,"Census Tract 155, Bronx County, New York",1142,11,1131,1069,2841,17083,1945,2006,860,44.1,145,10,158,9,939,1131,590
2018,36005015500,"Census Tract 155, Bronx County, New York",1119,8,1111,1035,2683,19230,1946,2007,882,41.3,108,10,168,17,863,1111,511
2019,36005015500,"Census Tract 155, Bronx County, New York",1136,8,1128,1064,2728,21367,1954,2010,928,38.8,118,0,243,21,875,1128,480
2020,36005015500,"Census Tract 155, Bronx County, New York",1114,32,1082,1029,2727,26607,1959,2008,978,37,93,0,327,36,764,1082,358
2012,36005015700,"Census Tract 157, Bronx County, New York",1272,175,1097,930,2591,25761,1972,2004,931,34,77,39,342,14,553,1097,352
2013,36005015700,"Census Tract 157, Bronx County, New York",1264,163,1101,957,2829,23606,1982,2006,991,37.7,86,27,383,16,567,1101,381
2014,36005015700,"Census Tract 157, Bronx County, New York",1299,81,1218,1021,3207,31424,1989,2008,958,34.6,56,13,385,15,644,1218,421
2015,36005015700,"Census Tract 157, Bronx County, New York",1389,100,1289,1112,3467,33750,1987,2008,982,35.1,79,18,398,17,706,1289,362
2016,36005015700,"Census Tract 157, Bronx County, New York",1408,106,1302,1110,3512,29432,1985,2010,1004,37,73,21,392,26,705,1302,386
2017,36005015700,"Census Tract 157, Bronx County, New York",1478,64,1414,1232,3797,33692,1989,2011,1041,34.1,124,0,510,25,769,1414,414
2018,36005015700,"Census Tract 157, Bronx County, New York",1603,87,1516,1348,3814,32292,1984,2011,1049,34.1,170,6,457,32,963,1516,587
2019,36005015700,"Census Tract 157, Bronx County, New York",1748,53,1695,1534,3997,29375,1983,2012,1175,35.1,235,9,835,16,876,1695,619
2020,36005015700,"Census Tract 157, Bronx County, New York",1700,50,1650,1514,4233,29205,1986,2013,1169,34.3,285,9,711,25,925,1650,612
2012,36005015800,"Census Tract 158, Bronx County, New York",517,57,460,212,562,53045,1968,2002,1181,26.1,21,72,48,0,92,460,65
2013,36005015800,"Census Tract 158, Bronx County, New York",507,63,444,171,428,53229,1967,2003,1203,23.5,19,48,44,0,79,444,76
2014,36005015800,"Census Tract 158, Bronx County, New York",510,66,444,172,453,52750,1965,2004,1414,24.7,39,47,31,0,94,444,65
2015,36005015800,"Census Tract 158, Bronx County, New York",506,82,424,157,418,69375,1969,2002,1590,24,44,45,18,0,94,424,37
2016,36005015800,"Census Tract 158, Bronx County, New York",490,90,400,159,436,60625,1965,2007,1608,25.9,55,32,14,0,113,400,22
2017,36005015800,"Census Tract 158, Bronx County, New York",577,75,502,254,577,41042,1968,2009,1451,43.6,78,101,32,0,121,502,48
2018,36005015800,"Census Tract 158, Bronx County, New York",561,92,469,271,637,31083,1971,2011,1453,47.5,55,121,24,0,126,469,43
2019,36005015800,"Census Tract 158, Bronx County, New York",555,85,470,250,663,30357,1969,2012,1535,40.5,42,135,13,4,98,470,84
2020,36005015800,"Census Tract 158, Bronx County, New York",521,80,441,233,655,NA,1965,2014,1561,37,42,119,12,4,98,441,90
2012,36005015900,"Census Tract 159, Bronx County, New York",714,0,714,706,2524,16696,1967,1997,705,28.1,100,0,60,0,657,714,358
2013,36005015900,"Census Tract 159, Bronx County, New York",714,41,673,664,2167,17244,1966,1998,640,27.6,127,0,41,0,632,673,326
2014,36005015900,"Census Tract 159, Bronx County, New York",709,51,658,645,1800,15972,1969,1997,441,29.7,109,0,56,6,609,658,337
2015,36005015900,"Census Tract 159, Bronx County, New York",708,67,641,629,1385,NA,1970,2002,419,31.3,149,0,66,21,567,641,353
2016,36005015900,"Census Tract 159, Bronx County, New York",701,68,633,607,1509,13958,1968,2001,387,30.3,73,0,60,20,547,633,358
2017,36005015900,"Census Tract 159, Bronx County, New York",708,59,649,600,1682,16538,1966,2003,461,32.8,56,0,63,18,541,649,367
2018,36005015900,"Census Tract 159, Bronx County, New York",705,15,690,643,1811,16103,1968,2003,494,32.1,54,0,86,19,566,690,376
2019,36005015900,"Census Tract 159, Bronx County, New York",715,13,702,630,1747,14250,1968,2004,423,30.5,39,0,62,14,573,702,399
2020,36005015900,"Census Tract 159, Bronx County, New York",782,10,772,693,1878,NA,1964,2004,NA,32,21,0,125,0,665,772,385
2012,36005016000,"Census Tract 160, Bronx County, New York",1632,137,1495,617,1372,55446,1971,2005,1719,38.4,204,387,0,0,195,1495,60
2013,36005016000,"Census Tract 160, Bronx County, New York",1608,113,1495,679,1664,47212,1954,2005,1772,41.3,217,456,0,0,223,1495,70
2014,36005016000,"Census Tract 160, Bronx County, New York",1680,97,1583,752,1946,67667,1956,2007,1589,29.2,270,479,0,0,273,1583,123
2015,36005016000,"Census Tract 160, Bronx County, New York",1702,176,1526,735,1917,68229,1961,2008,1636,28.4,226,444,0,0,291,1526,73
2016,36005016000,"Census Tract 160, Bronx County, New York",1641,101,1540,771,1876,78885,1971,2008,1692,28.2,197,498,0,0,264,1540,123
2017,36005016000,"Census Tract 160, Bronx County, New York",1661,121,1540,755,1929,69450,1972,2009,1686,29.4,182,392,8,0,346,1540,150
2018,36005016000,"Census Tract 160, Bronx County, New York",1642,81,1561,720,1988,68443,1975,2011,1715,34.1,218,269,10,0,433,1561,192
2019,36005016000,"Census Tract 160, Bronx County, New York",1601,119,1482,601,1544,71116,1972,2011,1748,31,158,284,10,0,298,1482,181
2020,36005016000,"Census Tract 160, Bronx County, New York",1637,149,1488,650,1746,80789,1963,2015,1798,26.8,146,249,29,0,365,1488,226
2012,36005016100,"Census Tract 161, Bronx County, New York",1825,65,1760,1708,4409,18701,1951,2001,597,37.4,122,24,375,16,1335,1760,912
2013,36005016100,"Census Tract 161, Bronx County, New York",1804,66,1738,1699,4255,15806,1959,2001,558,34.1,71,36,417,17,1291,1738,924
2014,36005016100,"Census Tract 161, Bronx County, New York",1781,70,1711,1673,4013,13849,1966,2003,528,32.5,127,0,551,19,1166,1711,911
2015,36005016100,"Census Tract 161, Bronx County, New York",1813,62,1751,1719,4043,12258,1971,2004,470,32.3,149,0,554,15,1211,1751,971
2016,36005016100,"Census Tract 161, Bronx County, New York",1801,65,1736,1716,4241,15385,1968,2004,455,30,157,0,533,18,1225,1736,913
2017,36005016100,"Census Tract 161, Bronx County, New York",1857,42,1815,1798,4314,14472,1965,2005,432,30.3,203,9,580,0,1270,1815,991
2018,36005016100,"Census Tract 161, Bronx County, New York",1856,104,1752,1722,4203,15690,1960,2007,447,31.1,202,9,617,0,1143,1752,931
2019,36005016100,"Census Tract 161, Bronx County, New York",1910,109,1801,1782,4510,17795,1958,2007,444,30.2,155,10,600,0,1226,1801,887
2020,36005016100,"Census Tract 161, Bronx County, New York",2014,134,1880,1865,4496,19050,1943,2011,895,29.6,159,11,704,0,1185,1880,716
2012,36005016200,"Census Tract 162, Bronx County, New York",628,56,572,268,653,37813,1951,2005,1153,43.4,77,160,40,0,97,572,115
2013,36005016200,"Census Tract 162, Bronx County, New York",636,92,544,301,794,34402,1954,2005,1007,31.7,99,162,50,0,127,544,104
2014,36005016200,"Census Tract 162, Bronx County, New York",652,80,572,274,736,28125,1948,2005,1167,46.9,58,164,17,0,99,572,95
2015,36005016200,"Census Tract 162, Bronx County, New York",638,84,554,245,682,27841,1950,2006,1213,43.9,42,129,29,0,104,554,83
2016,36005016200,"Census Tract 162, Bronx County, New York",623,66,557,250,662,NA,1943,2009,1233,29.3,55,105,29,0,131,557,74
2017,36005016200,"Census Tract 162, Bronx County, New York",625,56,569,265,725,NA,1939,2008,1361,28.1,44,126,0,0,139,569,63
2018,36005016200,"Census Tract 162, Bronx County, New York",617,41,576,244,655,77500,1946,2009,1360,27.6,53,115,0,0,129,576,59
2019,36005016200,"Census Tract 162, Bronx County, New York",607,47,560,288,791,NA,1962,2011,1395,27.8,59,92,0,15,181,560,70
2020,36005016200,"Census Tract 162, Bronx County, New York",569,32,537,287,880,NA,1963,2013,1460,41.9,47,108,0,12,167,537,70
2012,36005016300,"Census Tract 163, Bronx County, New York",0,0,0,0,0,NA,NA,NA,NA,NA,0,0,0,0,0,0,0
2013,36005016300,"Census Tract 163, Bronx County, New York",0,0,0,0,0,NA,NA,NA,NA,NA,0,0,0,0,0,0,0
2014,36005016300,"Census Tract 163, Bronx County, New York",0,0,0,0,0,NA,NA,NA,NA,NA,0,0,0,0,0,0,0
2015,36005016300,"Census Tract 163, Bronx County, New York",0,0,0,0,0,NA,NA,NA,NA,NA,0,0,0,0,0,0,0
2016,36005016300,"Census Tract 163, Bronx County, New York",0,0,0,0,0,NA,NA,NA,NA,NA,0,0,0,0,0,0,0
2017,36005016300,"Census Tract 163, Bronx County, New York",0,0,0,0,0,NA,NA,NA,NA,NA,0,0,0,0,0,0,0
2018,36005016300,"Census Tract 163, Bronx County, New York",0,0,0,0,0,NA,NA,NA,NA,NA,0,0,0,0,0,0,0
2019,36005016300,"Census Tract 163, Bronx County, New York",0,0,0,0,0,NA,NA,NA,NA,NA,0,0,0,0,0,0,0
2020,36005016300,"Census Tract 163, Bronx County, New York",0,0,0,0,0,NA,NA,NA,NA,NA,0,0,0,0,0,0,0
2012,36005016400,"Census Tract 164, Bronx County, New York",436,56,380,137,298,69196,1941,2003,1398,21.4,37,74,4,0,59,380,17
2013,36005016400,"Census Tract 164, Bronx County, New York",459,56,403,170,378,68500,1939,2003,1400,22.5,47,91,17,0,62,403,18
2014,36005016400,"Census Tract 164, Bronx County, New York",447,67,380,161,369,70208,1939,2003,1379,20,28,84,16,0,61,380,20
2015,36005016400,"Census Tract 164, Bronx County, New York",426,66,360,132,368,49583,1939,2005,1383,35,21,47,21,0,64,360,28
2016,36005016400,"Census Tract 164, Bronx County, New York",460,44,416,149,392,52813,1939,2006,1295,29.9,15,45,20,0,84,416,29
2017,36005016400,"Census Tract 164, Bronx County, New York",463,48,415,122,314,80556,1940,2007,1458,26.6,17,51,18,0,53,415,27
2018,36005016400,"Census Tract 164, Bronx County, New York",477,44,433,175,383,83050,1946,2010,1371,25.5,33,79,7,0,89,433,20
2019,36005016400,"Census Tract 164, Bronx County, New York",470,52,418,182,391,71429,1947,2009,1368,26.3,32,92,7,0,83,418,29
2020,36005016400,"Census Tract 164, Bronx County, New York",465,50,415,144,339,57000,1941,2011,1172,27.8,37,75,0,16,53,415,60
2012,36005016500,"Census Tract 165, Bronx County, New York",404,28,376,351,1245,25189,1957,2001,1210,45.8,94,4,242,0,171,376,146
2013,36005016500,"Census Tract 165, Bronx County, New York",402,41,361,331,1068,22768,1957,2003,1014,46,48,4,187,0,192,361,150
2014,36005016500,"Census Tract 165, Bronx County, New York",400,24,376,366,1272,27000,1959,2003,1087,44.1,74,4,220,0,197,376,145
2015,36005016500,"Census Tract 165, Bronx County, New York",403,40,363,349,1141,25724,1956,2005,1014,43.2,74,4,228,0,129,363,142
2016,36005016500,"Census Tract 165, Bronx County, New York",407,53,354,334,934,24342,1950,2006,1063,50,69,4,201,0,141,354,141
2017,36005016500,"Census Tract 165, Bronx County, New York",401,47,354,346,955,25081,1959,2008,1097,50,62,0,178,0,175,354,118
2018,36005016500,"Census Tract 165, Bronx County, New York",394,53,341,334,927,25743,1954,2010,1174,51,59,0,175,0,165,341,94
2019,36005016500,"Census Tract 165, Bronx County, New York",378,48,330,327,949,26576,1956,2010,1311,51,47,0,176,0,162,330,76
2020,36005016500,"Census Tract 165, Bronx County, New York",346,26,320,316,1008,26875,1960,2009,1337,51,37,0,176,0,141,320,83
2012,36005016600,"Census Tract 166, Bronx County, New York",875,82,793,313,785,46650,1954,2003,1173,24.5,102,153,0,5,155,793,70
2013,36005016600,"Census Tract 166, Bronx County, New York",878,112,766,263,639,39279,1954,2003,1184,38.8,65,140,0,6,117,766,70
2014,36005016600,"Census Tract 166, Bronx County, New York",876,103,773,241,556,24453,1965,2003,1372,50,27,78,18,7,140,773,80
2015,36005016600,"Census Tract 166, Bronx County, New York",862,120,742,213,501,25268,1963,2004,1490,49.1,23,39,15,7,156,742,87
2016,36005016600,"Census Tract 166, Bronx County, New York",859,97,762,237,605,37212,1962,2006,1594,45,28,54,19,0,171,762,69
2017,36005016600,"Census Tract 166, Bronx County, New York",852,95,757,205,537,37019,1962,2007,1615,45.3,37,43,27,4,141,757,41
2018,36005016600,"Census Tract 166, Bronx County, New York",834,61,773,225,704,36181,1960,2008,1794,51,44,31,54,6,165,773,63
2019,36005016600,"Census Tract 166, Bronx County, New York",838,52,786,265,727,54453,1950,2014,1902,42.6,19,48,53,3,170,786,61
2020,36005016600,"Census Tract 166, Bronx County, New York",860,84,776,320,945,92575,1955,2015,1783,22.5,84,116,58,8,145,776,50
2012,36005016700,"Census Tract 167, Bronx County, New York",741,92,649,612,2051,37151,1959,2004,975,34.1,76,4,359,0,262,649,191
2013,36005016700,"Census Tract 167, Bronx County, New York",793,98,695,650,2015,32045,1960,2006,985,36.6,79,4,366,0,291,695,209
2014,36005016700,"Census Tract 167, Bronx County, New York",856,102,754,700,2236,28500,1969,2007,997,38.5,88,8,439,0,261,754,256
2015,36005016700,"Census Tract 167, Bronx County, New York",922,96,826,773,2545,25625,1966,2010,1000,43.6,131,7,436,0,339,826,328
2016,36005016700,"Census Tract 167, Bronx County, New York",989,66,923,881,2664,25350,1978,NA,1039,43.3,143,8,436,0,456,923,392
2017,36005016700,"Census Tract 167, Bronx County, New York",1002,41,961,918,2888,28542,1984,2011,1037,38.6,177,13,436,0,529,961,383
2018,36005016700,"Census Tract 167, Bronx County, New York",1066,33,1033,976,3033,31144,2003,2011,1092,36.5,235,13,477,0,572,1033,362
2019,36005016700,"Census Tract 167, Bronx County, New York",1065,18,1047,994,3075,30981,2001,2011,1124,34.3,204,9,533,0,553,1047,423
2020,36005016700,"Census Tract 167, Bronx County, New York",1094,9,1085,1022,2860,30423,2006,2012,1145,35.3,170,9,490,0,624,1085,362
2012,36005016900,"Census Tract 169, Bronx County, New York",514,34,480,422,1220,28421,1980,2002,773,37.8,35,14,246,0,199,480,196
2013,36005016900,"Census Tract 169, Bronx County, New York",497,38,459,387,1113,31042,1977,2003,911,39,34,16,244,0,152,459,197
2014,36005016900,"Census Tract 169, Bronx County, New York",505,37,468,397,974,27563,1980,2004,903,42.1,42,20,241,0,160,468,193
2015,36005016900,"Census Tract 169, Bronx County, New York",502,49,453,394,937,22885,1963,2005,897,41,66,19,240,0,150,453,178
2016,36005016900,"Census Tract 169, Bronx County, New York",508,28,480,407,963,17891,1956,2004,819,44.6,72,18,223,2,179,480,204
2017,36005016900,"Census Tract 169, Bronx County, New York",509,10,499,414,988,21607,1964,2006,898,49.1,43,7,218,6,197,499,214
2018,36005016900,"Census Tract 169, Bronx County, New York",515,22,493,395,1017,21250,1963,2007,937,51,45,5,216,4,190,493,198
2019,36005016900,"Census Tract 169, Bronx County, New York",523,20,503,423,1125,23403,1976,2008,953,51,34,0,219,10,238,503,193
2020,36005016900,"Census Tract 169, Bronx County, New York",549,8,541,476,1150,44412,1959,2009,1130,29.7,133,0,182,17,264,541,123
2012,36005017100,"Census Tract 171, Bronx County, New York",0,0,0,0,0,NA,NA,NA,NA,NA,0,0,0,0,0,0,0
2013,36005017100,"Census Tract 171, Bronx County, New York",0,0,0,0,0,NA,NA,NA,NA,NA,0,0,0,0,0,0,0
2014,36005017100,"Census Tract 171, Bronx County, New York",0,0,0,0,0,NA,NA,NA,NA,NA,0,0,0,0,0,0,0
2015,36005017100,"Census Tract 171, Bronx County, New York",0,0,0,0,0,NA,NA,NA,NA,NA,0,0,0,0,0,0,0
2016,36005017100,"Census Tract 171, Bronx County, New York",0,0,0,0,0,NA,NA,NA,NA,NA,0,0,0,0,0,0,0
2017,36005017100,"Census Tract 171, Bronx County, New York",0,0,0,0,0,NA,NA,NA,NA,NA,0,0,0,0,0,0,0
2018,36005017100,"Census Tract 171, Bronx County, New York",0,0,0,0,0,NA,NA,NA,NA,NA,0,0,0,0,0,0,0
2019,36005017100,"Census Tract 171, Bronx County, New York",0,0,0,0,0,NA,NA,NA,NA,NA,0,0,0,0,0,0,0
2020,36005017100,"Census Tract 171, Bronx County, New York",0,0,0,0,0,NA,NA,NA,NA,NA,0,0,0,0,0,0,0
2012,36005017300,"Census Tract 173, Bronx County, New York",2316,160,2156,2030,5721,21143,1970,2002,725,29.9,153,0,831,27,1248,2156,862
2013,36005017300,"Census Tract 173, Bronx County, New York",2345,150,2195,2067,5462,20706,1968,2003,618,32.5,152,0,739,13,1375,2195,881
2014,36005017300,"Census Tract 173, Bronx County, New York",2381,105,2276,2192,5973,19695,1962,2004,713,33.3,159,0,672,20,1555,2276,912
2015,36005017300,"Census Tract 173, Bronx County, New York",2253,103,2150,2053,5494,NA,1954,2006,822,34.2,207,14,657,0,1391,2150,901
2016,36005017300,"Census Tract 173, Bronx County, New York",2093,93,2000,1916,4733,17273,1948,2006,788,33.1,207,20,660,5,1272,2000,838
2017,36005017300,"Census Tract 173, Bronx County, New York",2096,62,2034,1944,5107,19073,1946,2007,840,32.7,142,14,623,7,1387,2034,921
2018,36005017300,"Census Tract 173, Bronx County, New York",2136,26,2110,1966,5188,20451,1946,2007,887,29,235,21,743,11,1380,2110,995
2019,36005017300,"Census Tract 173, Bronx County, New York",2163,28,2135,1996,5323,20876,1947,2007,963,29.4,269,51,808,22,1310,2135,1023
2020,36005017300,"Census Tract 173, Bronx County, New York",2122,28,2094,1989,5656,21276,1950,2001,821,27.7,374,36,848,28,1333,2094,974
2012,36005017500,"Census Tract 175, Bronx County, New York",2581,131,2450,2411,6727,15934,1948,2003,820,40.1,221,14,1032,0,1474,2450,1263
2013,36005017500,"Census Tract 175, Bronx County, New York",2513,205,2308,2244,5962,17774,1939,2003,747,35.8,235,12,1036,0,1314,2308,1093
2014,36005017500,"Census Tract 175, Bronx County, New York",2575,122,2453,2390,6667,18463,1939,2004,727,35.2,230,0,1016,0,1434,2453,1182
2015,36005017500,"Census Tract 175, Bronx County, New York",2603,151,2452,2383,6615,21896,1939,2004,760,33.1,304,40,1087,0,1308,2452,1085
2016,36005017500,"Census Tract 175, Bronx County, New York",2679,103,2576,2541,6892,27095,1939,2005,748,29.7,365,53,1066,15,1424,2576,992
2017,36005017500,"Census Tract 175, Bronx County, New York",2713,87,2626,2585,7073,27934,1939,2006,759,29.7,255,48,1103,14,1392,2626,1026
2018,36005017500,"Census Tract 175, Bronx County, New York",2776,33,2743,2743,7200,25844,0,2007,781,29.6,246,53,1059,18,1563,2743,1065
2019,36005017500,"Census Tract 175, Bronx County, New York",2632,35,2597,2597,6485,26630,0,2008,782,30.3,206,96,1306,17,1476,2597,895
2020,36005017500,"Census Tract 175, Bronx County, New York",2892,34,2858,2858,6509,24399,1946,2008,874,31.6,206,66,1708,16,1354,2858,1065
2012,36005017701,"Census Tract 177.01, Bronx County, New York",1349,182,1167,1167,3573,23848,1939,2005,1129,39.4,103,74,342,0,764,1167,479
2013,36005017701,"Census Tract 177.01, Bronx County, New York",1354,229,1125,1114,3468,25938,1939,2005,1187,36.8,88,38,269,0,807,1125,448
2014,36005017701,"Census Tract 177.01, Bronx County, New York",1430,160,1270,1250,3944,20848,1939,2005,1132,50,62,36,244,0,970,1270,580
2015,36005017701,"Census Tract 177.01, Bronx County, New York",1437,198,1239,1154,4089,NA,1939,2006,1128,50,68,0,393,0,761,1239,610
2016,36005017701,"Census Tract 177.01, Bronx County, New York",1430,236,1194,1089,4266,22342,1939,2007,1178,50,50,0,409,0,680,1194,570
2017,36005017701,"Census Tract 177.01, Bronx County, New York",1426,285,1141,1010,3806,21916,1949,2008,1309,50,60,0,322,0,688,1141,504
2018,36005017701,"Census Tract 177.01, Bronx County, New York",1426,218,1208,1111,3949,28105,0,2011,1374,44,86,0,512,0,692,1208,510
2019,36005017701,"Census Tract 177.01, Bronx County, New York",1421,241,1180,1028,3530,23750,0,2011,1391,38.9,21,0,511,0,648,1180,544
2020,36005017701,"Census Tract 177.01, Bronx County, New York",1382,159,1223,1146,3780,24318,1945,2013,1484,46.9,50,0,630,0,705,1223,600
2012,36005017702,"Census Tract 177.02, Bronx County, New York",1825,228,1597,1475,4456,20207,1939,2004,1024,50,49,15,658,0,861,1597,720
2013,36005017702,"Census Tract 177.02, Bronx County, New York",1815,206,1609,1472,4215,16515,1939,2004,1039,48.9,57,0,644,0,906,1609,720
2014,36005017702,"Census Tract 177.02, Bronx County, New York",1871,209,1662,1515,4878,19477,1939,2004,1107,50,90,9,594,0,969,1662,735
2015,36005017702,"Census Tract 177.02, Bronx County, New York",1866,239,1627,1445,4612,20885,1944,2005,1115,47,120,7,500,0,920,1627,631
2016,36005017702,"Census Tract 177.02, Bronx County, New York",1876,233,1643,1440,4586,24727,1939,2006,1130,37.3,129,7,503,0,925,1643,558
2017,36005017702,"Census Tract 177.02, Bronx County, New York",1871,173,1698,1488,4596,24521,1943,2007,1107,37.5,126,7,511,0,985,1698,555
2018,36005017702,"Census Tract 177.02, Bronx County, New York",1868,150,1718,1477,4826,29653,1943,2008,1137,33.2,147,9,571,0,935,1718,565
2019,36005017702,"Census Tract 177.02, Bronx County, New York",1841,167,1674,1456,4593,31354,1940,2009,1131,31.2,111,9,586,0,909,1674,594
2020,36005017702,"Census Tract 177.02, Bronx County, New York",1687,148,1539,1317,4159,34869,1951,2009,1156,31.1,89,8,611,0,774,1539,503
2012,36005017901,"Census Tract 179.01, Bronx County, New York",1635,0,1635,1522,4615,19889,1939,2001,1054,49.9,83,0,504,0,1041,1635,776
2013,36005017901,"Census Tract 179.01, Bronx County, New York",1651,0,1651,1515,4433,19157,1939,2002,1112,50,104,0,606,0,995,1651,722
2014,36005017901,"Census Tract 179.01, Bronx County, New York",1671,19,1652,1497,4243,20383,1939,2003,1114,50,126,0,558,12,1041,1652,668
2015,36005017901,"Census Tract 179.01, Bronx County, New York",1722,18,1704,1532,4129,19711,1939,2004,1123,50,166,15,566,14,1019,1704,691
2016,36005017901,"Census Tract 179.01, Bronx County, New York",1746,21,1725,1534,4565,25000,1939,2006,1124,50,188,17,564,14,1041,1725,627
2017,36005017901,"Census Tract 179.01, Bronx County, New York",1759,60,1699,1490,4454,24342,1939,2006,1180,49,197,15,486,13,1075,1699,649
2018,36005017901,"Census Tract 179.01, Bronx County, New York",1774,101,1673,1492,4483,29375,0,2007,1219,42,185,20,481,10,1055,1673,629
2019,36005017901,"Census Tract 179.01, Bronx County, New York",1788,123,1665,1541,4422,NA,0,2008,1260,43.5,182,34,555,4,1010,1665,603
2020,36005017901,"Census Tract 179.01, Bronx County, New York",1739,134,1605,1489,4417,38942,0,2011,1390,42.5,177,10,532,12,1088,1605,456
2012,36005017902,"Census Tract 179.02, Bronx County, New York",1175,26,1149,1114,3461,25052,1945,2003,1080,37.5,128,13,532,0,619,1149,337
2013,36005017902,"Census Tract 179.02, Bronx County, New York",1163,24,1139,1139,3643,27088,1942,2003,1104,35.2,107,14,444,0,668,1139,392
2014,36005017902,"Census Tract 179.02, Bronx County, New York",1143,42,1101,1101,3605,18662,1939,2003,1146,44.9,66,0,430,0,600,1101,518
2015,36005017902,"Census Tract 179.02, Bronx County, New York",1155,41,1114,1114,3584,20852,1939,2003,1129,38.8,97,11,456,0,615,1114,467
2016,36005017902,"Census Tract 179.02, Bronx County, New York",1164,46,1118,1118,3565,19912,1939,2005,1117,42.6,138,7,497,0,555,1118,593
2017,36005017902,"Census Tract 179.02, Bronx County, New York",1171,20,1151,1151,3990,19396,1945,2007,1157,42.8,76,22,352,0,743,1151,618
2018,36005017902,"Census Tract 179.02, Bronx County, New York",1182,22,1160,1160,3684,23276,1944,2006,1182,38.7,110,9,344,21,793,1160,556
2019,36005017902,"Census Tract 179.02, Bronx County, New York",1235,0,1235,1235,4016,37250,0,2009,1288,32.4,146,8,399,9,916,1235,476
2020,36005017902,"Census Tract 179.02, Bronx County, New York",1277,25,1252,1252,3950,40236,1943,2009,1341,34.3,195,3,420,10,880,1252,469
2012,36005018101,"Census Tract 181.01, Bronx County, New York",1117,114,1003,838,2682,29478,1941,2004,1093,42.7,110,0,393,0,451,1003,327
2013,36005018101,"Census Tract 181.01, Bronx County, New York",1097,120,977,826,2488,25444,1942,2005,1090,45.1,52,0,316,0,505,977,370
2014,36005018101,"Census Tract 181.01, Bronx County, New York",1074,93,981,856,2464,26142,1940,2006,1113,45.5,41,0,352,0,514,981,371
2015,36005018101,"Census Tract 181.01, Bronx County, New York",1065,97,968,808,2415,26121,1940,2006,1079,47,57,0,324,0,499,968,353
2016,36005018101,"Census Tract 181.01, Bronx County, New York",1082,72,1010,920,2832,24198,1939,2007,1086,45.7,32,0,301,0,625,1010,440
2017,36005018101,"Census Tract 181.01, Bronx County, New York",1084,55,1029,946,2768,23250,1939,2007,1147,47.4,50,0,368,0,617,1029,450
2018,36005018101,"Census Tract 181.01, Bronx County, New York",1096,51,1045,967,2882,21504,0,2008,1158,51,42,0,375,0,624,1045,451
2019,36005018101,"Census Tract 181.01, Bronx County, New York",1109,50,1059,951,3056,21674,0,2010,1229,51,47,0,372,0,621,1059,423
2020,36005018101,"Census Tract 181.01, Bronx County, New York",1060,51,1009,952,3259,43243,1943,2012,1425,51,68,0,336,0,616,1009,410
2012,36005018102,"Census Tract 181.02, Bronx County, New York",1690,113,1577,1490,5097,39511,1939,2002,992,32.2,377,16,635,47,769,1577,435
2013,36005018102,"Census Tract 181.02, Bronx County, New York",1687,114,1573,1498,5362,38424,1939,2002,1032,32.9,435,40,690,44,728,1573,424
2014,36005018102,"Census Tract 181.02, Bronx County, New York",1695,87,1608,1536,5494,38060,1939,2003,1048,33.9,424,47,630,57,809,1608,421
2015,36005018102,"Census Tract 181.02, Bronx County, New York",1697,76,1621,1565,5270,37583,1939,2003,1077,33.7,453,71,605,37,860,1621,473
2016,36005018102,"Census Tract 181.02, Bronx County, New York",1703,117,1586,1559,5518,36430,1939,2003,1111,35.2,449,72,622,49,838,1586,431
2017,36005018102,"Census Tract 181.02, Bronx County, New York",1707,69,1638,1596,5883,35052,1939,2003,1158,38.1,317,41,730,55,846,1638,490
2018,36005018102,"Census Tract 181.02, Bronx County, New York",1719,80,1639,1608,5482,32945,0,2004,1189,40.7,300,32,730,57,899,1639,589
2019,36005018102,"Census Tract 181.02, Bronx County, New York",1757,104,1653,1607,4900,30792,0,2007,1229,44.5,332,34,743,34,875,1653,555
2020,36005018102,"Census Tract 181.02, Bronx County, New York",2185,85,2100,2045,4922,25215,0,2006,1083,51,242,68,882,39,1153,2100,796
2012,36005018301,"Census Tract 183.01, Bronx County, New York",2031,140,1891,1666,3972,27878,1944,2002,1078,33.3,346,31,900,39,878,1891,626
2013,36005018301,"Census Tract 183.01, Bronx County, New York",2030,104,1926,1671,4001,28845,1939,2002,1110,32.8,346,38,910,32,872,1926,631
2014,36005018301,"Census Tract 183.01, Bronx County, New York",2014,127,1887,1649,3783,28739,1939,2002,1115,35.9,360,42,834,40,926,1887,583
2015,36005018301,"Census Tract 183.01, Bronx County, New York",2033,134,1899,1614,3608,NA,1939,2004,1106,35.3,339,36,719,43,992,1899,550
2016,36005018301,"Census Tract 183.01, Bronx County, New York",2037,69,1968,1697,3513,26159,1939,2005,1094,33.9,416,19,652,67,1096,1968,608
2017,36005018301,"Census Tract 183.01, Bronx County, New York",2045,72,1973,1585,3219,25858,1939,2005,1136,37.4,393,0,687,89,912,1973,598
2018,36005018301,"Census Tract 183.01, Bronx County, New York",2054,59,1995,1647,3354,30221,0,2005,1184,34.4,402,4,681,64,997,1995,572
2019,36005018301,"Census Tract 183.01, Bronx County, New York",2059,31,2028,1618,3607,31239,0,2005,1213,32.1,404,45,614,50,975,2028,520
2020,36005018301,"Census Tract 183.01, Bronx County, New York",2074,0,2074,1642,3698,36106,0,2005,1214,35.3,432,76,700,31,853,2074,407
2012,36005018302,"Census Tract 183.02, Bronx County, New York",1300,73,1227,1160,3853,41667,1939,2002,1040,28,127,0,421,52,661,1227,343
2013,36005018302,"Census Tract 183.02, Bronx County, New York",1317,43,1274,1225,4079,45250,1939,2001,1058,26.9,128,0,485,22,743,1274,289
2014,36005018302,"Census Tract 183.02, Bronx County, New York",1302,48,1254,1215,3838,34901,1939,2002,1084,35.9,162,0,448,22,751,1254,344
2015,36005018302,"Census Tract 183.02, Bronx County, New York",1282,30,1252,1213,3988,30809,1939,2003,1118,44.8,116,7,434,5,784,1252,437
2016,36005018302,"Census Tract 183.02, Bronx County, New York",1307,34,1273,1221,3729,27938,1939,2002,1178,49.2,158,16,452,6,769,1273,459
2017,36005018302,"Census Tract 183.02, Bronx County, New York",1320,52,1268,1218,3505,32849,1939,2004,1192,43,238,20,478,6,739,1268,385
2018,36005018302,"Census Tract 183.02, Bronx County, New York",1325,46,1279,1208,3708,35833,0,2008,1249,39.6,278,18,425,22,736,1279,342
2019,36005018302,"Census Tract 183.02, Bronx County, New York",1345,83,1262,1192,3739,41288,0,2010,1281,35.4,270,22,374,23,806,1262,286
2020,36005018302,"Census Tract 183.02, Bronx County, New York",1477,71,1406,1346,3443,47939,1943,2011,1319,34.1,294,9,643,13,719,1406,159
2012,36005018400,"Census Tract 184, Bronx County, New York",1647,151,1496,664,1625,62976,1949,2004,1239,28.2,197,390,10,11,253,1496,119
2013,36005018400,"Census Tract 184, Bronx County, New York",1612,177,1435,627,1374,68188,1950,2006,1265,27.3,218,352,11,35,202,1435,152
2014,36005018400,"Census Tract 184, Bronx County, New York",1634,186,1448,744,1873,61354,1939,2007,1392,28.2,200,374,16,41,290,1448,170
2015,36005018400,"Census Tract 184, Bronx County, New York",1564,143,1421,790,1868,49239,1939,2010,1316,32.5,211,388,10,37,333,1421,226
2016,36005018400,"Census Tract 184, Bronx County, New York",1543,122,1421,780,1887,55667,1939,2011,1364,30.8,199,379,20,55,311,1421,196
2017,36005018400,"Census Tract 184, Bronx County, New York",1545,74,1471,818,1910,53804,1941,2012,1394,31.3,244,412,31,30,330,1471,238
2018,36005018400,"Census Tract 184, Bronx County, New York",1625,71,1554,863,1967,51439,1950,2011,1403,30.5,258,381,29,8,458,1554,262
2019,36005018400,"Census Tract 184, Bronx County, New York",1588,47,1541,896,1963,59667,1952,2012,1532,31,275,336,49,7,542,1541,229
2020,36005018400,"Census Tract 184, Bronx County, New York",1482,44,1438,823,1952,93819,1954,2013,1685,24.3,283,266,79,8,533,1438,157
2012,36005018500,"Census Tract 185, Bronx County, New York",2618,307,2311,2174,5976,21431,1973,2004,891,40.9,255,16,1078,25,1161,2311,948
2013,36005018500,"Census Tract 185, Bronx County, New York",2707,317,2390,2314,6136,22584,1978,2005,906,39,226,34,1041,0,1328,2390,993
2014,36005018500,"Census Tract 185, Bronx County, New York",2779,324,2455,2386,6144,22463,1964,2006,910,35.6,238,47,1202,0,1156,2455,1073
2015,36005018500,"Census Tract 185, Bronx County, New York",2808,369,2439,2434,6413,26384,1959,2007,942,34,252,49,1309,0,1101,2439,1049
2016,36005018500,"Census Tract 185, Bronx County, New York",2841,234,2607,2605,6844,28460,1949,2008,927,30.7,321,59,1369,0,1235,2607,1000
2017,36005018500,"Census Tract 185, Bronx County, New York",2853,175,2678,2638,7566,32162,1948,2009,1004,33.1,292,62,1306,0,1333,2678,1016
2018,36005018500,"Census Tract 185, Bronx County, New York",3048,177,2871,2813,7652,26837,1948,2010,1028,33.9,355,33,1505,0,1402,2871,1165
2019,36005018500,"Census Tract 185, Bronx County, New York",3125,156,2969,2908,7993,25151,1992,2012,1121,39.8,371,26,1600,0,1500,2969,1318
2020,36005018501,"Census Tract 185.01, Bronx County, New York",1129,14,1115,1100,2564,37500,2007,2013,1143,32.9,345,68,552,0,548,1115,323
2020,36005018502,"Census Tract 185.02, Bronx County, New York",2023,0,2023,1937,5453,21802,1981,2011,1097,45.3,208,0,904,0,1171,2023,992
2012,36005018900,"Census Tract 189, Bronx County, New York",2888,194,2694,2497,7000,23129,1939,2002,976,45.1,160,34,855,7,1714,2694,982
2013,36005018900,"Census Tract 189, Bronx County, New York",2879,163,2716,2501,7012,22326,1939,2003,1036,50,162,44,720,8,1821,2716,1103
2014,36005018900,"Census Tract 189, Bronx County, New York",2949,160,2789,2649,7714,21413,1939,2003,1055,50,222,76,830,9,1851,2789,1305
2015,36005018900,"Census Tract 189, Bronx County, New York",3028,149,2879,2674,7483,NA,1939,2005,1054,50,371,95,815,0,1857,2879,1331
2016,36005018900,"Census Tract 189, Bronx County, New York",3005,110,2895,2740,7494,21056,1939,2005,1053,45.2,417,84,878,0,1853,2895,1343
2017,36005018900,"Census Tract 189, Bronx County, New York",3005,75,2930,2728,7756,25068,1939,2007,1130,41.8,406,73,810,0,1901,2930,1337
2018,36005018900,"Census Tract 189, Bronx County, New York",2975,77,2898,2708,7507,26963,0,2010,1165,36.5,461,133,838,13,1734,2898,1209
2019,36005018900,"Census Tract 189, Bronx County, New York",3037,98,2939,2759,7501,25959,0,2011,1213,38.1,405,102,986,23,1708,2939,1215
2020,36005018900,"Census Tract 189, Bronx County, New York",2851,98,2753,2626,7618,28199,1944,2012,1186,38.3,288,93,1001,22,1554,2753,1099
2012,36005019300,"Census Tract 193, Bronx County, New York",2029,50,1979,1961,5182,18504,1952,2002,699,31.7,212,0,925,0,1087,1979,925
2013,36005019300,"Census Tract 193, Bronx County, New York",2008,74,1934,1914,5165,20155,1952,2003,713,32.7,195,0,852,0,1110,1934,910
2014,36005019300,"Census Tract 193, Bronx County, New York",2037,73,1964,1964,5301,17268,1952,2003,682,33.2,222,15,958,15,1048,1964,1020
2015,36005019300,"Census Tract 193, Bronx County, New York",2099,117,1982,1982,5737,23267,1949,2004,826,34,214,11,1005,11,1035,1982,902
2016,36005019300,"Census Tract 193, Bronx County, New York",2193,139,2054,2054,5659,22500,1949,2006,836,34.4,284,13,933,11,1164,2054,904
2017,36005019300,"Census Tract 193, Bronx County, New York",2254,134,2120,2120,5853,22761,1944,2008,879,38.2,270,16,1078,14,1143,2120,864
2018,36005019300,"Census Tract 193, Bronx County, New York",2318,159,2159,2159,5942,22750,1943,2007,947,36.8,354,41,1094,32,1202,2159,873
2019,36005019300,"Census Tract 193, Bronx County, New York",2382,157,2225,2206,6254,23717,1943,2007,1020,36.9,298,21,1139,18,1257,2225,882
2020,36005019300,"Census Tract 193, Bronx County, New York",2533,93,2440,2344,5962,29877,1940,2006,946,26.9,311,19,1248,13,1321,2440,750
2012,36005019400,"Census Tract 194, Bronx County, New York",763,40,723,586,1729,43409,1951,2005,1467,38.9,128,96,183,0,367,723,198
2013,36005019400,"Census Tract 194, Bronx County, New York",759,36,723,565,1708,50677,1953,2006,1425,34.6,154,86,101,0,371,723,132
2014,36005019400,"Census Tract 194, Bronx County, New York",795,61,734,563,1782,50690,1948,2008,1467,37.3,75,102,59,0,393,734,163
2015,36005019400,"Census Tract 194, Bronx County, New York",769,59,710,485,1538,45865,1958,2010,1386,38.2,54,81,91,0,307,710,157
2016,36005019400,"Census Tract 194, Bronx County, New York",780,50,730,503,1622,51895,1944,2010,1472,34.2,79,53,104,0,348,730,142
2017,36005019400,"Census Tract 194, Bronx County, New York",783,50,733,511,1489,49926,1952,2010,1548,38.2,89,39,89,0,378,733,163
2018,36005019400,"Census Tract 194, Bronx County, New York",793,60,733,503,1485,39519,1954,2011,1553,40.8,106,37,65,0,350,733,201
2019,36005019400,"Census Tract 194, Bronx County, New York",779,41,738,456,1458,48947,1954,2010,1645,38.4,116,13,63,0,352,738,164
2020,36005019400,"Census Tract 194, Bronx County, New York",800,82,718,412,1293,54271,1959,2010,1729,33.2,111,32,54,16,287,718,133
2012,36005019500,"Census Tract 195, Bronx County, New York",2735,250,2485,2390,7209,32807,1940,2003,996,33.2,395,46,878,19,1545,2485,710
2013,36005019500,"Census Tract 195, Bronx County, New York",2744,184,2560,2475,7372,31531,1946,2003,1008,35,452,0,1034,31,1602,2560,718
2014,36005019500,"Census Tract 195, Bronx County, New York",2772,149,2623,2561,7324,29347,1941,2003,1092,40,422,0,896,34,1814,2623,776
2015,36005019500,"Census Tract 195, Bronx County, New York",2805,66,2739,2608,7210,NA,1942,2004,1062,41.5,429,0,865,40,1866,2739,909
2016,36005019500,"Census Tract 195, Bronx County, New York",2834,62,2772,2642,7024,27309,1939,2004,1090,40.7,368,25,961,34,1789,2772,840
2017,36005019500,"Census Tract 195, Bronx County, New York",2763,32,2731,2615,6899,28085,1939,2005,1128,42.6,368,37,1021,30,1743,2731,753
2018,36005019500,"Census Tract 195, Bronx County, New York",2744,58,2686,2554,6928,27109,1940,2006,1201,47.4,353,80,1167,15,1467,2686,878
2019,36005019500,"Census Tract 195, Bronx County, New York",2769,75,2694,2548,6502,26773,0,2007,1199,49.7,279,103,1099,20,1536,2694,988
2020,36005019500,"Census Tract 195, Bronx County, New York",2632,60,2572,2488,6722,31673,1941,2007,1272,46.4,255,91,1146,0,1521,2572,796
2012,36005019700,"Census Tract 197, Bronx County, New York",2326,112,2214,2197,8018,30286,1939,2001,1010,38.2,161,27,744,75,1462,2214,851
2013,36005019700,"Census Tract 197, Bronx County, New York",2332,142,2190,2190,7620,27898,1939,2002,1038,37.4,184,0,575,139,1504,2190,830
2014,36005019700,"Census Tract 197, Bronx County, New York",2304,184,2120,2120,7084,25000,1939,2002,1058,47.5,170,0,648,110,1475,2120,895
2015,36005019700,"Census Tract 197, Bronx County, New York",2307,120,2187,2187,7104,25875,1939,2002,1090,44,253,0,647,116,1488,2187,775
2016,36005019700,"Census Tract 197, Bronx County, New York",2314,83,2231,2213,6678,21403,1939,2003,1109,44.6,236,0,608,89,1579,2231,864
2017,36005019700,"Census Tract 197, Bronx County, New York",2294,59,2235,2221,7394,25101,1939,2004,1175,42,208,0,602,139,1551,2235,873
2018,36005019700,"Census Tract 197, Bronx County, New York",2272,22,2250,2234,7063,30833,0,2004,1219,40,196,20,684,109,1562,2250,797
2019,36005019700,"Census Tract 197, Bronx County, New York",2297,0,2297,2282,7448,34894,0,2004,1264,36.3,259,17,600,109,1594,2297,891
2020,36005019700,"Census Tract 197, Bronx County, New York",2415,0,2415,2403,7027,22474,0,2004,1310,42.7,184,5,422,102,1937,2415,1347
2012,36005019900,"Census Tract 199, Bronx County, New York",2905,164,2741,2503,6858,23329,1945,2001,931,33.5,234,16,942,0,1529,2741,817
2013,36005019900,"Census Tract 199, Bronx County, New York",2900,282,2618,2408,6794,25056,1944,2002,957,34.2,233,11,866,0,1532,2618,863
2014,36005019900,"Census Tract 199, Bronx County, New York",2875,231,2644,2417,7120,22701,1951,2002,1065,42.8,197,19,745,0,1662,2644,1025
2015,36005019900,"Census Tract 199, Bronx County, New York",2909,229,2680,2491,7544,24336,1946,2002,1100,42,257,29,748,0,1720,2680,976
2016,36005019900,"Census Tract 199, Bronx County, New York",2930,170,2760,2573,7825,29738,1943,2003,1124,35.7,255,32,793,0,1750,2760,867
2017,36005019900,"Census Tract 199, Bronx County, New York",2914,134,2780,2643,8206,32652,1945,2004,1142,38.3,370,52,994,0,1708,2780,917
2018,36005019900,"Census Tract 199, Bronx County, New York",2927,53,2874,2775,8165,33818,1944,2004,1152,34.7,398,107,1012,0,1727,2874,885
2019,36005019900,"Census Tract 199, Bronx County, New York",2950,28,2922,2812,7908,40463,1946,2006,1162,33.6,436,67,1133,0,1763,2922,790
2020,36005019900,"Census Tract 199, Bronx County, New York",3172,27,3145,3028,7606,32642,1946,2007,1147,39.7,363,67,1477,0,1772,3145,1142
2012,36005020000,"Census Tract 200, Bronx County, New York",1624,141,1483,1272,3909,31651,1939,2004,1008,40.8,332,190,92,286,646,1483,375
2013,36005020000,"Census Tract 200, Bronx County, New York",1614,130,1484,1304,3862,31992,1939,2005,1059,39.4,342,205,93,266,702,1484,372
2014,36005020000,"Census Tract 200, Bronx County, New York",1636,111,1525,1346,4064,34454,1939,2006,1144,36.8,288,186,136,261,746,1525,399
2015,36005020000,"Census Tract 200, Bronx County, New York",1624,133,1491,1348,4193,43100,1939,2006,1165,36.1,328,97,135,363,768,1491,383
2016,36005020000,"Census Tract 200, Bronx County, New York",1629,140,1489,1334,4161,43000,1939,2008,1181,35.9,333,55,162,394,782,1489,348
2017,36005020000,"Census Tract 200, Bronx County, New York",1597,123,1474,1292,4002,41333,1945,2010,1203,39.5,233,49,169,370,762,1474,346
2018,36005020000,"Census Tract 200, Bronx County, New York",1580,152,1428,1277,3977,39018,1948,2011,1243,46.7,328,89,146,321,702,1428,401
2019,36005020000,"Census Tract 200, Bronx County, New York",1598,129,1469,1288,3958,35643,1948,2011,1278,46.9,342,41,131,295,814,1469,389
2020,36005020000,"Census Tract 200, Bronx County, New York",1550,84,1466,1210,3818,36094,1946,2014,1331,46.9,421,27,79,305,782,1466,384
2012,36005020100,"Census Tract 201, Bronx County, New York",1377,167,1210,1210,3718,31582,1939,2002,1026,33.1,98,0,444,0,855,1210,322
2013,36005020100,"Census Tract 201, Bronx County, New York",1383,85,1298,1282,3860,30491,1939,2003,1064,36.3,94,0,501,0,837,1298,367
2014,36005020100,"Census Tract 201, Bronx County, New York",1382,55,1327,1298,3913,28214,1950,2005,1089,36.2,131,0,458,0,905,1327,383
2015,36005020100,"Census Tract 201, Bronx County, New York",1374,67,1307,1273,3971,23463,1952,2006,1061,33.9,122,9,443,0,887,1307,496
2016,36005020100,"Census Tract 201, Bronx County, New York",1382,74,1308,1275,4032,29013,1946,2006,1087,34.3,144,19,478,0,860,1308,482
2017,36005020100,"Census Tract 201, Bronx County, New York",1389,41,1348,1316,4607,32938,1946,2007,1135,33.8,147,23,431,0,946,1348,512
2018,36005020100,"Census Tract 201, Bronx County, New York",1391,95,1296,1287,4031,32031,1948,2007,1144,32.5,183,30,471,0,891,1296,475
2019,36005020100,"Census Tract 201, Bronx County, New York",1398,126,1272,1264,3745,33846,1944,2008,1151,33.2,173,28,458,0,886,1272,429
2020,36005020100,"Census Tract 201, Bronx County, New York",1377,89,1288,1288,3602,42464,1948,2010,1240,33.6,219,32,454,0,936,1288,314
2012,36005020200,"Census Tract 202, Bronx County, New York",784,42,742,539,1359,35950,1961,2005,1105,35.2,83,76,85,45,339,742,136
2013,36005020200,"Census Tract 202, Bronx County, New York",805,45,760,562,1370,31250,1962,2006,1138,40.2,88,68,80,53,389,760,147
2014,36005020200,"Census Tract 202, Bronx County, New York",885,60,825,697,1741,37639,1959,2008,1151,33.1,110,77,78,71,494,825,157
2015,36005020200,"Census Tract 202, Bronx County, New York",904,57,847,748,1879,29427,1963,2010,1126,35,136,82,126,63,516,847,211
2016,36005020200,"Census Tract 202, Bronx County, New York",906,55,851,781,1939,28450,1962,2010,1116,40.8,139,68,136,64,543,851,239
2017,36005020200,"Census Tract 202, Bronx County, New York",908,64,844,756,1922,28158,1958,NA,1160,43.6,119,50,147,67,520,844,273
2018,36005020200,"Census Tract 202, Bronx County, New York",896,72,824,717,1837,33750,1948,2012,1230,41.2,119,43,127,49,526,824,255
2019,36005020200,"Census Tract 202, Bronx County, New York",916,53,863,725,1787,31518,1950,2012,1229,41.7,112,24,144,34,547,863,261
2020,36005020200,"Census Tract 202, Bronx County, New York",946,71,875,740,1779,36212,0,2012,1243,40.3,98,36,137,49,539,875,216
2012,36005020400,"Census Tract 204, Bronx County, New York",1123,165,958,792,2091,38716,1939,2004,1141,35,67,122,102,45,524,958,168
2013,36005020400,"Census Tract 204, Bronx County, New York",1144,135,1009,783,2178,46563,1943,2005,1187,34.7,54,96,125,22,579,1009,161
2014,36005020400,"Census Tract 204, Bronx County, New York",1139,137,1002,782,2284,49485,1939,2006,1202,31.3,97,50,197,28,562,1002,158
2015,36005020400,"Census Tract 204, Bronx County, New York",1117,88,1029,819,2338,49263,1943,2006,1210,32.8,114,57,198,29,602,1029,182
2016,36005020400,"Census Tract 204, Bronx County, New York",1116,82,1034,841,2287,41970,1945,2007,1336,38.5,70,63,164,24,658,1034,215
2017,36005020400,"Census Tract 204, Bronx County, New York",1106,33,1073,800,2318,37077,1939,2011,1296,40.5,59,62,134,38,629,1073,254
2018,36005020400,"Census Tract 204, Bronx County, New York",1099,56,1043,791,2218,41406,1943,2012,1342,35.9,135,36,130,83,560,1043,215
2019,36005020400,"Census Tract 204, Bronx County, New York",1102,77,1025,795,2189,50079,1950,2013,1401,36.6,124,73,84,83,566,1025,242
2020,36005020400,"Census Tract 204, Bronx County, New York",1064,70,994,800,2450,52005,1949,2015,1418,29.3,129,63,66,90,541,994,219
2012,36005020501,"Census Tract 205.01, Bronx County, New York",2665,106,2559,2438,6357,23735,1956,2001,839,29.9,347,0,1156,0,1409,2559,859
2013,36005020501,"Census Tract 205.01, Bronx County, New York",2685,88,2597,2440,6462,25018,1954,2001,857,30.2,339,0,1005,0,1550,2597,851
2014,36005020501,"Census Tract 205.01, Bronx County, New York",2723,114,2609,2468,6003,22457,1954,2002,739,30.8,265,0,916,0,1627,2609,1018
2015,36005020501,"Census Tract 205.01, Bronx County, New York",2808,118,2690,2539,6433,NA,1953,2004,812,31.5,292,0,946,0,1693,2690,1108
2016,36005020501,"Census Tract 205.01, Bronx County, New York",2885,121,2764,2678,6495,20741,1955,2006,822,33.4,380,12,998,0,1737,2764,1165
2017,36005020501,"Census Tract 205.01, Bronx County, New York",2882,61,2821,2756,7157,19845,1954,2007,790,33.1,386,13,962,0,1861,2821,1197
2018,36005020501,"Census Tract 205.01, Bronx County, New York",2908,86,2822,2771,6936,19986,1955,2009,827,36.1,340,15,906,0,1908,2822,1333
2019,36005020501,"Census Tract 205.01, Bronx County, New York",2912,54,2858,2802,6848,17879,1956,2010,726,38,280,16,971,0,1869,2858,1418
2020,36005020501,"Census Tract 205.01, Bronx County, New York",2718,21,2697,2657,6828,20101,1957,2010,895,38.5,366,18,888,0,1854,2697,1294
2012,36005020502,"Census Tract 205.02, Bronx County, New York",764,110,654,555,1424,22722,1945,2002,783,29.2,63,67,117,0,371,654,252
2013,36005020502,"Census Tract 205.02, Bronx County, New York",992,138,854,719,1734,22287,1971,2000,950,33,110,29,258,0,424,854,317
2014,36005020502,"Census Tract 205.02, Bronx County, New York",989,150,839,691,1587,15239,1967,2001,862,40.5,71,0,297,0,388,839,365
2015,36005020502,"Census Tract 205.02, Bronx County, New York",982,108,874,769,1673,13005,1949,2003,902,42.3,95,0,274,5,506,874,406
2016,36005020502,"Census Tract 205.02, Bronx County, New York",959,95,864,794,1822,14572,1949,2006,960,43.4,116,0,278,5,533,864,424
2017,36005020502,"Census Tract 205.02, Bronx County, New York",967,84,883,807,1739,13750,1946,2008,988,43.5,93,6,263,5,546,883,465
2018,36005020502,"Census Tract 205.02, Bronx County, New York",968,58,910,815,1793,14983,1947,2008,908,39,98,15,291,6,551,910,437
2019,36005020502,"Census Tract 205.02, Bronx County, New York",975,49,926,821,1792,16194,1947,2010,980,35.9,96,22,300,3,562,926,392
2020,36005020502,"Census Tract 205.02, Bronx County, New York",1014,19,995,829,1659,17882,1967,2008,894,37,155,14,308,3,584,995,384
2012,36005020601,"Census Tract 206.01, Bronx County, New York",1091,122,969,682,1624,43750,1962,2004,1091,30.4,72,22,199,15,494,969,281
2013,36005020601,"Census Tract 206.01, Bronx County, New York",1075,62,1013,747,1886,46581,1949,2005,1153,29.3,126,22,214,42,491,1013,261
2014,36005020601,"Census Tract 206.01, Bronx County, New York",1001,95,906,664,1569,34821,1958,2006,1135,31.5,78,36,135,59,426,906,272
2015,36005020601,"Census Tract 206.01, Bronx County, New York",918,72,846,584,1437,39063,1971,2006,1239,29.8,101,47,131,74,311,846,175
2016,36005020601,"Census Tract 206.01, Bronx County, New York",937,55,882,591,1752,33177,1972,2007,1497,29.6,108,16,113,96,309,882,235
2017,36005020601,"Census Tract 206.01, Bronx County, New York",926,36,890,626,1768,36023,1971,2010,1392,31,119,16,157,115,297,890,248
2018,36005020601,"Census Tract 206.01, Bronx County, New York",901,74,827,585,1540,NA,1972,2012,1207,28.9,68,25,143,116,313,827,217
2019,36005020601,"Census Tract 206.01, Bronx County, New York",979,73,906,644,1406,28679,1958,2013,1304,34.4,107,19,151,126,364,906,228
2020,36005020601,"Census Tract 206.01, Bronx County, New York",955,91,864,646,1544,29932,1965,2014,1333,33.5,85,8,131,98,417,864,235
2012,36005020900,"Census Tract 209, Bronx County, New York",1653,100,1553,1553,3841,28372,1939,2002,921,36.4,238,0,564,24,1011,1553,623
2013,36005020900,"Census Tract 209, Bronx County, New York",1655,122,1533,1533,4374,29508,1941,2004,979,36.4,211,5,496,17,1001,1533,607
2014,36005020900,"Census Tract 209, Bronx County, New York",1681,116,1565,1565,4516,32025,1943,2005,1033,34.9,279,6,496,22,1019,1565,545
2015,36005020900,"Census Tract 209, Bronx County, New York",1678,141,1537,1537,4351,27311,1944,2006,1013,34.2,351,23,588,7,897,1537,582
2016,36005020900,"Census Tract 209, Bronx County, New York",1718,157,1561,1561,4429,31396,1946,2007,1076,33.8,380,34,613,7,901,1561,533
2017,36005020900,"Census Tract 209, Bronx County, New York",1793,132,1661,1655,4757,28293,1948,2007,1079,39.6,396,39,711,0,890,1661,621
2018,36005020900,"Census Tract 209, Bronx County, New York",1792,83,1709,1703,4470,30428,1942,2007,1104,39.9,412,62,768,0,912,1709,590
2019,36005020900,"Census Tract 209, Bronx County, New York",1799,67,1732,1732,4238,31190,1943,2009,1121,38.6,363,66,785,11,914,1732,649
2020,36005020900,"Census Tract 209, Bronx County, New York",1957,109,1848,1848,4376,39741,1951,2010,1152,33.2,273,55,846,12,970,1848,522
2012,36005021001,"Census Tract 210.01, Bronx County, New York",4079,296,3783,2829,6596,45162,1946,2004,1111,30,845,55,2019,85,766,3783,534
2013,36005021001,"Census Tract 210.01, Bronx County, New York",4057,271,3786,2766,6648,45443,1946,2004,1131,30.6,783,64,1801,116,794,3786,636
2014,36005021001,"Census Tract 210.01, Bronx County, New York",4078,300,3778,2650,6337,46948,1946,2005,1143,31,802,29,1638,75,921,3778,619
2015,36005021001,"Census Tract 210.01, Bronx County, New York",4114,264,3850,2560,5878,45294,1946,2006,1144,31.8,622,30,1518,60,972,3850,570
2016,36005021001,"Census Tract 210.01, Bronx County, New York",4115,272,3843,2696,6598,47161,1944,2008,1160,31,486,34,1488,114,1084,3843,590
2017,36005021001,"Census Tract 210.01, Bronx County, New York",4203,258,3945,2827,6506,51038,1943,2010,1221,30.5,547,93,1392,79,1291,3945,492
2018,36005021001,"Census Tract 210.01, Bronx County, New York",4156,213,3943,3067,6723,51357,1942,2011,1322,30.9,711,70,1680,112,1284,3943,513
2019,36005021001,"Census Tract 210.01, Bronx County, New York",4060,219,3841,3032,6849,52305,1943,2011,1383,31.3,698,79,1714,118,1155,3841,583
2020,36005021001,"Census Tract 210.01, Bronx County, New York",3910,244,3666,2915,6464,56005,1944,2012,1419,29.2,763,109,1767,181,998,3666,648
2012,36005021002,"Census Tract 210.02, Bronx County, New York",3294,167,3127,2557,5599,44507,1946,2002,1077,29,670,196,1477,124,747,3127,612
2013,36005021002,"Census Tract 210.02, Bronx County, New York",3166,184,2982,2478,5123,41346,1944,2003,1095,29.9,662,153,1552,201,561,2982,533
2014,36005021002,"Census Tract 210.02, Bronx County, New York",3091,110,2981,2549,4959,42607,1941,2004,1131,29.4,647,126,1642,187,571,2981,496
2015,36005021002,"Census Tract 210.02, Bronx County, New York",3120,113,3007,2465,4930,41313,1941,2005,1142,29.5,572,130,1448,192,626,3007,506
2016,36005021002,"Census Tract 210.02, Bronx County, New York",3150,38,3112,2610,5571,54464,1942,2008,1174,26.3,781,114,1754,137,573,3112,328
2017,36005021002,"Census Tract 210.02, Bronx County, New York",3131,0,3131,2563,5728,54196,1943,2010,1214,27.1,727,52,1560,148,829,3131,375
2018,36005021002,"Census Tract 210.02, Bronx County, New York",3182,0,3182,2587,6083,55035,1944,2010,1298,28,625,53,1506,125,961,3182,489
2019,36005021002,"Census Tract 210.02, Bronx County, New York",3049,46,3003,2382,5885,55342,1945,2011,1379,30.2,639,72,1391,122,897,3003,495
2020,36005021002,"Census Tract 210.02, Bronx County, New York",3301,38,3263,2704,6607,59214,1945,2011,1445,28.2,727,63,1420,115,1206,3263,489
2012,36005021100,"Census Tract 211, Bronx County, New York",1956,126,1830,1774,5319,25795,1951,2004,970,37.9,298,0,828,0,1020,1830,782
2013,36005021100,"Census Tract 211, Bronx County, New York",1935,134,1801,1728,5071,23534,1957,2004,986,38.7,281,0,786,0,1011,1801,785
2014,36005021100,"Census Tract 211, Bronx County, New York",1987,134,1853,1761,5199,22151,1965,2004,1013,38.7,257,0,767,12,1070,1853,824
2015,36005021100,"Census Tract 211, Bronx County, New York",1976,185,1791,1690,4947,NA,1955,2006,999,43.8,228,0,682,8,1011,1791,808
2016,36005021100,"Census Tract 211, Bronx County, New York",1980,187,1793,1699,4814,24913,1950,2005,1021,43.8,152,8,618,8,1069,1793,766
2017,36005021100,"Census Tract 211, Bronx County, New York",1978,151,1827,1712,4707,25746,1944,2006,1021,41.4,126,7,632,7,1078,1827,739
2018,36005021100,"Census Tract 211, Bronx County, New York",1972,116,1856,1761,4742,27301,1943,2007,1010,41.7,149,8,719,14,1122,1856,745
2019,36005021100,"Census Tract 211, Bronx County, New York",2033,98,1935,1832,4870,29135,1941,2008,999,39.6,178,24,667,22,1217,1935,749
2020,36005021100,"Census Tract 211, Bronx County, New York",1866,63,1803,1692,5098,30733,1953,2009,1008,36.5,133,37,706,25,1019,1803,666
2012,36005021200,"Census Tract 212, Bronx County, New York",2289,141,2148,1660,4489,55130,1949,2002,1135,25.3,573,125,663,273,599,2148,160
2013,36005021200,"Census Tract 212, Bronx County, New York",2295,143,2152,1662,4278,56896,1949,2002,1165,24.2,598,129,730,180,603,2152,183
2014,36005021200,"Census Tract 212, Bronx County, New York",2303,139,2164,1546,3698,51691,1947,2003,1179,25.8,457,63,686,181,598,2164,233
2015,36005021200,"Census Tract 212, Bronx County, New York",2310,205,2105,1560,3942,51771,1943,2005,1196,26.2,419,17,739,214,565,2105,241
2016,36005021200,"Census Tract 212, Bronx County, New York",2292,140,2152,1505,3559,60070,1942,2006,1205,24.1,451,26,773,154,522,2152,231
2017,36005021200,"Census Tract 212, Bronx County, New York",2297,108,2189,1638,3867,57857,1943,2004,1228,23.2,431,26,937,153,545,2189,259
2018,36005021200,"Census Tract 212, Bronx County, New York",2292,145,2147,1711,3839,55852,1944,2006,1254,27,399,15,1052,209,467,2147,269
2019,36005021200,"Census Tract 212, Bronx County, New York",2468,162,2306,1925,3752,56350,1945,2008,1319,27.4,492,35,1070,179,646,2306,250
2020,36005021200,"Census Tract 212, Bronx County, New York",2427,104,2323,1741,3469,58379,1945,2008,1348,26.5,439,15,914,178,661,2323,305
2012,36005021301,"Census Tract 213.01, Bronx County, New York",422,16,406,389,1274,22313,1939,1997,651,25.1,31,0,61,0,336,406,162
2013,36005021301,"Census Tract 213.01, Bronx County, New York",459,16,443,416,1273,21802,1939,2000,953,38.2,35,0,60,0,362,443,216
2014,36005021301,"Census Tract 213.01, Bronx County, New York",455,31,424,392,1006,15156,1950,2002,769,37.5,44,0,71,0,334,424,205
2015,36005021301,"Census Tract 213.01, Bronx County, New York",468,9,459,417,1065,15032,1949,2004,900,37.5,49,0,85,0,352,459,221
2016,36005021301,"Census Tract 213.01, Bronx County, New York",467,9,458,405,971,14951,1946,2005,938,39.3,57,0,63,0,354,458,219
2017,36005021301,"Census Tract 213.01, Bronx County, New York",469,23,446,383,964,17156,1939,2006,938,43.7,50,0,58,0,339,446,210
2018,36005021301,"Census Tract 213.01, Bronx County, New York",457,8,449,373,1120,22652,1945,2008,1013,44.6,46,0,93,0,317,449,184
2019,36005021301,"Census Tract 213.01, Bronx County, New York",474,5,469,377,1019,23454,1943,2010,1056,40.4,55,0,65,0,343,469,175
2020,36005021301,"Census Tract 213.01, Bronx County, New York",411,2,409,308,776,26410,1944,2010,1142,34.7,70,0,66,0,278,409,96
2012,36005021302,"Census Tract 213.02, Bronx County, New York",1862,62,1800,1709,5084,22636,1985,2003,961,42,171,12,948,21,906,1800,651
2013,36005021302,"Census Tract 213.02, Bronx County, New York",1920,37,1883,1772,5275,24352,1984,2003,970,39.2,159,9,987,14,978,1883,643
2014,36005021302,"Census Tract 213.02, Bronx County, New York",1982,35,1947,1850,5913,28367,1980,2004,999,38.3,226,12,943,18,1055,1947,684
2015,36005021302,"Census Tract 213.02, Bronx County, New York",1995,34,1961,1881,5786,NA,1970,2005,996,38.1,257,26,1062,19,937,1961,621
2016,36005021302,"Census Tract 213.02, Bronx County, New York",2072,37,2035,1975,5989,31057,1991,2006,1066,36.4,271,30,1036,26,1016,2035,606
2017,36005021302,"Census Tract 213.02, Bronx County, New York",2100,51,2049,1992,6153,31573,1976,2010,1111,36.5,204,19,928,31,1151,2049,659
2018,36005021302,"Census Tract 213.02, Bronx County, New York",2158,141,2017,1976,5945,30231,1991,2011,1132,37.3,240,12,885,21,1247,2017,729
2019,36005021302,"Census Tract 213.02, Bronx County, New York",2260,162,2098,2044,5362,24868,1993,2012,1174,45.9,326,8,1001,25,1293,2098,887
2020,36005021302,"Census Tract 213.02, Bronx County, New York",2533,127,2406,2354,5191,18239,2000,2013,1228,51,276,0,850,22,1686,2406,1158
2012,36005021501,"Census Tract 215.01, Bronx County, New York",1335,322,1013,1006,3596,33971,1940,2004,984,27.7,104,0,318,22,710,1013,243
2013,36005021501,"Census Tract 215.01, Bronx County, New York",1351,225,1126,1114,3762,30591,1941,2005,1032,30.2,188,0,330,22,796,1126,342
2014,36005021501,"Census Tract 215.01, Bronx County, New York",1394,173,1221,1208,4051,28205,1941,2007,1031,32.5,162,0,317,22,915,1221,386
2015,36005021501,"Census Tract 215.01, Bronx County, New York",1421,19,1402,1391,4500,25902,1943,2008,1038,35.5,237,0,367,21,1082,1402,548
2016,36005021501,"Census Tract 215.01, Bronx County, New York",1413,34,1379,1362,4512,26533,1943,2010,1057,34.5,258,0,395,0,1056,1379,527
2017,36005021501,"Census Tract 215.01, Bronx County, New York",1436,53,1383,1369,4662,26837,1940,2011,1121,37.9,273,0,423,0,1058,1383,519
2018,36005021501,"Census Tract 215.01, Bronx County, New York",1445,56,1389,1370,4484,27182,0,2011,1151,37.1,236,0,424,0,1049,1389,516
2019,36005021501,"Census Tract 215.01, Bronx County, New York",1461,71,1390,1373,4328,32784,0,2011,1238,37.1,286,0,435,0,1063,1390,445
2020,36005021501,"Census Tract 215.01, Bronx County, New York",1389,70,1319,1293,4195,39225,0,2011,1351,35.9,223,0,451,0,963,1319,338
2012,36005021502,"Census Tract 215.02, Bronx County, New York",2103,98,2005,1942,5104,19231,1939,2002,939,40.9,129,25,648,0,1269,2005,955
2013,36005021502,"Census Tract 215.02, Bronx County, New York",2107,120,1987,1925,5423,18912,1939,2003,956,39.7,209,34,624,0,1281,1987,910
2014,36005021502,"Census Tract 215.02, Bronx County, New York",2166,62,2104,2104,5778,17664,1943,2004,990,47.9,175,17,650,0,1403,2104,1018
2015,36005021502,"Census Tract 215.02, Bronx County, New York",2155,46,2109,2094,5704,18681,1941,2005,1021,46.1,252,32,607,0,1472,2109,1025
2016,36005021502,"Census Tract 215.02, Bronx County, New York",2199,51,2148,2090,5818,19383,1945,2005,1039,44.7,254,27,663,0,1414,2148,1056
2017,36005021502,"Census Tract 215.02, Bronx County, New York",2218,95,2123,2064,6222,24136,1945,2007,1061,42.1,294,16,654,0,1478,2123,855
2018,36005021502,"Census Tract 215.02, Bronx County, New York",2221,68,2153,2092,5914,22692,1944,2007,1068,42.7,344,11,677,0,1438,2153,944
2019,36005021502,"Census Tract 215.02, Bronx County, New York",2225,76,2149,2032,5791,25556,0,2009,1095,42.7,370,8,740,0,1361,2149,884
2020,36005021502,"Census Tract 215.02, Bronx County, New York",2194,82,2112,2006,5679,31375,1944,2010,964,34.9,384,0,695,0,1383,2112,950
2012,36005021601,"Census Tract 216.01, Bronx County, New York",1699,157,1542,1340,3657,22294,1945,2003,1097,50,114,91,226,38,1022,1542,605
2013,36005021601,"Census Tract 216.01, Bronx County, New York",1692,162,1530,1313,3723,22482,1940,2005,1132,50,103,122,282,50,886,1530,602
2014,36005021601,"Census Tract 216.01, Bronx County, New York",1680,152,1528,1293,3541,24547,1939,2007,1176,50,112,105,310,28,887,1528,561
2015,36005021601,"Census Tract 216.01, Bronx County, New York",1753,167,1586,1362,3682,NA,1941,2008,1181,50,123,127,360,31,908,1586,564
2016,36005021601,"Census Tract 216.01, Bronx County, New York",1744,142,1602,1321,3595,24727,1950,2009,1215,50,196,163,443,34,748,1602,637
2017,36005021601,"Census Tract 216.01, Bronx County, New York",1743,97,1646,1331,3607,28960,1947,2011,1248,50,169,130,487,28,775,1646,510
2018,36005021601,"Census Tract 216.01, Bronx County, New York",1760,105,1655,1364,3631,29139,1945,2012,1296,51,191,101,568,20,807,1655,478
2019,36005021601,"Census Tract 216.01, Bronx County, New York",1760,83,1677,1394,3885,31375,1944,2012,1321,51,133,110,570,18,841,1677,440
2020,36005021601,"Census Tract 216.01, Bronx County, New York",1517,49,1468,1205,3511,33257,1940,2013,1372,51,142,53,494,20,755,1468,376
2012,36005021602,"Census Tract 216.02, Bronx County, New York",2583,83,2500,1896,4402,49346,1943,2002,1150,28.1,651,62,993,159,715,2500,471
2013,36005021602,"Census Tract 216.02, Bronx County, New York",2565,114,2451,1945,4708,43038,1943,2004,1151,32.6,681,50,914,220,821,2451,562
2014,36005021602,"Census Tract 216.02, Bronx County, New York",2560,108,2452,2071,4871,43204,1944,2005,1178,34.6,673,43,989,180,885,2452,634
2015,36005021602,"Census Tract 216.02, Bronx County, New York",2588,71,2517,2173,5353,39496,1941,2005,1194,36.6,722,85,915,170,901,2517,606
2016,36005021602,"Census Tract 216.02, Bronx County, New York",2559,127,2432,2106,5034,43269,1941,2006,1190,34.6,648,99,893,150,874,2432,629
2017,36005021602,"Census Tract 216.02, Bronx County, New York",2474,167,2307,1963,4782,46484,1943,2007,1265,29.8,661,47,822,205,795,2307,486
2018,36005021602,"Census Tract 216.02, Bronx County, New York",2587,158,2429,2018,4481,50250,0,2006,1314,29.5,702,55,955,164,760,2429,458
2019,36005021602,"Census Tract 216.02, Bronx County, New York",2569,126,2443,1922,4284,55230,0,2007,1355,28.6,690,102,814,164,774,2443,364
2020,36005021602,"Census Tract 216.02, Bronx County, New York",2307,107,2200,1673,4227,56839,1941,2012,1435,27.9,589,52,752,223,699,2200,314
2012,36005021700,"Census Tract 217, Bronx County, New York",1840,274,1566,1543,3950,17253,1939,2004,953,45.1,111,0,765,0,810,1566,811
2013,36005021700,"Census Tract 217, Bronx County, New York",1832,243,1589,1572,4246,20488,1939,2004,990,41.5,128,0,809,0,784,1589,734
2014,36005021700,"Census Tract 217, Bronx County, New York",1855,264,1591,1574,4426,20909,1939,2006,1022,39.9,142,0,759,0,793,1591,766
2015,36005021700,"Census Tract 217, Bronx County, New York",1931,256,1675,1651,4436,22525,1939,2007,998,41.9,161,0,841,0,800,1675,755
2016,36005021700,"Census Tract 217, Bronx County, New York",1924,223,1701,1678,4663,23723,1939,2008,1060,39,131,16,858,5,825,1701,757
2017,36005021700,"Census Tract 217, Bronx County, New York",1900,210,1690,1662,4886,27381,1939,2008,1064,36.6,146,16,888,6,786,1690,650
2018,36005021700,"Census Tract 217, Bronx County, New York",1866,187,1679,1662,4662,25338,0,2008,1111,38,175,24,923,22,728,1679,671
2019,36005021700,"Census Tract 217, Bronx County, New York",1823,148,1675,1660,4591,35568,0,2008,1134,34.3,196,35,978,24,715,1675,538
2020,36005021700,"Census Tract 217, Bronx County, New York",1740,130,1610,1603,4671,40583,0,2009,1217,33.7,275,33,807,59,776,1610,449
2012,36005021800,"Census Tract 218, Bronx County, New York",2397,166,2231,1849,4938,27982,1946,2003,1092,40.9,405,34,585,29,1157,2231,616
2013,36005021800,"Census Tract 218, Bronx County, New York",2341,175,2166,1781,4744,27427,1948,2003,1116,42.6,411,0,652,55,1036,2166,602
2014,36005021800,"Census Tract 218, Bronx County, New York",2425,141,2284,1934,5557,27289,1945,2003,1133,43.9,315,0,645,96,1285,2284,685
2015,36005021800,"Census Tract 218, Bronx County, New York",2441,164,2277,1838,5084,27298,1953,2005,1159,38.5,331,13,669,47,1256,2277,567
2016,36005021800,"Census Tract 218, Bronx County, New York",2470,144,2326,1791,4955,26875,1953,2008,1161,42.9,285,29,681,50,1242,2326,596
2017,36005021800,"Census Tract 218, Bronx County, New York",2449,174,2275,1802,5230,29722,1939,2009,1220,42.1,358,30,679,22,1282,2275,548
2018,36005021800,"Census Tract 218, Bronx County, New York",2462,142,2320,1834,5397,31500,1944,2011,1296,40.5,313,28,644,0,1412,2320,566
2019,36005021800,"Census Tract 218, Bronx County, New York",2435,106,2329,1852,5045,37911,1943,2012,1341,34.6,299,27,672,0,1367,2329,499
2020,36005021800,"Census Tract 218, Bronx County, New York",2420,155,2265,1857,4693,38346,0,2014,1329,34,268,77,555,0,1417,2265,576
2012,36005021900,"Census Tract 219, Bronx County, New York",457,0,457,452,1306,30357,1939,2004,959,39.3,37,4,175,0,282,457,135
2013,36005021900,"Census Tract 219, Bronx County, New York",441,7,434,428,1308,30595,1939,2003,1035,37.7,40,8,92,0,365,434,130
2014,36005021900,"Census Tract 219, Bronx County, New York",432,25,407,401,1182,28646,1939,2004,1083,36.1,15,11,100,0,332,407,133
2015,36005021900,"Census Tract 219, Bronx County, New York",439,30,409,403,1253,31042,1939,2004,1128,35.8,29,8,86,0,338,409,128
2016,36005021900,"Census Tract 219, Bronx County, New York",437,40,397,390,1115,22632,1939,2005,1163,43.4,37,11,78,0,305,397,148
2017,36005021900,"Census Tract 219, Bronx County, New York",442,54,388,388,1118,23370,1939,2007,1247,45.9,46,12,37,4,340,388,141
2018,36005021900,"Census Tract 219, Bronx County, New York",452,54,398,398,1045,21686,0,2011,1326,51,51,6,68,3,339,398,174
2019,36005021900,"Census Tract 219, Bronx County, New York",376,10,366,366,872,26316,0,2010,1310,45.8,67,18,53,11,303,366,116
2020,36005021900,"Census Tract 219, Bronx County, New York",388,9,379,379,839,27569,0,2007,1342,48.1,68,14,90,9,284,379,148
2012,36005022000,"Census Tract 220, Bronx County, New York",500,68,432,418,1259,13190,1939,2004,1172,50,75,8,177,0,240,432,287
2013,36005022000,"Census Tract 220, Bronx County, New York",479,40,439,434,1376,13100,1939,2005,1257,50,91,8,151,0,280,439,294
2014,36005022000,"Census Tract 220, Bronx County, New York",472,20,452,436,1741,23250,1948,2006,1211,50,51,0,91,16,334,452,241
2015,36005022000,"Census Tract 220, Bronx County, New York",485,21,464,448,1766,NA,1954,2005,1222,50,52,0,59,10,383,464,249
2016,36005022000,"Census Tract 220, Bronx County, New York",514,23,491,470,1724,26061,1954,2007,1226,50,45,0,40,22,408,491,233
2017,36005022000,"Census Tract 220, Bronx County, New York",699,8,691,680,2039,27177,1965,2009,1215,36.8,76,20,153,26,481,691,260
2018,36005022000,"Census Tract 220, Bronx County, New York",720,44,676,663,1926,31319,1984,2009,1197,33,52,18,148,26,489,676,208
2019,36005022000,"Census Tract 220, Bronx County, New York",742,64,678,652,1712,34423,1990,2010,1176,36.7,60,5,179,17,471,678,193
2020,36005022000,"Census Tract 220, Bronx County, New York",691,71,620,606,1811,32115,2002,2012,1192,38.1,58,6,196,24,402,620,184
2012,36005022101,"Census Tract 221.01, Bronx County, New York",1198,20,1178,1174,4108,30792,1942,2003,1004,34,49,20,291,9,849,1178,357
2013,36005022101,"Census Tract 221.01, Bronx County, New York",1187,46,1141,1141,3837,27058,1941,2004,1016,41.4,88,16,350,19,779,1141,350
2014,36005022101,"Census Tract 221.01, Bronx County, New York",1193,31,1162,1162,3956,26875,1946,2005,1049,42.2,95,0,249,8,913,1162,395
2015,36005022101,"Census Tract 221.01, Bronx County, New York",1232,39,1193,1193,3884,25870,1941,2006,1080,45.1,104,0,254,10,912,1193,474
2016,36005022101,"Census Tract 221.01, Bronx County, New York",1263,65,1198,1198,3948,27000,1940,2006,1070,43.1,116,0,312,19,890,1198,526
2017,36005022101,"Census Tract 221.01, Bronx County, New York",1269,58,1211,1211,3927,26732,1939,2007,1110,44.9,186,0,253,48,942,1211,568
2018,36005022101,"Census Tract 221.01, Bronx County, New York",1294,33,1261,1261,3896,28192,1941,2007,1161,44.9,180,0,206,51,1020,1261,608
2019,36005022101,"Census Tract 221.01, Bronx County, New York",1276,14,1262,1262,4133,32600,1942,2009,1217,40.5,212,0,354,88,866,1262,524
2020,36005022101,"Census Tract 221.01, Bronx County, New York",1284,26,1258,1258,3908,41128,1982,2008,1183,33.5,248,0,227,63,946,1258,425
2012,36005022102,"Census Tract 221.02, Bronx County, New York",1735,188,1547,1518,5153,20928,1939,2000,1012,49.9,100,31,291,14,1291,1547,830
2013,36005022102,"Census Tract 221.02, Bronx County, New York",1711,177,1534,1505,4791,17793,1941,2002,1090,50,166,0,310,9,1287,1534,855
2014,36005022102,"Census Tract 221.02, Bronx County, New York",1717,199,1518,1492,4831,17696,1946,2003,1099,50,214,0,348,15,1218,1518,877
2015,36005022102,"Census Tract 221.02, Bronx County, New York",1733,150,1583,1535,4710,NA,1939,2005,1109,50,220,0,368,13,1236,1583,828
2016,36005022102,"Census Tract 221.02, Bronx County, New York",1750,90,1660,1630,5166,19683,1939,2005,1155,50,226,0,378,16,1301,1660,809
2017,36005022102,"Census Tract 221.02, Bronx County, New York",1748,70,1678,1642,5302,21555,1939,2006,1164,50,244,0,410,23,1266,1678,766
2018,36005022102,"Census Tract 221.02, Bronx County, New York",1746,57,1689,1655,5383,23721,0,2009,1148,47.2,214,7,291,21,1373,1689,702
2019,36005022102,"Census Tract 221.02, Bronx County, New York",1745,67,1678,1625,5161,33354,0,2009,1234,42.1,249,19,300,0,1354,1678,525
2020,36005022102,"Census Tract 221.02, Bronx County, New York",1630,37,1593,1582,5374,34409,0,2008,1219,42.5,226,33,243,0,1329,1593,576
2012,36005022200,"Census Tract 222, Bronx County, New York",1189,157,1032,888,2394,30156,1951,2004,1125,43,110,59,156,57,669,1032,260
2013,36005022200,"Census Tract 222, Bronx County, New York",1193,117,1076,906,2540,35395,1939,2005,1187,38.8,136,103,213,72,542,1076,220
2014,36005022200,"Census Tract 222, Bronx County, New York",1212,123,1089,975,2611,32868,1939,2006,1241,42.8,131,92,196,98,622,1089,187
2015,36005022200,"Census Tract 222, Bronx County, New York",1238,59,1179,1018,2844,35147,1951,2008,1254,42.2,202,82,218,99,655,1179,223
2016,36005022200,"Census Tract 222, Bronx County, New York",1218,68,1150,997,2771,35458,1952,2010,1270,39.8,220,90,194,115,628,1150,211
2017,36005022200,"Census Tract 222, Bronx County, New York",1222,47,1175,1025,2725,40066,1939,2010,1272,38,246,113,161,139,604,1175,178
2018,36005022200,"Census Tract 222, Bronx County, New York",1193,53,1140,975,2633,38185,0,2011,1343,40.9,220,111,179,155,524,1140,174
2019,36005022200,"Census Tract 222, Bronx County, New York",1169,65,1104,905,2584,43608,1951,2012,1378,36.9,187,79,144,149,518,1104,195
2020,36005022200,"Census Tract 222, Bronx County, New York",1083,76,1007,810,2330,43362,1940,2013,1393,36.3,189,72,112,206,409,1007,178
2012,36005022300,"Census Tract 223, Bronx County, New York",1867,47,1820,1820,5489,29522,1939,2003,986,31.3,122,12,539,15,1354,1820,569
2013,36005022300,"Census Tract 223, Bronx County, New York",1810,24,1786,1786,5840,31604,1946,2002,1051,29.4,170,33,544,21,1322,1786,485
2014,36005022300,"Census Tract 223, Bronx County, New York",1833,29,1804,1804,5214,29535,1955,2001,1031,32.4,153,42,744,25,1088,1804,574
2015,36005022300,"Census Tract 223, Bronx County, New York",1859,29,1830,1830,5108,24277,1949,2002,1059,41,187,41,696,0,1109,1830,706
2016,36005022300,"Census Tract 223, Bronx County, New York",1850,16,1834,1834,5177,23947,1947,2002,1034,38.4,164,42,583,0,1171,1834,731
2017,36005022300,"Census Tract 223, Bronx County, New York",1864,38,1826,1826,5275,26000,1943,2003,1082,44.4,125,42,427,0,1326,1826,709
2018,36005022300,"Census Tract 223, Bronx County, New York",1884,39,1845,1845,5078,26537,0,2004,1122,45.7,223,15,440,0,1340,1845,688
2019,36005022300,"Census Tract 223, Bronx County, New York",1889,43,1846,1846,5268,26761,0,2006,1146,42.7,259,37,435,0,1360,1846,713
2020,36005022300,"Census Tract 223, Bronx County, New York",2033,40,1993,1993,5150,27232,1946,2008,981,38.4,201,24,446,0,1511,1993,817
2012,36005022401,"Census Tract 224.01, Bronx County, New York",1149,21,1128,1003,2458,38323,1939,2003,1147,33.2,211,246,173,86,515,1128,233
2013,36005022401,"Census Tract 224.01, Bronx County, New York",1144,19,1125,941,2299,36375,1939,2003,1201,34.3,242,212,187,73,490,1125,212
2014,36005022401,"Census Tract 224.01, Bronx County, New York",1138,21,1117,932,2305,38750,1939,2004,1222,33.3,309,187,192,62,507,1117,273
2015,36005022401,"Census Tract 224.01, Bronx County, New York",1147,35,1112,924,2361,44167,1939,2005,1240,30.4,250,93,226,48,575,1112,274
2016,36005022401,"Census Tract 224.01, Bronx County, New York",1170,34,1136,953,2552,46908,1939,2006,1290,31,248,88,192,54,634,1136,299
2017,36005022401,"Census Tract 224.01, Bronx County, New York",1166,37,1129,938,2361,39875,1941,2008,1355,36.3,229,99,216,76,532,1129,293
2018,36005022401,"Census Tract 224.01, Bronx County, New York",1185,51,1134,989,2411,51150,1944,2011,1454,32.7,237,95,196,55,638,1134,249
2019,36005022401,"Census Tract 224.01, Bronx County, New York",1173,71,1102,991,2295,51065,1944,2010,1543,33.9,158,111,199,54,620,1102,205
2020,36005022401,"Census Tract 224.01, Bronx County, New York",1088,41,1047,946,2260,44802,1945,2011,1585,35.6,176,110,162,50,617,1047,136
2012,36005022403,"Census Tract 224.03, Bronx County, New York",1371,58,1313,1195,2844,32163,1939,2003,1096,37.6,403,283,129,33,702,1313,402
2013,36005022403,"Census Tract 224.03, Bronx County, New York",1364,69,1295,1180,3091,33385,1939,2004,1160,39.5,383,294,128,26,705,1295,366
2014,36005022403,"Census Tract 224.03, Bronx County, New York",1370,65,1305,1189,3060,27212,1939,2005,1200,42.6,336,264,161,20,782,1305,404
2015,36005022403,"Census Tract 224.03, Bronx County, New York",1366,46,1320,1219,3281,33750,1939,2005,1269,42,348,238,198,0,807,1320,354
2016,36005022403,"Census Tract 224.03, Bronx County, New York",1373,46,1327,1186,3111,34265,1939,2006,1357,41,255,193,225,0,798,1327,369
2017,36005022403,"Census Tract 224.03, Bronx County, New York",1380,21,1359,1206,3148,34076,1939,2005,1335,40.8,259,209,259,0,777,1359,365
2018,36005022403,"Census Tract 224.03, Bronx County, New York",1361,20,1341,1183,2832,33750,0,2004,1449,38.9,300,230,276,0,712,1341,414
2019,36005022403,"Census Tract 224.03, Bronx County, New York",1356,77,1279,1126,2665,47556,0,2006,1439,33,377,207,320,0,634,1279,285
2020,36005022403,"Census Tract 224.03, Bronx County, New York",1285,55,1230,1067,2326,41875,0,2010,1492,34.3,279,158,258,41,637,1230,307
2012,36005022404,"Census Tract 224.04, Bronx County, New York",1763,52,1711,1391,3592,40755,1939,2003,1100,30.3,336,379,205,68,635,1711,255
2013,36005022404,"Census Tract 224.04, Bronx County, New York",1798,52,1746,1528,3583,38000,1942,2002,1116,33.2,334,461,256,38,684,1746,415
2014,36005022404,"Census Tract 224.04, Bronx County, New York",1824,36,1788,1493,3320,32016,1948,2003,1159,34,372,508,378,71,590,1788,460
2015,36005022404,"Census Tract 224.04, Bronx County, New York",1849,42,1807,1488,3485,37833,1946,2005,1190,35.4,337,444,340,44,713,1807,366
2016,36005022404,"Census Tract 224.04, Bronx County, New York",1835,46,1789,1472,3540,38906,1939,2006,1199,35.1,389,450,400,58,610,1789,377
2017,36005022404,"Census Tract 224.04, Bronx County, New York",1842,24,1818,1452,3423,38108,1939,2010,1269,36.1,439,446,377,112,535,1818,408
2018,36005022404,"Census Tract 224.04, Bronx County, New York",1849,16,1833,1427,3317,46594,1943,2009,1303,33.2,518,410,334,80,630,1833,245
2019,36005022404,"Census Tract 224.04, Bronx County, New York",1883,22,1861,1461,3324,52038,1945,2010,1323,32.2,481,339,273,74,739,1861,221
2020,36005022404,"Census Tract 224.04, Bronx County, New York",1883,44,1839,1378,3161,53333,1944,2011,1355,30.4,375,333,264,77,686,1839,279
2012,36005022500,"Census Tract 225, Bronx County, New York",2293,126,2167,2115,7359,31697,1939,2003,1070,37.6,232,51,975,0,1265,2167,724
2013,36005022500,"Census Tract 225, Bronx County, New York",2348,139,2209,2169,7347,31670,1939,2004,1120,37.6,266,63,843,0,1417,2209,647
2014,36005022500,"Census Tract 225, Bronx County, New York",2380,113,2267,2267,7231,31309,1939,2005,1130,38.4,350,13,952,0,1445,2267,676
2015,36005022500,"Census Tract 225, Bronx County, New York",2400,93,2307,2266,7101,29375,1939,2007,1105,40,191,18,936,35,1321,2307,753
2016,36005022500,"Census Tract 225, Bronx County, New York",2416,54,2362,2292,7202,29128,1939,2009,1126,39.1,252,35,902,79,1316,2362,709
2017,36005022500,"Census Tract 225, Bronx County, New York",2415,64,2351,2275,7349,31034,1939,2009,1145,37.6,269,53,890,47,1413,2351,639
2018,36005022500,"Census Tract 225, Bronx County, New York",2395,67,2328,2261,7093,35508,0,2008,1188,35.1,282,57,807,39,1601,2328,696
2019,36005022500,"Census Tract 225, Bronx County, New York",2411,74,2337,2227,7147,38265,0,2011,1294,36.3,270,56,775,35,1684,2337,654
2020,36005022500,"Census Tract 225, Bronx County, New York",2307,87,2220,2141,7581,47553,0,2009,1319,34.1,247,73,707,18,1680,2220,557
2012,36005022701,"Census Tract 227.01, Bronx County, New York",1760,121,1639,1521,5154,34450,1939,2003,1039,36.3,126,18,612,4,949,1639,548
2013,36005022701,"Census Tract 227.01, Bronx County, New York",1842,84,1758,1635,5499,31166,1939,2003,1046,38.4,171,13,597,22,1064,1758,595
2014,36005022701,"Census Tract 227.01, Bronx County, New York",1876,82,1794,1722,5678,29000,1940,2003,1092,42.4,203,15,621,30,1094,1794,579
2015,36005022701,"Census Tract 227.01, Bronx County, New York",1907,78,1829,1770,5625,NA,1942,2004,1097,42.5,272,23,675,31,1112,1829,590
2016,36005022701,"Census Tract 227.01, Bronx County, New York",1898,52,1846,1772,5377,30049,1943,2004,1154,43.5,334,5,712,45,1049,1846,551
2017,36005022701,"Census Tract 227.01, Bronx County, New York",1874,28,1846,1774,5318,31261,1941,2006,1176,41,362,32,581,48,1136,1846,509
2018,36005022701,"Census Tract 227.01, Bronx County, New York",1898,42,1856,1805,4855,30661,1942,2007,1198,41.5,342,26,692,30,1124,1856,592
2019,36005022701,"Census Tract 227.01, Bronx County, New York",1891,58,1833,1789,4829,33359,0,2009,1192,37.5,337,27,769,23,1102,1833,652
2020,36005022701,"Census Tract 227.01, Bronx County, New York",1984,50,1934,1890,4453,24268,1946,2009,1318,39.3,313,30,774,30,1166,1934,587
2012,36005022702,"Census Tract 227.02, Bronx County, New York",636,86,550,550,1545,48250,1941,2003,952,23.6,99,0,196,13,323,550,100
2013,36005022702,"Census Tract 227.02, Bronx County, New York",666,16,650,650,1678,42955,1939,2003,941,24.7,111,0,220,25,375,650,157
2014,36005022702,"Census Tract 227.02, Bronx County, New York",679,16,663,658,1501,30690,1943,2005,932,35.2,120,0,254,10,358,663,214
2015,36005022702,"Census Tract 227.02, Bronx County, New York",663,17,646,636,1434,21875,1945,2005,899,39.5,119,0,261,23,333,646,266
2016,36005022702,"Census Tract 227.02, Bronx County, New York",643,29,614,602,1384,22125,1946,2008,974,34,163,4,230,35,323,614,240
2017,36005022702,"Census Tract 227.02, Bronx County, New York",566,0,566,561,1501,31639,1942,2005,1098,47,135,0,192,32,347,566,178
2018,36005022702,"Census Tract 227.02, Bronx County, New York",577,0,577,573,1597,30144,1942,2005,1118,46.9,137,0,150,25,402,577,213
2019,36005022702,"Census Tract 227.02, Bronx County, New York",568,0,568,560,1560,26284,1941,2006,1177,44.1,149,0,127,27,402,568,188
2020,36005022702,"Census Tract 227.02, Bronx County, New York",538,0,538,512,1451,25969,0,2007,1283,51,158,0,93,26,395,538,157
2012,36005022703,"Census Tract 227.03, Bronx County, New York",604,14,590,590,1702,41100,1942,2001,1143,31.7,104,56,166,53,317,590,139
2013,36005022703,"Census Tract 227.03, Bronx County, New York",600,12,588,588,1812,42500,1939,2002,1152,33,152,47,172,82,277,588,139
2014,36005022703,"Census Tract 227.03, Bronx County, New York",614,14,600,600,1871,45465,1939,2003,1167,32,151,56,128,92,338,600,154
2015,36005022703,"Census Tract 227.03, Bronx County, New York",595,10,585,585,1871,45673,1939,2004,1228,31.6,162,55,165,106,259,585,176
2016,36005022703,"Census Tract 227.03, Bronx County, New York",605,9,596,585,1729,42689,1939,2006,1198,37.7,161,38,122,93,330,596,176
2017,36005022703,"Census Tract 227.03, Bronx County, New York",601,16,585,573,1791,48920,1939,2008,1278,32,173,37,163,89,316,585,153
2018,36005022703,"Census Tract 227.03, Bronx County, New York",599,12,587,576,1688,45577,0,2010,1327,35.7,150,15,184,61,357,587,133
2019,36005022703,"Census Tract 227.03, Bronx County, New York",596,10,586,573,1633,58250,1942,2009,1395,34.4,181,26,196,49,335,586,143
2020,36005022703,"Census Tract 227.03, Bronx County, New York",670,11,659,647,1807,66106,1952,2013,1384,30.4,274,17,207,36,435,659,126
2012,36005022800,"Census Tract 228, Bronx County, New York",2550,281,2269,2073,5716,43036,1944,2003,1174,32.8,677,445,415,235,996,2269,495
2013,36005022800,"Census Tract 228, Bronx County, New York",2588,154,2434,2255,5891,42740,1944,2005,1246,32.2,746,378,432,183,1262,2434,414
2014,36005022800,"Census Tract 228, Bronx County, New York",2586,125,2461,2329,5710,43431,1942,2006,1278,32.3,759,357,594,223,1169,2461,400
2015,36005022800,"Census Tract 228, Bronx County, New York",2515,76,2439,2289,5690,43060,1944,2006,1342,32.9,693,415,583,205,1109,2439,361
2016,36005022800,"Census Tract 228, Bronx County, New York",2523,141,2382,2137,5185,47396,1941,2007,1311,30.3,671,417,448,196,1090,2382,309
2017,36005022800,"Census Tract 228, Bronx County, New York",2518,131,2387,2127,5170,50302,1939,2009,1353,30.1,635,451,469,159,1075,2387,363
2018,36005022800,"Census Tract 228, Bronx County, New York",2480,148,2332,2091,5295,53002,0,2010,1425,31.6,595,426,419,254,1006,2332,326
2019,36005022800,"Census Tract 228, Bronx County, New York",2464,74,2390,2099,5365,57321,1945,2011,1431,28.9,560,427,472,270,971,2390,367
2020,36005022800,"Census Tract 228, Bronx County, New York",2528,71,2457,2074,5402,61036,1948,2013,1563,29.6,721,302,465,260,1078,2457,309
2012,36005022901,"Census Tract 229.01, Bronx County, New York",1877,172,1705,1670,4963,22028,1939,2003,1011,44.7,253,54,506,167,974,1705,679
2013,36005022901,"Census Tract 229.01, Bronx County, New York",1887,212,1675,1638,4785,22480,1939,2004,996,44.2,206,38,503,96,1040,1675,586
2014,36005022901,"Census Tract 229.01, Bronx County, New York",1863,225,1638,1592,5031,23452,1939,2006,1033,41.8,264,31,613,38,939,1638,586
2015,36005022901,"Census Tract 229.01, Bronx County, New York",1937,221,1716,1655,5358,NA,1939,2007,1048,42.8,282,16,465,40,1162,1716,635
2016,36005022901,"Census Tract 229.01, Bronx County, New York",1977,173,1804,1776,5496,27500,1939,2008,1085,41.6,301,14,593,35,1104,1804,657
2017,36005022901,"Census Tract 229.01, Bronx County, New York",1983,151,1832,1777,5697,27691,1939,2010,1140,40.7,295,20,747,50,1054,1832,674
2018,36005022901,"Census Tract 229.01, Bronx County, New York",2057,87,1970,1891,5591,27517,0,2010,1254,40.7,336,17,883,54,1015,1970,779
2019,36005022901,"Census Tract 229.01, Bronx County, New York",2101,90,2011,1913,5418,32236,1940,2011,1288,39.1,308,7,1034,47,1037,2011,744
2020,36005022901,"Census Tract 229.01, Bronx County, New York",2050,123,1927,1853,4926,31414,1943,2010,1274,39.7,409,20,1056,67,877,1927,653
2012,36005022902,"Census Tract 229.02, Bronx County, New York",1098,85,1013,1002,3218,21108,1939,2003,990,50,100,23,349,0,687,1013,570
2013,36005022902,"Census Tract 229.02, Bronx County, New York",1093,51,1042,1000,3076,22424,1940,2003,1010,39.2,149,25,362,0,705,1042,469
2014,36005022902,"Census Tract 229.02, Bronx County, New York",1107,54,1053,1003,2998,21829,1940,2005,1042,44.4,56,29,347,0,738,1053,474
2015,36005022902,"Census Tract 229.02, Bronx County, New York",1159,67,1092,984,2894,22069,1939,2006,1091,44.6,75,8,309,0,749,1092,397
2016,36005022902,"Census Tract 229.02, Bronx County, New York",1148,65,1083,993,2921,23018,1939,2008,1080,44.4,76,0,329,0,732,1083,390
2017,36005022902,"Census Tract 229.02, Bronx County, New York",1136,63,1073,959,3076,27341,1939,2011,1135,44.8,112,16,343,0,681,1073,324
2018,36005022902,"Census Tract 229.02, Bronx County, New York",1159,54,1105,963,3137,27005,0,2011,1174,45.7,101,17,290,0,725,1105,349
2019,36005022902,"Census Tract 229.02, Bronx County, New York",1162,48,1114,952,3121,30585,0,2012,1126,43.6,133,17,300,0,735,1114,342
2020,36005022902,"Census Tract 229.02, Bronx County, New York",1145,35,1110,876,2691,29115,1947,2013,1066,40.3,182,37,304,0,618,1110,360
2012,36005023000,"Census Tract 230, Bronx County, New York",1068,36,1032,788,2338,28068,1939,2004,1121,43.5,49,45,93,31,635,1032,258
2013,36005023000,"Census Tract 230, Bronx County, New York",1075,34,1041,828,2602,36429,1945,2006,1216,34.2,113,104,140,60,524,1041,265
2014,36005023000,"Census Tract 230, Bronx County, New York",1056,70,986,795,2709,36607,1947,2008,1234,41,80,148,108,59,480,986,256
2015,36005023000,"Census Tract 230, Bronx County, New York",1064,58,1006,796,2693,33750,1946,2010,1270,42.2,113,165,124,54,453,1006,248
2016,36005023000,"Census Tract 230, Bronx County, New York",1022,69,953,739,2310,27452,1947,2011,1273,50,134,186,154,59,315,953,278
2017,36005023000,"Census Tract 230, Bronx County, New York",999,65,934,740,2407,33370,1948,2012,1318,47.9,163,146,156,50,361,934,247
2018,36005023000,"Census Tract 230, Bronx County, New York",1029,81,948,720,2088,26458,1944,2012,1310,51,135,118,135,18,422,948,266
2019,36005023000,"Census Tract 230, Bronx County, New York",1045,54,991,784,2183,26786,1943,2013,1363,51,174,96,178,43,436,991,274
2020,36005023000,"Census Tract 230, Bronx County, New York",1052,32,1020,844,2231,45149,1944,2013,1372,38.4,156,115,134,28,537,1020,253
2012,36005023100,"Census Tract 231, Bronx County, New York",461,58,403,386,1230,26630,1939,2003,1070,44.2,46,0,184,0,244,403,170
2013,36005023100,"Census Tract 231, Bronx County, New York",441,34,407,389,1253,28599,1939,2004,1171,45.5,74,0,176,0,234,407,183
2014,36005023100,"Census Tract 231, Bronx County, New York",445,12,433,400,1319,28810,1939,2004,1156,46.9,85,7,147,0,278,433,180
2015,36005023100,"Census Tract 231, Bronx County, New York",450,9,441,422,1288,NA,1939,2006,1117,45.4,63,4,132,0,295,441,227
2016,36005023100,"Census Tract 231, Bronx County, New York",462,0,462,447,1366,26420,1939,2007,1182,46.6,69,4,163,0,293,462,217
2017,36005023100,"Census Tract 231, Bronx County, New York",464,0,464,448,1306,18088,1941,2006,1202,41,47,3,172,0,288,464,236
2018,36005023100,"Census Tract 231, Bronx County, New York",462,7,455,426,1275,27885,1942,2005,1177,38.3,25,3,166,0,273,455,200
2019,36005023100,"Census Tract 231, Bronx County, New York",468,25,443,424,1207,28654,0,2006,1241,36.4,28,0,184,0,297,443,213
2020,36005023100,"Census Tract 231, Bronx County, New York",454,27,427,411,1239,40096,0,2006,1253,33.2,32,0,216,0,240,427,127
2012,36005023200,"Census Tract 232, Bronx County, New York",939,112,827,577,1735,34637,1939,2005,1257,38.8,115,123,65,26,372,827,170
2013,36005023200,"Census Tract 232, Bronx County, New York",932,84,848,607,1850,38594,1939,2005,1193,34.1,122,157,62,10,374,848,163
2014,36005023200,"Census Tract 232, Bronx County, New York",916,76,840,585,1818,35875,1939,2007,1248,39.8,122,159,35,10,367,840,168
2015,36005023200,"Census Tract 232, Bronx County, New York",889,49,840,596,1818,33448,1939,2008,1259,42.4,92,133,38,7,390,840,187
2016,36005023200,"Census Tract 232, Bronx County, New York",879,48,831,567,1749,34479,1939,2009,1207,38.1,103,155,57,0,337,831,186
2017,36005023200,"Census Tract 232, Bronx County, New York",889,63,826,503,1611,35433,1939,2010,1198,38,105,139,48,0,310,826,177
2018,36005023200,"Census Tract 232, Bronx County, New York",892,83,809,479,1592,34875,0,2011,1383,51,111,120,48,0,300,809,183
2019,36005023200,"Census Tract 232, Bronx County, New York",904,90,814,451,1363,45820,0,2012,1316,36.9,81,147,71,0,235,814,159
2020,36005023200,"Census Tract 232, Bronx County, New York",877,100,777,453,1360,45292,0,2013,1225,41.3,86,142,61,31,217,777,134
2012,36005023301,"Census Tract 233.01, Bronx County, New York",1607,194,1413,1390,4492,27944,1939,2003,1019,34.6,157,0,573,19,807,1413,435
2013,36005023301,"Census Tract 233.01, Bronx County, New York",1605,76,1529,1492,4439,27364,1939,2003,1025,41.7,204,0,572,0,926,1529,567
2014,36005023301,"Census Tract 233.01, Bronx County, New York",1602,103,1499,1456,4247,28101,1939,2005,1078,43.8,168,0,568,0,918,1499,543
2015,36005023301,"Census Tract 233.01, Bronx County, New York",1611,92,1519,1473,4201,NA,1939,2007,1071,50,158,0,557,0,949,1519,613
2016,36005023301,"Census Tract 233.01, Bronx County, New York",1620,79,1541,1509,4097,22448,1939,2010,1065,50,171,0,482,0,1027,1541,699
2017,36005023301,"Census Tract 233.01, Bronx County, New York",1626,79,1547,1501,3817,24219,1939,2008,1081,47.3,174,0,626,0,875,1547,608
2018,36005023301,"Census Tract 233.01, Bronx County, New York",1627,82,1545,1495,3669,27238,0,2009,1101,40.1,193,0,602,0,906,1545,538
2019,36005023301,"Census Tract 233.01, Bronx County, New York",1632,48,1584,1480,3711,30444,0,2009,1119,38.2,182,0,596,0,882,1584,529
2020,36005023301,"Census Tract 233.01, Bronx County, New York",1642,41,1601,1447,3537,29886,0,2011,1194,35,219,0,645,0,862,1601,471
2012,36005023302,"Census Tract 233.02, Bronx County, New York",1064,133,931,909,2937,19391,1939,2003,1124,47.9,119,23,238,0,702,931,421
2013,36005023302,"Census Tract 233.02, Bronx County, New York",1056,115,941,918,2987,18105,1939,2002,1124,50,137,28,208,0,744,941,457
2014,36005023302,"Census Tract 233.02, Bronx County, New York",1022,124,898,874,3090,21471,1939,2004,1157,50,158,0,238,0,692,898,432
2015,36005023302,"Census Tract 233.02, Bronx County, New York",1024,65,959,953,3517,22171,1939,2006,1245,50,147,0,238,17,729,959,467
2016,36005023302,"Census Tract 233.02, Bronx County, New York",1009,38,971,968,3488,25625,1939,2007,1296,50,138,7,242,19,735,971,438
2017,36005023302,"Census Tract 233.02, Bronx County, New York",1035,39,996,992,3509,26484,1939,2008,1233,48.3,114,10,285,19,804,996,408
2018,36005023302,"Census Tract 233.02, Bronx County, New York",1023,35,988,987,3487,34448,0,2008,1240,36.1,99,10,304,19,799,988,363
2019,36005023302,"Census Tract 233.02, Bronx County, New York",1054,48,1006,1002,3551,41786,0,2008,1226,32.8,91,6,384,17,812,1006,332
2020,36005023302,"Census Tract 233.02, Bronx County, New York",965,52,913,913,3445,40852,0,2008,1238,32.2,111,11,376,5,741,913,307
2012,36005023501,"Census Tract 235.01, Bronx County, New York",1134,38,1096,1085,3434,33092,1939,2001,1050,36.8,184,8,239,21,874,1096,321
2013,36005023501,"Census Tract 235.01, Bronx County, New York",1121,36,1085,1073,3416,33155,1939,2003,1089,37.1,207,9,247,49,810,1085,361
2014,36005023501,"Census Tract 235.01, Bronx County, New York",1125,20,1105,1095,3457,30114,1939,2005,1127,42,220,14,169,20,920,1105,393
2015,36005023501,"Census Tract 235.01, Bronx County, New York",1117,18,1099,1099,3044,27316,1939,2005,1122,43.6,179,12,190,19,897,1099,472
2016,36005023501,"Census Tract 235.01, Bronx County, New York",1134,22,1112,1112,3225,25854,1939,2006,1127,47.2,119,7,194,24,903,1112,461
2017,36005023501,"Census Tract 235.01, Bronx County, New York",1100,20,1080,1080,3235,23311,1939,2007,1188,50,102,10,214,26,815,1080,521
2018,36005023501,"Census Tract 235.01, Bronx County, New York",1118,0,1118,1118,3182,22315,0,2009,1277,51,63,4,157,9,1020,1118,463
2019,36005023501,"Census Tract 235.01, Bronx County, New York",1127,0,1127,1127,3184,34591,0,2011,1302,38.3,42,0,216,8,1006,1127,389
2020,36005023501,"Census Tract 235.01, Bronx County, New York",1187,0,1187,1187,3222,30381,0,2012,1257,38.2,55,0,206,10,1080,1187,458
2012,36005023502,"Census Tract 235.02, Bronx County, New York",1723,71,1652,1607,4560,22547,1939,2003,946,39,53,16,431,53,1177,1652,694
2013,36005023502,"Census Tract 235.02, Bronx County, New York",1722,56,1666,1599,4402,22417,1939,2004,963,38.9,76,22,465,58,1100,1666,625
2014,36005023502,"Census Tract 235.02, Bronx County, New York",1733,77,1656,1605,4300,23027,1939,2005,1017,43,125,34,466,46,1122,1656,600
2015,36005023502,"Census Tract 235.02, Bronx County, New York",1761,74,1687,1635,4328,21206,1939,2007,1081,47.1,147,53,455,44,1159,1687,669
2016,36005023502,"Census Tract 235.02, Bronx County, New York",1742,71,1671,1608,4231,20613,1939,2008,1069,42.8,117,63,428,45,1163,1671,697
2017,36005023502,"Census Tract 235.02, Bronx County, New York",1735,69,1666,1585,4383,22253,1939,2008,1125,42.9,140,49,520,16,1141,1666,572
2018,36005023502,"Census Tract 235.02, Bronx County, New York",1741,72,1669,1602,3973,21641,0,2010,1197,45.4,151,31,561,23,1211,1669,589
2019,36005023502,"Census Tract 235.02, Bronx County, New York",1735,61,1674,1607,3964,26641,0,2010,1281,39.5,158,17,636,26,1176,1674,586
2020,36005023502,"Census Tract 235.02, Bronx County, New York",1533,47,1486,1411,4130,34570,1941,2011,1273,37.2,156,0,580,0,1050,1486,476
2012,36005023600,"Census Tract 236, Bronx County, New York",647,44,603,489,1638,31563,1940,2005,1168,30.4,64,144,60,0,295,603,186
2013,36005023600,"Census Tract 236, Bronx County, New York",678,27,651,535,1861,36542,1947,2005,1222,31.2,78,158,64,7,327,651,220
2014,36005023600,"Census Tract 236, Bronx County, New York",679,38,641,533,1857,34261,1939,2008,1289,36.4,109,146,76,4,335,641,246
2015,36005023600,"Census Tract 236, Bronx County, New York",671,34,637,514,1844,40061,1939,2009,1308,37,89,157,84,4,280,637,208
2016,36005023600,"Census Tract 236, Bronx County, New York",675,45,630,541,1886,37670,1939,2010,1343,42.4,65,161,81,4,314,630,224
2017,36005023600,"Census Tract 236, Bronx County, New York",664,17,647,543,1683,32011,1939,2010,1342,40.2,63,165,87,6,312,647,201
2018,36005023600,"Census Tract 236, Bronx County, New York",623,17,606,509,1503,27865,0,2011,1299,42.1,46,153,63,0,309,606,212
2019,36005023600,"Census Tract 236, Bronx County, New York",601,16,585,464,1324,30714,1953,2013,1260,34.1,75,140,102,0,245,585,190
2020,36005023600,"Census Tract 236, Bronx County, New York",563,21,542,428,1180,38036,0,2013,1256,31.7,76,75,66,0,311,542,169
2012,36005023702,"Census Tract 237.02, Bronx County, New York",352,19,333,308,967,17273,1939,1995,800,49.5,0,42,68,0,178,333,150
2013,36005023702,"Census Tract 237.02, Bronx County, New York",352,6,346,325,1072,12361,1939,1996,944,50,4,26,73,0,226,346,181
2014,36005023702,"Census Tract 237.02, Bronx County, New York",341,7,334,306,1090,24219,1939,2000,1085,40,15,11,62,4,223,334,118
2015,36005023702,"Census Tract 237.02, Bronx County, New York",355,31,324,324,1147,32500,1939,2003,1172,38.8,17,13,96,4,210,324,93
2016,36005023702,"Census Tract 237.02, Bronx County, New York",359,22,337,330,1137,32500,1939,2003,1182,33.9,27,5,112,4,205,337,87
2017,36005023702,"Census Tract 237.02, Bronx County, New York",358,18,340,334,1120,31875,1939,2005,1187,42.4,29,4,106,3,243,340,91
2018,36005023702,"Census Tract 237.02, Bronx County, New York",360,29,331,325,1062,37734,0,2004,1123,35.2,52,2,89,3,242,331,75
2019,36005023702,"Census Tract 237.02, Bronx County, New York",370,23,347,345,1103,37891,0,2006,1171,37.6,38,3,73,0,276,347,107
2020,36005023702,"Census Tract 237.02, Bronx County, New York",424,10,414,408,1319,46923,0,2010,1189,32.7,33,5,120,0,293,414,126
2012,36005023703,"Census Tract 237.03, Bronx County, New York",1552,123,1429,1359,3885,32350,1939,2005,1009,37.3,179,17,369,0,1028,1429,514
2013,36005023703,"Census Tract 237.03, Bronx County, New York",1576,187,1389,1314,4471,27065,1939,2006,1072,50,120,52,208,8,1067,1389,531
2014,36005023703,"Census Tract 237.03, Bronx County, New York",1581,178,1403,1339,4461,27408,1939,2006,1146,50,173,64,296,8,1010,1403,541
2015,36005023703,"Census Tract 237.03, Bronx County, New York",1587,153,1434,1371,4554,26470,1939,2006,1147,50,146,80,287,15,1022,1434,564
2016,36005023703,"Census Tract 237.03, Bronx County, New York",1598,119,1479,1463,5380,29119,1939,2006,1165,50,170,60,366,6,1076,1479,552
2017,36005023703,"Census Tract 237.03, Bronx County, New York",1612,103,1509,1490,5341,32171,1939,2006,1159,45.4,160,79,445,10,1034,1509,550
2018,36005023703,"Census Tract 237.03, Bronx County, New York",1640,46,1594,1584,5162,32734,0,2008,1178,45.1,119,47,530,5,1120,1594,665
2019,36005023703,"Census Tract 237.03, Bronx County, New York",1658,50,1608,1598,5195,30380,0,2010,1268,45.8,104,28,601,5,1212,1608,640
2020,36005023703,"Census Tract 237.03, Bronx County, New York",1643,50,1593,1582,5236,24405,0,2011,1347,51,89,18,529,6,1243,1593,748
2012,36005023704,"Census Tract 237.04, Bronx County, New York",1283,71,1212,1212,3701,23041,1939,2003,1124,50,184,13,476,0,798,1212,557
2013,36005023704,"Census Tract 237.04, Bronx County, New York",1290,69,1221,1212,3607,18587,1939,2003,1139,50,273,16,433,0,835,1221,585
2014,36005023704,"Census Tract 237.04, Bronx County, New York",1319,37,1282,1272,3659,20132,1939,2005,1128,50,181,14,414,11,904,1282,613
2015,36005023704,"Census Tract 237.04, Bronx County, New York",1346,0,1346,1337,3676,20842,1939,2007,1110,50,170,10,381,11,993,1346,662
2016,36005023704,"Census Tract 237.04, Bronx County, New York",1401,0,1401,1393,4104,21752,1939,2010,1154,50,171,14,356,9,1048,1401,647
2017,36005023704,"Census Tract 237.04, Bronx County, New York",1392,43,1349,1322,4236,20962,1939,2010,1172,50,146,8,332,9,1014,1349,687
2018,36005023704,"Census Tract 237.04, Bronx County, New York",1386,61,1325,1309,3917,20889,0,2011,1193,51,86,11,371,8,977,1325,661
2019,36005023704,"Census Tract 237.04, Bronx County, New York",1380,60,1320,1305,3754,20411,0,2011,1231,49.2,91,0,312,0,1047,1320,721
2020,36005023704,"Census Tract 237.04, Bronx County, New York",1290,58,1232,1218,3786,24444,0,2011,1335,43.3,112,0,278,0,978,1232,622
2012,36005023800,"Census Tract 238, Bronx County, New York",889,106,783,514,1526,41429,1939,2005,1291,32,81,136,74,0,293,783,189
2013,36005023800,"Census Tract 238, Bronx County, New York",903,127,776,556,1839,55369,1939,2007,1410,30.7,122,117,89,6,335,776,200
2014,36005023800,"Census Tract 238, Bronx County, New York",905,148,757,559,1910,45329,1939,2008,1475,33.6,130,99,97,6,350,757,219
2015,36005023800,"Census Tract 238, Bronx County, New York",937,162,775,574,1904,43235,1939,2010,1433,35,116,91,111,6,359,775,215
2016,36005023800,"Census Tract 238, Bronx County, New York",931,112,819,613,1905,41250,1939,2011,1426,37.5,146,87,90,17,431,819,209
2017,36005023800,"Census Tract 238, Bronx County, New York",928,91,837,599,1842,41625,1939,2011,1473,38.7,133,82,117,16,404,837,213
2018,36005023800,"Census Tract 238, Bronx County, New York",916,113,803,533,1501,40670,0,2012,1432,40.9,77,68,145,16,332,803,164
2019,36005023800,"Census Tract 238, Bronx County, New York",914,113,801,524,1487,43917,0,2013,1581,39.8,73,75,138,13,330,801,128
2020,36005023800,"Census Tract 238, Bronx County, New York",847,91,756,469,1367,50469,0,2013,1712,37.5,95,51,123,40,295,756,89
2012,36005023900,"Census Tract 239, Bronx County, New York",2609,180,2429,2325,7990,20975,1939,2003,1086,44.9,187,79,794,70,1510,2429,1058
2013,36005023900,"Census Tract 239, Bronx County, New York",2636,121,2515,2401,7790,19623,1939,2003,1070,40.9,196,71,708,66,1528,2515,1106
2014,36005023900,"Census Tract 239, Bronx County, New York",2620,121,2499,2376,7810,20299,1939,2004,1076,46,156,24,675,65,1652,2499,1128
2015,36005023900,"Census Tract 239, Bronx County, New York",2652,121,2531,2434,7839,NA,1939,2005,1086,42.1,209,11,646,58,1754,2531,1197
2016,36005023900,"Census Tract 239, Bronx County, New York",2717,115,2602,2560,7653,20088,1939,2006,1136,48.7,178,10,691,0,1901,2602,1185
2017,36005023900,"Census Tract 239, Bronx County, New York",2687,150,2537,2472,7162,20061,1939,2007,1130,50,163,0,697,0,1787,2537,1210
2018,36005023900,"Census Tract 239, Bronx County, New York",2672,162,2510,2469,7409,23085,0,2008,1153,44.5,193,0,826,0,1764,2510,1168
2019,36005023900,"Census Tract 239, Bronx County, New York",2708,136,2572,2517,7485,24411,0,2010,1176,39.5,245,0,980,0,1739,2572,1056
2020,36005023900,"Census Tract 239, Bronx County, New York",2493,122,2371,2345,7687,40132,0,2010,1269,34.8,259,0,786,0,1733,2371,708
2012,36005024000,"Census Tract 240, Bronx County, New York",1385,136,1249,890,3003,28788,1948,2003,1213,44.2,108,71,225,0,604,1249,295
2013,36005024000,"Census Tract 240, Bronx County, New York",1321,130,1191,913,2958,28156,1943,2004,1254,50,78,57,170,0,663,1191,267
2014,36005024000,"Census Tract 240, Bronx County, New York",1346,106,1240,969,3227,31229,1945,2005,1322,43.3,115,33,206,0,752,1240,306
2015,36005024000,"Census Tract 240, Bronx County, New York",1327,162,1165,850,2779,28182,1939,2006,1233,40.1,90,36,216,0,615,1165,276
2016,36005024000,"Census Tract 240, Bronx County, New York",1343,184,1159,903,2645,26434,1945,2010,1245,46.7,145,59,260,0,637,1159,306
2017,36005024000,"Census Tract 240, Bronx County, New York",1382,151,1231,907,2641,30583,1945,2011,1317,42,129,44,241,0,659,1231,312
2018,36005024000,"Census Tract 240, Bronx County, New York",1422,138,1284,930,2717,30812,1951,2012,1304,42.2,161,69,217,0,675,1284,350
2019,36005024000,"Census Tract 240, Bronx County, New York",1398,176,1222,795,2115,24507,1943,2013,1294,51,154,80,308,0,472,1222,380
2020,36005024000,"Census Tract 240, Bronx County, New York",1414,124,1290,813,2117,24638,1945,2013,1527,51,129,121,304,0,461,1290,391
2012,36005024100,"Census Tract 241, Bronx County, New York",2065,167,1898,1864,6146,24500,1939,2002,985,44.9,185,19,523,41,1351,1898,864
2013,36005024100,"Census Tract 241, Bronx County, New York",2043,202,1841,1788,5961,20560,1939,2003,1017,48.9,165,14,549,23,1287,1841,888
2014,36005024100,"Census Tract 241, Bronx County, New York",2082,262,1820,1780,6116,19956,1939,2004,1052,50,209,18,539,20,1282,1820,845
2015,36005024100,"Census Tract 241, Bronx County, New York",2084,281,1803,1742,5779,NA,1939,2006,1062,50,259,0,564,33,1219,1803,700
2016,36005024100,"Census Tract 241, Bronx County, New York",2088,300,1788,1733,5473,25026,1947,2007,1076,45.6,267,56,571,7,1180,1788,689
2017,36005024100,"Census Tract 241, Bronx County, New York",2076,227,1849,1753,5724,29631,1950,2009,1101,42.1,256,69,654,8,1135,1849,616
2018,36005024100,"Census Tract 241, Bronx County, New York",2119,161,1958,1893,6115,37074,1945,2010,1132,35.2,261,61,668,7,1279,1958,564
2019,36005024100,"Census Tract 241, Bronx County, New York",2145,133,2012,1936,6074,40930,1945,2011,1171,34.7,297,84,757,32,1184,2012,509
2020,36005024100,"Census Tract 241, Bronx County, New York",2347,73,2274,2218,6191,35482,0,2011,1182,33.9,376,144,800,38,1310,2274,888
2012,36005024300,"Census Tract 243, Bronx County, New York",2112,134,1978,1916,5614,24111,1939,2001,919,39.3,206,19,591,16,1375,1978,776
2013,36005024300,"Census Tract 243, Bronx County, New York",2073,131,1942,1876,5503,21830,1939,2002,949,43.5,123,10,687,41,1270,1942,824
2014,36005024300,"Census Tract 243, Bronx County, New York",2066,122,1944,1853,5377,21658,1939,2003,972,47.1,133,10,649,23,1277,1944,838
2015,36005024300,"Census Tract 243, Bronx County, New York",2047,125,1922,1824,5363,19522,1939,2004,958,47.9,102,9,643,30,1262,1922,846
2016,36005024300,"Census Tract 243, Bronx County, New York",2058,111,1947,1851,5281,19653,1939,2005,995,48.9,161,9,662,44,1223,1947,864
2017,36005024300,"Census Tract 243, Bronx County, New York",2042,89,1953,1875,5135,20166,1941,2005,1071,46,153,0,661,33,1263,1953,843
2018,36005024300,"Census Tract 243, Bronx County, New York",2068,64,2004,1932,5419,23556,0,2006,1110,40.9,183,8,648,0,1333,2004,777
2019,36005024300,"Census Tract 243, Bronx County, New York",2072,43,2029,1976,5554,24890,0,2007,1107,33.9,196,24,554,0,1481,2029,776
2020,36005024300,"Census Tract 243, Bronx County, New York",1946,28,1918,1876,5308,27092,0,2007,1122,34.5,214,26,448,0,1462,1918,767
2012,36005024400,"Census Tract 244, Bronx County, New York",871,60,811,438,1333,62250,1943,2003,1251,24.3,168,213,27,11,187,811,93
2013,36005024400,"Census Tract 244, Bronx County, New York",858,63,795,452,1294,57917,1948,2003,1322,27.9,153,212,25,19,196,795,89
2014,36005024400,"Census Tract 244, Bronx County, New York",865,42,823,466,1289,43125,1944,2005,1324,29.6,181,171,52,5,238,823,112
2015,36005024400,"Census Tract 244, Bronx County, New York",871,45,826,511,1341,48897,1939,2006,1317,29.7,169,171,62,10,268,826,113
2016,36005024400,"Census Tract 244, Bronx County, New York",850,59,791,501,1176,43819,1939,2007,1282,34.3,168,190,49,11,256,791,110
2017,36005024400,"Census Tract 244, Bronx County, New York",867,64,803,504,1087,43500,1943,2008,1215,37.3,137,161,30,17,283,803,145
2018,36005024400,"Census Tract 244, Bronx County, New York",865,60,805,463,1013,45050,1943,2010,1370,37.4,108,179,31,15,237,805,116
2019,36005024400,"Census Tract 244, Bronx County, New York",863,54,809,487,1036,45625,1942,2010,1412,41.7,78,197,8,14,268,809,111
2020,36005024400,"Census Tract 244, Bronx County, New York",869,49,820,464,968,50326,0,2011,1483,42.3,94,184,17,15,257,820,105
2012,36005024501,"Census Tract 245.01, Bronx County, New York",1632,129,1503,1358,4412,25894,1939,2004,919,39.6,88,0,355,0,1015,1503,378
2013,36005024501,"Census Tract 245.01, Bronx County, New York",1595,95,1500,1358,4609,25000,1939,2003,934,41.1,97,0,354,0,1044,1500,506
2014,36005024501,"Census Tract 245.01, Bronx County, New York",1581,45,1536,1451,4743,25574,1939,2003,993,37.7,119,0,416,0,1075,1536,477
2015,36005024501,"Census Tract 245.01, Bronx County, New York",1604,30,1574,1487,4709,NA,1939,2005,1006,41.8,139,0,372,0,1149,1574,633
2016,36005024501,"Census Tract 245.01, Bronx County, New York",1610,44,1566,1505,5086,21318,1939,2005,1036,42.3,116,0,393,6,1153,1566,701
2017,36005024501,"Census Tract 245.01, Bronx County, New York",1597,73,1524,1452,5273,18542,1939,2006,1061,43.9,142,0,373,7,1152,1524,840
2018,36005024501,"Census Tract 245.01, Bronx County, New York",1566,90,1476,1419,4737,21298,0,2008,1115,45.3,133,0,372,8,1095,1476,719
2019,36005024501,"Census Tract 245.01, Bronx County, New York",1582,72,1510,1466,4646,24878,0,2010,1189,46.2,135,5,381,6,1198,1510,681
2020,36005024501,"Census Tract 245.01, Bronx County, New York",1449,53,1396,1370,4647,26688,0,2009,1201,41.2,118,5,407,11,1106,1396,563
2012,36005024502,"Census Tract 245.02, Bronx County, New York",1201,130,1071,1033,4058,26511,1939,2005,862,30,15,0,391,0,715,1071,518
2013,36005024502,"Census Tract 245.02, Bronx County, New York",1192,104,1088,1050,3742,25372,1939,2005,854,32.6,64,13,318,0,754,1088,557
2014,36005024502,"Census Tract 245.02, Bronx County, New York",1198,98,1100,1059,3395,26647,1939,2006,877,32,118,7,362,0,744,1100,595
2015,36005024502,"Census Tract 245.02, Bronx County, New York",1194,105,1089,1058,3379,NA,1939,2006,1053,43.8,158,8,378,0,739,1089,566
2016,36005024502,"Census Tract 245.02, Bronx County, New York",1228,50,1178,1109,3559,27574,1939,2006,1110,46.3,136,10,325,0,873,1178,524
2017,36005024502,"Census Tract 245.02, Bronx County, New York",1255,35,1220,1177,3616,26953,1939,2007,1154,40.5,148,8,337,0,908,1220,549
2018,36005024502,"Census Tract 245.02, Bronx County, New York",1232,30,1202,1165,3522,26172,0,2007,1174,39,104,0,366,0,891,1202,503
2019,36005024502,"Census Tract 245.02, Bronx County, New York",1204,13,1191,1172,3599,29387,0,2006,1265,36.9,78,0,399,0,890,1191,417
2020,36005024502,"Census Tract 245.02, Bronx County, New York",1203,0,1203,1180,3521,29981,0,2008,1254,35,98,0,365,0,948,1203,341
2012,36005024600,"Census Tract 246, Bronx County, New York",775,78,697,347,825,65375,1948,2006,1287,19.5,178,111,0,47,174,697,20
2013,36005024600,"Census Tract 246, Bronx County, New York",795,16,779,339,693,66908,1948,2007,1218,19.2,182,80,10,52,185,779,25
2014,36005024600,"Census Tract 246, Bronx County, New York",799,46,753,273,651,62820,1939,2010,1176,22.2,120,99,13,17,137,753,29
2015,36005024600,"Census Tract 246, Bronx County, New York",802,49,753,343,790,60819,1939,2011,1151,23.4,135,142,18,7,178,753,61
2016,36005024600,"Census Tract 246, Bronx County, New York",773,31,742,323,954,60129,1939,2011,1364,26,114,119,18,14,184,742,89
2017,36005024600,"Census Tract 246, Bronx County, New York",771,29,742,350,1134,60581,1939,2011,1488,26.5,75,156,15,25,157,742,108
2018,36005024600,"Census Tract 246, Bronx County, New York",768,43,725,366,1081,59063,1941,2011,1430,27,101,168,22,25,156,725,114
2019,36005024600,"Census Tract 246, Bronx County, New York",744,16,728,411,1191,63021,1949,2011,1413,26.5,140,172,26,62,157,728,111
2020,36005024600,"Census Tract 246, Bronx County, New York",784,36,748,420,1273,63250,1953,2012,1538,28.1,148,143,27,56,190,748,113
2012,36005024700,"Census Tract 247, Bronx County, New York",663,21,642,642,2029,51250,1955,2001,1164,29,120,20,361,4,255,642,78
2013,36005024700,"Census Tract 247, Bronx County, New York",676,8,668,661,1867,40179,1952,2002,1141,34,145,38,371,10,279,668,148
2014,36005024700,"Census Tract 247, Bronx County, New York",696,9,687,677,1814,41188,1952,2003,1181,33.7,122,24,393,6,269,687,137
2015,36005024700,"Census Tract 247, Bronx County, New York",747,7,740,718,1909,NA,1952,2006,1224,34.5,100,17,437,5,279,740,194
2016,36005024700,"Census Tract 247, Bronx County, New York",766,14,752,732,1868,41538,1952,2009,1202,34,83,16,451,4,282,752,189
2017,36005024700,"Census Tract 247, Bronx County, New York",770,15,755,717,1793,43021,1953,2010,1281,32.4,110,17,370,5,346,755,193
2018,36005024700,"Census Tract 247, Bronx County, New York",784,15,769,731,1949,44266,1960,2011,1334,32.6,106,6,395,0,335,769,197
2019,36005024700,"Census Tract 247, Bronx County, New York",798,17,781,748,2003,48095,1961,2012,1378,31.6,162,15,397,0,341,781,188
2020,36005024700,"Census Tract 247, Bronx County, New York",767,16,751,736,1873,56042,1963,2012,1320,29.7,196,22,334,46,331,751,117
2012,36005024800,"Census Tract 248, Bronx County, New York",1244,21,1223,732,1553,56923,1955,2004,1267,24.4,268,395,20,103,201,1223,110
2013,36005024800,"Census Tract 248, Bronx County, New York",1245,24,1221,764,1623,61983,1955,2005,1283,22.9,327,387,48,106,222,1221,75
2014,36005024800,"Census Tract 248, Bronx County, New York",1239,50,1189,755,1727,60729,1957,2006,1378,24.7,303,351,48,84,284,1189,132
2015,36005024800,"Census Tract 248, Bronx County, New York",1214,48,1166,902,1800,51397,1957,2010,1338,24.5,387,352,109,101,366,1166,125
2016,36005024800,"Census Tract 248, Bronx County, New York",1201,54,1147,830,1726,52750,1956,2010,1248,24.8,339,374,135,98,235,1147,112
2017,36005024800,"Census Tract 248, Bronx County, New York",1214,69,1145,864,1871,52331,1958,2010,1262,26.5,346,428,107,103,237,1145,153
2018,36005024800,"Census Tract 248, Bronx County, New York",1189,89,1100,808,1832,54797,1959,2011,1414,28.4,344,405,80,71,262,1100,152
2019,36005024800,"Census Tract 248, Bronx County, New York",1191,65,1126,846,1966,64097,1956,2011,1418,26.3,322,448,86,80,261,1126,106
2020,36005024800,"Census Tract 248, Bronx County, New York",1173,31,1142,859,2098,65288,1956,2009,1363,29.1,217,496,30,51,299,1142,111
2012,36005024900,"Census Tract 249, Bronx County, New York",0,0,0,0,0,NA,NA,NA,NA,NA,0,0,0,0,0,0,0
2013,36005024900,"Census Tract 249, Bronx County, New York",0,0,0,0,0,NA,NA,NA,NA,NA,0,0,0,0,0,0,0
2014,36005024900,"Census Tract 249, Bronx County, New York",0,0,0,0,0,NA,NA,NA,NA,NA,0,0,0,0,0,0,0
2015,36005024900,"Census Tract 249, Bronx County, New York",0,0,0,0,0,NA,NA,NA,NA,NA,0,0,0,0,0,0,0
2016,36005024900,"Census Tract 249, Bronx County, New York",0,0,0,0,0,NA,NA,NA,NA,NA,0,0,0,0,0,0,0
2017,36005024900,"Census Tract 249, Bronx County, New York",0,0,0,0,0,NA,NA,NA,NA,NA,0,0,0,0,0,0,0
2018,36005024900,"Census Tract 249, Bronx County, New York",0,0,0,0,0,NA,NA,NA,NA,NA,0,0,0,0,0,0,0
2019,36005024900,"Census Tract 249, Bronx County, New York",0,0,0,0,0,NA,NA,NA,NA,NA,0,0,0,0,0,0,0
2020,36005024900,"Census Tract 249, Bronx County, New York",0,0,0,0,0,NA,NA,NA,NA,NA,0,0,0,0,0,0,0
2012,36005025000,"Census Tract 250, Bronx County, New York",991,57,934,488,1184,32177,1946,2004,1235,37,100,331,0,23,124,934,92
2013,36005025000,"Census Tract 250, Bronx County, New York",1022,57,965,514,1267,45227,1949,2005,1387,35.3,126,342,0,20,133,965,85
2014,36005025000,"Census Tract 250, Bronx County, New York",1065,52,1013,541,1340,36114,1954,2007,1332,37.4,85,312,0,18,191,1013,165
2015,36005025000,"Census Tract 250, Bronx County, New York",1016,23,993,506,1104,36859,1953,2009,1325,36.1,102,285,0,8,203,993,126
2016,36005025000,"Census Tract 250, Bronx County, New York",984,0,984,516,1215,45117,1955,2010,1295,32.9,120,307,0,27,171,984,131
2017,36005025000,"Census Tract 250, Bronx County, New York",991,27,964,452,1087,45200,1951,2011,1237,33.8,92,215,0,16,210,964,108
2018,36005025000,"Census Tract 250, Bronx County, New York",1022,42,980,458,1030,39850,1951,2012,1215,33.3,104,212,0,20,226,980,136
2019,36005025000,"Census Tract 250, Bronx County, New York",1006,49,957,484,1252,65078,1952,2013,1396,28.4,221,213,8,68,203,957,76
2020,36005025000,"Census Tract 250, Bronx County, New York",1056,73,983,441,1118,56698,1948,2013,1340,31.3,207,244,3,74,123,983,58
2012,36005025100,"Census Tract 251, Bronx County, New York",2260,140,2120,1896,6352,31717,1939,2003,1078,34.7,264,25,701,16,1253,2120,623
2013,36005025100,"Census Tract 251, Bronx County, New York",2217,134,2083,1915,6104,31021,1939,2003,1019,36.8,336,26,654,16,1260,2083,631
2014,36005025100,"Census Tract 251, Bronx County, New York",2232,109,2123,1943,5428,31910,1939,2003,998,35,311,14,684,19,1312,2123,661
2015,36005025100,"Census Tract 251, Bronx County, New York",2269,132,2137,1956,5771,NA,1939,2004,1025,38.9,363,14,597,52,1367,2137,770
2016,36005025100,"Census Tract 251, Bronx County, New York",2269,112,2157,1954,5661,25269,1939,2005,1065,41,385,14,567,65,1432,2157,896
2017,36005025100,"Census Tract 251, Bronx County, New York",2264,60,2204,1899,5605,26232,1939,2007,1111,38.7,350,0,477,57,1433,2204,827
2018,36005025100,"Census Tract 251, Bronx County, New York",2256,100,2156,1863,5799,24903,1940,2008,1193,39.8,308,0,448,112,1374,2156,825
2019,36005025100,"Census Tract 251, Bronx County, New York",2240,68,2172,1876,6342,35455,1941,2009,1278,37.1,333,0,485,102,1347,2172,636
2020,36005025100,"Census Tract 251, Bronx County, New York",2231,51,2180,1689,5116,40856,1940,2008,1255,33.6,237,0,442,147,1136,2180,510
2012,36005025200,"Census Tract 252, Bronx County, New York",932,63,869,482,1276,43846,1939,2004,1141,32.4,97,225,47,31,179,869,121
2013,36005025200,"Census Tract 252, Bronx County, New York",961,75,886,512,1340,42800,1947,2004,1203,32.1,121,238,15,27,232,886,154
2014,36005025200,"Census Tract 252, Bronx County, New York",986,111,875,542,1402,48300,1951,2004,1253,31.2,100,246,14,38,244,875,162
2015,36005025200,"Census Tract 252, Bronx County, New York",966,99,867,500,1353,43333,1950,2006,1359,33.4,67,228,13,27,220,867,192
2016,36005025200,"Census Tract 252, Bronx County, New York",994,97,897,513,1433,41369,1946,2009,1397,37.1,80,227,14,40,230,897,156
2017,36005025200,"Census Tract 252, Bronx County, New York",998,71,927,527,1453,43583,1939,2010,1502,34.9,76,254,34,17,226,927,147
2018,36005025200,"Census Tract 252, Bronx County, New York",1006,91,915,509,1331,57868,0,2011,1515,31.1,98,228,35,28,218,915,99
2019,36005025200,"Census Tract 252, Bronx County, New York",1008,72,936,536,1461,51250,0,2013,1618,37.5,116,208,43,42,242,936,138
2020,36005025200,"Census Tract 252, Bronx County, New York",982,46,936,580,1614,60132,1950,2015,1701,33.8,168,244,55,33,260,936,99
2012,36005025300,"Census Tract 253, Bronx County, New York",2034,183,1851,1767,5293,28169,1939,2002,975,37.9,158,58,402,78,1261,1851,691
2013,36005025300,"Census Tract 253, Bronx County, New York",1950,205,1745,1691,5485,30750,1939,2002,1038,38.1,138,72,395,71,1178,1745,590
2014,36005025300,"Census Tract 253, Bronx County, New York",1993,162,1831,1772,5663,29250,1939,2003,1104,42.4,219,40,443,50,1221,1831,614
2015,36005025300,"Census Tract 253, Bronx County, New York",2018,145,1873,1775,5497,30651,1939,2006,1159,42.3,257,51,439,42,1246,1873,533
2016,36005025300,"Census Tract 253, Bronx County, New York",2084,138,1946,1838,5440,29000,1939,2009,1161,43.5,262,35,414,49,1338,1946,576
2017,36005025300,"Census Tract 253, Bronx County, New York",2059,103,1956,1840,5725,29452,1939,2010,1179,47.1,237,33,383,57,1337,1956,641
2018,36005025300,"Census Tract 253, Bronx County, New York",2093,68,2025,1924,5786,32544,0,2011,1216,44.7,242,14,391,45,1449,2025,588
2019,36005025300,"Census Tract 253, Bronx County, New York",2064,80,1984,1883,5695,36065,0,2011,1246,41.4,225,19,436,57,1470,1984,610
2020,36005025300,"Census Tract 253, Bronx County, New York",1957,80,1877,1820,5796,37292,0,2010,1309,36.6,95,0,335,55,1502,1877,651
2012,36005025400,"Census Tract 254, Bronx County, New York",872,57,815,531,972,40139,1949,2005,1141,31.1,186,360,36,41,89,815,127
2013,36005025400,"Census Tract 254, Bronx County, New York",872,58,814,498,1013,31679,1951,2006,1171,37.5,175,314,12,42,120,814,144
2014,36005025400,"Census Tract 254, Bronx County, New York",891,95,796,485,1098,40977,1948,2008,1206,32.7,185,286,20,46,114,796,132
2015,36005025400,"Census Tract 254, Bronx County, New York",871,83,788,458,1206,47955,1949,2011,1266,33.2,154,231,19,41,148,788,122
2016,36005025400,"Census Tract 254, Bronx County, New York",849,98,751,430,1083,49531,1945,2011,1332,31.7,135,204,34,36,154,751,106
2017,36005025400,"Census Tract 254, Bronx County, New York",845,54,791,414,1120,49643,1947,2011,1496,36.5,135,212,38,30,134,791,114
2018,36005025400,"Census Tract 254, Bronx County, New York",837,59,778,404,973,49239,1950,2012,1459,34.9,144,221,44,24,124,778,130
2019,36005025400,"Census Tract 254, Bronx County, New York",813,58,755,387,898,49213,1953,2012,1456,35.6,121,223,29,21,130,755,94
2020,36005025400,"Census Tract 254, Bronx County, New York",819,48,771,371,840,45994,1951,2014,1435,33.9,112,239,43,8,108,771,96
2012,36005025500,"Census Tract 255, Bronx County, New York",2284,203,2081,2009,5925,20866,1939,2002,980,44,174,0,488,19,1548,2081,905
2013,36005025500,"Census Tract 255, Bronx County, New York",2253,163,2090,2043,5720,18912,1939,2002,1059,47.1,236,15,514,4,1563,2090,959
2014,36005025500,"Census Tract 255, Bronx County, New York",2302,132,2170,2116,5579,19342,1939,2003,1088,46.3,314,18,501,5,1648,2170,978
2015,36005025500,"Census Tract 255, Bronx County, New York",2301,103,2198,2136,5617,18167,1939,2005,1068,46.6,322,20,453,0,1710,2198,1037
2016,36005025500,"Census Tract 255, Bronx County, New York",2341,58,2283,2221,5662,24831,1939,2006,1059,33.9,300,20,324,0,1926,2283,863
2017,36005025500,"Census Tract 255, Bronx County, New York",2283,29,2254,2163,6230,31611,1939,2006,1159,40.2,345,79,265,0,1847,2254,814
2018,36005025500,"Census Tract 255, Bronx County, New York",2291,0,2291,2195,6554,26639,0,2008,1125,34.5,238,65,332,0,1892,2291,762
2019,36005025500,"Census Tract 255, Bronx County, New York",2296,0,2296,2179,7054,28750,0,2010,1278,35.6,255,64,496,0,1877,2296,812
2020,36005025500,"Census Tract 255, Bronx County, New York",2398,0,2398,2257,6966,44135,0,2009,1370,40.8,215,64,412,0,2018,2398,755
2012,36005025600,"Census Tract 256, Bronx County, New York",721,36,685,450,933,36890,1963,2005,1190,36,105,140,56,39,215,685,81
2013,36005025600,"Census Tract 256, Bronx County, New York",713,30,683,451,933,36970,1962,2005,1309,37.5,100,107,85,44,215,683,64
2014,36005025600,"Census Tract 256, Bronx County, New York",713,56,657,438,988,41061,1960,2006,1271,36.5,108,105,75,54,204,657,91
2015,36005025600,"Census Tract 256, Bronx County, New York",706,58,648,450,1155,NA,1961,2008,1295,38.5,66,80,74,31,265,648,124
2016,36005025600,"Census Tract 256, Bronx County, New York",703,62,641,430,1084,40122,1959,2011,1321,37.7,97,98,95,34,197,641,122
2017,36005025600,"Census Tract 256, Bronx County, New York",695,69,626,363,795,41719,1941,2012,1252,34.6,91,94,35,39,189,626,91
2018,36005025600,"Census Tract 256, Bronx County, New York",693,71,622,420,1040,42364,1947,NA,1365,35,137,110,21,54,232,622,114
2019,36005025600,"Census Tract 256, Bronx County, New York",673,63,610,417,1002,42120,1954,2012,1450,34.6,109,94,28,36,255,610,109
2020,36005025600,"Census Tract 256, Bronx County, New York",673,61,612,429,906,32404,0,2011,1263,37,103,191,23,46,166,612,37
2012,36005025700,"Census Tract 257, Bronx County, New York",685,71,614,539,1664,30571,1939,2002,1091,43.5,107,0,169,0,391,614,196
2013,36005025700,"Census Tract 257, Bronx County, New York",671,61,610,575,1667,29250,1939,2003,1091,44.6,99,5,191,0,401,610,224
2014,36005025700,"Census Tract 257, Bronx County, New York",694,71,623,623,1661,27545,1939,2001,1050,44.4,132,6,205,0,423,623,277
2015,36005025700,"Census Tract 257, Bronx County, New York",695,57,638,615,1433,24107,1939,2003,1083,50,100,6,195,0,433,638,241
2016,36005025700,"Census Tract 257, Bronx County, New York",716,43,673,642,1552,28990,1939,2010,1158,46,130,8,210,0,449,673,232
2017,36005025700,"Census Tract 257, Bronx County, New York",720,28,692,660,1612,33382,1939,2011,1221,43.4,137,8,197,0,478,692,209
2018,36005025700,"Census Tract 257, Bronx County, New York",721,30,691,652,1647,36875,0,2010,1367,38,140,0,159,0,530,691,176
2019,36005025700,"Census Tract 257, Bronx County, New York",723,28,695,649,1648,49602,0,2010,1439,34.1,171,6,199,0,511,695,123
2020,36005025700,"Census Tract 257, Bronx County, New York",722,23,699,676,1639,47800,0,2010,1379,28.5,141,11,262,0,475,699,152
2012,36005026100,"Census Tract 261, Bronx County, New York",1419,183,1236,203,367,53686,1947,2002,1010,26.1,64,0,127,0,54,1236,105
2013,36005026100,"Census Tract 261, Bronx County, New York",1239,172,1067,217,389,49933,1947,2002,1004,26.9,67,12,123,0,62,1067,68
2014,36005026100,"Census Tract 261, Bronx County, New York",1098,144,954,231,337,60054,1948,2005,1069,19.9,112,17,124,0,76,954,61
2015,36005026100,"Census Tract 261, Bronx County, New York",1041,87,954,240,368,61346,1950,2006,1083,20.6,123,19,125,0,84,954,51
2016,36005026100,"Census Tract 261, Bronx County, New York",1058,67,991,249,402,62396,1951,2010,1173,23.8,108,18,118,6,107,991,42
2017,36005026100,"Census Tract 261, Bronx County, New York",1061,53,1008,229,348,71042,1953,2009,1154,23.5,74,16,91,6,128,1008,43
2018,36005026100,"Census Tract 261, Bronx County, New York",1060,55,1005,227,349,72292,1954,2008,1358,24.3,84,11,120,6,103,1005,40
2019,36005026100,"Census Tract 261, Bronx County, New York",1113,58,1055,208,323,78636,1956,2009,1320,23.7,101,10,123,6,91,1055,32
2020,36005026100,"Census Tract 261, Bronx County, New York",1187,79,1108,180,326,53939,1959,2013,1426,30.9,60,4,106,16,84,1108,230
2012,36005026300,"Census Tract 263, Bronx County, New York",2258,153,2105,2067,5842,26322,1939,2004,1074,47.3,313,198,470,119,1374,2105,678
2013,36005026300,"Census Tract 263, Bronx County, New York",2279,210,2069,1981,5681,28772,1939,2004,1107,45.1,243,156,449,84,1360,2069,673
2014,36005026300,"Census Tract 263, Bronx County, New York",2317,211,2106,2008,5715,28850,1939,2006,1173,47.5,330,169,382,41,1486,2106,668
2015,36005026300,"Census Tract 263, Bronx County, New York",2372,197,2175,2057,5740,29798,1939,2007,1177,45.7,311,183,325,0,1587,2175,673
2016,36005026300,"Census Tract 263, Bronx County, New York",2392,221,2171,2082,5208,28349,1939,2007,1110,43.6,261,236,328,0,1555,2171,674
2017,36005026300,"Census Tract 263, Bronx County, New York",2446,198,2248,2145,5256,27872,1939,2010,1126,45.1,270,181,342,0,1577,2248,714
2018,36005026300,"Census Tract 263, Bronx County, New York",2469,87,2382,2263,5143,19988,0,2011,1123,48.1,260,254,340,0,1584,2382,860
2019,36005026300,"Census Tract 263, Bronx County, New York",2459,168,2291,2184,5303,18707,0,2010,1158,46.9,347,289,412,0,1454,2291,904
2020,36005026300,"Census Tract 263, Bronx County, New York",2412,71,2341,2240,5319,28171,0,2013,1042,38.2,430,222,355,0,1551,2341,651
2012,36005026400,"Census Tract 264, Bronx County, New York",2097,118,1979,1228,2896,48946,1954,2004,1487,30.9,249,550,135,0,543,1979,434
2013,36005026400,"Census Tract 264, Bronx County, New York",2174,167,2007,1063,2754,53652,1952,2004,1459,29.3,269,449,97,12,480,2007,327
2014,36005026400,"Census Tract 264, Bronx County, New York",2186,164,2022,1114,3290,53724,1947,2006,1543,32.2,326,371,136,34,549,2022,340
2015,36005026400,"Census Tract 264, Bronx County, New York",2160,203,1957,1152,3364,52813,1944,2006,1531,34.9,331,381,92,44,630,1957,254
2016,36005026400,"Census Tract 264, Bronx County, New York",2179,181,1998,1133,2862,51523,1945,2009,1344,34.2,256,444,85,83,519,1998,206
2017,36005026400,"Census Tract 264, Bronx County, New York",2140,283,1857,924,2416,46735,1943,2011,1400,40.6,170,388,69,108,375,1857,121
2018,36005026400,"Census Tract 264, Bronx County, New York",2124,216,1908,1021,2468,47877,1941,2012,1408,40,139,447,84,65,442,1908,129
2019,36005026400,"Census Tract 264, Bronx County, New York",2110,237,1873,858,1570,40385,1946,2013,1311,42,82,381,35,79,380,1873,104
2020,36005026400,"Census Tract 264, Bronx County, New York",2149,154,1995,966,1996,39417,1952,2016,1401,35.8,120,264,94,88,488,1995,180
2012,36005026500,"Census Tract 265, Bronx County, New York",2181,173,2008,1817,5688,28504,1939,2002,1020,43.8,188,36,282,156,1313,2008,737
2013,36005026500,"Census Tract 265, Bronx County, New York",2158,182,1976,1759,5784,34909,1939,2004,1051,38.8,185,20,276,94,1326,1976,618
2014,36005026500,"Census Tract 265, Bronx County, New York",2167,153,2014,1841,6062,31125,1939,2005,1050,41.9,223,51,247,108,1409,2014,683
2015,36005026500,"Census Tract 265, Bronx County, New York",2193,176,2017,1876,6327,30289,1939,2006,1073,41.6,242,66,218,120,1482,2017,791
2016,36005026500,"Census Tract 265, Bronx County, New York",2226,128,2098,2056,7579,27750,1941,2007,1146,43,251,95,215,116,1629,2098,813
2017,36005026500,"Census Tract 265, Bronx County, New York",2252,96,2156,2102,8316,33831,1939,2008,1285,40.9,265,85,174,78,1714,2156,709
2018,36005026500,"Census Tract 265, Bronx County, New York",2257,109,2148,2098,7433,37647,1942,2007,1212,38,278,69,228,55,1723,2148,791
2019,36005026500,"Census Tract 265, Bronx County, New York",2270,119,2151,2096,7668,40688,0,2009,1278,37.6,263,44,307,46,1807,2151,709
2020,36005026500,"Census Tract 265, Bronx County, New York",2211,71,2140,2091,7242,47348,0,2009,1341,36.8,285,23,372,53,1775,2140,645
2012,36005026601,"Census Tract 266.01, Bronx County, New York",1408,163,1245,992,2224,48750,1961,2002,1145,28.4,187,577,40,11,349,1245,203
2013,36005026601,"Census Tract 266.01, Bronx County, New York",1410,179,1231,1040,2362,51944,1956,2002,1180,28.9,184,545,49,7,422,1231,210
2014,36005026601,"Census Tract 266.01, Bronx County, New York",1411,122,1289,1061,2295,55057,1963,2004,1226,28.1,248,525,66,22,423,1289,141
2015,36005026601,"Census Tract 266.01, Bronx County, New York",1433,126,1307,1074,2361,55870,1960,2004,1221,27.9,212,490,64,35,478,1307,174
2016,36005026601,"Census Tract 266.01, Bronx County, New York",1429,67,1362,1068,2301,59313,1951,2008,1311,28,226,402,84,27,558,1362,149
2017,36005026601,"Census Tract 266.01, Bronx County, New York",1447,74,1373,1036,2475,51800,1949,2010,1368,29.3,221,389,53,55,543,1373,133
2018,36005026601,"Census Tract 266.01, Bronx County, New York",1421,35,1386,1017,2447,47301,1955,2011,1407,30.7,199,394,65,55,508,1386,165
2019,36005026601,"Census Tract 266.01, Bronx County, New York",1498,58,1440,1112,2632,52000,1949,2011,1476,28.2,221,354,102,22,648,1440,215
2020,36005026601,"Census Tract 266.01, Bronx County, New York",1393,30,1363,1068,2460,49013,1961,2011,1597,35,252,380,73,35,599,1363,118
2012,36005026602,"Census Tract 266.02, Bronx County, New York",2626,193,2433,2014,4002,43042,1951,2003,1103,28.6,388,891,187,44,934,2433,439
2013,36005026602,"Census Tract 266.02, Bronx County, New York",2704,160,2544,2049,4150,43975,1960,2005,1141,28.6,315,817,190,31,1042,2544,446
2014,36005026602,"Census Tract 266.02, Bronx County, New York",2751,213,2538,2001,3977,41543,1958,2005,1121,29.2,332,836,162,16,996,2538,490
2015,36005026602,"Census Tract 266.02, Bronx County, New York",2705,174,2531,2037,4365,37434,1949,2006,1130,34.2,341,798,186,19,1048,2531,518
2016,36005026602,"Census Tract 266.02, Bronx County, New York",2606,150,2456,1904,3818,34775,1961,2008,1195,32.2,494,767,209,52,882,2456,527
2017,36005026602,"Census Tract 266.02, Bronx County, New York",2662,92,2570,1890,3863,45183,1951,2010,1231,29,507,682,200,74,942,2570,507
2018,36005026602,"Census Tract 266.02, Bronx County, New York",2620,188,2432,1848,3725,51099,1949,2011,1274,29,525,733,178,58,879,2432,515
2019,36005026602,"Census Tract 266.02, Bronx County, New York",2618,178,2440,1891,3705,51991,1948,2012,1326,31.9,596,804,261,48,813,2440,477
2020,36005026602,"Census Tract 266.02, Bronx County, New York",2619,150,2469,1945,4027,52575,1950,2013,1339,31.6,461,674,340,34,922,2469,506
2012,36005026701,"Census Tract 267.01, Bronx County, New York",1349,63,1286,1255,3340,26890,1939,2004,1069,37.6,223,51,164,162,888,1286,412
2013,36005026701,"Census Tract 267.01, Bronx County, New York",1317,107,1210,1195,3439,32845,1939,2004,1139,34.7,205,66,134,164,860,1210,332
2014,36005026701,"Census Tract 267.01, Bronx County, New York",1352,84,1268,1251,3365,37344,1939,2004,1166,32.6,268,43,201,206,862,1268,336
2015,36005026701,"Census Tract 267.01, Bronx County, New York",1386,98,1288,1272,3596,37128,1939,2005,1155,32.7,302,64,122,258,860,1288,389
2016,36005026701,"Census Tract 267.01, Bronx County, New York",1396,116,1280,1269,3904,27337,1939,2006,1196,35.5,286,54,227,206,835,1280,491
2017,36005026701,"Census Tract 267.01, Bronx County, New York",1383,100,1283,1277,4083,42109,1939,2005,1265,35.5,268,50,267,192,826,1283,374
2018,36005026701,"Census Tract 267.01, Bronx County, New York",1402,83,1319,1284,4064,48000,0,2005,1315,34.4,293,33,286,194,846,1319,339
2019,36005026701,"Census Tract 267.01, Bronx County, New York",1386,91,1295,1263,4003,44732,0,2006,1371,38.5,284,55,256,190,836,1295,306
2020,36005026701,"Census Tract 267.01, Bronx County, New York",1387,106,1281,1257,3850,43949,0,2010,1354,37.9,277,58,311,144,826,1281,372
2012,36005026702,"Census Tract 267.02, Bronx County, New York",2491,130,2361,2217,5948,37188,1939,2003,1092,34.6,423,116,585,30,1559,2361,719
2013,36005026702,"Census Tract 267.02, Bronx County, New York",2465,138,2327,2108,5518,31768,1939,2004,1131,37.3,331,99,450,57,1565,2327,743
2014,36005026702,"Census Tract 267.02, Bronx County, New York",2486,149,2337,2067,5560,32567,1939,2004,1141,38,340,69,454,50,1577,2337,749
2015,36005026702,"Census Tract 267.02, Bronx County, New York",2503,86,2417,2147,6053,34011,1939,2006,1168,36.4,440,77,377,43,1700,2417,717
2016,36005026702,"Census Tract 267.02, Bronx County, New York",2582,32,2550,2279,6367,33031,1939,2007,1193,39.9,457,72,423,44,1797,2550,795
2017,36005026702,"Census Tract 267.02, Bronx County, New York",2575,35,2540,2332,6580,33725,1939,2009,1252,46.5,503,66,455,35,1877,2540,908
2018,36005026702,"Census Tract 267.02, Bronx County, New York",2577,36,2541,2419,6886,34364,0,2010,1286,42.6,469,90,489,12,1916,2541,942
2019,36005026702,"Census Tract 267.02, Bronx County, New York",2607,0,2607,2496,7529,33602,0,2010,1351,46.5,448,84,547,0,2041,2607,960
2020,36005026702,"Census Tract 267.02, Bronx County, New York",2787,0,2787,2340,7296,28397,0,2009,1347,49.2,409,83,570,0,1927,2787,921
2012,36005026900,"Census Tract 269, Bronx County, New York",1464,146,1318,1196,2860,26836,1944,2003,979,33.3,231,39,220,47,885,1318,363
2013,36005026900,"Census Tract 269, Bronx County, New York",1445,140,1305,1185,2668,28210,1944,2003,974,33.3,237,42,215,44,895,1305,341
2014,36005026900,"Census Tract 269, Bronx County, New York",1447,122,1325,1212,2808,31800,1948,2003,999,31.6,242,51,185,74,921,1325,379
2015,36005026900,"Census Tract 269, Bronx County, New York",1459,88,1371,1233,3222,29313,1949,2003,983,34.4,214,49,255,38,911,1371,421
2016,36005026900,"Census Tract 269, Bronx County, New York",1479,86,1393,1216,3080,34400,1949,2005,1009,32.5,215,23,248,31,936,1393,418
2017,36005026900,"Census Tract 269, Bronx County, New York",1485,84,1401,1206,3197,36990,1951,2007,1074,31.7,234,23,219,30,948,1401,347
2018,36005026900,"Census Tract 269, Bronx County, New York",1494,142,1352,1197,2967,36155,1949,2007,1092,29.5,255,15,256,32,904,1352,387
2019,36005026900,"Census Tract 269, Bronx County, New York",1520,158,1362,1191,3197,37623,1943,2008,1109,33.5,264,0,269,19,908,1362,395
2020,36005026900,"Census Tract 269, Bronx County, New York",1860,125,1735,1560,3151,23086,1945,2012,895,45,257,0,280,20,1290,1735,706
2012,36005027300,"Census Tract 273, Bronx County, New York",2633,151,2482,2146,7087,41408,1939,2001,1083,31.4,194,98,453,38,1630,2482,550
2013,36005027300,"Census Tract 273, Bronx County, New York",2653,105,2548,2149,7189,41130,1939,2001,1150,32.7,263,91,488,30,1610,2548,530
2014,36005027300,"Census Tract 273, Bronx County, New York",2765,122,2643,2360,7345,35167,1942,2003,1157,38.8,288,127,547,34,1767,2643,749
2015,36005027300,"Census Tract 273, Bronx County, New York",2770,160,2610,2347,7219,40509,1942,2004,1206,33.7,457,131,600,27,1681,2610,618
2016,36005027300,"Census Tract 273, Bronx County, New York",2823,147,2676,2442,7374,38343,1941,2005,1225,39.1,492,111,499,0,1942,2676,601
2017,36005027300,"Census Tract 273, Bronx County, New York",2847,208,2639,2382,6880,34615,1941,2006,1271,42,513,123,565,0,1849,2639,685
2018,36005027300,"Census Tract 273, Bronx County, New York",2848,164,2684,2418,6721,31763,1942,2007,1302,43.2,563,85,609,0,1868,2684,753
2019,36005027300,"Census Tract 273, Bronx County, New York",2819,192,2627,2282,6429,38333,1941,2006,1316,39.9,494,129,524,0,1729,2627,596
2020,36005027300,"Census Tract 273, Bronx County, New York",2978,99,2879,2498,5939,36400,0,2006,1313,40.1,440,152,498,0,1921,2879,787
2012,36005027401,"Census Tract 274.01, Bronx County, New York",1871,58,1813,521,1177,44911,1957,2002,1575,29.3,143,455,0,0,66,1813,188
2013,36005027401,"Census Tract 274.01, Bronx County, New York",1903,115,1788,635,1541,53875,1956,2003,1583,26.4,195,449,0,37,149,1788,200
2014,36005027401,"Census Tract 274.01, Bronx County, New York",1931,181,1750,553,1217,68750,1956,2005,1539,25.6,167,402,0,30,121,1750,133
2015,36005027401,"Census Tract 274.01, Bronx County, New York",1830,179,1651,565,1204,68618,1959,2009,1421,24.2,160,411,0,39,115,1651,93
2016,36005027401,"Census Tract 274.01, Bronx County, New York",1860,156,1704,576,1143,67969,1959,2010,1416,24.1,134,366,0,34,176,1704,67
2017,36005027401,"Census Tract 274.01, Bronx County, New York",1851,153,1698,488,1004,74919,1961,2011,1455,22.5,163,287,0,47,154,1698,37
2018,36005027401,"Census Tract 274.01, Bronx County, New York",1840,111,1729,476,968,68088,1966,2011,1493,28.6,133,316,0,12,148,1729,20
2019,36005027401,"Census Tract 274.01, Bronx County, New York",1769,49,1720,439,903,56328,1962,2012,1663,33.9,134,282,0,18,139,1720,37
2020,36005027401,"Census Tract 274.01, Bronx County, New York",1814,81,1733,441,1115,38750,1957,2013,1903,48,196,267,0,24,150,1733,60
2012,36005027402,"Census Tract 274.02, Bronx County, New York",1388,140,1248,537,1332,47357,1946,2005,1323,26.9,145,350,68,0,136,1248,54
2013,36005027402,"Census Tract 274.02, Bronx County, New York",1394,153,1241,619,1219,46469,1954,2006,1386,28.5,190,320,60,51,201,1241,77
2014,36005027402,"Census Tract 274.02, Bronx County, New York",1414,120,1294,585,1204,55292,1958,2007,1517,28.3,232,273,49,36,238,1294,94
2015,36005027402,"Census Tract 274.02, Bronx County, New York",1348,46,1302,625,1496,61268,1962,2008,1584,28.6,236,394,15,32,199,1302,118
2016,36005027402,"Census Tract 274.02, Bronx County, New York",1348,49,1299,611,1451,56211,1962,2010,1459,30.7,207,338,9,38,235,1299,144
2017,36005027402,"Census Tract 274.02, Bronx County, New York",1378,26,1352,640,1347,50250,1964,2010,1422,36,154,391,0,34,215,1352,204
2018,36005027402,"Census Tract 274.02, Bronx County, New York",1358,26,1332,535,1180,66875,1970,2010,1524,28.1,162,364,0,0,171,1332,143
2019,36005027402,"Census Tract 274.02, Bronx County, New York",1336,58,1278,579,1312,78155,1968,2012,1762,30.7,160,322,12,0,245,1278,142
2020,36005027402,"Census Tract 274.02, Bronx County, New York",1385,120,1265,484,948,56204,1969,2013,1822,36.2,121,255,8,0,221,1265,115
2012,36005027600,"Census Tract 276, Bronx County, New York",12,0,12,5,24,47083,1972,1998,1208,25.8,5,0,3,2,0,12,0
2013,36005027600,"Census Tract 276, Bronx County, New York",30,0,30,16,48,56111,1947,2003,1154,22.8,7,0,4,3,0,30,0
2014,36005027600,"Census Tract 276, Bronx County, New York",16,0,16,6,10,NA,NA,NA,NA,NA,3,0,3,0,3,16,3
2015,36005027600,"Census Tract 276, Bronx County, New York",18,0,18,7,11,NA,NA,NA,NA,NA,3,0,3,0,4,18,4
2016,36005027600,"Census Tract 276, Bronx County, New York",16,0,16,4,8,NA,NA,NA,NA,NA,0,0,0,0,4,16,4
2017,36005027600,"Census Tract 276, Bronx County, New York",10,0,10,3,7,NA,NA,NA,NA,NA,0,0,0,0,3,10,3
2018,36005027600,"Census Tract 276, Bronx County, New York",4,0,4,4,4,NA,NA,NA,NA,NA,0,0,0,0,4,4,0
2019,36005027600,"Census Tract 276, Bronx County, New York",8,0,8,8,24,NA,NA,NA,NA,NA,0,0,4,0,4,8,0
2020,36005027600,"Census Tract 276, Bronx County, New York",146,0,146,146,261,2499,0,2016,1608,37.9,93,93,49,0,4,146,93
2012,36005027700,"Census Tract 277, Bronx County, New York",1826,77,1749,1549,4326,21983,1939,2002,928,41,203,207,373,59,954,1749,729
2013,36005027700,"Census Tract 277, Bronx County, New York",1863,72,1791,1533,4950,27193,1939,2002,966,41.1,179,183,363,49,987,1791,691
2014,36005027700,"Census Tract 277, Bronx County, New York",1861,107,1754,1505,4833,27830,1939,2004,1021,41.8,240,146,388,28,1013,1754,614
2015,36005027700,"Census Tract 277, Bronx County, New York",1862,114,1748,1462,4963,29406,1939,2006,1100,39.9,235,183,327,24,962,1748,614
2016,36005027700,"Census Tract 277, Bronx County, New York",1834,126,1708,1464,4816,29429,1939,2008,1173,42.4,244,246,245,45,966,1708,585
2017,36005027700,"Census Tract 277, Bronx County, New York",1868,110,1758,1553,5001,33535,1939,2010,1289,41.3,282,233,269,45,1064,1758,553
2018,36005027700,"Census Tract 277, Bronx County, New York",1840,106,1734,1590,4305,25223,0,2011,1294,44.5,329,196,244,33,1136,1734,636
2019,36005027700,"Census Tract 277, Bronx County, New York",1847,68,1779,1670,4332,28483,0,2011,1314,45.2,362,212,272,36,1151,1779,695
2020,36005027700,"Census Tract 277, Bronx County, New York",1861,45,1816,1759,4353,29446,0,2011,1297,39.3,489,244,211,31,1294,1816,556
2012,36005027900,"Census Tract 279, Bronx County, New York",2898,197,2701,2008,5171,43185,1948,2002,1159,28.6,602,447,315,118,1076,2701,293
2013,36005027900,"Census Tract 279, Bronx County, New York",2924,140,2784,2060,5518,44261,1948,2003,1196,28.8,531,448,375,55,1118,2784,275
2014,36005027900,"Census Tract 279, Bronx County, New York",2840,222,2618,1955,5201,50368,1948,2004,1266,28.7,635,403,420,75,1077,2618,335
2015,36005027900,"Census Tract 279, Bronx County, New York",2841,236,2605,1998,4872,53457,1949,2006,1237,28.7,755,448,371,51,1137,2605,297
2016,36005027900,"Census Tract 279, Bronx County, New York",2819,254,2565,1799,4564,56156,1951,2007,1265,28.4,671,330,340,47,1088,2565,309
2017,36005027900,"Census Tract 279, Bronx County, New York",2875,249,2626,1854,4916,53192,1952,2010,1322,29.3,717,394,212,30,1208,2626,323
2018,36005027900,"Census Tract 279, Bronx County, New York",2858,214,2644,1815,4525,54076,1955,2009,1361,29.6,546,345,89,23,1365,2644,309
2019,36005027900,"Census Tract 279, Bronx County, New York",2963,154,2809,1993,5039,51529,1952,2008,1423,31.3,498,309,128,17,1494,2809,309
2020,36005027900,"Census Tract 279, Bronx County, New York",2898,138,2760,1931,5482,49789,1948,2011,1605,34.7,301,163,240,16,1519,2760,201
2012,36005028100,"Census Tract 281, Bronx County, New York",1874,107,1767,881,1943,44716,1953,2000,1000,24,317,463,156,26,255,1767,159
2013,36005028100,"Census Tract 281, Bronx County, New York",1854,109,1745,876,2169,58036,1950,2002,1003,23.8,310,413,159,15,299,1745,167
2014,36005028100,"Census Tract 281, Bronx County, New York",1813,103,1710,696,1523,56500,1950,2002,1042,23,253,337,143,14,210,1710,134
2015,36005028100,"Census Tract 281, Bronx County, New York",1754,102,1652,589,1237,57875,1953,2002,1071,23.8,197,239,187,8,151,1652,121
2016,36005028100,"Census Tract 281, Bronx County, New York",1758,73,1685,684,1375,47232,1951,2003,1096,32.6,241,260,220,8,196,1685,126
2017,36005028100,"Census Tract 281, Bronx County, New York",1777,55,1722,731,1564,49276,1947,2003,1129,30.6,259,283,151,9,288,1722,92
2018,36005028100,"Census Tract 281, Bronx County, New York",1765,54,1711,656,1369,48278,1948,2005,1138,31.4,228,280,131,10,240,1711,114
2019,36005028100,"Census Tract 281, Bronx County, New York",1756,85,1671,809,1707,44755,1951,2005,1224,35.1,371,336,168,17,303,1671,159
2020,36005028100,"Census Tract 281, Bronx County, New York",1827,81,1746,820,1705,48846,1953,2010,1221,34.1,390,369,149,6,306,1746,160
2012,36005028300,"Census Tract 283, Bronx County, New York",1284,20,1264,1176,2914,40515,1953,2002,806,26.7,187,60,304,5,897,1264,224
2013,36005028300,"Census Tract 283, Bronx County, New York",1320,83,1237,1136,2928,41931,1953,2002,887,24.3,221,79,323,14,771,1237,116
2014,36005028300,"Census Tract 283, Bronx County, New York",1371,99,1272,1251,3320,28705,1954,2003,680,27.1,237,53,372,6,856,1272,342
2015,36005028300,"Census Tract 283, Bronx County, New York",1362,81,1281,1240,3273,NA,1955,2005,801,30.8,193,48,373,4,863,1281,385
2016,36005028300,"Census Tract 283, Bronx County, New York",1374,53,1321,1219,3094,23266,1954,2005,843,31.3,224,69,392,0,805,1321,465
2017,36005028300,"Census Tract 283, Bronx County, New York",1234,84,1150,1064,2762,24282,1954,2006,862,31.2,196,121,319,0,699,1150,429
2018,36005028300,"Census Tract 283, Bronx County, New York",1136,42,1094,1014,2473,23434,1955,2006,796,32.8,177,132,324,0,612,1094,485
2019,36005028300,"Census Tract 283, Bronx County, New York",1125,34,1091,1019,2364,26678,1957,2007,985,32.1,236,143,354,0,614,1091,434
2020,36005028300,"Census Tract 283, Bronx County, New York",889,51,838,803,1979,NA,1957,2006,1254,33.6,122,119,211,0,572,838,348
2012,36005028400,"Census Tract 284, Bronx County, New York",73,0,73,57,313,49120,1939,2004,1824,36.8,0,27,0,0,19,73,0
2013,36005028400,"Census Tract 284, Bronx County, New York",34,0,34,12,12,NA,NA,NA,NA,NA,0,0,0,0,0,34,0
2014,36005028400,"Census Tract 284, Bronx County, New York",44,0,44,25,92,NA,NA,NA,NA,NA,0,0,0,0,13,44,0
2015,36005028400,"Census Tract 284, Bronx County, New York",41,0,41,29,116,NA,1939,2003,1492,40.3,0,0,0,0,18,41,0
2016,36005028400,"Census Tract 284, Bronx County, New York",33,0,33,18,104,NA,NA,NA,NA,NA,0,0,0,0,18,33,0
2017,36005028400,"Census Tract 284, Bronx County, New York",20,0,20,17,98,NA,NA,NA,NA,NA,0,0,0,0,17,20,0
2018,36005028400,"Census Tract 284, Bronx County, New York",21,0,21,17,91,NA,NA,NA,NA,NA,0,0,0,0,17,21,0
2019,36005028400,"Census Tract 284, Bronx County, New York",5,0,5,5,22,NA,NA,NA,NA,NA,0,0,0,0,5,5,0
2020,36005028400,"Census Tract 284, Bronx County, New York",0,0,0,0,0,NA,NA,NA,NA,NA,0,0,0,0,0,0,0
2012,36005028500,"Census Tract 285, Bronx County, New York",1579,124,1455,1222,2478,45871,1949,2005,1163,29.9,554,731,117,36,347,1455,329
2013,36005028500,"Census Tract 285, Bronx County, New York",1609,139,1470,1258,2577,52592,1951,2006,1217,29,654,775,98,32,361,1470,296
2014,36005028500,"Census Tract 285, Bronx County, New York",1707,171,1536,1298,2714,49861,1955,2007,1265,31.1,582,799,90,28,381,1536,254
2015,36005028500,"Census Tract 285, Bronx County, New York",1688,165,1523,1268,2827,58011,1956,2008,1331,27.9,659,761,125,47,340,1523,240
2016,36005028500,"Census Tract 285, Bronx County, New York",1681,142,1539,1253,2802,61601,1955,2010,1442,28.9,729,652,143,102,415,1539,297
2017,36005028500,"Census Tract 285, Bronx County, New York",1686,104,1582,1275,2825,61230,1959,2010,1478,29.1,720,655,111,103,454,1582,295
2018,36005028500,"Census Tract 285, Bronx County, New York",1662,63,1599,1301,2917,58401,1958,2011,1499,29.9,716,661,126,154,405,1599,367
2019,36005028500,"Census Tract 285, Bronx County, New York",1671,54,1617,1323,2871,59911,1959,2012,1499,29.8,796,623,125,191,441,1617,415
2020,36005028500,"Census Tract 285, Bronx County, New York",1728,31,1697,1231,2546,63538,1961,2012,1621,29,661,500,127,179,495,1697,278
2012,36005028600,"Census Tract 286, Bronx County, New York",506,79,427,213,386,28125,1939,2003,1283,46.7,73,91,10,54,72,427,78
2013,36005028600,"Census Tract 286, Bronx County, New York",527,99,428,210,477,29038,1952,2006,1317,31.9,83,82,13,51,76,428,74
2014,36005028600,"Census Tract 286, Bronx County, New York",531,89,442,232,577,36042,1956,2011,1375,34.6,103,111,12,31,78,442,62
2015,36005028600,"Census Tract 286, Bronx County, New York",513,83,430,204,571,41667,1941,2009,1505,42.2,97,92,11,25,76,430,63
2016,36005028600,"Census Tract 286, Bronx County, New York",499,63,436,263,624,55729,1950,2011,1463,34.4,118,72,10,23,158,436,59
2017,36005028600,"Census Tract 286, Bronx County, New York",511,41,470,231,560,61875,1961,2012,1351,26.3,120,94,7,20,117,470,72
2018,36005028600,"Census Tract 286, Bronx County, New York",470,12,458,222,478,64688,1954,2012,1479,26.2,114,86,7,34,102,458,56
2019,36005028600,"Census Tract 286, Bronx County, New York",461,15,446,209,412,78512,1950,2012,1388,19.8,105,62,19,28,106,446,43
2020,36005028600,"Census Tract 286, Bronx County, New York",499,29,470,255,413,65917,1941,2007,1234,25.8,138,34,40,26,161,470,45
2012,36005028700,"Census Tract 287, Bronx County, New York",1314,108,1206,848,2483,33958,1939,2003,1312,41.1,373,222,106,66,472,1206,186
2013,36005028700,"Census Tract 287, Bronx County, New York",1290,165,1125,868,2626,41908,1939,2003,1314,36.3,353,264,92,47,481,1125,212
2014,36005028700,"Census Tract 287, Bronx County, New York",1285,119,1166,902,2738,45915,1939,2004,1328,35.3,394,263,121,43,506,1166,185
2015,36005028700,"Census Tract 287, Bronx County, New York",1252,118,1134,850,2500,48182,1939,2006,1330,34.9,341,262,118,38,477,1134,196
2016,36005028700,"Census Tract 287, Bronx County, New York",1237,110,1127,934,2599,50607,1939,2007,1329,32.8,382,254,177,47,508,1127,209
2017,36005028700,"Census Tract 287, Bronx County, New York",1267,69,1198,972,2610,52865,1942,2010,1391,30.5,301,285,137,63,522,1198,150
2018,36005028700,"Census Tract 287, Bronx County, New York",1265,23,1242,955,2265,53444,1943,2009,1390,27.4,319,265,164,45,527,1242,128
2019,36005028700,"Census Tract 287, Bronx County, New York",1278,45,1233,937,2315,52211,0,2010,1478,31.4,224,221,140,42,574,1233,143
2020,36005028700,"Census Tract 287, Bronx County, New York",1263,36,1227,946,2664,52250,1947,2012,1536,32.3,189,163,151,31,622,1227,94
2012,36005028800,"Census Tract 288, Bronx County, New York",1257,87,1170,386,1066,49605,1962,2005,1161,25.1,148,167,11,92,116,1170,51
2013,36005028800,"Census Tract 288, Bronx County, New York",1270,133,1137,412,1090,55565,1962,2006,1202,26.4,172,158,29,101,124,1137,45
2014,36005028800,"Census Tract 288, Bronx County, New York",1290,123,1167,542,1467,78182,1958,2008,1390,23.1,274,222,16,105,199,1167,46
2015,36005028800,"Census Tract 288, Bronx County, New York",1243,102,1141,480,1398,84000,1957,2010,1426,21.7,261,219,16,109,136,1141,58
2016,36005028800,"Census Tract 288, Bronx County, New York",1217,85,1132,458,1244,83125,1957,2009,1555,20.8,223,189,20,77,183,1132,60
2017,36005028800,"Census Tract 288, Bronx County, New York",1221,110,1111,439,1106,73173,1956,2011,1690,23.1,245,226,11,62,153,1111,65
2018,36005028800,"Census Tract 288, Bronx County, New York",1208,75,1133,510,1265,72769,1955,2012,1700,30.4,213,254,56,79,133,1133,158
2019,36005028800,"Census Tract 288, Bronx County, New York",1176,35,1141,498,1124,NA,1954,2015,1642,40.7,178,189,79,135,105,1141,260
2020,36005028800,"Census Tract 288, Bronx County, New York",1118,44,1074,497,1041,54948,1954,2015,1616,34.3,165,234,65,149,59,1074,210
2012,36005028900,"Census Tract 289, Bronx County, New York",1835,182,1653,1531,3778,53531,1940,2003,1173,25.7,491,465,161,206,788,1653,207
2013,36005028900,"Census Tract 289, Bronx County, New York",1854,199,1655,1534,3526,54091,1939,2004,1177,24.9,475,472,149,177,783,1655,259
2014,36005028900,"Census Tract 289, Bronx County, New York",1876,145,1731,1601,3435,40888,1939,2004,1223,27.5,457,467,117,165,892,1731,304
2015,36005028900,"Census Tract 289, Bronx County, New York",1881,105,1776,1599,3582,41629,1939,2005,1200,28.7,424,522,126,125,870,1776,282
2016,36005028900,"Census Tract 289, Bronx County, New York",1929,88,1841,1609,3588,45168,1939,2006,1199,30.7,400,405,111,62,1017,1841,291
2017,36005028900,"Census Tract 289, Bronx County, New York",1968,94,1874,1614,3661,49265,1939,2009,1234,29.4,470,363,162,21,1095,1874,291
2018,36005028900,"Census Tract 289, Bronx County, New York",1954,77,1877,1654,4094,48000,0,2009,1275,30.6,459,342,127,41,1170,1877,318
2019,36005028900,"Census Tract 289, Bronx County, New York",1965,62,1903,1674,4111,52743,0,2010,1287,29.6,488,363,150,30,1143,1903,332
2020,36005028900,"Census Tract 289, Bronx County, New York",1889,65,1824,1557,3778,46750,0,2010,1280,30.9,454,315,229,42,1015,1824,403
2012,36005029301,"Census Tract 293.01, Bronx County, New York",969,89,880,238,391,61000,1954,1993,1087,17.9,138,193,0,6,39,880,89
2013,36005029301,"Census Tract 293.01, Bronx County, New York",970,112,858,275,451,70688,1954,1998,1185,17.8,182,228,0,5,42,858,64
2014,36005029301,"Census Tract 293.01, Bronx County, New York",965,115,850,220,363,72500,1960,1998,1299,22.7,128,195,11,6,8,850,69
2015,36005029301,"Census Tract 293.01, Bronx County, New York",990,110,880,212,299,62955,1956,2002,1200,23.5,128,151,10,8,43,880,59
2016,36005029301,"Census Tract 293.01, Bronx County, New York",961,118,843,199,277,61131,1954,2001,1545,26.3,122,162,14,6,17,843,34
2017,36005029301,"Census Tract 293.01, Bronx County, New York",971,59,912,184,252,58750,1957,2001,1540,27.5,108,148,16,0,20,912,53
2018,36005029301,"Census Tract 293.01, Bronx County, New York",952,58,894,154,216,54706,1956,1989,1569,30.6,82,117,17,0,20,894,36
2019,36005029301,"Census Tract 293.01, Bronx County, New York",939,57,882,139,215,57292,1953,2004,1703,31.6,94,109,0,6,20,882,34
2020,36005029301,"Census Tract 293.01, Bronx County, New York",938,77,861,123,187,63828,1955,1989,1768,28.4,74,113,0,6,0,861,28
2012,36005029302,"Census Tract 293.02, Bronx County, New York",2762,258,2504,1196,2406,95000,1968,2002,1862,24.8,827,939,54,35,191,2504,36
2013,36005029302,"Census Tract 293.02, Bronx County, New York",2776,293,2483,1086,2075,82336,1967,2003,1860,25.8,717,816,49,43,196,2483,25
2014,36005029302,"Census Tract 293.02, Bronx County, New York",2820,218,2602,1130,2137,97232,1967,2004,1889,25.4,682,792,72,30,236,2602,30
2015,36005029302,"Census Tract 293.02, Bronx County, New York",2740,173,2567,1115,2085,100917,1967,2005,1943,24.7,712,829,65,18,191,2567,42
2016,36005029302,"Census Tract 293.02, Bronx County, New York",2686,183,2503,1059,2034,104073,1967,2009,1951,23.3,727,704,88,39,218,2503,61
2017,36005029302,"Census Tract 293.02, Bronx County, New York",2806,95,2711,1146,2206,107647,1964,2011,2084,24.2,785,730,125,56,216,2711,87
2018,36005029302,"Census Tract 293.02, Bronx County, New York",2741,17,2724,1139,2198,95729,1968,2011,2089,25.8,721,720,126,32,240,2724,189
2019,36005029302,"Census Tract 293.02, Bronx County, New York",2698,83,2615,1105,2267,90417,1968,2011,2240,29.6,728,709,147,46,184,2615,220
2020,36005029302,"Census Tract 293.02, Bronx County, New York",2748,82,2666,1027,2274,98233,1971,2013,2269,28.9,678,616,181,23,207,2666,210
2012,36005029500,"Census Tract 295, Bronx County, New York",2031,270,1761,1062,2640,69276,1957,2004,1662,26.9,723,663,81,85,191,1761,92
2013,36005029500,"Census Tract 295, Bronx County, New York",2115,323,1792,923,2344,76553,1957,2006,1699,25.7,539,595,92,23,187,1792,96
2014,36005029500,"Census Tract 295, Bronx County, New York",2127,273,1854,984,2320,77688,1960,2007,1653,26.6,637,652,99,13,205,1854,106
2015,36005029500,"Census Tract 295, Bronx County, New York",2110,277,1833,1045,2569,79604,1960,2010,1643,27.4,658,711,98,38,186,1833,81
2016,36005029500,"Census Tract 295, Bronx County, New York",2138,196,1942,1152,2933,85769,1961,2011,1650,26.4,758,607,149,51,347,1942,77
2017,36005029500,"Census Tract 295, Bronx County, New York",2150,154,1996,1155,2614,80934,1958,2011,1633,27.2,673,682,61,50,302,1996,88
2018,36005029500,"Census Tract 295, Bronx County, New York",2108,106,2002,1165,2623,83155,1956,2011,1680,27.2,701,712,48,55,290,2002,98
2019,36005029500,"Census Tract 295, Bronx County, New York",2083,87,1996,1027,2289,83813,1954,2012,1706,25.7,612,639,49,47,180,1996,69
2020,36005029500,"Census Tract 295, Bronx County, New York",2134,19,2115,1054,2240,85536,1952,2012,1655,24.1,581,441,95,13,378,2115,130
2012,36005029600,"Census Tract 296, Bronx County, New York",994,75,919,792,1652,33523,1962,2005,1000,25.8,528,222,150,261,170,919,229
2013,36005029600,"Census Tract 296, Bronx County, New York",885,99,786,689,1476,45536,1961,2006,1094,27.8,405,224,214,125,136,786,175
2014,36005029600,"Census Tract 296, Bronx County, New York",763,51,712,616,1353,50286,1959,2007,1210,29.6,338,167,207,111,134,712,124
2015,36005029600,"Census Tract 296, Bronx County, New York",707,52,655,543,1137,46750,1958,2010,1260,32.2,295,146,140,109,141,655,111
2016,36005029600,"Census Tract 296, Bronx County, New York",727,41,686,583,1242,50806,1959,2011,1314,31.9,309,121,170,122,161,686,101
2017,36005029600,"Census Tract 296, Bronx County, New York",742,60,682,571,1276,55824,1961,2012,1358,30.5,335,121,158,118,163,682,88
2018,36005029600,"Census Tract 296, Bronx County, New York",738,40,698,577,1212,54150,1964,2012,1384,30.8,327,94,149,124,225,698,106
2019,36005029600,"Census Tract 296, Bronx County, New York",751,65,686,546,1074,51591,1965,2013,1448,32,308,114,133,122,192,686,78
2020,36005029600,"Census Tract 296, Bronx County, New York",895,57,838,687,1169,48962,1964,2016,1570,33.2,417,107,112,155,327,838,122
2012,36005029700,"Census Tract 297, Bronx County, New York",1789,378,1411,497,1053,64275,1955,2003,1246,32.1,296,450,16,0,39,1411,52
2013,36005029700,"Census Tract 297, Bronx County, New York",1819,345,1474,578,1331,68333,1958,2004,1513,34.4,341,487,23,0,48,1474,51
2014,36005029700,"Census Tract 297, Bronx County, New York",1872,231,1641,688,1497,73636,1958,2005,1549,28.3,428,532,58,0,106,1641,65
2015,36005029700,"Census Tract 297, Bronx County, New York",1789,243,1546,689,1366,73051,1956,2010,1503,24.4,427,463,58,33,121,1546,57
2016,36005029700,"Census Tract 297, Bronx County, New York",1762,177,1585,758,1402,67273,1957,2010,1556,26,458,454,66,42,189,1585,95
2017,36005029700,"Census Tract 297, Bronx County, New York",1780,133,1647,777,1448,68583,1956,2011,1597,26.3,499,496,53,42,163,1647,86
2018,36005029700,"Census Tract 297, Bronx County, New York",1761,98,1663,746,1404,67188,1956,2012,1619,26.9,504,467,43,49,162,1663,78
2019,36005029700,"Census Tract 297, Bronx County, New York",1741,103,1638,683,1327,72422,1955,2012,1732,27.9,502,435,0,46,161,1638,88
2020,36005029700,"Census Tract 297, Bronx County, New York",1830,37,1793,834,1392,52056,1958,2016,1831,46,466,490,125,33,174,1793,83
2012,36005030000,"Census Tract 300, Bronx County, New York",2651,121,2530,1651,3331,39297,1953,2004,1145,33.8,588,829,6,65,729,2530,355
2013,36005030000,"Census Tract 300, Bronx County, New York",2693,172,2521,1795,3847,39519,1957,2005,1255,36.7,683,830,40,128,805,2521,393
2014,36005030000,"Census Tract 300, Bronx County, New York",2759,156,2603,1772,3627,40408,1955,2007,1228,35.6,610,834,73,98,759,2603,298
2015,36005030000,"Census Tract 300, Bronx County, New York",2771,171,2600,1933,4075,43406,1953,2010,1250,34.5,610,747,126,77,1016,2600,295
2016,36005030000,"Census Tract 300, Bronx County, New York",2712,177,2535,1838,3765,54167,1957,2009,1380,32.4,558,796,136,87,846,2535,275
2017,36005030000,"Census Tract 300, Bronx County, New York",2688,83,2605,1992,4087,49737,1959,2010,1371,32.9,622,841,171,126,881,2605,326
2018,36005030000,"Census Tract 300, Bronx County, New York",2739,137,2602,1911,4371,56417,1954,2011,1422,28.6,513,647,152,59,1080,2602,254
2019,36005030000,"Census Tract 300, Bronx County, New York",2709,155,2554,1799,4009,58688,1956,2011,1457,30.9,540,564,119,77,1066,2554,370
2020,36005030000,"Census Tract 300, Bronx County, New York",2615,110,2505,1665,3992,67250,1956,2013,1529,24.7,463,474,85,79,1044,2505,290
2012,36005030100,"Census Tract 301, Bronx County, New York",621,14,607,360,547,36029,1968,2004,909,25.6,179,243,7,7,103,607,144
2013,36005030100,"Census Tract 301, Bronx County, New York",622,77,545,287,467,35341,1968,2004,930,28.1,135,179,10,8,90,545,108
2014,36005030100,"Census Tract 301, Bronx County, New York",596,66,530,266,390,26250,1980,2004,504,29.5,101,165,11,11,79,530,92
2015,36005030100,"Census Tract 301, Bronx County, New York",576,93,483,258,408,23854,1979,2006,NA,28.3,102,170,0,9,79,483,93
2016,36005030100,"Census Tract 301, Bronx County, New York",551,81,470,222,353,21538,1982,2008,554,29.9,79,108,0,12,102,470,81
2017,36005030100,"Census Tract 301, Bronx County, New York",560,70,490,218,345,19643,1982,2008,446,29.1,75,107,4,11,96,490,74
2018,36005030100,"Census Tract 301, Bronx County, New York",578,32,546,214,314,18167,1981,2010,400,30,65,97,5,9,103,546,83
2019,36005030100,"Census Tract 301, Bronx County, New York",620,51,569,248,422,15500,1982,2011,380,29.4,78,86,5,5,144,569,106
2020,36005030100,"Census Tract 301, Bronx County, New York",651,16,635,312,438,29643,1967,2013,1013,26.8,161,156,5,7,125,635,69
2012,36005030200,"Census Tract 302, Bronx County, New York",4366,248,4118,1899,3965,40299,1971,1993,892,26.5,409,240,1241,28,370,4118,444
2013,36005030200,"Census Tract 302, Bronx County, New York",4301,165,4136,2095,4066,48325,1970,1995,946,25.9,494,226,1477,13,356,4136,416
2014,36005030200,"Census Tract 302, Bronx County, New York",4275,120,4155,2192,4163,42895,1969,1996,973,26.5,506,217,1432,10,422,4155,429
2015,36005030200,"Census Tract 302, Bronx County, New York",4287,74,4213,2203,4107,41549,1969,1999,1001,27.3,484,206,1460,14,392,4213,419
2016,36005030200,"Census Tract 302, Bronx County, New York",4249,35,4214,2205,4387,42427,1971,2000,1050,28,479,173,1494,0,462,4214,381
2017,36005030200,"Census Tract 302, Bronx County, New York",4296,74,4222,2122,4383,49766,1969,2003,1178,27.8,439,113,1386,0,508,4222,249
2018,36005030200,"Census Tract 302, Bronx County, New York",4221,66,4155,2012,4382,43602,1968,2003,1194,29.5,446,57,1258,0,529,4155,292
2019,36005030200,"Census Tract 302, Bronx County, New York",4220,117,4103,2043,4219,47697,1969,2002,1178,28.8,506,51,1426,0,505,4103,305
2020,36005030201,"Census Tract 302.01, Bronx County, New York",1572,0,1572,735,1646,43313,1968,2000,1204,29.9,173,25,455,0,292,1572,135
2020,36005030202,"Census Tract 302.02, Bronx County, New York",2532,76,2456,1422,2899,65119,1969,2001,1198,29.8,386,13,1097,0,223,2456,150
2012,36005030701,"Census Tract 307.01, Bronx County, New York",2890,319,2571,1458,2807,65551,1959,2002,1582,25.9,1076,1220,102,37,95,2571,139
2013,36005030701,"Census Tract 307.01, Bronx County, New York",2875,297,2578,1339,2500,75625,1957,2003,1713,24.7,917,1083,110,25,107,2578,148
2014,36005030701,"Census Tract 307.01, Bronx County, New York",2907,318,2589,1424,2801,74529,1957,2004,1742,29.7,1027,1186,103,26,109,2589,172
2015,36005030701,"Census Tract 307.01, Bronx County, New York",2790,320,2470,1389,2903,74764,1959,2006,1758,30.1,951,1057,145,35,152,2470,177
2016,36005030701,"Census Tract 307.01, Bronx County, New York",2724,239,2485,1365,2949,84173,1959,2008,1807,23.9,936,1047,93,42,143,2485,126
2017,36005030701,"Census Tract 307.01, Bronx County, New York",2783,280,2503,1383,3276,93359,1958,2011,1878,22.5,974,1022,138,40,139,2503,164
2018,36005030701,"Census Tract 307.01, Bronx County, New York",2774,260,2514,1458,3612,99083,1958,2010,1915,21.7,1075,1074,170,41,136,2514,161
2019,36005030701,"Census Tract 307.01, Bronx County, New York",2741,199,2542,1470,3607,124226,1958,2011,1963,20.6,1151,1072,217,41,102,2542,114
2020,36005030701,"Census Tract 307.01, Bronx County, New York",2496,139,2357,1384,3959,156154,1959,2013,2453,18.6,1157,961,147,72,181,2357,93
2012,36005030900,"Census Tract 309, Bronx County, New York",1487,69,1418,570,1191,83986,1964,2002,1615,17.3,393,484,22,16,48,1418,87
2013,36005030900,"Census Tract 309, Bronx County, New York",1459,61,1398,559,1111,85329,1968,2006,1714,19.4,330,471,22,16,50,1398,84
2014,36005030900,"Census Tract 309, Bronx County, New York",1432,26,1406,642,1513,86202,1966,2007,1743,18.8,390,507,38,23,74,1406,88
2015,36005030900,"Census Tract 309, Bronx County, New York",1379,62,1317,623,1439,85617,1967,2011,1785,22.6,380,517,37,19,50,1317,57
2016,36005030900,"Census Tract 309, Bronx County, New York",1358,87,1271,541,1330,86157,1965,2011,1783,23.9,324,416,29,17,79,1271,27
2017,36005030900,"Census Tract 309, Bronx County, New York",1390,84,1306,564,1135,71667,1965,2011,1750,28.6,302,476,9,18,61,1306,43
2018,36005030900,"Census Tract 309, Bronx County, New York",1386,89,1297,574,1101,70956,1962,2010,1726,32,308,474,23,19,58,1297,47
2019,36005030900,"Census Tract 309, Bronx County, New York",1349,60,1289,591,1138,80313,1962,2011,1779,25.7,336,492,20,9,70,1289,48
2020,36005030900,"Census Tract 309, Bronx County, New York",1453,26,1427,746,1326,44914,1963,2011,1739,43.1,363,637,32,0,77,1427,48
2012,36005031000,"Census Tract 310, Bronx County, New York",1273,47,1226,209,615,44583,1962,1998,1415,39.1,67,148,24,0,37,1226,47
2013,36005031000,"Census Tract 310, Bronx County, New York",1260,71,1189,151,419,39511,1961,2000,1883,50,38,102,23,0,26,1189,37
2014,36005031000,"Census Tract 310, Bronx County, New York",1299,64,1235,168,496,39615,1965,2003,1897,50,43,87,38,0,41,1235,59
2015,36005031000,"Census Tract 310, Bronx County, New York",1251,76,1175,251,794,56607,1964,2006,1741,46.4,49,88,67,0,90,1175,106
2016,36005031000,"Census Tract 310, Bronx County, New York",1260,19,1241,245,859,51681,1964,2011,1631,42,40,55,81,0,102,1241,89
2017,36005031000,"Census Tract 310, Bronx County, New York",1256,21,1235,261,753,60602,1966,2010,1428,32.8,79,33,49,50,118,1235,115
2018,36005031000,"Census Tract 310, Bronx County, New York",1279,18,1261,268,694,61974,1965,2013,1468,26.6,129,32,86,45,99,1261,135
2019,36005031000,"Census Tract 310, Bronx County, New York",1233,16,1217,359,1005,55125,1969,2013,1565,38.8,155,34,87,72,166,1217,174
2020,36005031000,"Census Tract 310, Bronx County, New York",1308,0,1308,376,779,97778,1960,2016,2014,22.4,271,40,49,163,124,1308,108
2012,36005031200,"Census Tract 312, Bronx County, New York",613,12,601,155,324,55972,1952,2004,1681,36,24,65,32,5,53,601,67
2013,36005031200,"Census Tract 312, Bronx County, New York",637,13,624,170,372,57500,1950,2006,1656,33.6,43,58,36,19,57,624,50
2014,36005031200,"Census Tract 312, Bronx County, New York",634,16,618,117,305,57067,1954,2011,1538,36.3,40,31,39,23,24,618,32
2015,36005031200,"Census Tract 312, Bronx County, New York",620,15,605,137,395,57219,1951,2010,1549,27.1,72,31,27,40,39,605,32
2016,36005031200,"Census Tract 312, Bronx County, New York",584,0,584,173,369,59922,1954,2011,1479,28.1,93,75,38,44,16,584,18
2017,36005031200,"Census Tract 312, Bronx County, New York",583,0,583,181,395,63355,1950,2011,1470,27.2,100,76,42,45,18,583,24
2018,36005031200,"Census Tract 312, Bronx County, New York",605,0,605,193,381,72670,1954,2012,1565,25.3,67,89,34,35,44,605,13
2019,36005031200,"Census Tract 312, Bronx County, New York",597,0,597,235,465,74583,1952,2014,1922,27,81,91,37,40,76,597,13
2020,36005031200,"Census Tract 312, Bronx County, New York",573,13,560,234,376,61771,1954,2015,1900,29.2,52,99,34,32,87,560,13
2012,36005031400,"Census Tract 314, Bronx County, New York",710,57,653,120,180,60625,1942,2006,1177,27.6,51,71,18,0,31,653,28
2013,36005031400,"Census Tract 314, Bronx County, New York",707,43,664,129,211,60030,1951,2002,955,27.1,47,75,18,7,29,664,44
2014,36005031400,"Census Tract 314, Bronx County, New York",715,21,694,133,248,44432,1953,2003,1109,27.5,61,55,17,7,54,694,55
2015,36005031400,"Census Tract 314, Bronx County, New York",699,30,669,160,359,61324,1949,2007,1173,24.8,50,55,30,6,83,669,47
2016,36005031400,"Census Tract 314, Bronx County, New York",674,26,648,229,550,65568,1949,2010,1277,23.8,54,73,16,10,138,648,55
2017,36005031400,"Census Tract 314, Bronx County, New York",683,22,661,232,627,65278,1952,2010,1470,24.6,82,64,36,11,136,661,29
2018,36005031400,"Census Tract 314, Bronx County, New York",672,26,646,202,577,75938,1952,2011,1767,24.4,81,50,38,10,118,646,15
2019,36005031400,"Census Tract 314, Bronx County, New York",669,52,617,175,463,71146,1952,2011,1973,26.8,59,49,28,10,92,617,14
2020,36005031400,"Census Tract 314, Bronx County, New York",695,63,632,202,434,65116,1955,2015,1870,31.9,116,52,38,54,60,632,18
2012,36005031600,"Census Tract 316, Bronx County, New York",709,55,654,255,786,55341,1964,2005,1504,32.8,60,86,11,32,106,654,62
2013,36005031600,"Census Tract 316, Bronx County, New York",699,61,638,260,799,32417,1959,2006,1417,50,75,92,16,45,101,638,58
2014,36005031600,"Census Tract 316, Bronx County, New York",690,61,629,272,864,31951,1959,2007,1637,50,39,82,26,47,94,629,67
2015,36005031600,"Census Tract 316, Bronx County, New York",669,44,625,203,624,30665,1952,2010,1389,50,38,58,35,30,85,625,71
2016,36005031600,"Census Tract 316, Bronx County, New York",654,56,598,224,645,34583,1954,2011,1474,45.5,43,51,38,29,108,598,77
2017,36005031600,"Census Tract 316, Bronx County, New York",669,26,643,230,588,41250,1958,2012,1378,41.3,24,45,21,57,107,643,100
2018,36005031600,"Census Tract 316, Bronx County, New York",680,41,639,283,678,61719,1960,2013,1610,34.2,47,50,23,34,176,639,78
2019,36005031600,"Census Tract 316, Bronx County, New York",641,31,610,262,623,58875,1963,2014,1733,30.2,52,44,29,57,134,610,86
2020,36005031600,"Census Tract 316, Bronx County, New York",720,36,684,325,696,58822,1959,2014,1797,34.5,50,48,17,38,188,684,103
2012,36005031800,"Census Tract 318, Bronx County, New York",665,14,651,229,1052,48365,1952,2000,1872,42.4,23,125,9,13,87,651,51
2013,36005031800,"Census Tract 318, Bronx County, New York",678,40,638,260,1230,55000,1961,2003,1991,38.2,32,101,18,13,133,638,71
2014,36005031800,"Census Tract 318, Bronx County, New York",673,49,624,270,1069,60000,1950,2008,1763,29.3,42,122,27,14,114,624,76
2015,36005031800,"Census Tract 318, Bronx County, New York",645,62,583,266,1043,60804,1952,2008,1747,29.4,36,117,35,10,111,583,76
2016,36005031800,"Census Tract 318, Bronx County, New York",650,88,562,244,869,64423,1957,2011,1734,27.2,52,107,62,0,92,562,74
2017,36005031800,"Census Tract 318, Bronx County, New York",641,82,559,277,856,63688,1962,2011,1646,27.2,59,117,76,0,94,559,57
2018,36005031800,"Census Tract 318, Bronx County, New York",639,63,576,271,853,66146,1961,2011,1621,26.1,53,104,65,11,101,576,80
2019,36005031800,"Census Tract 318, Bronx County, New York",635,57,578,197,632,NA,1981,2009,1531,22.6,57,72,86,13,42,578,65
2020,36005031800,"Census Tract 318, Bronx County, New York",601,36,565,195,580,NA,1984,2011,1634,21.8,95,53,90,11,79,565,31
2012,36005031900,"Census Tract 319, Bronx County, New York",9,0,9,9,31,NA,NA,NA,NA,NA,0,9,0,0,0,9,0
2013,36005031900,"Census Tract 319, Bronx County, New York",0,0,0,0,0,NA,NA,NA,NA,NA,0,0,0,0,0,0,0
2014,36005031900,"Census Tract 319, Bronx County, New York",0,0,0,0,0,NA,NA,NA,NA,NA,0,0,0,0,0,0,0
2015,36005031900,"Census Tract 319, Bronx County, New York",0,0,0,0,0,NA,NA,NA,NA,NA,0,0,0,0,0,0,0
2016,36005031900,"Census Tract 319, Bronx County, New York",0,0,0,0,0,NA,NA,NA,NA,NA,0,0,0,0,0,0,0
2017,36005031900,"Census Tract 319, Bronx County, New York",0,0,0,0,0,NA,NA,NA,NA,NA,0,0,0,0,0,0,0
2018,36005031900,"Census Tract 319, Bronx County, New York",0,0,0,0,0,NA,NA,NA,NA,NA,0,0,0,0,0,0,0
2019,36005031900,"Census Tract 319, Bronx County, New York",0,0,0,0,0,NA,NA,NA,NA,NA,0,0,0,0,0,0,0
2020,36005031900,"Census Tract 319, Bronx County, New York",0,0,0,0,0,NA,NA,NA,NA,NA,0,0,0,0,0,0,0
2012,36005032300,"Census Tract 323, Bronx County, New York",2733,522,2211,795,1362,54132,1954,1992,1167,30.3,277,603,51,62,79,2211,122
2013,36005032300,"Census Tract 323, Bronx County, New York",2788,529,2259,789,1413,47270,1955,1996,1135,31.3,265,514,66,89,143,2259,181
2014,36005032300,"Census Tract 323, Bronx County, New York",2773,494,2279,883,1668,53903,1954,2000,1187,29.6,325,534,68,174,140,2279,129
2015,36005032300,"Census Tract 323, Bronx County, New York",2719,374,2345,898,1445,55375,1953,2000,1251,30.1,460,565,145,132,79,2345,118
2016,36005032300,"Census Tract 323, Bronx County, New York",2667,320,2347,932,1412,56579,1956,2001,1309,26,494,614,128,104,97,2347,173
2017,36005032300,"Census Tract 323, Bronx County, New York",2705,288,2417,987,1749,51977,1952,2008,1335,30.3,441,570,144,116,107,2417,138
2018,36005032300,"Census Tract 323, Bronx County, New York",2757,359,2398,1050,1797,52857,1954,2006,1357,31.6,484,540,154,135,94,2398,177
2019,36005032300,"Census Tract 323, Bronx County, New York",2732,230,2502,1055,1788,53693,1959,2006,1348,31.4,508,574,161,73,128,2502,190
2020,36005032300,"Census Tract 323, Bronx County, New York",2787,195,2592,848,1350,61618,1952,2008,1291,26.3,365,476,110,49,137,2592,181
2012,36005032400,"Census Tract 324, Bronx County, New York",1292,16,1276,1170,2509,28980,1955,2002,581,30.6,174,203,275,0,723,1276,261
2013,36005032400,"Census Tract 324, Bronx County, New York",1284,57,1227,1103,2365,25506,1951,2001,606,26.4,216,199,209,7,713,1227,248
2014,36005032400,"Census Tract 324, Bronx County, New York",1289,80,1209,1068,2294,25183,1948,2002,584,26.1,196,141,246,9,670,1209,263
2015,36005032400,"Census Tract 324, Bronx County, New York",1325,113,1212,1124,2655,25652,1952,2003,594,27.8,194,99,256,15,768,1212,403
2016,36005032400,"Census Tract 324, Bronx County, New York",1292,173,1119,1020,2424,22500,1952,2003,567,27.5,163,87,254,18,628,1119,394
2017,36005032400,"Census Tract 324, Bronx County, New York",1306,119,1187,1060,2666,17455,1951,2005,604,29.3,190,82,309,18,672,1187,561
2018,36005032400,"Census Tract 324, Bronx County, New York",1306,48,1258,1111,2797,14329,1952,2005,629,32.9,146,66,424,27,640,1258,673
2019,36005032400,"Census Tract 324, Bronx County, New York",1260,123,1137,987,2299,16853,1954,2008,811,34.3,176,99,455,57,418,1137,563
2020,36005032400,"Census Tract 324, Bronx County, New York",1254,65,1189,1015,2306,19063,1950,2006,872,43.8,184,131,430,90,473,1189,534
2012,36005032600,"Census Tract 326, Bronx County, New York",1166,90,1076,376,1315,62115,1959,2005,1475,28.1,124,139,65,28,155,1076,72
2013,36005032600,"Census Tract 326, Bronx County, New York",1121,81,1040,439,1352,70660,1956,2004,1384,27,156,195,58,51,147,1040,69
2014,36005032600,"Census Tract 326, Bronx County, New York",1110,73,1037,463,1485,54676,1949,2006,1406,27.4,128,200,60,69,144,1037,83
2015,36005032600,"Census Tract 326, Bronx County, New York",1075,69,1006,454,1490,53125,1948,2008,1407,36.2,76,150,70,68,178,1006,80
2016,36005032600,"Census Tract 326, Bronx County, New York",1047,45,1002,455,1298,54263,1946,2010,1411,36.5,69,172,37,76,183,1002,64
2017,36005032600,"Census Tract 326, Bronx County, New York",1068,57,1011,479,1487,55923,1947,2011,1557,35.1,45,215,13,105,146,1011,99
2018,36005032600,"Census Tract 326, Bronx County, New York",1124,61,1063,508,1610,65227,1949,2012,1698,33.1,45,180,27,87,227,1063,136
2019,36005032600,"Census Tract 326, Bronx County, New York",1098,61,1037,506,1365,67065,1951,2013,1670,32.1,90,189,33,83,219,1037,144
2020,36005032600,"Census Tract 326, Bronx County, New York",1064,27,1037,539,1535,92595,1956,2014,1825,33.3,85,192,56,87,218,1037,186
2012,36005032800,"Census Tract 328, Bronx County, New York",1494,45,1449,1310,3785,29189,1954,2003,920,29.8,220,331,237,76,669,1449,429
2013,36005032800,"Census Tract 328, Bronx County, New York",1460,107,1353,1198,3482,28036,1952,2003,890,30.3,174,303,302,77,541,1353,413
2014,36005032800,"Census Tract 328, Bronx County, New York",1468,93,1375,1213,3767,34155,1951,2003,969,31.5,175,273,341,70,573,1375,334
2015,36005032800,"Census Tract 328, Bronx County, New York",1475,116,1359,1171,3546,25469,1952,2004,888,38.8,153,224,352,9,639,1359,443
2016,36005032800,"Census Tract 328, Bronx County, New York",1488,96,1392,1152,3323,19660,1950,2005,834,38.3,167,224,360,9,606,1392,521
2017,36005032800,"Census Tract 328, Bronx County, New York",1459,101,1358,1122,3110,19583,1948,2005,775,38.4,182,190,390,16,560,1358,518
2018,36005032800,"Census Tract 328, Bronx County, New York",1482,53,1429,1175,3161,31648,1950,2007,881,34.9,200,228,313,20,647,1429,447
2019,36005032800,"Census Tract 328, Bronx County, New York",1481,59,1422,1233,3186,27354,1949,2010,1196,38,211,223,273,20,752,1422,464
2020,36005032800,"Census Tract 328, Bronx County, New York",1525,50,1475,1299,3377,40994,1949,2010,1229,30.8,249,255,299,16,762,1475,367
2012,36005033000,"Census Tract 330, Bronx County, New York",2093,114,1979,1807,5179,40202,1952,2003,1040,31.6,301,524,498,53,812,1979,607
2013,36005033000,"Census Tract 330, Bronx County, New York",2157,124,2033,1892,5436,39045,1956,2004,1028,30.7,297,509,476,71,909,2033,615
2014,36005033000,"Census Tract 330, Bronx County, New York",2181,197,1984,1865,5450,38688,1961,2005,1064,32.6,277,553,434,34,931,1984,565
2015,36005033000,"Census Tract 330, Bronx County, New York",2201,190,2011,1900,5399,NA,1958,2006,1074,33.6,270,470,395,26,1095,2011,525
2016,36005033000,"Census Tract 330, Bronx County, New York",2188,104,2084,1988,5510,37390,1956,2006,1050,33.6,265,602,290,31,1098,2084,470
2017,36005033000,"Census Tract 330, Bronx County, New York",2252,105,2147,2052,5613,35930,1956,2007,1091,34.1,238,664,362,22,1038,2147,582
2018,36005033000,"Census Tract 330, Bronx County, New York",2238,109,2129,2024,5525,36684,1948,2007,1206,36.5,173,660,396,0,967,2129,527
2019,36005033000,"Census Tract 330, Bronx County, New York",2237,33,2204,2014,5094,38538,1949,2009,1198,34.9,212,685,430,0,755,2204,538
2020,36005033000,"Census Tract 330, Bronx County, New York",2227,95,2132,1945,4787,39343,1951,2011,1274,34.9,187,551,560,23,642,2132,563
2012,36005033201,"Census Tract 332.01, Bronx County, New York",1946,132,1814,1434,2682,31006,1961,2004,1010,30.1,370,282,353,45,764,1814,303
2013,36005033201,"Census Tract 332.01, Bronx County, New York",1964,152,1812,1473,3252,41635,1961,2004,1066,28.4,374,295,346,43,795,1812,302
2014,36005033201,"Census Tract 332.01, Bronx County, New York",1977,164,1813,1536,3286,41413,1954,2006,1139,28.4,491,309,304,62,860,1813,322
2015,36005033201,"Census Tract 332.01, Bronx County, New York",1947,168,1779,1532,3618,34777,1952,2006,1177,30.2,418,337,293,62,910,1779,377
2016,36005033201,"Census Tract 332.01, Bronx County, New York",1949,138,1811,1550,3773,42582,1952,2006,1264,30.4,446,333,307,41,932,1811,364
2017,36005033201,"Census Tract 332.01, Bronx County, New York",2108,106,2002,1658,3836,40391,1954,2006,1287,30.3,571,390,350,17,985,2002,333
2018,36005033201,"Census Tract 332.01, Bronx County, New York",2362,131,2231,1794,4377,36860,1951,2008,1343,33.3,505,421,303,23,1102,2231,514
2019,36005033201,"Census Tract 332.01, Bronx County, New York",2376,131,2245,1756,4540,41786,1948,2009,1357,33.1,375,375,307,5,1138,2245,470
2020,36005033201,"Census Tract 332.01, Bronx County, New York",2690,139,2551,2103,4433,26250,0,2011,1383,44.1,558,638,271,13,1263,2551,777
2012,36005033202,"Census Tract 332.02, Bronx County, New York",1629,215,1414,1194,2804,26214,1960,2002,1082,35.2,290,235,392,32,550,1414,426
2013,36005033202,"Census Tract 332.02, Bronx County, New York",1667,221,1446,1217,2779,26979,1957,2003,1156,35,244,223,383,4,559,1446,402
2014,36005033202,"Census Tract 332.02, Bronx County, New York",1678,230,1448,1227,2949,28620,1959,2004,1112,31.3,245,143,439,26,623,1448,423
2015,36005033202,"Census Tract 332.02, Bronx County, New York",1681,123,1558,1336,3163,30833,1960,2005,1133,32.6,296,147,481,32,693,1558,474
2016,36005033202,"Census Tract 332.02, Bronx County, New York",1696,110,1586,1312,3127,31875,1959,2007,1166,32.3,247,130,455,26,734,1586,453
2017,36005033202,"Census Tract 332.02, Bronx County, New York",1723,93,1630,1293,3037,40234,1960,2008,1203,30.4,198,210,440,16,693,1630,449
2018,36005033202,"Census Tract 332.02, Bronx County, New York",1697,63,1634,1243,2688,42996,1964,2011,1303,33.8,204,232,396,9,649,1634,423
2019,36005033202,"Census Tract 332.02, Bronx County, New York",1688,55,1633,1270,2552,33555,1962,2011,1288,36.8,194,202,357,0,737,1633,474
2020,36005033202,"Census Tract 332.02, Bronx County, New York",1663,18,1645,1238,2343,35878,1962,2011,1300,38.1,136,161,268,18,837,1645,460
2012,36005033400,"Census Tract 334, Bronx County, New York",497,48,449,333,796,38315,1954,2005,1166,42.1,60,37,107,0,196,449,104
2013,36005033400,"Census Tract 334, Bronx County, New York",572,44,528,426,1031,39457,1954,2006,1212,34.6,118,35,165,0,268,528,127
2014,36005033400,"Census Tract 334, Bronx County, New York",649,53,596,487,1089,37863,1951,2006,1217,34.8,140,79,177,5,262,596,162
2015,36005033400,"Census Tract 334, Bronx County, New York",654,49,605,490,1155,37000,1947,2006,1214,32.8,149,79,168,4,275,605,147
2016,36005033400,"Census Tract 334, Bronx County, New York",645,19,626,512,1206,32361,1948,2006,1230,31.9,147,65,176,5,297,626,138
2017,36005033400,"Census Tract 334, Bronx County, New York",279,19,260,176,371,46346,1939,2010,1422,31.5,55,37,49,0,114,260,59
2018,36005033400,"Census Tract 334, Bronx County, New York",19,0,19,0,0,NA,NA,NA,NA,NA,0,0,0,0,0,19,0
2019,36005033400,"Census Tract 334, Bronx County, New York",5,0,5,0,0,NA,NA,NA,NA,NA,0,0,0,0,0,5,0
2020,36005033400,"Census Tract 334, Bronx County, New York",4,0,4,0,0,NA,NA,NA,NA,NA,0,0,0,0,0,4,0
2012,36005033500,"Census Tract 335, Bronx County, New York",766,14,752,311,517,66435,1939,1999,1150,21.4,165,204,15,19,62,752,86
2013,36005033500,"Census Tract 335, Bronx County, New York",765,13,752,338,580,67143,1939,2001,1289,19.7,186,240,16,16,57,752,63
2014,36005033500,"Census Tract 335, Bronx County, New York",805,38,767,330,542,66765,1939,2000,1288,22.2,188,240,18,18,47,767,64
2015,36005033500,"Census Tract 335, Bronx County, New York",791,53,738,346,639,70000,1939,2003,1355,24.1,155,194,7,20,95,738,45
2016,36005033500,"Census Tract 335, Bronx County, New York",770,97,673,312,636,75625,1939,2006,1438,24.8,155,179,12,18,80,673,40
2017,36005033500,"Census Tract 335, Bronx County, New York",782,83,699,284,564,54655,1939,2004,1473,29.8,142,162,15,6,85,699,33
2018,36005033500,"Census Tract 335, Bronx County, New York",768,92,676,260,544,72955,0,2006,1544,26.9,166,171,19,0,53,676,42
2019,36005033500,"Census Tract 335, Bronx County, New York",774,102,672,275,605,57454,0,2011,1611,29.4,161,161,19,8,72,672,44
2020,36005033500,"Census Tract 335, Bronx County, New York",782,79,703,291,642,85469,0,2012,1809,26.6,213,174,12,5,100,703,45
2012,36005033600,"Census Tract 336, Bronx County, New York",2702,96,2606,2411,5509,26033,1955,2003,863,34.5,340,80,1026,48,1272,2606,930
2013,36005033600,"Census Tract 336, Bronx County, New York",2689,62,2627,2423,5820,29020,1956,2002,892,30.3,422,57,1134,25,1194,2627,923
2014,36005033600,"Census Tract 336, Bronx County, New York",2674,45,2629,2380,5625,29167,1956,2003,898,28.5,492,71,1186,28,1153,2629,891
2015,36005033600,"Census Tract 336, Bronx County, New York",2667,47,2620,2326,5411,NA,1954,2004,901,30.4,465,110,1326,70,871,2620,1026
2016,36005033600,"Census Tract 336, Bronx County, New York",2672,55,2617,2280,5653,25000,1954,2004,911,31.6,480,66,1210,47,1001,2617,891
2017,36005033600,"Census Tract 336, Bronx County, New York",2695,44,2651,2218,5293,24250,1953,2004,965,32.2,443,101,1257,48,837,2651,853
2018,36005033600,"Census Tract 336, Bronx County, New York",2683,45,2638,2187,5130,25865,1951,2006,1073,32.6,447,143,1175,46,861,2638,870
2019,36005033600,"Census Tract 336, Bronx County, New York",2685,51,2634,2175,5174,31980,1950,2007,1133,33.4,385,127,1156,81,878,2634,792
2020,36005033601,"Census Tract 336.01, Bronx County, New York",2234,111,2123,2040,4273,40625,1943,2004,1181,33,363,138,910,54,1055,2123,561
2020,36005033602,"Census Tract 336.02, Bronx County, New York",676,0,676,393,1220,NA,1976,2013,1236,41.6,97,18,290,0,85,676,182
2012,36005033700,"Census Tract 337, Bronx County, New York",1071,112,959,444,1263,106042,1952,2004,1721,19.5,266,339,0,68,34,959,11
2013,36005033700,"Census Tract 337, Bronx County, New York",1072,116,956,446,1125,80469,1943,2006,1668,26.6,255,274,7,66,53,956,33
2014,36005033700,"Census Tract 337, Bronx County, New York",1087,153,934,464,1127,76444,1951,2009,1736,28.1,252,283,40,40,59,934,45
2015,36005033700,"Census Tract 337, Bronx County, New York",1037,157,880,389,942,75642,1951,2011,1656,27.4,234,221,39,30,51,880,47
2016,36005033700,"Census Tract 337, Bronx County, New York",1012,126,886,395,936,76536,1946,2011,1708,27.2,240,210,41,38,56,886,49
2017,36005033700,"Census Tract 337, Bronx County, New York",1031,89,942,406,980,56875,1939,2011,1675,30.6,253,202,64,30,55,942,51
2018,36005033700,"Census Tract 337, Bronx County, New York",974,107,867,348,892,74167,1943,2011,1683,28.8,226,198,67,34,38,867,29
2019,36005033700,"Census Tract 337, Bronx County, New York",954,71,883,326,882,75104,0,2011,1720,32.5,217,193,43,29,36,883,20
2020,36005033700,"Census Tract 337, Bronx County, New York",985,51,934,277,777,76563,0,2012,1788,35.3,178,165,38,27,33,934,33
2012,36005033800,"Census Tract 338, Bronx County, New York",1393,49,1344,1169,3043,36069,1945,2005,1187,37,159,50,631,18,460,1344,332
2013,36005033800,"Census Tract 338, Bronx County, New York",1356,67,1289,1097,2953,37712,1948,2005,1186,32.6,134,55,579,19,434,1289,299
2014,36005033800,"Census Tract 338, Bronx County, New York",1375,101,1274,1071,3046,30430,1952,2006,1176,44.1,128,55,446,41,509,1274,400
2015,36005033800,"Census Tract 338, Bronx County, New York",1427,72,1355,1153,3453,31794,1947,2006,1173,43,178,55,515,52,498,1355,435
2016,36005033800,"Census Tract 338, Bronx County, New York",1467,100,1367,1143,3568,32385,1946,2008,1205,45.2,179,55,446,59,561,1367,375
2017,36005033800,"Census Tract 338, Bronx County, New York",1455,93,1362,1132,3525,33804,1939,2009,1309,50,206,58,344,62,655,1362,324
2018,36005033800,"Census Tract 338, Bronx County, New York",1490,65,1425,1204,3419,34239,0,2011,1389,51,230,35,403,63,666,1425,303
2019,36005033800,"Census Tract 338, Bronx County, New York",1475,99,1376,1142,3163,47500,0,2012,1453,40.2,289,42,497,66,536,1376,143
2020,36005033801,"Census Tract 338.01, Bronx County, New York",827,36,791,576,1491,61346,0,2015,1436,29.7,153,28,244,0,268,791,52
2020,36005033802,"Census Tract 338.02, Bronx County, New York",581,30,551,532,1603,50588,0,2012,1477,33.1,100,20,185,20,283,551,102
2012,36005034000,"Census Tract 340, Bronx County, New York",1787,190,1597,1355,3425,39669,1939,2004,1115,34.4,184,130,547,31,662,1597,364
2013,36005034000,"Census Tract 340, Bronx County, New York",1762,177,1585,1329,3249,36601,1939,2005,1138,39.8,142,99,613,26,652,1585,431
2014,36005034000,"Census Tract 340, Bronx County, New York",1796,167,1629,1322,3480,35000,1939,2006,1127,40.6,115,78,607,38,621,1629,463
2015,36005034000,"Census Tract 340, Bronx County, New York",1827,118,1709,1392,3601,28177,1939,2007,1153,45.3,138,91,574,20,748,1709,516
2016,36005034000,"Census Tract 340, Bronx County, New York",1887,83,1804,1469,3905,30708,1941,2009,1191,41.5,187,80,562,8,813,1804,497
2017,36005034000,"Census Tract 340, Bronx County, New York",1871,65,1806,1393,3830,34870,1941,2010,1200,41.4,203,96,529,7,693,1806,363
2018,36005034000,"Census Tract 340, Bronx County, New York",1887,69,1818,1501,4514,38931,0,2011,1308,36.7,206,63,575,0,806,1818,355
2019,36005034000,"Census Tract 340, Bronx County, New York",1833,55,1778,1415,4507,47560,0,2012,1381,35.6,188,81,472,0,819,1778,300
2020,36005034000,"Census Tract 340, Bronx County, New York",1900,79,1821,1464,4652,53716,1940,2012,1390,31.6,193,60,485,0,869,1821,212
2012,36005034200,"Census Tract 342, Bronx County, New York",651,21,630,334,1030,24583,1963,2004,1264,50,125,76,209,39,14,630,153
2013,36005034200,"Census Tract 342, Bronx County, New York",656,27,629,370,1285,31167,1960,2003,1302,50,107,100,207,23,42,629,115
2014,36005034200,"Census Tract 342, Bronx County, New York",629,40,589,369,1031,30234,1960,2005,1178,45.6,87,49,249,37,40,589,127
2015,36005034200,"Census Tract 342, Bronx County, New York",617,40,577,308,989,28871,1957,2008,1170,50,39,42,197,32,42,577,126
2016,36005034200,"Census Tract 342, Bronx County, New York",604,38,566,302,909,32237,1954,2008,1250,49.7,42,31,176,47,54,566,123
2017,36005034200,"Census Tract 342, Bronx County, New York",595,37,558,285,866,43375,1952,2009,1418,46.9,40,29,171,28,57,558,132
2018,36005034200,"Census Tract 342, Bronx County, New York",583,20,563,226,623,41538,1954,2010,1591,48.6,41,24,132,23,47,563,110
2019,36005034200,"Census Tract 342, Bronx County, New York",598,17,581,232,665,40238,1952,2010,1601,51,35,34,128,9,70,581,106
2020,36005034200,"Census Tract 342, Bronx County, New York",660,59,601,288,641,60290,0,2016,1900,44.7,36,35,183,4,75,601,81
2012,36005034300,"Census Tract 343, Bronx County, New York",646,65,581,313,601,52660,1952,2004,1140,33.2,122,106,44,9,160,581,73
2013,36005034300,"Census Tract 343, Bronx County, New York",641,80,561,330,586,53221,1957,2005,1250,28.6,132,100,41,0,194,561,96
2014,36005034300,"Census Tract 343, Bronx County, New York",659,100,559,331,657,52835,1955,2007,1219,29.3,110,56,40,0,238,559,92
2015,36005034300,"Census Tract 343, Bronx County, New York",636,110,526,292,647,55455,1955,2007,1234,27.5,106,54,72,0,177,526,66
2016,36005034300,"Census Tract 343, Bronx County, New York",624,86,538,349,787,63750,1957,2010,1523,28.5,166,96,79,0,176,538,61
2017,36005034300,"Census Tract 343, Bronx County, New York",624,61,563,422,937,66944,1959,2010,1532,27.4,165,111,95,0,215,563,82
2018,36005034300,"Census Tract 343, Bronx County, New York",617,53,564,397,938,59509,1959,2012,1559,28.3,146,85,102,0,210,564,56
2019,36005034300,"Census Tract 343, Bronx County, New York",602,16,586,392,903,77566,1959,2013,1626,28.2,194,126,109,9,154,586,40
2020,36005034300,"Census Tract 343, Bronx County, New York",583,13,570,366,849,75859,1953,2015,1515,27.8,177,77,60,8,215,570,8
2012,36005034400,"Census Tract 344, Bronx County, New York",586,53,533,203,754,37908,1964,2005,1159,36.7,24,6,112,29,56,533,72
2013,36005034400,"Census Tract 344, Bronx County, New York",566,43,523,176,771,38750,1961,2005,1492,39.7,28,13,85,21,50,523,52
2014,36005034400,"Census Tract 344, Bronx County, New York",593,42,551,225,951,39115,1962,2005,1563,45.8,38,26,79,34,80,551,88
2015,36005034400,"Census Tract 344, Bronx County, New York",610,40,570,251,991,51641,1957,2010,1646,46.1,47,20,127,12,85,570,87
2016,36005034400,"Census Tract 344, Bronx County, New York",624,44,580,270,1058,50735,1952,2010,1719,43.8,42,16,113,13,121,580,112
2017,36005034400,"Census Tract 344, Bronx County, New York",625,22,603,244,759,42308,1955,2011,1613,45,59,17,103,13,103,603,107
2018,36005034400,"Census Tract 344, Bronx County, New York",659,24,635,287,890,40583,1955,2010,1634,40.3,81,10,111,15,151,635,135
2019,36005034400,"Census Tract 344, Bronx County, New York",670,14,656,233,712,50438,1954,2012,1689,39.8,82,6,97,0,130,656,97
2020,36005034400,"Census Tract 344, Bronx County, New York",640,14,626,239,904,28735,1957,2016,2055,51,30,6,134,0,104,626,136
2012,36005034500,"Census Tract 345, Bronx County, New York",1599,142,1457,886,1673,58889,1964,2000,1260,26.6,374,458,163,122,207,1457,134
2013,36005034500,"Census Tract 345, Bronx County, New York",1642,182,1460,901,1737,43438,1965,2003,1311,32.3,387,528,103,112,204,1460,191
2014,36005034500,"Census Tract 345, Bronx County, New York",1601,193,1408,800,1633,42794,1964,2005,1329,33.5,312,391,97,104,238,1408,170
2015,36005034500,"Census Tract 345, Bronx County, New York",1573,198,1375,769,1789,43083,1963,2009,1488,33.7,335,381,77,99,269,1375,212
2016,36005034500,"Census Tract 345, Bronx County, New York",1542,163,1379,741,1588,42411,1963,2010,1466,34.9,365,368,55,47,279,1379,223
2017,36005034500,"Census Tract 345, Bronx County, New York",1595,233,1362,697,1615,46688,1962,2011,1586,35.4,350,413,48,30,217,1362,229
2018,36005034500,"Census Tract 345, Bronx County, New York",1565,199,1366,732,1722,70000,1961,2011,1494,24.7,397,396,66,37,266,1366,220
2019,36005034500,"Census Tract 345, Bronx County, New York",1625,190,1435,835,1896,53368,1962,2011,1519,27.2,418,470,58,23,294,1435,212
2020,36005034500,"Census Tract 345, Bronx County, New York",1483,196,1287,687,1401,53375,1962,2011,1482,28.1,373,344,65,19,261,1287,153
2012,36005034800,"Census Tract 348, Bronx County, New York",2185,129,2056,1270,3805,26563,1948,2001,603,26.3,132,33,793,0,485,2056,575
2013,36005034800,"Census Tract 348, Bronx County, New York",2165,150,2015,1342,4366,27228,1950,2002,607,26.3,113,23,821,0,566,2015,625
2014,36005034800,"Census Tract 348, Bronx County, New York",2161,103,2058,1309,4531,27212,1947,2001,611,25,73,28,767,0,599,2058,575
2015,36005034800,"Census Tract 348, Bronx County, New York",2153,61,2092,1422,4655,28571,1946,2002,620,25.3,100,25,784,22,693,2092,537
2016,36005034800,"Census Tract 348, Bronx County, New York",2178,88,2090,1471,4771,27289,1948,2005,643,27.6,155,32,735,14,807,2090,562
2017,36005034800,"Census Tract 348, Bronx County, New York",2196,133,2063,1267,4118,27884,1948,2004,643,28.2,129,34,566,15,751,2063,517
2018,36005034800,"Census Tract 348, Bronx County, New York",2206,140,2066,1245,3709,28586,1947,2003,861,27.9,88,26,497,18,737,2066,403
2019,36005034800,"Census Tract 348, Bronx County, New York",2201,142,2059,1326,3604,37892,1952,2002,798,27.4,114,0,681,17,686,2059,446
2020,36005034800,"Census Tract 348, Bronx County, New York",2268,190,2078,1314,3514,24676,1954,2003,562,27.7,134,0,504,0,830,2078,518
2012,36005035000,"Census Tract 350, Bronx County, New York",716,28,688,309,794,64625,1954,2004,1302,24.5,111,12,208,33,80,688,122
2013,36005035000,"Census Tract 350, Bronx County, New York",694,56,638,329,852,65288,1951,2005,1303,27.6,98,0,254,13,90,638,127
2014,36005035000,"Census Tract 350, Bronx County, New York",705,81,624,312,794,63167,1949,2005,1568,28.2,87,0,234,17,91,624,106
2015,36005035000,"Census Tract 350, Bronx County, New York",698,85,613,295,824,37083,1948,2006,1577,40.5,93,0,201,1,107,613,76
2016,36005035000,"Census Tract 350, Bronx County, New York",699,84,615,312,962,42188,1956,2010,1543,44.5,96,0,233,2,71,615,63
2017,36005035000,"Census Tract 350, Bronx County, New York",706,78,628,287,885,39776,1954,2011,1478,45,67,0,176,6,97,628,38
2018,36005035000,"Census Tract 350, Bronx County, New York",718,64,654,309,929,39229,1955,2011,1419,43.3,71,0,171,11,109,654,31
2019,36005035000,"Census Tract 350, Bronx County, New York",702,40,662,257,802,39583,1957,2012,1426,43.1,53,0,156,15,80,662,41
2020,36005035000,"Census Tract 350, Bronx County, New York",724,9,715,370,1040,48594,1958,2013,1841,43.7,111,0,276,23,66,715,45
2012,36005035100,"Census Tract 351, Bronx County, New York",1160,209,951,592,1075,49722,1959,2004,1197,24,272,289,108,11,192,951,147
2013,36005035100,"Census Tract 351, Bronx County, New York",1152,178,974,589,1201,51675,1959,2006,1245,24.4,290,269,129,12,186,974,137
2014,36005035100,"Census Tract 351, Bronx County, New York",1165,192,973,586,1273,43750,1952,2007,1416,37.4,275,298,62,0,232,973,175
2015,36005035100,"Census Tract 351, Bronx County, New York",1161,118,1043,618,1284,50735,1956,2010,1481,33.3,327,260,77,7,293,1043,153
2016,36005035100,"Census Tract 351, Bronx County, New York",1141,36,1105,641,1337,54583,1954,2011,1481,31.6,392,266,57,8,322,1105,149
2017,36005035100,"Census Tract 351, Bronx County, New York",1136,34,1102,559,1131,72781,1953,2011,1453,29.6,307,260,46,18,248,1102,161
2018,36005035100,"Census Tract 351, Bronx County, New York",1203,34,1169,588,1180,85046,1955,2013,1530,27.6,326,251,47,34,270,1169,144
2019,36005035100,"Census Tract 351, Bronx County, New York",1218,6,1212,597,1165,90163,1962,2015,1675,24.3,368,206,57,31,317,1212,90
2020,36005035100,"Census Tract 351, Bronx County, New York",1267,0,1267,763,1443,75096,1963,2016,1401,24.4,325,237,72,96,365,1267,170
2012,36005035600,"Census Tract 356, Bronx County, New York",710,44,666,172,544,45000,1960,2005,1455,32.4,68,5,121,0,46,666,58
2013,36005035600,"Census Tract 356, Bronx County, New York",736,59,677,195,643,35774,1965,2006,1637,50,58,4,113,0,67,677,44
2014,36005035600,"Census Tract 356, Bronx County, New York",690,23,667,222,672,32000,1958,2006,1623,50,68,5,117,0,72,667,41
2015,36005035600,"Census Tract 356, Bronx County, New York",683,36,647,203,577,29236,1963,2006,1483,50,62,5,111,0,57,647,31
2016,36005035600,"Census Tract 356, Bronx County, New York",685,18,667,234,637,NA,1960,2008,1659,34.3,88,0,122,0,79,667,45
2017,36005035600,"Census Tract 356, Bronx County, New York",702,19,683,223,521,NA,1962,2010,1498,34.3,89,0,124,0,66,683,60
2018,36005035600,"Census Tract 356, Bronx County, New York",731,20,711,221,499,59792,1944,2011,1470,31.4,88,0,148,0,54,711,48
2019,36005035600,"Census Tract 356, Bronx County, New York",724,22,702,217,549,61484,1960,2012,1581,27,76,0,192,0,25,702,53
2020,36005035600,"Census Tract 356, Bronx County, New York",712,7,705,248,645,75086,0,2013,1714,24.9,82,0,168,0,80,705,69
2012,36005035800,"Census Tract 358, Bronx County, New York",2430,44,2386,1009,2952,50080,1957,2003,1246,35.7,158,31,862,0,100,2386,190
2013,36005035800,"Census Tract 358, Bronx County, New York",2483,44,2439,1155,3273,50383,1957,2005,1294,37.7,200,15,952,0,179,2439,193
2014,36005035800,"Census Tract 358, Bronx County, New York",2485,46,2439,1051,3029,53576,1957,2005,1387,36.5,210,16,829,0,196,2439,194
2015,36005035800,"Census Tract 358, Bronx County, New York",2513,84,2429,1034,2834,52600,1964,2006,1339,35.5,260,0,752,0,274,2429,149
2016,36005035800,"Census Tract 358, Bronx County, New York",2506,150,2356,1035,2628,54160,1964,2006,1236,30.2,358,14,792,0,220,2356,166
2017,36005035800,"Census Tract 358, Bronx County, New York",2546,114,2432,936,2825,49535,1964,2010,1404,35.7,210,18,684,0,244,2432,128
2018,36005035800,"Census Tract 358, Bronx County, New York",2551,108,2443,834,2613,47500,1965,2010,1431,33.1,123,25,579,0,248,2443,212
2019,36005035800,"Census Tract 358, Bronx County, New York",2567,83,2484,934,2945,39089,1965,2012,1462,41.8,208,20,629,0,296,2484,283
2020,36005035800,"Census Tract 358, Bronx County, New York",2883,67,2816,955,2957,NA,1970,2015,1416,44.9,179,27,587,0,277,2816,286
2012,36005035900,"Census Tract 359, Bronx County, New York",694,33,661,647,1794,25778,1948,2003,969,39.2,25,12,164,0,504,661,230
2013,36005035900,"Census Tract 359, Bronx County, New York",706,44,662,632,1799,19625,1946,2004,999,47.8,54,20,177,0,457,662,291
2014,36005035900,"Census Tract 359, Bronx County, New York",726,59,667,631,1780,18813,1983,2005,987,50,50,10,195,0,453,667,301
2015,36005035900,"Census Tract 359, Bronx County, New York",743,49,694,656,1832,19479,1989,2005,970,47,50,0,191,8,478,694,285
2016,36005035900,"Census Tract 359, Bronx County, New York",729,37,692,643,1858,22446,1990,2007,977,49.2,42,0,200,6,466,692,284
2017,36005035900,"Census Tract 359, Bronx County, New York",740,27,713,657,1957,20580,1996,2008,1016,50,35,0,193,14,478,713,289
2018,36005035900,"Census Tract 359, Bronx County, New York",736,26,710,682,1839,24375,1995,2007,998,47.1,41,0,198,12,503,710,262
2019,36005035900,"Census Tract 359, Bronx County, New York",758,12,746,707,1878,22303,1996,2009,1068,45.4,27,5,234,13,495,746,270
2020,36005035900,"Census Tract 359, Bronx County, New York",781,0,781,743,1918,25994,1997,2010,1085,45.6,41,9,254,7,518,781,287
2012,36005036000,"Census Tract 360, Bronx County, New York",1021,82,939,458,1289,45238,1947,2003,1055,27,166,120,219,0,119,939,168
2013,36005036000,"Census Tract 360, Bronx County, New York",996,98,898,374,1146,48684,1951,2004,1305,26.9,143,80,183,0,123,898,85
2014,36005036000,"Census Tract 360, Bronx County, New York",998,70,928,379,993,48693,1951,2004,1304,29.9,112,59,202,0,131,928,79
2015,36005036000,"Census Tract 360, Bronx County, New York",993,72,921,375,979,43688,1954,2006,1503,37.9,89,42,214,0,135,921,104
2016,36005036000,"Census Tract 360, Bronx County, New York",968,35,933,328,908,43125,1953,2006,1350,33.1,62,26,195,0,125,933,74
2017,36005036000,"Census Tract 360, Bronx County, New York",961,53,908,282,689,43125,1952,2007,1246,33.7,30,13,177,0,112,908,83
2018,36005036000,"Census Tract 360, Bronx County, New York",971,45,926,285,793,46583,1950,2011,1352,28.1,34,8,175,0,102,926,88
2019,36005036000,"Census Tract 360, Bronx County, New York",982,38,944,247,770,72417,1953,2012,1495,21.8,32,8,173,0,66,944,93
2020,36005036000,"Census Tract 360, Bronx County, New York",981,38,943,199,685,78021,1948,2014,1486,27.2,38,7,173,0,19,943,71
2012,36005036100,"Census Tract 361, Bronx County, New York",2198,153,2045,2038,5323,14092,1965,2002,448,34.6,110,38,572,0,1560,2045,1075
2013,36005036100,"Census Tract 361, Bronx County, New York",2204,137,2067,2059,5944,15999,1965,2002,516,33,138,0,615,0,1574,2067,1005
2014,36005036100,"Census Tract 361, Bronx County, New York",2213,66,2147,2136,6419,17302,1969,2003,515,31.8,177,0,644,0,1656,2147,1017
2015,36005036100,"Census Tract 361, Bronx County, New York",2228,76,2152,2124,6042,NA,1972,2003,491,31.7,144,11,656,0,1596,2152,1004
2016,36005036100,"Census Tract 361, Bronx County, New York",2217,60,2157,2128,5966,20827,1973,2003,561,31.6,191,12,726,0,1524,2157,972
2017,36005036100,"Census Tract 361, Bronx County, New York",2212,104,2108,2072,5725,23824,1973,2002,541,29.8,174,12,771,0,1385,2108,778
2018,36005036100,"Census Tract 361, Bronx County, New York",2232,78,2154,2110,5467,23173,1972,2005,677,30.1,108,14,752,0,1458,2154,884
2019,36005036100,"Census Tract 361, Bronx County, New York",2256,96,2160,2128,5504,21593,1971,2007,680,30.8,96,16,796,0,1550,2160,1015
2020,36005036100,"Census Tract 361, Bronx County, New York",2167,96,2071,2046,5739,19728,1970,2011,678,30.6,88,0,913,0,1447,2071,1155
2012,36005036300,"Census Tract 363, Bronx County, New York",2627,90,2537,2406,7209,18312,1971,2003,946,37.5,152,38,459,0,1996,2537,1129
2013,36005036300,"Census Tract 363, Bronx County, New York",2601,115,2486,2334,7182,19629,1960,2004,965,38.2,120,17,428,0,1942,2486,1139
2014,36005036300,"Census Tract 363, Bronx County, New York",2631,89,2542,2439,7470,18967,1967,2005,1001,38.3,128,18,432,0,2023,2542,1246
2015,36005036300,"Census Tract 363, Bronx County, New York",2642,109,2533,2417,7555,18200,1970,2006,903,39,95,17,440,0,1961,2533,1314
2016,36005036300,"Census Tract 363, Bronx County, New York",2661,152,2509,2375,7366,17769,1965,2006,937,42,122,15,466,0,1895,2509,1289
2017,36005036300,"Census Tract 363, Bronx County, New York",2663,109,2554,2369,7417,19124,1953,2007,1050,43.5,178,18,457,0,1895,2554,1204
2018,36005036300,"Census Tract 363, Bronx County, New York",2613,75,2538,2343,6893,18792,1956,2007,945,44.4,176,33,581,0,1788,2538,1220
2019,36005036300,"Census Tract 363, Bronx County, New York",2681,147,2534,2356,6795,21143,1954,2010,1062,41.6,240,59,743,0,1833,2534,1166
2020,36005036300,"Census Tract 363, Bronx County, New York",2490,121,2369,2207,6233,22134,1960,2010,1148,43.9,296,75,768,0,1677,2369,1031
2012,36005036400,"Census Tract 364, Bronx County, New York",935,40,895,513,1144,36375,1941,2003,1242,46.2,83,0,460,0,53,895,164
2013,36005036400,"Census Tract 364, Bronx County, New York",904,71,833,433,897,32240,1939,2003,1221,50,80,0,403,0,30,833,142
2014,36005036400,"Census Tract 364, Bronx County, New York",916,93,823,394,1039,33654,1944,2005,1291,50,81,0,350,0,44,823,129
2015,36005036400,"Census Tract 364, Bronx County, New York",919,97,822,377,971,35474,1949,2009,1235,46.3,80,0,346,0,31,822,84
2016,36005036400,"Census Tract 364, Bronx County, New York",922,107,815,355,972,36477,1949,2010,1245,46.3,46,0,298,0,57,815,62
2017,36005036400,"Census Tract 364, Bronx County, New York",932,144,788,332,951,38871,1954,2010,1228,45,40,0,270,0,62,788,44
2018,36005036400,"Census Tract 364, Bronx County, New York",945,113,832,324,1017,42330,1954,2011,1352,44.1,38,0,262,0,62,832,43
2019,36005036400,"Census Tract 364, Bronx County, New York",938,94,844,311,892,42208,1945,2012,1428,42.9,27,0,257,0,54,844,93
2020,36005036400,"Census Tract 364, Bronx County, New York",945,77,868,375,1015,31053,0,2013,1423,51,43,0,323,0,52,868,110
2012,36005036501,"Census Tract 365.01, Bronx County, New York",1425,76,1349,1266,3377,21161,1972,2003,1019,48,171,0,705,18,581,1349,567
2013,36005036501,"Census Tract 365.01, Bronx County, New York",1366,60,1306,1251,3588,20553,1971,2005,893,40.4,196,0,672,0,620,1306,597
2014,36005036501,"Census Tract 365.01, Bronx County, New York",1372,70,1302,1266,3598,19293,1972,2005,941,46.2,134,0,638,0,661,1302,674
2015,36005036501,"Census Tract 365.01, Bronx County, New York",1355,43,1312,1244,3637,NA,1972,2006,954,38.5,185,0,658,0,609,1312,592
2016,36005036501,"Census Tract 365.01, Bronx County, New York",1383,70,1313,1222,3466,20563,1972,2006,899,36.1,179,0,559,0,707,1313,602
2017,36005036501,"Census Tract 365.01, Bronx County, New York",1400,41,1359,1232,3524,24907,1971,2005,960,33.3,192,0,528,0,755,1359,508
2018,36005036501,"Census Tract 365.01, Bronx County, New York",1424,35,1389,1259,3136,24193,1969,2006,1051,34.9,139,0,516,0,768,1389,494
2019,36005036501,"Census Tract 365.01, Bronx County, New York",1450,59,1391,1268,3283,26321,1969,2007,1106,34,131,0,564,0,776,1391,429
2020,36005036501,"Census Tract 365.01, Bronx County, New York",1430,59,1371,1273,3510,33661,1969,2007,1177,31.3,101,0,560,0,767,1371,388
2012,36005036502,"Census Tract 365.02, Bronx County, New York",789,89,700,588,1796,17093,1951,2004,893,48.1,33,0,172,0,457,700,313
2013,36005036502,"Census Tract 365.02, Bronx County, New York",772,82,690,594,1713,14700,1952,2004,943,50,44,2,173,0,448,690,340
2014,36005036502,"Census Tract 365.02, Bronx County, New York",734,86,648,553,1410,16140,1965,2006,985,48,47,2,121,0,446,648,296
2015,36005036502,"Census Tract 365.02, Bronx County, New York",762,99,663,580,1613,16635,1947,2006,975,48.5,57,9,138,0,433,663,290
2016,36005036502,"Census Tract 365.02, Bronx County, New York",756,106,650,566,1723,19083,1966,2007,954,41.2,33,10,141,0,415,650,264
2017,36005036502,"Census Tract 365.02, Bronx County, New York",744,72,672,577,1719,19688,1960,2009,1089,48.7,32,12,197,0,395,672,265
2018,36005036502,"Census Tract 365.02, Bronx County, New York",779,62,717,668,2034,30500,1944,2010,1168,44.7,52,5,244,0,433,717,247
2019,36005036502,"Census Tract 365.02, Bronx County, New York",818,43,775,729,2331,30304,1940,2011,1182,44.2,62,9,273,0,469,775,286
2020,36005036502,"Census Tract 365.02, Bronx County, New York",791,33,758,721,2229,26542,0,2012,1257,48.3,48,5,264,0,476,758,314
2012,36005036700,"Census Tract 367, Bronx County, New York",712,100,612,538,1623,16029,1949,2003,946,50,24,12,118,7,465,612,289
2013,36005036700,"Census Tract 367, Bronx County, New York",701,65,636,582,1811,19659,1945,2005,1000,50,71,9,136,15,467,636,289
2014,36005036700,"Census Tract 367, Bronx County, New York",708,46,662,612,1834,21554,1947,2005,1053,50,67,8,159,7,484,662,295
2015,36005036700,"Census Tract 367, Bronx County, New York",721,63,658,592,1782,21622,1945,2006,1078,50,73,10,141,5,465,658,302
2016,36005036700,"Census Tract 367, Bronx County, New York",712,41,671,604,1792,21596,1950,2006,1087,49,71,15,148,0,456,671,297
2017,36005036700,"Census Tract 367, Bronx County, New York",702,45,657,556,1594,23520,1948,2008,1140,45.3,59,18,166,0,388,657,241
2018,36005036700,"Census Tract 367, Bronx County, New York",675,56,619,498,1455,22845,1946,2010,1299,51,32,23,139,9,339,619,232
2019,36005036700,"Census Tract 367, Bronx County, New York",651,45,606,427,1229,22375,0,2011,1340,51,33,15,128,7,292,606,178
2020,36005036700,"Census Tract 367, Bronx County, New York",678,46,632,491,1254,21607,1953,2011,1308,51,75,18,132,7,357,632,205
2012,36005036800,"Census Tract 368, Bronx County, New York",661,34,627,281,794,32401,1955,2005,1225,32.5,40,0,206,0,68,627,67
2013,36005036800,"Census Tract 368, Bronx County, New York",663,22,641,316,977,40278,1959,2005,1449,31.6,38,0,254,0,77,641,76
2014,36005036800,"Census Tract 368, Bronx County, New York",662,26,636,310,1005,40985,1960,2005,1426,40.7,40,0,295,0,34,636,99
2015,36005036800,"Census Tract 368, Bronx County, New York",668,40,628,356,1049,41313,1959,2007,1446,37.4,87,21,305,0,50,628,77
2016,36005036800,"Census Tract 368, Bronx County, New York",678,40,638,360,1078,42143,1964,2008,1431,36.4,51,17,277,0,87,638,95
2017,36005036800,"Census Tract 368, Bronx County, New York",657,43,614,373,1183,43295,1962,2010,1570,36.2,62,17,294,0,86,614,93
2018,36005036800,"Census Tract 368, Bronx County, New York",627,27,600,346,982,35417,1956,2011,1479,43,66,17,237,0,92,600,91
2019,36005036800,"Census Tract 368, Bronx County, New York",639,32,607,327,946,37417,1953,2012,1489,49.1,73,6,183,9,123,607,108
2020,36005036800,"Census Tract 368, Bronx County, New York",592,22,570,288,867,39038,1954,2012,1621,35,54,0,184,7,97,570,122
2012,36005036901,"Census Tract 369.01, Bronx County, New York",814,98,716,716,2264,13188,1944,2003,1021,44.3,3,4,239,5,569,716,410
2013,36005036901,"Census Tract 369.01, Bronx County, New York",816,51,765,765,2249,13594,1939,2004,961,41.6,6,6,253,11,605,765,411
2014,36005036901,"Census Tract 369.01, Bronx County, New York",818,51,767,767,2266,17292,1944,2006,1000,42.6,9,5,283,12,564,767,414
2015,36005036901,"Census Tract 369.01, Bronx County, New York",829,55,774,774,2255,14821,1941,2007,951,40.9,9,5,234,13,571,774,427
2016,36005036901,"Census Tract 369.01, Bronx County, New York",834,32,802,802,2213,15735,1939,2008,949,44,39,0,245,8,578,802,410
2017,36005036901,"Census Tract 369.01, Bronx County, New York",834,23,811,811,2238,18679,1942,2009,993,41.9,59,0,273,0,613,811,401
2018,36005036901,"Census Tract 369.01, Bronx County, New York",845,22,823,823,2267,20461,1945,2009,1018,40.9,70,0,330,0,598,823,406
2019,36005036901,"Census Tract 369.01, Bronx County, New York",820,22,798,798,2064,22273,1948,2009,1029,41.2,81,0,327,0,597,798,356
2020,36005036901,"Census Tract 369.01, Bronx County, New York",786,20,766,698,1754,23778,1957,2009,1085,44.5,111,0,305,0,515,766,362
2012,36005036902,"Census Tract 369.02, Bronx County, New York",807,62,745,704,2097,34512,1954,2002,777,24.7,114,0,361,0,425,745,289
2013,36005036902,"Census Tract 369.02, Bronx County, New York",805,86,719,674,2166,31900,1952,2002,805,26.8,57,0,337,0,386,719,279
2014,36005036902,"Census Tract 369.02, Bronx County, New York",790,71,719,672,2134,25179,1948,2002,862,34.3,11,0,330,0,373,719,303
2015,36005036902,"Census Tract 369.02, Bronx County, New York",772,68,704,659,2088,NA,1939,2002,717,27.5,30,0,286,0,437,704,276
2016,36005036902,"Census Tract 369.02, Bronx County, New York",782,80,702,662,2051,23182,1939,2003,846,29.9,43,11,286,0,422,702,274
2017,36005036902,"Census Tract 369.02, Bronx County, New York",794,77,717,688,2013,23333,1940,2005,910,31.8,68,10,292,0,427,717,286
2018,36005036902,"Census Tract 369.02, Bronx County, New York",818,71,747,725,2057,18033,1951,2007,948,47,56,22,246,0,516,747,382
2019,36005036902,"Census Tract 369.02, Bronx County, New York",838,40,798,762,1951,16078,1956,2008,847,46.1,58,29,351,0,477,798,448
2020,36005036902,"Census Tract 369.02, Bronx County, New York",797,18,779,757,2000,16069,1961,2009,981,46.5,102,45,349,0,434,779,411
2012,36005037000,"Census Tract 370, Bronx County, New York",860,58,802,312,834,49200,1958,2005,1430,30.6,58,16,202,0,94,802,80
2013,36005037000,"Census Tract 370, Bronx County, New York",859,80,779,357,955,40625,1960,2006,1382,32.4,57,33,209,0,115,779,96
2014,36005037000,"Census Tract 370, Bronx County, New York",842,64,778,425,1200,38622,1957,2008,1478,35,43,15,235,4,171,778,113
2015,36005037000,"Census Tract 370, Bronx County, New York",856,60,796,425,1271,36125,1955,2010,1541,46.6,55,21,228,4,172,796,146
2016,36005037000,"Census Tract 370, Bronx County, New York",875,82,793,423,1282,35912,1957,2010,1583,50,51,20,241,4,158,793,169
2017,36005037000,"Census Tract 370, Bronx County, New York",862,72,790,361,1096,36065,1957,2011,1597,50,16,20,188,3,150,790,146
2018,36005037000,"Census Tract 370, Bronx County, New York",855,62,793,320,1064,38773,1955,2010,1646,51,28,11,178,4,122,793,135
2019,36005037000,"Census Tract 370, Bronx County, New York",849,91,758,261,907,41941,1956,2008,1594,38.7,26,0,199,0,65,758,129
2020,36005037000,"Census Tract 370, Bronx County, New York",775,75,700,195,591,46635,1959,2007,1547,28.5,20,0,152,0,45,700,102
2012,36005037100,"Census Tract 371, Bronx County, New York",1789,120,1669,1447,2862,17780,1964,2003,783,36.6,189,34,666,16,895,1669,662
2013,36005037100,"Census Tract 371, Bronx County, New York",1795,162,1633,1430,2879,16792,1962,2004,849,39.9,210,21,630,0,877,1633,696
2014,36005037100,"Census Tract 371, Bronx County, New York",1773,163,1610,1395,2818,15265,1966,2004,877,35.9,131,71,667,0,759,1610,729
2015,36005037100,"Census Tract 371, Bronx County, New York",1824,133,1691,1488,3069,15000,1964,2004,740,34.7,168,28,658,0,869,1691,800
2016,36005037100,"Census Tract 371, Bronx County, New York",1851,128,1723,1442,3022,14737,1951,2004,887,34.8,125,19,556,8,863,1723,800
2017,36005037100,"Census Tract 371, Bronx County, New York",1822,122,1700,1474,3323,21197,1970,2005,1004,33.5,134,19,571,10,867,1700,716
2018,36005037100,"Census Tract 371, Bronx County, New York",1828,89,1739,1558,3554,23801,1970,2005,795,32.4,196,59,522,9,948,1739,590
2019,36005037100,"Census Tract 371, Bronx County, New York",1858,74,1784,1687,3849,21821,1970,2007,804,31.1,239,54,599,8,1148,1784,660
2020,36005037100,"Census Tract 371, Bronx County, New York",1855,60,1795,1653,3663,21492,1974,2008,844,31.5,321,44,643,19,1181,1795,710
2012,36005037200,"Census Tract 372, Bronx County, New York",833,54,779,528,1335,50313,1951,2004,1162,31.5,109,8,387,8,122,779,131
2013,36005037200,"Census Tract 372, Bronx County, New York",812,64,748,537,1373,44712,1962,2006,1168,33,104,6,390,13,115,748,144
2014,36005037200,"Census Tract 372, Bronx County, New York",835,88,747,525,1308,44911,1964,2007,1201,32.4,115,12,377,12,101,747,124
2015,36005037200,"Census Tract 372, Bronx County, New York",801,92,709,481,1217,42049,1964,2007,1204,32.5,111,10,359,10,82,709,110
2016,36005037200,"Census Tract 372, Bronx County, New York",822,87,735,508,1320,40283,1962,2009,1238,34.7,140,9,357,6,131,735,125
2017,36005037200,"Census Tract 372, Bronx County, New York",803,76,727,488,1238,39167,1965,2009,1323,36.2,118,0,313,7,170,727,140
2018,36005037200,"Census Tract 372, Bronx County, New York",832,66,766,527,1330,38413,1964,2010,1383,37.6,147,0,325,7,198,766,130
2019,36005037200,"Census Tract 372, Bronx County, New York",843,73,770,581,1389,35958,1963,2008,1448,38.6,144,0,336,9,258,770,172
2020,36005037200,"Census Tract 372, Bronx County, New York",885,56,829,598,1345,37091,1966,2009,1505,38.4,179,0,302,11,287,829,158
2012,36005037300,"Census Tract 373, Bronx County, New York",1835,300,1535,1275,3892,26322,1942,2004,1098,42.1,214,21,456,0,864,1535,494
2013,36005037300,"Census Tract 373, Bronx County, New York",1895,231,1664,1352,4186,27303,1945,2005,1065,39.1,149,16,453,0,919,1664,525
2014,36005037300,"Census Tract 373, Bronx County, New York",1939,246,1693,1337,3986,27736,1946,2005,1058,43.2,160,19,491,0,864,1693,515
2015,36005037300,"Census Tract 373, Bronx County, New York",1972,177,1795,1413,4009,25551,1942,2007,998,44,158,36,541,0,848,1795,663
2016,36005037300,"Census Tract 373, Bronx County, New York",2047,182,1865,1485,4212,27839,1941,2009,996,37.2,153,55,518,0,895,1865,634
2017,36005037300,"Census Tract 373, Bronx County, New York",2060,114,1946,1617,4508,27668,1942,2008,1005,42,83,58,762,0,897,1946,734
2018,36005037300,"Census Tract 373, Bronx County, New York",2080,179,1901,1633,4842,24479,1941,2010,1146,47,106,39,851,0,913,1901,858
2019,36005037300,"Census Tract 373, Bronx County, New York",2142,168,1974,1694,5170,19448,1951,2011,1154,47.4,129,51,948,0,945,1974,930
2020,36005037300,"Census Tract 373, Bronx County, New York",2163,264,1899,1672,5354,17978,1951,2012,1223,48.8,161,29,891,0,1025,1899,887
2012,36005037400,"Census Tract 374, Bronx County, New York",1452,74,1378,1297,2974,19078,1955,2002,695,29.1,59,16,654,22,632,1378,552
2013,36005037400,"Census Tract 374, Bronx County, New York",1449,63,1386,1290,3310,20179,1956,2002,716,29.1,24,9,744,21,546,1386,517
2014,36005037400,"Census Tract 374, Bronx County, New York",1506,69,1437,1318,3210,20852,1956,2003,773,29.6,84,13,781,30,547,1437,550
2015,36005037400,"Census Tract 374, Bronx County, New York",1535,72,1463,1326,3257,22055,1954,2002,716,28.8,125,26,746,37,568,1463,521
2016,36005037400,"Census Tract 374, Bronx County, New York",1568,48,1520,1416,3505,25975,1954,2004,765,28.7,113,25,800,28,628,1520,578
2017,36005037400,"Census Tract 374, Bronx County, New York",1580,47,1533,1414,3474,26198,1957,2007,927,32.6,111,31,776,31,619,1533,579
2018,36005037400,"Census Tract 374, Bronx County, New York",1622,78,1544,1413,3420,26930,1954,2009,952,31.8,128,32,811,11,617,1544,492
2019,36005037400,"Census Tract 374, Bronx County, New York",1618,57,1561,1431,3490,26708,1956,2011,1096,33.3,131,30,709,6,727,1561,584
2020,36005037400,"Census Tract 374, Bronx County, New York",1576,82,1494,1297,3074,27192,1956,2012,1190,33.8,124,31,702,15,585,1494,503
2012,36005037504,"Census Tract 375.04, Bronx County, New York",1305,61,1244,1171,3857,15339,1964,2003,790,41.3,53,71,421,0,728,1244,656
2013,36005037504,"Census Tract 375.04, Bronx County, New York",1322,125,1197,1148,3620,18200,1950,2004,811,41.5,66,63,469,28,633,1197,559
2014,36005037504,"Census Tract 375.04, Bronx County, New York",1339,133,1206,1148,3524,20116,1961,2005,830,39.6,49,42,433,29,683,1206,573
2015,36005037504,"Census Tract 375.04, Bronx County, New York",1361,112,1249,1194,3278,14803,1939,2006,842,44.9,106,41,427,29,736,1249,666
2016,36005037504,"Census Tract 375.04, Bronx County, New York",1337,133,1204,1153,3045,18671,1939,2007,856,43.5,131,46,434,27,690,1204,587
2017,36005037504,"Census Tract 375.04, Bronx County, New York",1341,104,1237,1201,3080,20257,1939,2007,922,41,163,11,475,28,744,1237,598
2018,36005037504,"Census Tract 375.04, Bronx County, New York",1340,64,1276,1246,3118,18320,1944,2007,891,42.3,144,23,473,0,856,1276,646
2019,36005037504,"Census Tract 375.04, Bronx County, New York",1354,96,1258,1236,3022,20371,1949,2010,992,44.8,155,23,528,0,804,1258,585
2020,36005037504,"Census Tract 375.04, Bronx County, New York",1319,99,1220,1195,3020,24223,1973,2012,923,34.8,109,26,495,0,817,1220,471
2012,36005037600,"Census Tract 376, Bronx County, New York",802,107,695,429,1535,40050,1939,2004,1128,36.6,144,12,276,12,118,695,126
2013,36005037600,"Census Tract 376, Bronx County, New York",796,93,703,485,1678,47426,1953,2005,1336,34.8,132,14,265,10,173,703,86
2014,36005037600,"Census Tract 376, Bronx County, New York",799,83,716,532,1834,47381,1950,2006,1374,35.7,151,0,231,15,270,716,116
2015,36005037600,"Census Tract 376, Bronx County, New York",798,77,721,527,1748,46850,1952,2006,1445,36.2,138,8,209,29,257,721,90
2016,36005037600,"Census Tract 376, Bronx County, New York",808,61,747,523,1693,50711,1953,2006,1448,32.7,144,19,148,27,300,747,77
2017,36005037600,"Census Tract 376, Bronx County, New York",805,64,741,499,1473,50655,1953,2006,1390,31.3,112,30,139,19,311,741,75
2018,36005037600,"Census Tract 376, Bronx County, New York",837,53,784,528,1580,42115,1953,2009,1350,31.3,124,40,157,22,324,784,144
2019,36005037600,"Census Tract 376, Bronx County, New York",836,60,776,501,1403,42604,1947,2013,1311,33.2,154,47,225,9,248,776,164
2020,36005037600,"Census Tract 376, Bronx County, New York",819,44,775,502,1322,60694,1949,2013,1358,27.6,121,31,224,9,253,775,165
2012,36005037800,"Census Tract 378, Bronx County, New York",1099,33,1066,881,2770,38435,1955,2002,1168,39.9,187,0,567,0,346,1066,130
2013,36005037800,"Census Tract 378, Bronx County, New York",1087,36,1051,837,2568,38862,1958,2004,1149,40,84,21,493,0,351,1051,139
2014,36005037800,"Census Tract 378, Bronx County, New York",1068,16,1052,870,2566,33113,1954,2005,1157,43.2,75,19,484,0,398,1052,189
2015,36005037800,"Census Tract 378, Bronx County, New York",1075,18,1057,893,2672,32518,1948,2006,1175,44.8,73,21,519,0,393,1057,217
2016,36005037800,"Census Tract 378, Bronx County, New York",1065,40,1025,839,2548,32336,1946,2007,1196,45.3,84,14,558,0,314,1025,283
2017,36005037800,"Census Tract 378, Bronx County, New York",1102,54,1048,848,2463,33583,1948,2009,1242,35.5,81,21,500,0,372,1048,322
2018,36005037800,"Census Tract 378, Bronx County, New York",1151,86,1065,918,2501,32429,1950,2010,1228,38.5,124,11,559,0,389,1065,340
2019,36005037800,"Census Tract 378, Bronx County, New York",1220,110,1110,959,2276,36760,1965,2010,1194,34.5,212,11,624,0,368,1110,283
2020,36005037800,"Census Tract 378, Bronx County, New York",1199,129,1070,919,2480,36865,1964,2011,1303,33.7,218,11,480,0,460,1070,278
2012,36005037900,"Census Tract 379, Bronx County, New York",1662,148,1514,1437,4986,22114,1949,2003,1057,45.8,93,0,729,0,797,1514,607
2013,36005037900,"Census Tract 379, Bronx County, New York",1640,156,1484,1424,4819,22373,1949,2004,1073,47,92,8,738,0,749,1484,628
2014,36005037900,"Census Tract 379, Bronx County, New York",1640,151,1489,1427,4773,24256,1947,2005,1076,47.6,115,8,737,0,739,1489,650
2015,36005037900,"Census Tract 379, Bronx County, New York",1656,129,1527,1462,4760,NA,1942,2007,1077,44.6,143,10,743,0,776,1527,637
2016,36005037900,"Census Tract 379, Bronx County, New York",1620,154,1466,1411,4517,27776,1943,2008,1133,44.4,146,11,687,0,740,1466,613
2017,36005037900,"Census Tract 379, Bronx County, New York",1597,127,1470,1422,4859,27667,1945,2009,1197,46.4,147,10,766,34,646,1470,673
2018,36005037900,"Census Tract 379, Bronx County, New York",1606,126,1480,1440,4795,23354,1944,2010,1215,48.6,138,0,792,42,668,1480,691
2019,36005037900,"Census Tract 379, Bronx County, New York",1637,90,1547,1486,4872,23767,1956,2010,1321,46,101,0,940,41,716,1547,633
2020,36005037900,"Census Tract 379, Bronx County, New York",1564,50,1514,1447,4882,28551,1970,2011,1368,42.7,113,0,968,31,638,1514,562
2012,36005038000,"Census Tract 380, Bronx County, New York",1786,267,1519,1150,3168,31125,1963,2002,965,34.5,133,32,981,10,92,1519,336
2013,36005038000,"Census Tract 380, Bronx County, New York",1803,261,1542,1175,3371,30423,1962,2003,1020,40.7,199,37,984,8,124,1542,405
2014,36005038000,"Census Tract 380, Bronx County, New York",1836,226,1610,1214,3313,31184,1959,2006,1086,41,213,17,1042,7,155,1610,458
2015,36005038000,"Census Tract 380, Bronx County, New York",1882,149,1733,1307,3662,28264,1959,2010,1132,46.7,343,17,1025,35,237,1733,559
2016,36005038000,"Census Tract 380, Bronx County, New York",1905,128,1777,1290,3407,31389,1958,2011,1191,44.3,394,17,986,44,243,1777,589
2017,36005038000,"Census Tract 380, Bronx County, New York",1979,94,1885,1277,3613,22958,1956,2011,1267,49.6,391,17,949,52,287,1885,657
2018,36005038000,"Census Tract 380, Bronx County, New York",2032,117,1915,1299,3722,21311,1957,2012,1364,51,319,18,1004,49,346,1915,692
2019,36005038000,"Census Tract 380, Bronx County, New York",2050,106,1944,1261,3481,27455,1956,2013,1390,47,231,10,929,38,437,1944,656
2020,36005038000,"Census Tract 380, Bronx County, New York",2126,151,1975,1261,3487,22288,1968,2013,1378,46.6,207,10,878,27,495,1975,708
2012,36005038100,"Census Tract 381, Bronx County, New York",2261,137,2124,2022,5467,25316,1939,2003,1005,35.9,236,13,630,0,1559,2124,842
2013,36005038100,"Census Tract 381, Bronx County, New York",2298,140,2158,2080,5669,25118,1939,2003,1048,39.8,193,11,703,15,1527,2158,897
2014,36005038100,"Census Tract 381, Bronx County, New York",2303,145,2158,2064,5741,22549,1939,2004,1130,45.7,260,10,677,8,1568,2158,826
2015,36005038100,"Census Tract 381, Bronx County, New York",2345,115,2230,2097,5926,23475,1939,2004,1172,47.3,190,10,636,15,1613,2230,796
2016,36005038100,"Census Tract 381, Bronx County, New York",2305,124,2181,2010,6163,29167,1939,2005,1175,42.7,228,0,578,17,1504,2181,590
2017,36005038100,"Census Tract 381, Bronx County, New York",2317,80,2237,2080,6610,35451,1945,2005,1223,40.8,242,11,773,24,1397,2237,635
2018,36005038100,"Census Tract 381, Bronx County, New York",2315,26,2289,2108,6195,29038,1943,2008,1335,44.7,237,11,877,0,1539,2289,611
2019,36005038100,"Census Tract 381, Bronx County, New York",2399,43,2356,2203,7044,38275,0,2011,1320,39.8,313,10,1048,0,1671,2356,675
2020,36005038100,"Census Tract 381, Bronx County, New York",2552,39,2513,2402,7455,41818,0,2012,1427,43.7,238,12,942,0,1879,2513,688
2012,36005038200,"Census Tract 382, Bronx County, New York",872,93,779,395,1127,25536,1955,2004,1340,50,42,0,249,0,146,779,189
2013,36005038200,"Census Tract 382, Bronx County, New York",885,95,790,377,1224,23603,1972,2005,1455,49.6,53,0,213,0,168,790,180
2014,36005038200,"Census Tract 382, Bronx County, New York",917,95,822,366,1171,36061,1954,2005,1435,44.1,59,0,239,0,131,822,144
2015,36005038200,"Census Tract 382, Bronx County, New York",924,87,837,416,1304,29688,1953,2006,1305,39,50,9,247,3,163,837,184
2016,36005038200,"Census Tract 382, Bronx County, New York",942,67,875,450,1547,33182,1953,2009,1408,40.7,37,19,269,2,155,875,213
2017,36005038200,"Census Tract 382, Bronx County, New York",945,66,879,466,1508,33409,1951,2011,1393,39.7,27,19,286,4,153,879,194
2018,36005038200,"Census Tract 382, Bronx County, New York",962,39,923,487,1557,29519,1955,2011,1467,43.7,31,14,308,13,145,923,198
2019,36005038200,"Census Tract 382, Bronx County, New York",996,51,945,536,1669,26316,1957,2012,1454,46.4,44,13,267,17,226,945,255
2020,36005038200,"Census Tract 382, Bronx County, New York",1016,45,971,445,1316,26208,1955,2013,1489,51,23,0,309,7,125,971,211
2012,36005038301,"Census Tract 383.01, Bronx County, New York",1579,104,1475,1443,4544,25120,1939,2003,1049,46.3,107,35,592,18,969,1475,521
2013,36005038301,"Census Tract 383.01, Bronx County, New York",1595,79,1516,1493,4685,24074,1939,2004,1142,47.3,132,33,521,14,1069,1516,639
2014,36005038301,"Census Tract 383.01, Bronx County, New York",1618,82,1536,1477,4125,24041,1939,2004,1097,49.7,120,0,556,15,999,1536,609
2015,36005038301,"Census Tract 383.01, Bronx County, New York",1624,115,1509,1491,4197,25491,1939,2005,1144,50,152,35,480,0,1029,1509,585
2016,36005038301,"Census Tract 383.01, Bronx County, New York",1613,96,1517,1495,4422,27668,1939,2006,1162,39.8,171,30,468,8,985,1517,598
2017,36005038301,"Census Tract 383.01, Bronx County, New York",1619,80,1539,1506,4643,27500,1939,2008,1153,39.8,169,32,529,6,985,1539,599
2018,36005038301,"Census Tract 383.01, Bronx County, New York",1648,82,1566,1516,4660,38100,0,2008,1249,36,189,33,501,8,1048,1566,476
2019,36005038301,"Census Tract 383.01, Bronx County, New York",1617,97,1520,1497,4885,42876,0,2010,1284,36.1,190,34,442,25,1073,1520,442
2020,36005038301,"Census Tract 383.01, Bronx County, New York",1692,51,1641,1609,4820,44616,0,2011,1311,33.1,169,23,552,23,1110,1641,480
2012,36005038302,"Census Tract 383.02, Bronx County, New York",1879,86,1793,1768,5068,16605,1939,2003,927,39.8,156,0,1025,0,782,1793,956
2013,36005038302,"Census Tract 383.02, Bronx County, New York",1909,99,1810,1790,5087,20203,1939,2003,926,36.2,183,0,987,0,857,1810,907
2014,36005038302,"Census Tract 383.02, Bronx County, New York",1974,122,1852,1831,5235,16749,1942,2004,978,38.9,207,7,1047,0,851,1852,1007
2015,36005038302,"Census Tract 383.02, Bronx County, New York",1992,109,1883,1874,5833,23667,1939,2004,988,35.7,229,7,1015,0,937,1883,918
2016,36005038302,"Census Tract 383.02, Bronx County, New York",2050,119,1931,1913,5863,22213,1939,2005,1063,38.9,250,8,1030,0,942,1931,911
2017,36005038302,"Census Tract 383.02, Bronx County, New York",2051,114,1937,1925,5855,22404,1939,2006,1083,44.2,281,24,1009,0,998,1937,873
2018,36005038302,"Census Tract 383.02, Bronx County, New York",2065,90,1975,1962,5950,21084,0,2007,1123,48.1,198,25,965,0,1058,1975,948
2019,36005038302,"Census Tract 383.02, Bronx County, New York",2075,57,2018,1984,5820,20633,0,2009,1093,45.9,177,17,880,0,1109,2018,1016
2020,36005038303,"Census Tract 383.03, Bronx County, New York",1312,30,1282,1240,3463,19640,1946,2010,1020,38.6,105,16,600,0,623,1282,603
2020,36005038304,"Census Tract 383.04, Bronx County, New York",826,31,795,757,2240,NA,0,2010,993,42.3,13,0,293,0,458,795,537
2012,36005038500,"Census Tract 385, Bronx County, New York",1665,233,1432,1331,3963,18112,1939,2004,1026,50,174,12,406,0,966,1432,688
2013,36005038500,"Census Tract 385, Bronx County, New York",1695,158,1537,1422,4281,18698,1941,2004,1074,49.8,157,13,465,0,986,1537,719
2014,36005038500,"Census Tract 385, Bronx County, New York",1712,118,1594,1476,4547,16833,1945,2006,1101,50,152,0,451,0,1075,1594,796
2015,36005038500,"Census Tract 385, Bronx County, New York",1742,135,1607,1449,4545,18503,1946,2008,1103,49.8,161,0,458,0,1031,1607,767
2016,36005038500,"Census Tract 385, Bronx County, New York",1810,104,1706,1560,4371,19729,1954,2009,1047,42.1,165,6,518,0,1054,1706,780
2017,36005038500,"Census Tract 385, Bronx County, New York",1814,141,1673,1602,4481,18275,1960,2010,1040,49.8,109,7,598,0,1020,1673,774
2018,36005038500,"Census Tract 385, Bronx County, New York",1829,155,1674,1648,4631,19924,0,2011,1034,44.5,71,12,644,0,1070,1674,791
2019,36005038500,"Census Tract 385, Bronx County, New York",1868,192,1676,1634,4626,25519,0,2012,1049,37.1,68,10,596,0,1115,1676,665
2020,36005038500,"Census Tract 385, Bronx County, New York",1812,177,1635,1586,4233,21078,0,2012,1017,51,62,15,635,0,1021,1635,721
2012,36005038600,"Census Tract 386, Bronx County, New York",2783,322,2461,1983,5655,39292,1964,2004,1228,36.7,239,68,1548,0,423,2461,482
2013,36005038600,"Census Tract 386, Bronx County, New York",2825,272,2553,2005,6325,48154,1966,2004,1312,27.4,376,77,1512,0,395,2553,482
2014,36005038600,"Census Tract 386, Bronx County, New York",2785,370,2415,1942,5795,47698,1952,2006,1304,30.8,296,86,1469,39,390,2415,442
2015,36005038600,"Census Tract 386, Bronx County, New York",2813,324,2489,1944,5648,47500,1953,2007,1282,31.1,302,77,1574,44,285,2489,423
2016,36005038600,"Census Tract 386, Bronx County, New York",2833,327,2506,1934,6015,46833,1951,2007,1310,36.7,456,50,1573,111,230,2506,421
2017,36005038600,"Census Tract 386, Bronx County, New York",2824,238,2586,1863,5861,42486,1944,2007,1275,38.6,384,0,1560,141,177,2586,461
2018,36005038600,"Census Tract 386, Bronx County, New York",2822,140,2682,2134,6653,41231,1950,2010,1390,39.4,413,0,1733,177,255,2682,507
2019,36005038600,"Census Tract 386, Bronx County, New York",2848,77,2771,2052,6363,32456,1944,2011,1417,39.3,474,0,1645,108,394,2771,493
2020,36005038600,"Census Tract 386, Bronx County, New York",2870,36,2834,1915,6498,34524,0,2012,1602,38.4,410,0,1438,99,420,2834,434
2012,36005038700,"Census Tract 387, Bronx County, New York",1278,196,1082,997,2518,23798,1939,2005,1107,46.7,161,102,320,27,593,1082,416
2013,36005038700,"Census Tract 387, Bronx County, New York",1279,145,1134,1069,2767,23319,1939,2006,1126,46.5,159,179,312,36,591,1134,428
2014,36005038700,"Census Tract 387, Bronx County, New York",1289,141,1148,1081,2781,19859,1939,2009,1148,50,142,169,294,33,598,1148,464
2015,36005038700,"Census Tract 387, Bronx County, New York",1295,119,1176,1092,2962,17335,1939,2011,1160,50,112,164,257,43,627,1176,584
2016,36005038700,"Census Tract 387, Bronx County, New York",1311,110,1201,1100,3005,18864,1939,2011,1176,50,111,186,207,32,683,1201,557
2017,36005038700,"Census Tract 387, Bronx County, New York",1295,91,1204,1132,3351,18796,1947,2011,1192,50,158,205,243,17,677,1204,567
2018,36005038700,"Census Tract 387, Bronx County, New York",1319,122,1197,1137,3390,31024,0,2011,1270,46.4,135,156,284,10,682,1197,472
2019,36005038700,"Census Tract 387, Bronx County, New York",1360,104,1256,1199,3594,35243,0,2013,1394,43.6,235,165,305,11,725,1256,490
2020,36005038700,"Census Tract 387, Bronx County, New York",1379,120,1259,1230,3546,38190,0,2014,1449,43.7,213,151,307,17,761,1259,375
2012,36005038800,"Census Tract 388, Bronx County, New York",885,47,838,483,1382,38348,1950,2004,1161,38.9,50,0,439,0,73,838,162
2013,36005038800,"Census Tract 388, Bronx County, New York",893,53,840,481,1442,46298,1941,2005,1185,37.7,59,0,427,0,79,840,154
2014,36005038800,"Census Tract 388, Bronx County, New York",880,71,809,453,1312,49609,1951,2006,1142,32,90,0,374,0,83,809,149
2015,36005038800,"Census Tract 388, Bronx County, New York",902,85,817,463,1346,41797,1939,2007,1116,33.3,107,0,368,0,98,817,145
2016,36005038800,"Census Tract 388, Bronx County, New York",888,104,784,391,1117,37950,1939,2010,1180,42.2,116,0,296,0,99,784,146
2017,36005038800,"Census Tract 388, Bronx County, New York",936,102,834,409,1175,40189,1951,2010,1188,39.3,128,0,313,0,96,834,144
2018,36005038800,"Census Tract 388, Bronx County, New York",948,79,869,389,1143,32961,1954,2009,1513,51,97,0,267,0,122,869,167
2019,36005038800,"Census Tract 388, Bronx County, New York",968,90,878,384,1102,34595,1954,2011,1605,49.5,81,5,260,0,126,878,157
2020,36005038800,"Census Tract 388, Bronx County, New York",962,37,925,393,1121,41856,1956,2011,1571,34.4,71,3,291,0,108,925,156
2012,36005038900,"Census Tract 389, Bronx County, New York",1816,238,1578,1513,4800,23662,1939,2004,1111,50,105,433,230,34,813,1578,769
2013,36005038900,"Census Tract 389, Bronx County, New York",1833,203,1630,1542,4588,25095,1939,2005,1150,50,157,428,317,39,734,1630,752
2014,36005038900,"Census Tract 389, Bronx County, New York",1900,185,1715,1645,5022,25334,1939,2007,1191,49.1,181,494,256,28,839,1715,793
2015,36005038900,"Census Tract 389, Bronx County, New York",1872,151,1721,1657,5518,27140,1939,2010,1250,50,254,438,225,34,919,1721,819
2016,36005038900,"Census Tract 389, Bronx County, New York",1847,125,1722,1662,5158,27866,1943,2011,1211,48.7,260,510,240,63,840,1722,809
2017,36005038900,"Census Tract 389, Bronx County, New York",1866,91,1775,1715,5678,31088,1943,2011,1264,41.6,263,493,233,46,926,1775,804
2018,36005038900,"Census Tract 389, Bronx County, New York",1851,184,1667,1592,5129,32028,0,2012,1267,38,274,521,140,76,844,1667,723
2019,36005038900,"Census Tract 389, Bronx County, New York",1877,172,1705,1639,5215,35694,0,2012,1263,38.8,286,427,205,100,904,1705,697
2020,36005038900,"Census Tract 389, Bronx County, New York",1971,150,1821,1781,5101,36455,0,2013,1326,39.9,253,435,216,92,1068,1821,765
2012,36005039000,"Census Tract 390, Bronx County, New York",1064,120,944,703,2076,30946,1961,2006,1240,43.5,108,32,493,0,133,944,235
2013,36005039000,"Census Tract 390, Bronx County, New York",1091,108,983,708,2152,30000,1969,2007,1367,48,77,14,556,0,107,983,277
2014,36005039000,"Census Tract 390, Bronx County, New York",1073,84,989,760,2334,30711,1983,2008,1474,50,95,37,574,0,140,989,268
2015,36005039000,"Census Tract 390, Bronx County, New York",1040,34,1006,756,2127,30045,1984,2008,1330,50,125,11,621,0,147,1006,363
2016,36005039000,"Census Tract 390, Bronx County, New York",1082,81,1001,783,2096,30928,1961,2011,1388,48.9,139,16,666,0,117,1001,248
2017,36005039000,"Census Tract 390, Bronx County, New York",1065,123,942,726,1817,31534,1957,2011,1364,49.6,161,23,627,0,106,942,206
2018,36005039000,"Census Tract 390, Bronx County, New York",1083,105,978,746,1898,34388,1949,2011,1383,46.3,181,25,643,0,128,978,171
2019,36005039000,"Census Tract 390, Bronx County, New York",1111,85,1026,835,2199,42156,0,2012,1498,40.9,121,37,643,0,166,1026,226
2020,36005039000,"Census Tract 390, Bronx County, New York",1150,57,1093,910,2326,48867,1946,2013,1666,33.6,97,42,580,0,146,1093,159
2012,36005039100,"Census Tract 391, Bronx County, New York",2397,269,2128,1979,6307,22884,1939,2005,1047,44.8,272,323,365,56,1283,2128,996
2013,36005039100,"Census Tract 391, Bronx County, New York",2484,233,2251,2084,6263,22977,1939,2005,1004,43.9,308,440,349,37,1315,2251,969
2014,36005039100,"Census Tract 391, Bronx County, New York",2586,239,2347,2181,6625,22615,1939,2006,1048,45.7,365,455,354,25,1413,2347,1059
2015,36005039100,"Census Tract 391, Bronx County, New York",2631,272,2359,2195,6393,29084,1939,2010,1078,39,514,505,333,0,1418,2359,930
2016,36005039100,"Census Tract 391, Bronx County, New York",2658,234,2424,2278,6765,29573,1939,2010,1130,41.5,602,430,476,32,1396,2424,863
2017,36005039100,"Census Tract 391, Bronx County, New York",2654,243,2411,2291,6802,31307,1939,2011,1162,38.6,685,402,507,36,1416,2411,712
2018,36005039100,"Census Tract 391, Bronx County, New York",2630,183,2447,2307,6998,30952,0,2012,1261,41.5,421,297,513,39,1440,2447,715
2019,36005039100,"Census Tract 391, Bronx County, New York",2619,182,2437,2261,6978,30137,0,2011,1347,46.2,421,221,530,116,1379,2437,759
2020,36005039100,"Census Tract 391, Bronx County, New York",2972,216,2756,2553,6944,26396,0,2012,1271,34.3,459,404,450,97,1572,2756,848
2012,36005039200,"Census Tract 392, Bronx County, New York",619,34,585,439,979,21738,1939,2004,1067,50,72,0,314,0,125,585,155
2013,36005039200,"Census Tract 392, Bronx County, New York",593,54,539,426,1074,22917,1942,2005,1121,50,68,0,324,0,102,539,150
2014,36005039200,"Census Tract 392, Bronx County, New York",599,42,557,476,1254,34207,1945,2003,1181,38.5,78,0,355,0,121,557,133
2015,36005039200,"Census Tract 392, Bronx County, New York",593,39,554,472,1292,37188,1943,2006,1253,38.2,82,5,354,0,113,554,118
2016,36005039200,"Census Tract 392, Bronx County, New York",628,35,593,502,1462,37237,1944,2008,1286,41,91,5,344,0,158,593,143
2017,36005039200,"Census Tract 392, Bronx County, New York",620,46,574,454,1162,39214,1939,2010,1325,42.7,98,6,322,0,133,574,127
2018,36005039200,"Census Tract 392, Bronx County, New York",658,20,638,499,1096,40179,1940,2011,1378,39,96,8,337,0,189,638,130
2019,36005039200,"Census Tract 392, Bronx County, New York",646,10,636,505,1069,43060,0,2012,1407,38.5,100,6,394,0,136,636,113
2020,36005039200,"Census Tract 392, Bronx County, New York",679,44,635,474,1101,43707,1943,2013,1471,38.2,152,0,393,0,111,635,110
2012,36005039300,"Census Tract 393, Bronx County, New York",3274,235,3039,2961,6969,15225,1954,2003,855,43.7,196,235,991,43,1798,3039,1543
2013,36005039300,"Census Tract 393, Bronx County, New York",3219,260,2959,2907,7369,16627,1952,2004,847,39.2,206,211,970,31,1806,2959,1447
2014,36005039300,"Census Tract 393, Bronx County, New York",3215,291,2924,2828,7554,18457,1947,2005,891,39.6,218,245,804,26,1774,2924,1353
2015,36005039300,"Census Tract 393, Bronx County, New York",3260,264,2996,2867,7998,NA,1953,2006,930,42.5,256,272,823,0,1814,2996,1247
2016,36005039300,"Census Tract 393, Bronx County, New York",3354,135,3219,3060,8941,20846,1953,2008,921,43.6,356,227,824,12,2012,3219,1359
2017,36005039300,"Census Tract 393, Bronx County, New York",3352,85,3267,3108,8808,20760,1954,2009,956,38.8,351,230,879,22,1989,3267,1362
2018,36005039300,"Census Tract 393, Bronx County, New York",3366,121,3245,3059,8140,20487,1958,2010,967,39.5,398,214,882,18,1929,3245,1388
2019,36005039300,"Census Tract 393, Bronx County, New York",3362,130,3232,3083,7665,18912,1952,2009,990,38.9,385,140,1176,13,1991,3232,1441
2020,36005039300,"Census Tract 393, Bronx County, New York",3216,159,3057,2958,7668,20098,0,2010,999,35.6,323,92,1235,10,1837,3057,1333
2012,36005039400,"Census Tract 394, Bronx County, New York",1592,62,1530,1296,3562,37277,1939,2002,1045,31.5,211,19,954,13,402,1530,380
2013,36005039400,"Census Tract 394, Bronx County, New York",1605,58,1547,1287,3527,37466,1939,2002,1084,31.2,252,18,860,13,454,1547,422
2014,36005039400,"Census Tract 394, Bronx County, New York",1669,64,1605,1371,3782,33354,1943,2004,1122,35.7,210,43,872,7,483,1605,502
2015,36005039400,"Census Tract 394, Bronx County, New York",1656,54,1602,1386,3931,28750,1952,2006,1147,38.5,161,51,869,13,502,1602,522
2016,36005039400,"Census Tract 394, Bronx County, New York",1654,51,1603,1337,3740,26678,1953,2008,1166,39.9,131,57,840,0,493,1603,496
2017,36005039400,"Census Tract 394, Bronx County, New York",1694,63,1631,1326,3746,24750,1953,2010,1223,43.6,145,60,841,0,482,1631,477
2018,36005039400,"Census Tract 394, Bronx County, New York",1715,33,1682,1374,3821,25962,1952,2011,1309,41,148,47,940,0,451,1682,491
2019,36005039400,"Census Tract 394, Bronx County, New York",1739,16,1723,1412,4073,42500,1941,2012,1461,37.3,177,18,955,0,521,1723,412
2020,36005039400,"Census Tract 394, Bronx County, New York",1711,34,1677,1297,3498,47875,0,2014,1579,34.9,164,24,834,0,536,1677,377
2012,36005039500,"Census Tract 395, Bronx County, New York",1455,133,1322,1040,2601,20270,1945,2004,786,33.8,100,14,437,0,693,1322,451
2013,36005039500,"Census Tract 395, Bronx County, New York",1523,165,1358,1104,2795,15833,1946,2005,804,34.3,130,0,467,0,769,1358,513
2014,36005039500,"Census Tract 395, Bronx County, New York",1581,171,1410,1216,3060,17315,1939,2007,983,34.6,187,5,554,0,771,1410,571
2015,36005039500,"Census Tract 395, Bronx County, New York",1634,187,1447,1281,3206,20625,1939,2007,995,35.3,229,5,533,0,778,1447,547
2016,36005039500,"Census Tract 395, Bronx County, New York",1660,194,1466,1319,3433,19784,1939,2009,1030,38.6,188,5,499,0,808,1466,588
2017,36005039500,"Census Tract 395, Bronx County, New York",1722,164,1558,1414,3598,20645,1939,2010,1035,37,249,6,660,7,813,1558,597
2018,36005039500,"Census Tract 395, Bronx County, New York",1706,139,1567,1453,3698,24620,1943,2010,1061,35,233,4,716,6,847,1567,602
2019,36005039500,"Census Tract 395, Bronx County, New York",1736,150,1586,1418,3564,26796,1949,2011,957,35.5,183,0,734,7,816,1586,524
2020,36005039500,"Census Tract 395, Bronx County, New York",1747,155,1592,1402,3473,19808,1987,2012,903,39.2,161,0,751,16,842,1592,698
2012,36005039600,"Census Tract 396, Bronx County, New York",1484,293,1191,872,2609,23947,1951,2005,1354,50,100,8,629,0,218,1191,404
2013,36005039600,"Census Tract 396, Bronx County, New York",1492,211,1281,922,2664,20509,1953,2005,1321,50,72,9,670,0,234,1281,441
2014,36005039600,"Census Tract 396, Bronx County, New York",1440,231,1209,946,2566,19556,1963,2006,1208,50,100,8,627,0,297,1209,468
2015,36005039600,"Census Tract 396, Bronx County, New York",1487,164,1323,995,2906,22413,1965,2008,1230,47,141,0,741,0,208,1323,447
2016,36005039600,"Census Tract 396, Bronx County, New York",1494,136,1358,1018,2985,23796,1965,2009,1273,44.3,141,0,774,0,196,1358,459
2017,36005039600,"Census Tract 396, Bronx County, New York",1502,124,1378,1005,3157,26483,1966,2010,1322,48,192,0,781,0,181,1378,444
2018,36005039600,"Census Tract 396, Bronx County, New York",1500,136,1364,1072,3395,34213,1967,2011,1430,44.5,186,0,778,0,240,1364,351
2019,36005039600,"Census Tract 396, Bronx County, New York",1570,89,1481,1144,3645,33983,1957,2012,1463,38.7,169,0,857,0,249,1481,322
2020,36005039600,"Census Tract 396, Bronx County, New York",1482,101,1381,1062,3285,33994,1951,2013,1558,41.6,135,22,745,0,295,1381,279
2012,36005039700,"Census Tract 397, Bronx County, New York",559,67,492,484,1072,18750,1939,2004,826,40.3,84,57,124,77,237,492,203
2013,36005039700,"Census Tract 397, Bronx County, New York",565,97,468,457,1015,18598,1939,2004,813,40.3,82,50,101,67,244,468,215
2014,36005039700,"Census Tract 397, Bronx County, New York",564,55,509,498,1118,18516,1939,2005,769,39.3,92,75,70,68,306,509,249
2015,36005039700,"Census Tract 397, Bronx County, New York",584,60,524,506,1335,20833,1939,2007,1018,33.1,81,64,78,60,315,524,270
2016,36005039700,"Census Tract 397, Bronx County, New York",592,42,550,536,1279,21303,1939,2010,1035,36.1,63,63,84,60,345,550,278
2017,36005039700,"Census Tract 397, Bronx County, New York",590,33,557,539,1218,26369,1939,2008,1080,32.9,45,47,117,47,349,557,206
2018,36005039700,"Census Tract 397, Bronx County, New York",568,24,544,525,1106,27321,0,2008,1115,31.8,65,40,141,40,327,544,170
2019,36005039700,"Census Tract 397, Bronx County, New York",571,54,517,502,1035,32143,0,2011,1066,30.2,81,33,128,41,317,517,154
2020,36005039700,"Census Tract 397, Bronx County, New York",616,68,548,543,923,32188,1945,2013,1130,40.3,176,20,124,69,286,548,150
2012,36005039800,"Census Tract 398, Bronx County, New York",1094,97,997,411,889,36229,1950,2006,1160,31.4,88,0,376,20,15,997,66
2013,36005039800,"Census Tract 398, Bronx County, New York",1088,131,957,482,1166,37188,1952,2007,1263,30.7,154,0,444,16,22,957,109
2014,36005039800,"Census Tract 398, Bronx County, New York",1094,131,963,444,1118,38276,1950,2007,1302,32.5,117,26,384,18,16,963,109
2015,36005039800,"Census Tract 398, Bronx County, New York",1079,126,953,447,1097,44464,1950,2010,1299,31.8,92,28,381,22,16,953,165
2016,36005039800,"Census Tract 398, Bronx County, New York",1074,65,1009,484,1164,56324,1950,2011,1345,31.9,132,25,435,6,18,1009,153
2017,36005039800,"Census Tract 398, Bronx County, New York",1110,64,1046,465,1260,61615,1953,2012,1541,30.6,142,26,408,12,19,1046,157
2018,36005039800,"Census Tract 398, Bronx County, New York",1141,76,1065,450,1231,52159,1955,2012,1602,33.5,127,21,385,8,36,1065,108
2019,36005039800,"Census Tract 398, Bronx County, New York",1161,92,1069,486,1190,52340,1957,2014,1521,35.3,160,0,438,7,41,1069,123
2020,36005039800,"Census Tract 398, Bronx County, New York",1361,152,1209,636,1540,NA,1950,2016,1333,51,115,0,448,0,188,1209,325
2012,36005039901,"Census Tract 399.01, Bronx County, New York",1765,118,1647,1585,4845,25330,1939,2003,1058,45.9,137,32,372,117,1056,1647,658
2013,36005039901,"Census Tract 399.01, Bronx County, New York",1763,142,1621,1542,4772,26006,1939,2003,1058,43.3,148,43,321,92,1045,1621,601
2014,36005039901,"Census Tract 399.01, Bronx County, New York",1764,148,1616,1522,4807,24148,1939,2004,1111,44.6,164,50,335,101,1003,1616,619
2015,36005039901,"Census Tract 399.01, Bronx County, New York",1790,144,1646,1576,4834,21797,1939,2006,1109,45.3,200,47,374,99,1022,1646,722
2016,36005039901,"Census Tract 399.01, Bronx County, New York",1779,108,1671,1599,5186,25790,1939,2006,1151,44.5,202,55,350,103,1037,1671,707
2017,36005039901,"Census Tract 399.01, Bronx County, New York",1771,77,1694,1647,5739,25438,1939,2006,1162,46.6,194,61,335,101,1099,1694,774
2018,36005039901,"Census Tract 399.01, Bronx County, New York",1768,63,1705,1678,5469,25618,0,2008,1199,49,191,48,414,94,1110,1705,782
2019,36005039901,"Census Tract 399.01, Bronx County, New York",1774,56,1718,1683,5441,29116,0,2008,1203,44.8,137,59,456,80,1078,1718,794
2020,36005039901,"Census Tract 399.01, Bronx County, New York",1769,64,1705,1695,5585,36941,0,2009,1226,39.2,135,37,355,98,1193,1705,581
2012,36005039902,"Census Tract 399.02, Bronx County, New York",1758,103,1655,1637,4519,20888,1939,2002,1052,39.2,199,58,479,62,1097,1655,792
2013,36005039902,"Census Tract 399.02, Bronx County, New York",1734,110,1624,1595,4763,26563,1939,2004,1077,35.3,160,89,404,21,1144,1624,698
2014,36005039902,"Census Tract 399.02, Bronx County, New York",1735,94,1641,1626,4733,24831,1939,2004,1065,36,125,88,455,26,1170,1641,760
2015,36005039902,"Census Tract 399.02, Bronx County, New York",1761,50,1711,1696,5102,24777,1939,2004,1080,36.3,135,100,467,31,1144,1711,795
2016,36005039902,"Census Tract 399.02, Bronx County, New York",1766,13,1753,1736,5485,33125,1939,2006,1141,38.1,157,111,392,24,1219,1753,728
2017,36005039902,"Census Tract 399.02, Bronx County, New York",1774,45,1729,1720,5324,32838,1939,2008,1167,40.1,200,121,350,25,1237,1729,707
2018,36005039902,"Census Tract 399.02, Bronx County, New York",1799,31,1768,1759,5297,32963,0,2009,1202,38.5,245,55,382,29,1310,1768,700
2019,36005039902,"Census Tract 399.02, Bronx County, New York",1828,85,1743,1734,5579,36250,0,2011,1273,38.7,266,61,313,27,1299,1743,632
2020,36005039902,"Census Tract 399.02, Bronx County, New York",1850,149,1701,1692,5500,42976,0,2012,1340,38.4,269,34,252,48,1345,1701,515
2012,36005040100,"Census Tract 401, Bronx County, New York",1404,20,1384,1321,4936,35587,1939,2004,1152,34.8,274,55,223,0,1041,1384,403
2013,36005040100,"Census Tract 401, Bronx County, New York",1468,18,1450,1379,4992,35915,1939,2003,1198,35.6,173,58,216,13,1129,1450,462
2014,36005040100,"Census Tract 401, Bronx County, New York",1535,41,1494,1472,5365,35893,1939,2003,1252,35.2,151,49,236,23,1209,1494,534
2015,36005040100,"Census Tract 401, Bronx County, New York",1576,34,1542,1521,5039,32796,1939,2005,1293,35.8,137,50,295,28,1199,1542,603
2016,36005040100,"Census Tract 401, Bronx County, New York",1582,72,1510,1503,4623,29129,1939,2006,1213,37.7,103,45,264,21,1223,1510,595
2017,36005040100,"Census Tract 401, Bronx County, New York",1551,43,1508,1500,4395,31042,1939,2007,1223,37,88,35,281,56,1196,1508,618
2018,36005040100,"Census Tract 401, Bronx County, New York",1552,42,1510,1494,4540,34408,0,2009,1344,37.4,117,30,281,41,1226,1510,514
2019,36005040100,"Census Tract 401, Bronx County, New York",1554,26,1528,1516,4406,36646,0,2011,1370,37.3,125,30,408,13,1225,1528,485
2020,36005040100,"Census Tract 401, Bronx County, New York",1887,55,1832,1821,4517,26238,0,2012,1422,51,157,174,435,10,1361,1832,654
2012,36005040302,"Census Tract 403.02, Bronx County, New York",1440,95,1345,1345,3566,20268,1939,2003,998,47.1,54,21,332,50,1009,1345,582
2013,36005040302,"Census Tract 403.02, Bronx County, New York",1445,72,1373,1373,3734,20492,1939,2003,1026,50,68,22,325,44,1049,1373,595
2014,36005040302,"Census Tract 403.02, Bronx County, New York",1496,59,1437,1437,4182,22318,1939,2003,1144,50,65,21,342,40,1069,1437,599
2015,36005040302,"Census Tract 403.02, Bronx County, New York",1490,61,1429,1420,4115,25842,1939,2004,1154,39.3,70,38,295,44,1092,1429,495
2016,36005040302,"Census Tract 403.02, Bronx County, New York",1481,32,1449,1434,4191,27313,1939,2004,1189,34.5,158,48,360,49,1041,1449,451
2017,36005040302,"Census Tract 403.02, Bronx County, New York",1477,9,1468,1449,4353,28410,1939,2007,1212,42.5,159,63,298,48,1049,1468,461
2018,36005040302,"Census Tract 403.02, Bronx County, New York",1473,28,1445,1431,4234,29879,0,2007,1253,40.1,219,63,219,48,1104,1445,465
2019,36005040302,"Census Tract 403.02, Bronx County, New York",1461,51,1410,1399,4128,37877,0,2009,1250,36,212,43,217,52,1124,1410,356
2020,36005040302,"Census Tract 403.02, Bronx County, New York",1640,60,1580,1569,5057,32487,0,2007,1448,41.3,211,17,155,40,1372,1580,582
2012,36005040303,"Census Tract 403.03, Bronx County, New York",1610,174,1436,1391,3658,29583,1939,2004,1047,42.5,297,121,391,31,901,1436,489
2013,36005040303,"Census Tract 403.03, Bronx County, New York",1617,191,1426,1321,3623,35194,1939,2005,1116,41,276,93,348,15,909,1426,439
2014,36005040303,"Census Tract 403.03, Bronx County, New York",1608,148,1460,1354,3931,36818,1939,2006,1134,39.8,267,44,366,10,975,1460,467
2015,36005040303,"Census Tract 403.03, Bronx County, New York",1615,108,1507,1359,3992,NA,1939,2006,1161,36.9,266,54,332,11,1028,1507,499
2016,36005040303,"Census Tract 403.03, Bronx County, New York",1597,46,1551,1414,4249,41679,1939,2007,1171,35.1,245,40,268,21,1149,1551,493
2017,36005040303,"Census Tract 403.03, Bronx County, New York",1615,62,1553,1430,4420,38603,1939,2008,1202,37.2,277,47,245,10,1128,1553,484
2018,36005040303,"Census Tract 403.03, Bronx County, New York",1600,59,1541,1416,4442,37704,0,2009,1243,38.4,286,20,250,10,1129,1541,464
2019,36005040303,"Census Tract 403.03, Bronx County, New York",1653,51,1602,1496,4374,37378,0,2010,1331,39,315,19,292,10,1217,1602,434
2020,36005040303,"Census Tract 403.03, Bronx County, New York",1393,36,1357,1275,3837,36082,0,2010,1399,40,300,11,228,10,1042,1357,363
2012,36005040304,"Census Tract 403.04, Bronx County, New York",1288,147,1141,1097,3803,44276,1939,2003,1154,33.2,117,61,133,36,892,1141,233
2013,36005040304,"Census Tract 403.04, Bronx County, New York",1287,175,1112,1065,3580,32946,1939,2003,1230,35.9,144,53,113,46,872,1112,316
2014,36005040304,"Census Tract 403.04, Bronx County, New York",1281,151,1130,1103,3866,36435,1939,2005,1197,34.7,111,83,133,53,861,1130,355
2015,36005040304,"Census Tract 403.04, Bronx County, New York",1272,88,1184,1157,4133,NA,1939,2006,1219,37.9,152,69,115,60,944,1184,447
2016,36005040304,"Census Tract 403.04, Bronx County, New York",1286,72,1214,1183,3856,30788,1939,2006,1244,40.4,244,76,166,69,938,1214,544
2017,36005040304,"Census Tract 403.04, Bronx County, New York",1274,112,1162,1138,3920,22750,1939,2008,1303,44.8,210,53,128,63,963,1162,610
2018,36005040304,"Census Tract 403.04, Bronx County, New York",1280,77,1203,1178,3796,23867,0,2009,1387,51,189,52,131,54,997,1203,524
2019,36005040304,"Census Tract 403.04, Bronx County, New York",1298,82,1216,1190,3496,25089,0,2009,1373,40.8,158,37,186,46,1022,1216,485
2020,36005040304,"Census Tract 403.04, Bronx County, New York",1273,71,1202,1177,3115,30378,0,2009,1380,36.4,273,24,250,36,981,1202,412
2012,36005040400,"Census Tract 404, Bronx County, New York",1052,91,961,408,1264,23750,1941,2004,1185,50,74,31,322,0,55,961,208
2013,36005040400,"Census Tract 404, Bronx County, New York",1118,90,1028,539,1477,31339,1945,2007,1172,50,96,18,417,0,52,1028,196
2014,36005040400,"Census Tract 404, Bronx County, New York",1136,117,1019,599,1708,30565,1939,2006,1233,50,116,22,483,0,75,1019,198
2015,36005040400,"Census Tract 404, Bronx County, New York",1125,124,1001,565,1416,27019,1939,2007,1208,50,109,24,444,0,80,1001,200
2016,36005040400,"Census Tract 404, Bronx County, New York",1152,85,1067,568,1433,33879,1939,2009,1184,44.7,161,23,466,0,41,1067,144
2017,36005040400,"Census Tract 404, Bronx County, New York",1150,82,1068,514,1427,34063,1941,2010,1278,47.2,163,24,442,0,16,1068,154
2018,36005040400,"Census Tract 404, Bronx County, New York",1153,63,1090,516,1319,31692,0,2011,1304,47.8,153,26,437,0,45,1090,157
2019,36005040400,"Census Tract 404, Bronx County, New York",1184,63,1121,433,1011,31713,1950,2011,1447,46.2,103,9,363,0,28,1121,162
2020,36005040400,"Census Tract 404, Bronx County, New York",1180,80,1100,480,1211,45726,1953,2011,1567,24.4,114,8,359,0,64,1100,133
2012,36005040501,"Census Tract 405.01, Bronx County, New York",1465,281,1184,1056,3718,23636,1939,2004,1118,39.8,51,14,330,72,705,1184,440
2013,36005040501,"Census Tract 405.01, Bronx County, New York",1440,247,1193,1110,4029,24657,1939,2004,1171,44.5,61,4,291,72,789,1193,433
2014,36005040501,"Census Tract 405.01, Bronx County, New York",1470,215,1255,1151,3719,28109,1939,2007,1167,44,118,17,265,57,820,1255,403
2015,36005040501,"Census Tract 405.01, Bronx County, New York",1447,94,1353,1242,4145,33621,1939,2007,1189,40.5,124,23,287,81,868,1353,389
2016,36005040501,"Census Tract 405.01, Bronx County, New York",1449,91,1358,1272,4405,35610,1939,2008,1178,36.2,126,25,219,85,969,1358,429
2017,36005040501,"Census Tract 405.01, Bronx County, New York",1439,101,1338,1227,4159,35683,1939,2010,1184,35,119,18,166,76,1019,1338,322
2018,36005040501,"Census Tract 405.01, Bronx County, New York",1437,105,1332,1249,4140,37096,0,2009,1182,32.5,118,42,202,52,999,1332,368
2019,36005040501,"Census Tract 405.01, Bronx County, New York",1454,114,1340,1270,4146,37156,0,2010,1221,33.9,67,32,219,28,1045,1340,416
2020,36005040501,"Census Tract 405.01, Bronx County, New York",1413,74,1339,1262,3866,37111,0,2010,1315,34.9,131,31,158,20,1090,1339,363
2012,36005040502,"Census Tract 405.02, Bronx County, New York",2320,230,2090,2019,5830,19391,1939,2003,1095,50,214,47,642,40,1408,2090,920
2013,36005040502,"Census Tract 405.02, Bronx County, New York",2357,262,2095,2028,5429,19050,1939,2004,1114,50,248,49,688,65,1282,2095,888
2014,36005040502,"Census Tract 405.02, Bronx County, New York",2391,257,2134,2030,5203,20847,1939,2004,1146,50,229,41,746,13,1329,2134,838
2015,36005040502,"Census Tract 405.02, Bronx County, New York",2431,163,2268,2104,5342,22128,1939,2005,1116,50,219,17,694,57,1372,2268,867
2016,36005040502,"Census Tract 405.02, Bronx County, New York",2455,147,2308,2072,5686,21268,1939,2006,1117,48.9,249,16,685,61,1314,2308,912
2017,36005040502,"Census Tract 405.02, Bronx County, New York",2449,225,2224,1980,6096,26176,1939,2007,1175,40.8,285,16,718,38,1281,2224,718
2018,36005040502,"Census Tract 405.02, Bronx County, New York",2427,162,2265,2047,6319,30671,0,2008,1195,36.2,203,12,704,160,1262,2265,679
2019,36005040502,"Census Tract 405.02, Bronx County, New York",2498,147,2351,2109,6232,26582,0,2012,1261,44.2,242,10,570,120,1487,2351,791
2020,36005040502,"Census Tract 405.02, Bronx County, New York",2627,262,2365,2172,6367,45317,0,2011,1300,34.7,303,11,611,71,1560,2365,617
2012,36005040600,"Census Tract 406, Bronx County, New York",1294,197,1097,799,1783,30916,1939,2004,1143,36,99,21,682,0,110,1097,293
2013,36005040600,"Census Tract 406, Bronx County, New York",1298,202,1096,798,1897,30144,1939,2004,1144,34.8,75,0,714,0,98,1096,275
2014,36005040600,"Census Tract 406, Bronx County, New York",1284,196,1088,800,2291,26686,1939,2006,1149,41.5,64,0,626,0,174,1088,385
2015,36005040600,"Census Tract 406, Bronx County, New York",1343,159,1184,811,2407,41477,1939,2007,1205,33.8,102,0,626,9,176,1184,331
2016,36005040600,"Census Tract 406, Bronx County, New York",1308,159,1149,817,2526,41797,1939,2007,1212,33.3,166,0,687,9,121,1149,275
2017,36005040600,"Census Tract 406, Bronx County, New York",1278,147,1131,821,2922,44069,1939,2010,1423,41.8,204,0,681,10,130,1131,264
2018,36005040600,"Census Tract 406, Bronx County, New York",1316,128,1188,867,2879,38657,0,2011,1425,44.4,204,0,669,25,173,1188,324
2019,36005040600,"Census Tract 406, Bronx County, New York",1334,83,1251,859,2551,45313,0,2010,1562,41.7,228,0,680,27,152,1251,260
2020,36005040600,"Census Tract 406, Bronx County, New York",1334,44,1290,924,2715,34211,0,2011,1528,46,200,29,672,17,206,1290,241
2012,36005040701,"Census Tract 407.01, Bronx County, New York",1251,75,1176,1176,3667,31136,1939,2004,1174,44.6,205,101,275,25,751,1176,360
2013,36005040701,"Census Tract 407.01, Bronx County, New York",1245,104,1141,1141,3142,29479,1939,2004,1171,47.9,199,101,233,21,774,1141,348
2014,36005040701,"Census Tract 407.01, Bronx County, New York",1262,121,1141,1141,3260,31045,1939,2004,1145,47.8,168,87,219,8,808,1141,372
2015,36005040701,"Census Tract 407.01, Bronx County, New York",1270,109,1161,1161,3193,30354,1939,2005,1163,49.3,152,95,217,25,831,1161,375
2016,36005040701,"Census Tract 407.01, Bronx County, New York",1283,45,1238,1238,3140,36607,1939,2007,1206,39.8,178,102,179,33,921,1238,343
2017,36005040701,"Census Tract 407.01, Bronx County, New York",1281,52,1229,1229,3291,35785,1939,2008,1246,37.5,141,91,185,30,924,1229,348
2018,36005040701,"Census Tract 407.01, Bronx County, New York",1263,40,1223,1223,3259,34007,0,2009,1294,37.3,171,77,189,18,967,1223,386
2019,36005040701,"Census Tract 407.01, Bronx County, New York",1252,26,1226,1226,3111,34695,0,2011,1288,36,173,72,186,28,983,1226,381
2020,36005040701,"Census Tract 407.01, Bronx County, New York",1241,24,1217,1211,3074,42692,0,2013,1263,33.8,186,34,186,17,1017,1217,329
2012,36005040702,"Census Tract 407.02, Bronx County, New York",2580,181,2399,2269,6026,27872,1939,2003,1007,37.7,258,308,485,128,1393,2399,457
2013,36005040702,"Census Tract 407.02, Bronx County, New York",2650,107,2543,2427,6547,26197,1939,2004,1043,36.9,276,337,586,109,1490,2543,668
2014,36005040702,"Census Tract 407.02, Bronx County, New York",2722,176,2546,2468,6497,27457,1939,2006,1038,37.9,334,319,546,108,1598,2546,880
2015,36005040702,"Census Tract 407.02, Bronx County, New York",2747,135,2612,2573,7650,NA,1939,2007,1085,35.3,491,388,631,149,1551,2612,803
2016,36005040702,"Census Tract 407.02, Bronx County, New York",2761,111,2650,2612,6650,29691,1939,2008,1090,34.2,504,302,575,158,1673,2650,891
2017,36005040702,"Census Tract 407.02, Bronx County, New York",2758,157,2601,2524,6731,31778,1939,2010,1130,33.5,426,181,560,104,1717,2601,938
2018,36005040702,"Census Tract 407.02, Bronx County, New York",2762,138,2624,2498,6399,33750,0,2011,1199,33.2,408,146,488,80,1805,2624,700
2019,36005040702,"Census Tract 407.02, Bronx County, New York",2801,106,2695,2545,6460,34695,0,2012,1310,34,390,167,539,113,1745,2695,622
2020,36005040702,"Census Tract 407.02, Bronx County, New York",2895,141,2754,2656,6200,28250,0,2014,1314,34.5,235,132,632,53,1827,2754,773
2012,36005040800,"Census Tract 408, Bronx County, New York",1521,154,1367,1185,3579,30691,1941,2004,1134,37.7,174,25,890,44,246,1367,351
2013,36005040800,"Census Tract 408, Bronx County, New York",1528,138,1390,1217,3499,28036,1939,2004,1153,37.3,213,72,767,71,311,1390,375
2014,36005040800,"Census Tract 408, Bronx County, New York",1590,138,1452,1269,3442,26172,1939,2004,1174,44.9,241,59,832,38,337,1452,427
2015,36005040800,"Census Tract 408, Bronx County, New York",1617,111,1506,1335,3896,30160,1939,2007,1184,43.6,280,74,845,34,421,1506,439
2016,36005040800,"Census Tract 408, Bronx County, New York",1630,92,1538,1339,3942,30260,1941,2010,1219,41.4,246,62,935,0,423,1538,454
2017,36005040800,"Census Tract 408, Bronx County, New York",1665,73,1592,1344,3695,27937,1944,NA,1244,45.3,223,76,905,0,457,1592,525
2018,36005040800,"Census Tract 408, Bronx County, New York",1691,80,1611,1351,3588,22192,1944,2012,1306,47,189,69,868,0,466,1611,544
2019,36005040800,"Census Tract 408, Bronx County, New York",1722,65,1657,1386,3572,23774,0,2012,1306,47.7,164,90,869,0,497,1657,586
2020,36005040800,"Census Tract 408, Bronx County, New York",1786,53,1733,1508,3505,28000,1950,2013,1302,40.1,113,79,893,0,728,1733,495
2012,36005040900,"Census Tract 409, Bronx County, New York",1312,64,1248,1091,3385,54028,1973,1997,964,21.9,282,162,852,10,66,1248,70
2013,36005040900,"Census Tract 409, Bronx County, New York",1324,77,1247,1055,3183,49356,1973,2000,946,21.6,280,98,810,29,117,1247,118
2014,36005040900,"Census Tract 409, Bronx County, New York",1336,38,1298,1095,2999,48924,1973,1997,997,25.1,279,93,866,33,76,1298,171
2015,36005040900,"Census Tract 409, Bronx County, New York",1384,64,1320,1079,2522,45881,1973,1999,986,25.9,258,85,847,28,101,1320,201
2016,36005040900,"Census Tract 409, Bronx County, New York",1465,69,1396,1079,2439,44356,1972,2001,1043,28.9,287,91,854,26,108,1396,216
2017,36005040900,"Census Tract 409, Bronx County, New York",1468,60,1408,1066,2395,45170,1972,2002,1133,29.4,259,91,837,27,132,1408,223
2018,36005040900,"Census Tract 409, Bronx County, New York",1466,57,1409,1062,2392,46579,1972,2001,1204,28.6,246,111,855,0,118,1409,207
2019,36005040900,"Census Tract 409, Bronx County, New York",1458,71,1387,1067,2491,49525,1972,2003,1231,27.5,278,149,772,6,148,1387,191
2020,36005040900,"Census Tract 409, Bronx County, New York",1415,40,1375,1012,2600,57826,1970,2003,1318,26.4,302,147,761,6,111,1375,115
2012,36005041100,"Census Tract 411, Bronx County, New York",1171,35,1136,981,2457,38859,1939,2004,1195,38.4,175,245,209,0,584,1136,262
2013,36005041100,"Census Tract 411, Bronx County, New York",1190,30,1160,1009,2770,30542,1939,2004,1227,50,131,195,238,19,645,1160,396
2014,36005041100,"Census Tract 411, Bronx County, New York",1188,74,1114,943,2577,31650,1939,2006,1299,39.9,186,118,290,28,590,1114,321
2015,36005041100,"Census Tract 411, Bronx County, New York",1215,78,1137,978,2589,NA,1939,2008,1311,38.4,236,125,308,31,601,1137,277
2016,36005041100,"Census Tract 411, Bronx County, New York",1248,88,1160,1038,2910,36481,1942,2010,1334,36.4,247,182,295,35,644,1160,342
2017,36005041100,"Census Tract 411, Bronx County, New York",1296,110,1186,1036,3089,36034,1939,2010,1312,39.1,193,190,231,49,640,1186,360
2018,36005041100,"Census Tract 411, Bronx County, New York",1327,119,1208,1091,3466,37758,0,2012,1343,36.8,216,192,179,32,729,1208,338
2019,36005041100,"Census Tract 411, Bronx County, New York",1354,123,1231,1091,3144,37861,0,2013,1331,39.8,182,202,237,32,700,1231,328
2020,36005041100,"Census Tract 411, Bronx County, New York",1335,50,1285,1139,3213,36604,0,2012,1338,45,181,184,261,35,722,1285,368
2012,36005041300,"Census Tract 413, Bronx County, New York",3030,75,2955,2759,7221,34450,1939,2003,1111,34.7,520,475,465,115,1836,2955,775
2013,36005041300,"Census Tract 413, Bronx County, New York",3009,164,2845,2662,6472,31353,1939,2002,1056,31,409,432,474,150,1716,2845,801
2014,36005041300,"Census Tract 413, Bronx County, New York",2966,108,2858,2713,7071,36822,1939,2004,1129,33,418,328,458,243,1781,2858,658
2015,36005041300,"Census Tract 413, Bronx County, New York",2956,154,2802,2632,6917,36843,1939,2007,1161,33.8,463,354,416,177,1735,2802,640
2016,36005041300,"Census Tract 413, Bronx County, New York",3036,162,2874,2728,6874,38629,1942,2008,1208,32.9,522,285,425,174,1881,2874,665
2017,36005041300,"Census Tract 413, Bronx County, New York",3080,162,2918,2791,7353,43516,1941,2010,1230,32.7,686,221,557,175,1958,2918,739
2018,36005041300,"Census Tract 413, Bronx County, New York",3130,201,2929,2830,7846,47174,0,2012,1313,33.8,645,245,581,123,2012,2929,815
2019,36005041300,"Census Tract 413, Bronx County, New York",3187,222,2965,2830,8165,51080,0,2012,1324,31.3,639,284,561,40,2059,2965,764
2020,36005041300,"Census Tract 413, Bronx County, New York",3330,261,3069,2858,8212,54476,0,2013,1395,29.8,620,226,445,38,2243,3069,779
2012,36005041400,"Census Tract 414, Bronx County, New York",1843,171,1672,959,2870,47871,1945,2003,1126,31,251,56,635,23,236,1672,186
2013,36005041400,"Census Tract 414, Bronx County, New York",1817,196,1621,885,2281,47821,1942,2004,1182,30.9,190,32,620,11,213,1621,180
2014,36005041400,"Census Tract 414, Bronx County, New York",1827,202,1625,906,2300,50813,1939,2005,1196,30.3,206,54,663,13,167,1625,172
2015,36005041400,"Census Tract 414, Bronx County, New York",1783,212,1571,835,2104,45807,1943,2006,1254,34,190,55,627,0,152,1571,228
2016,36005041400,"Census Tract 414, Bronx County, New York",1791,174,1617,886,2152,43958,1941,2008,1292,34.9,228,71,648,19,151,1617,160
2017,36005041400,"Census Tract 414, Bronx County, New York",1781,180,1601,949,2367,38324,1939,2011,1362,42.3,194,65,647,26,224,1601,212
2018,36005041400,"Census Tract 414, Bronx County, New York",1789,93,1696,977,2469,33750,0,2012,1370,40.6,242,50,644,26,268,1696,238
2019,36005041400,"Census Tract 414, Bronx County, New York",1817,81,1736,1111,2722,33125,0,2013,1335,41,247,32,801,29,248,1736,273
2020,36005041400,"Census Tract 414, Bronx County, New York",1821,34,1787,1162,2800,42828,0,2013,1482,42.3,403,160,631,86,268,1787,221
2012,36005041500,"Census Tract 415, Bronx County, New York",2322,197,2125,2011,5355,40492,1939,2004,1129,36.6,377,304,564,90,1137,2125,498
2013,36005041500,"Census Tract 415, Bronx County, New York",2322,204,2118,2017,5567,35043,1939,2005,1195,37.9,450,287,515,83,1222,2118,479
2014,36005041500,"Census Tract 415, Bronx County, New York",2352,145,2207,2107,5248,33406,1939,2006,1187,39.1,430,274,483,81,1353,2207,574
2015,36005041500,"Census Tract 415, Bronx County, New York",2337,92,2245,2105,5572,40488,1939,2009,1208,36.5,490,230,470,27,1353,2245,477
2016,36005041500,"Census Tract 415, Bronx County, New York",2374,80,2294,2181,5807,47445,1939,2010,1290,34.1,378,195,465,21,1474,2294,486
2017,36005041500,"Census Tract 415, Bronx County, New York",2415,92,2323,2220,6017,48718,1939,2010,1335,35.4,387,201,436,21,1533,2323,478
2018,36005041500,"Census Tract 415, Bronx County, New York",2450,120,2330,2192,5778,45633,0,2011,1331,34.9,408,228,397,0,1503,2330,542
2019,36005041500,"Census Tract 415, Bronx County, New York",2479,140,2339,2247,6162,42775,0,2011,1367,36.6,367,214,390,58,1572,2339,651
2020,36005041500,"Census Tract 415, Bronx County, New York",2525,100,2425,2362,5966,43558,0,2013,1415,35.6,388,287,365,44,1697,2425,767
2012,36005041800,"Census Tract 418, Bronx County, New York",1292,52,1240,993,3024,32038,1939,2004,1079,34.3,56,47,564,34,335,1240,300
2013,36005041800,"Census Tract 418, Bronx County, New York",1288,27,1261,1037,3198,34281,1939,2004,1126,33.5,102,40,618,11,324,1261,375
2014,36005041800,"Census Tract 418, Bronx County, New York",1316,35,1281,1056,3016,34405,1939,2005,1179,33.3,146,11,576,0,440,1281,439
2015,36005041800,"Census Tract 418, Bronx County, New York",1318,38,1280,1010,3328,29250,1939,2006,1258,39.8,196,19,597,29,390,1280,434
2016,36005041800,"Census Tract 418, Bronx County, New York",1316,21,1295,1066,3467,36184,1939,2007,1351,33.8,224,29,619,52,369,1295,409
2017,36005041800,"Census Tract 418, Bronx County, New York",1329,22,1307,1043,3232,39177,1939,2010,1427,40.2,257,24,589,67,396,1307,394
2018,36005041800,"Census Tract 418, Bronx County, New York",1290,19,1271,1027,2911,34338,1943,2011,1406,43.9,254,46,554,89,329,1271,348
2019,36005041800,"Census Tract 418, Bronx County, New York",1298,24,1274,952,2604,32162,1941,2011,1482,44.3,234,42,475,89,316,1274,329
2020,36005041800,"Census Tract 418, Bronx County, New York",1233,25,1208,918,2374,51094,0,2010,1616,32.5,155,44,440,114,275,1208,175
2012,36005041900,"Census Tract 419, Bronx County, New York",2609,153,2456,2390,6086,35577,1939,2001,1086,32,700,461,549,125,1273,2456,632
2013,36005041900,"Census Tract 419, Bronx County, New York",2599,64,2535,2449,6459,34834,1939,2002,1140,32.1,562,412,544,199,1390,2535,679
2014,36005041900,"Census Tract 419, Bronx County, New York",2572,28,2544,2439,6599,36283,1939,2004,1137,32.8,583,396,570,227,1357,2544,635
2015,36005041900,"Census Tract 419, Bronx County, New York",2566,42,2524,2424,6590,NA,1939,2005,1169,29.7,578,440,515,183,1416,2524,538
2016,36005041900,"Census Tract 419, Bronx County, New York",2599,64,2535,2411,6588,36306,1939,2007,1191,34.4,687,314,459,203,1567,2535,652
2017,36005041900,"Census Tract 419, Bronx County, New York",2604,127,2477,2407,6675,33106,1939,2010,1228,37.9,624,350,485,127,1612,2477,679
2018,36005041900,"Census Tract 419, Bronx County, New York",2639,169,2470,2409,6364,32212,0,2010,1304,43.6,630,341,485,63,1578,2470,735
2019,36005041900,"Census Tract 419, Bronx County, New York",2682,213,2469,2443,5697,35568,0,2011,1343,39.9,671,335,456,170,1608,2469,705
2020,36005041900,"Census Tract 419, Bronx County, New York",2611,146,2465,2429,5747,33930,0,2013,1341,42.2,643,275,413,220,1568,2465,710
2012,36005042000,"Census Tract 420, Bronx County, New York",1424,147,1277,1153,3183,40188,1939,2003,1114,32.7,135,83,627,52,445,1277,371
2013,36005042000,"Census Tract 420, Bronx County, New York",1410,126,1284,1155,3106,29489,1939,2004,1127,41.2,127,65,689,31,413,1284,458
2014,36005042000,"Census Tract 420, Bronx County, New York",1461,109,1352,1181,2865,23467,1939,2005,1113,41.3,110,77,639,43,456,1352,490
2015,36005042000,"Census Tract 420, Bronx County, New York",1471,74,1397,1212,2939,23952,1939,2006,1119,36.4,97,33,656,43,502,1397,474
2016,36005042000,"Census Tract 420, Bronx County, New York",1482,72,1410,1208,2874,32500,1950,2008,1134,34.3,147,32,677,22,498,1410,393
2017,36005042000,"Census Tract 420, Bronx County, New York",1520,44,1476,1280,2860,26250,1956,2010,1174,36.8,133,30,749,12,533,1476,442
2018,36005042000,"Census Tract 420, Bronx County, New York",1532,49,1483,1339,3043,28240,1945,2011,1237,37.2,196,12,756,26,595,1483,448
2019,36005042000,"Census Tract 420, Bronx County, New York",1512,34,1478,1356,3466,38203,1947,2012,1313,36.2,255,22,830,47,540,1478,390
2020,36005042000,"Census Tract 420, Bronx County, New York",1686,32,1654,1560,3619,29808,0,2012,1344,45,274,20,794,35,753,1654,571
2012,36005042100,"Census Tract 421, Bronx County, New York",2433,206,2227,2188,5777,51500,1939,2001,1074,30.3,520,469,302,267,1155,2227,554
2013,36005042100,"Census Tract 421, Bronx County, New York",2454,260,2194,2150,5836,50237,1939,2003,1092,30.9,509,392,341,208,1233,2194,580
2014,36005042100,"Census Tract 421, Bronx County, New York",2400,270,2130,2088,5538,38221,1939,2004,1111,34.1,522,370,369,282,1114,2130,590
2015,36005042100,"Census Tract 421, Bronx County, New York",2382,283,2099,2043,5416,36137,1943,2007,1102,37.3,556,225,425,252,1178,2099,623
2016,36005042100,"Census Tract 421, Bronx County, New York",2351,233,2118,2087,5408,30787,1946,2008,1090,40.8,609,160,470,271,1249,2118,678
2017,36005042100,"Census Tract 421, Bronx County, New York",2389,150,2239,2155,5629,31760,1955,2009,1080,35,598,182,439,276,1331,2239,763
2018,36005042100,"Census Tract 421, Bronx County, New York",2300,151,2149,2056,5439,34731,1957,2010,1185,34,526,187,488,270,1180,2149,678
2019,36005042100,"Census Tract 421, Bronx County, New York",2334,186,2148,2026,5287,37037,0,2011,1170,33.7,543,202,527,215,1133,2148,596
2020,36005042100,"Census Tract 421, Bronx County, New York",2156,118,2038,1907,5156,42957,0,2010,1233,31.3,595,212,392,208,1179,2038,555
2012,36005042200,"Census Tract 422, Bronx County, New York",1141,38,1103,568,1404,33235,1957,2005,1162,36.3,75,25,454,0,128,1103,159
2013,36005042200,"Census Tract 422, Bronx County, New York",1159,67,1092,580,1523,37024,1956,2004,1242,33.1,75,16,449,0,155,1092,144
2014,36005042200,"Census Tract 422, Bronx County, New York",1145,101,1044,550,1516,53047,1958,2005,1247,30.8,86,9,431,0,109,1044,134
2015,36005042200,"Census Tract 422, Bronx County, New York",1184,96,1088,555,1538,36823,1956,2007,1298,36.3,72,8,408,0,146,1088,186
2016,36005042200,"Census Tract 422, Bronx County, New York",1172,119,1053,505,1452,33227,1952,2008,1198,42.1,65,7,361,0,122,1053,163
2017,36005042200,"Census Tract 422, Bronx County, New York",1216,113,1103,563,1667,35764,1951,2009,1239,42.4,64,0,377,0,171,1103,140
2018,36005042200,"Census Tract 422, Bronx County, New York",1234,131,1103,565,1555,35253,1949,2011,1231,47.6,59,0,407,0,150,1103,163
2019,36005042200,"Census Tract 422, Bronx County, New York",1255,87,1168,636,1735,36415,1945,2012,1194,43.5,103,0,433,0,200,1168,173
2020,36005042200,"Census Tract 422, Bronx County, New York",1259,106,1153,603,1408,45378,1942,2014,1267,36.8,73,0,373,0,211,1153,87
2012,36005042300,"Census Tract 423, Bronx County, New York",1469,15,1454,1336,3612,34286,1942,2003,1164,32.9,284,268,306,102,693,1454,368
2013,36005042300,"Census Tract 423, Bronx County, New York",1465,11,1454,1327,3731,28438,1944,2004,1197,37,267,333,342,136,571,1454,415
2014,36005042300,"Census Tract 423, Bronx County, New York",1487,25,1462,1397,3929,36343,1942,2006,1218,33.9,408,288,281,88,784,1462,432
2015,36005042300,"Census Tract 423, Bronx County, New York",1476,22,1454,1409,4258,30744,1942,2009,1204,36.7,352,241,284,91,834,1454,534
2016,36005042300,"Census Tract 423, Bronx County, New York",1494,67,1427,1377,4064,32064,1939,2010,1177,39,376,216,283,132,839,1427,544
2017,36005042300,"Census Tract 423, Bronx County, New York",1501,64,1437,1383,4324,34336,1941,2010,1224,40.7,381,206,260,101,908,1437,559
2018,36005042300,"Census Tract 423, Bronx County, New York",1466,98,1368,1300,4084,36969,1941,2010,1311,37.2,338,180,197,90,874,1368,472
2019,36005042300,"Census Tract 423, Bronx County, New York",1453,116,1337,1294,4036,38056,1940,2010,1372,38.6,289,209,211,87,844,1337,450
2020,36005042300,"Census Tract 423, Bronx County, New York",1427,138,1289,1259,3867,45651,1941,2011,1415,33.8,315,250,196,65,785,1289,320
2012,36005042400,"Census Tract 424, Bronx County, New York",840,53,787,404,1316,36771,1939,2005,1228,45.7,55,0,294,6,66,787,127
2013,36005042400,"Census Tract 424, Bronx County, New York",817,14,803,415,1425,31250,1939,2006,1220,48.1,76,0,330,5,28,803,142
2014,36005042400,"Census Tract 424, Bronx County, New York",870,40,830,431,1241,30458,1939,2007,1174,47.6,81,0,334,6,51,830,167
2015,36005042400,"Census Tract 424, Bronx County, New York",860,63,797,374,1082,33056,1939,2007,1267,44.2,67,0,309,15,55,797,122
2016,36005042400,"Census Tract 424, Bronx County, New York",863,55,808,364,1090,34375,1943,2008,1275,40.6,67,0,310,10,44,808,137
2017,36005042400,"Census Tract 424, Bronx County, New York",867,63,804,335,832,40347,1952,2009,1267,40.9,79,0,268,14,53,804,125
2018,36005042400,"Census Tract 424, Bronx County, New York",894,50,844,333,770,42917,1954,2010,1263,41.4,90,0,264,11,58,844,122
2019,36005042400,"Census Tract 424, Bronx County, New York",892,59,833,328,839,62262,1949,2009,1402,29,93,0,279,4,45,833,86
2020,36005042400,"Census Tract 424, Bronx County, New York",840,42,798,336,1035,60167,1951,2013,1446,32.2,95,0,254,0,82,798,72
2012,36005042500,"Census Tract 425, Bronx County, New York",2286,130,2156,2003,6525,35946,1939,2004,1164,37.2,237,388,410,39,1126,2156,638
2013,36005042500,"Census Tract 425, Bronx County, New York",2267,102,2165,2029,5997,30165,1939,2004,1148,39.4,333,375,404,88,1137,2165,715
2014,36005042500,"Census Tract 425, Bronx County, New York",2295,123,2172,2012,6054,31354,1939,2005,1194,40.4,315,379,325,44,1227,2172,756
2015,36005042500,"Census Tract 425, Bronx County, New York",2289,103,2186,2074,5744,NA,1939,2006,1211,45.4,440,363,291,59,1304,2186,719
2016,36005042500,"Census Tract 425, Bronx County, New York",2251,79,2172,2054,6128,28026,1939,2008,1247,45.5,349,349,240,99,1383,2172,725
2017,36005042500,"Census Tract 425, Bronx County, New York",2259,80,2179,2085,5657,25778,1939,2007,1234,42.8,414,302,220,151,1411,2179,783
2018,36005042500,"Census Tract 425, Bronx County, New York",2275,145,2130,2074,6197,33026,0,2010,1342,37.5,474,149,323,130,1478,2130,781
2019,36005042500,"Census Tract 425, Bronx County, New York",2240,147,2093,2037,6011,31326,0,2011,1327,41.6,500,212,328,211,1289,2093,687
2020,36005042500,"Census Tract 425, Bronx County, New York",2256,206,2050,2026,6111,36705,0,2011,1330,36.5,433,281,299,177,1279,2050,556
2012,36005042600,"Census Tract 426, Bronx County, New York",2183,118,2065,532,1617,29868,1960,2005,1531,50,97,0,532,0,27,2065,291
2013,36005042600,"Census Tract 426, Bronx County, New York",2216,116,2100,600,2192,33667,1966,2005,1575,50,139,0,547,0,53,2100,286
2014,36005042600,"Census Tract 426, Bronx County, New York",2172,124,2048,687,2451,36208,1966,2006,1554,44.8,132,0,600,0,98,2048,331
2015,36005042600,"Census Tract 426, Bronx County, New York",2170,168,2002,753,2619,39078,1965,2006,1532,44.3,167,67,621,0,79,2002,314
2016,36005042600,"Census Tract 426, Bronx County, New York",2128,121,2007,693,2434,41849,1964,2005,1479,37.9,146,60,566,0,75,2007,242
2017,36005042600,"Census Tract 426, Bronx County, New York",2174,172,2002,750,2552,59602,1963,2007,1614,26.6,253,79,588,0,96,2002,210
2018,36005042600,"Census Tract 426, Bronx County, New York",2185,174,2011,757,2172,58438,1961,2010,1625,29.3,273,102,655,0,10,2011,245
2019,36005042600,"Census Tract 426, Bronx County, New York",2170,142,2028,704,2106,81486,1960,2010,1774,25.5,249,121,583,0,0,2028,156
2020,36005042600,"Census Tract 426, Bronx County, New York",2265,87,2178,909,2415,85612,1943,2016,1713,24.3,262,0,761,0,148,2178,250
2012,36005042800,"Census Tract 428, Bronx County, New York",740,51,689,189,604,58520,1946,2004,1183,23.7,20,0,189,0,0,689,41
2013,36005042800,"Census Tract 428, Bronx County, New York",744,33,711,245,719,59028,1952,2006,1303,24.5,47,0,221,0,28,711,55
2014,36005042800,"Census Tract 428, Bronx County, New York",741,45,696,265,776,57566,1953,2007,1327,26.4,54,0,244,0,20,696,45
2015,36005042800,"Census Tract 428, Bronx County, New York",729,55,674,229,663,42250,1954,2010,1250,39.7,57,0,187,0,42,674,41
2016,36005042800,"Census Tract 428, Bronx County, New York",730,50,680,229,658,41250,1954,2010,1336,40.1,48,0,193,0,37,680,58
2017,36005042800,"Census Tract 428, Bronx County, New York",741,33,708,244,724,43704,1956,2011,1363,36.9,35,0,207,0,40,708,58
2018,36005042800,"Census Tract 428, Bronx County, New York",755,39,716,245,662,53417,1955,2008,1502,35.3,35,0,227,0,12,716,60
2019,36005042800,"Census Tract 428, Bronx County, New York",746,31,715,245,659,62574,1953,2008,1572,34.3,27,0,224,0,13,715,67
2020,36005042800,"Census Tract 428, Bronx County, New York",784,22,762,239,614,47361,1952,2006,1594,33.3,41,7,221,0,0,762,69
2012,36005042901,"Census Tract 429.01, Bronx County, New York",1268,86,1182,1115,2960,35390,1939,2003,1074,38.3,175,241,286,73,533,1182,403
2013,36005042901,"Census Tract 429.01, Bronx County, New York",1262,78,1184,1109,2904,37109,1939,2003,1115,37.9,225,214,298,38,590,1184,365
2014,36005042901,"Census Tract 429.01, Bronx County, New York",1275,104,1171,1087,3519,37473,1939,2005,1164,37.8,269,232,175,115,594,1171,423
2015,36005042901,"Census Tract 429.01, Bronx County, New York",1271,73,1198,1087,3641,NA,1939,2006,1173,37.3,287,213,227,105,582,1198,366
2016,36005042901,"Census Tract 429.01, Bronx County, New York",1275,16,1259,1167,3781,40433,1939,2008,1222,37.9,282,189,286,95,662,1259,334
2017,36005042901,"Census Tract 429.01, Bronx County, New York",1283,18,1265,1166,3706,41053,1939,2010,1296,37.8,274,184,246,81,707,1265,339
2018,36005042901,"Census Tract 429.01, Bronx County, New York",1262,22,1240,1156,3659,38472,0,2011,1340,43.3,260,182,225,117,710,1240,390
2019,36005042901,"Census Tract 429.01, Bronx County, New York",1275,20,1255,1151,3062,36181,0,2011,1311,40.6,216,115,215,81,824,1255,320
2020,36005042901,"Census Tract 429.01, Bronx County, New York",1341,22,1319,1249,2905,31563,0,2014,1472,41.5,210,136,169,153,864,1319,396
2012,36005042902,"Census Tract 429.02, Bronx County, New York",1511,136,1375,1232,3161,26912,1939,2003,1091,44.5,137,137,397,22,743,1375,427
2013,36005042902,"Census Tract 429.02, Bronx County, New York",1549,61,1488,1358,3532,25793,1939,2004,1095,41.9,172,106,505,21,791,1488,487
2014,36005042902,"Census Tract 429.02, Bronx County, New York",1565,70,1495,1348,3541,23239,1939,2008,1159,47.8,256,68,504,40,745,1495,491
2015,36005042902,"Census Tract 429.02, Bronx County, New York",1609,17,1592,1500,4203,NA,1940,2010,1212,45.7,313,79,474,39,921,1592,523
2016,36005042902,"Census Tract 429.02, Bronx County, New York",1640,14,1626,1509,4169,26354,1939,2010,1233,46.2,337,67,496,38,938,1626,578
2017,36005042902,"Census Tract 429.02, Bronx County, New York",1659,12,1647,1502,4047,25763,1939,2011,1295,50,344,81,455,26,954,1647,612
2018,36005042902,"Census Tract 429.02, Bronx County, New York",1647,48,1599,1442,3769,28904,0,2011,1354,48.8,320,97,570,36,797,1599,536
2019,36005042902,"Census Tract 429.02, Bronx County, New York",1690,32,1658,1537,3698,30069,0,2012,1389,46.4,305,129,593,23,854,1658,492
2020,36005042902,"Census Tract 429.02, Bronx County, New York",1677,29,1648,1518,3495,36176,0,2013,1403,46,349,97,568,26,891,1648,437
2012,36005043000,"Census Tract 430, Bronx County, New York",1068,43,1025,368,819,22414,1946,2000,875,34.2,82,19,266,0,49,1025,205
2013,36005043000,"Census Tract 430, Bronx County, New York",1054,40,1014,374,905,29688,1943,2001,913,33.8,90,43,257,0,42,1014,167
2014,36005043000,"Census Tract 430, Bronx County, New York",1076,39,1037,409,1071,37888,1947,2003,954,30.8,106,51,278,0,47,1037,129
2015,36005043000,"Census Tract 430, Bronx County, New York",1079,38,1041,469,1247,36956,1953,2003,944,31.1,114,29,318,0,91,1041,110
2016,36005043000,"Census Tract 430, Bronx County, New York",1076,26,1050,430,1232,39464,1955,2005,1016,32.9,66,49,322,0,34,1050,92
2017,36005043000,"Census Tract 430, Bronx County, New York",1076,87,989,426,1370,39415,1954,2006,1009,34.1,0,43,282,0,70,989,109
2018,36005043000,"Census Tract 430, Bronx County, New York",1090,78,1012,358,1248,38542,1952,2010,1196,40.3,31,10,239,0,60,1012,145
2019,36005043000,"Census Tract 430, Bronx County, New York",1083,60,1023,287,962,35052,1952,2013,1573,51,20,12,193,0,36,1023,202
2020,36005043000,"Census Tract 430, Bronx County, New York",1270,53,1217,517,1471,72868,1954,2015,1493,28,164,11,336,0,31,1217,325
2012,36005043100,"Census Tract 431, Bronx County, New York",3587,245,3342,3066,9451,28598,1947,2002,1081,45.4,449,225,1047,224,1519,3342,1008
2013,36005043100,"Census Tract 431, Bronx County, New York",3582,300,3282,3014,9607,29643,1948,2003,1126,44.3,582,151,857,220,1681,3282,984
2014,36005043100,"Census Tract 431, Bronx County, New York",3622,304,3318,3162,9555,31553,1947,2003,1158,40.1,606,140,919,289,1740,3318,899
2015,36005043100,"Census Tract 431, Bronx County, New York",3625,229,3396,3314,9708,30750,1942,2004,1162,39.8,581,167,895,311,1905,3396,1211
2016,36005043100,"Census Tract 431, Bronx County, New York",3648,122,3526,3406,9688,28250,1942,2005,1181,42.5,650,136,880,363,2045,3526,1331
2017,36005043100,"Census Tract 431, Bronx County, New York",3637,111,3526,3412,9612,29338,1944,2006,1262,40.1,743,172,777,331,2189,3526,1359
2018,36005043100,"Census Tract 431, Bronx County, New York",3620,71,3549,3354,9787,32339,1943,2006,1317,40.6,671,192,756,335,2131,3549,1262
2019,36005043100,"Census Tract 431, Bronx County, New York",3640,61,3579,3359,9249,34798,0,2009,1345,42.4,711,252,823,268,2049,3579,1129
2020,36005043101,"Census Tract 431.01, Bronx County, New York",1757,0,1757,1706,5490,34631,0,2012,1338,34.3,434,192,616,164,861,1757,423
2020,36005043102,"Census Tract 431.02, Bronx County, New York",1813,57,1756,1527,3593,29034,0,2011,1384,51,242,126,375,31,955,1756,476
2012,36005043400,"Census Tract 434, Bronx County, New York",1341,65,1276,1069,2801,32383,1939,2004,1110,34.1,128,114,687,56,207,1276,284
2013,36005043400,"Census Tract 434, Bronx County, New York",1300,87,1213,1023,2646,31373,1939,2005,1153,36.2,163,100,662,56,203,1213,268
2014,36005043400,"Census Tract 434, Bronx County, New York",1348,86,1262,972,2462,35806,1939,2005,1171,38.4,164,89,616,34,206,1262,232
2015,36005043400,"Census Tract 434, Bronx County, New York",1340,77,1263,921,2277,31629,1939,2006,1181,42.2,165,80,572,12,227,1263,235
2016,36005043400,"Census Tract 434, Bronx County, New York",1324,67,1257,909,2439,30472,1939,2009,1211,45,173,43,516,36,293,1257,244
2017,36005043400,"Census Tract 434, Bronx County, New York",1300,68,1232,838,2194,30139,1939,2009,1278,46.1,215,28,479,38,293,1232,234
2018,36005043400,"Census Tract 434, Bronx County, New York",1333,76,1257,843,2198,27134,0,2011,1344,51,192,23,505,35,311,1257,264
2019,36005043400,"Census Tract 434, Bronx County, New York",1345,77,1268,908,2428,50227,0,2013,1384,36.6,261,26,551,59,302,1268,223
2020,36005043400,"Census Tract 434, Bronx County, New York",1422,58,1364,814,2086,51103,0,2013,1327,29.5,242,0,477,49,294,1364,257
2012,36005043500,"Census Tract 435, Bronx County, New York",12,0,12,0,0,NA,NA,NA,NA,NA,0,0,0,0,0,12,0
2013,36005043500,"Census Tract 435, Bronx County, New York",20,4,16,0,0,NA,NA,NA,NA,NA,0,0,0,0,0,16,0
2014,36005043500,"Census Tract 435, Bronx County, New York",26,5,21,11,45,43750,2011,2011,708,13.4,0,0,11,0,0,21,0
2015,36005043500,"Census Tract 435, Bronx County, New York",22,5,17,17,52,42750,1959,2012,744,14.7,0,0,17,0,0,17,0
2016,36005043500,"Census Tract 435, Bronx County, New York",28,4,24,24,62,NA,2012,2013,800,40,0,0,16,0,8,24,8
2017,36005043500,"Census Tract 435, Bronx County, New York",63,4,59,59,165,41042,2012,2013,903,28.8,10,0,37,0,28,59,17
2018,36005043500,"Census Tract 435, Bronx County, New York",144,0,144,144,361,NA,2012,2015,970,45.9,15,0,89,0,42,144,73
2019,36005043500,"Census Tract 435, Bronx County, New York",219,0,219,219,499,27813,2012,2015,983,42.6,30,0,111,0,80,219,96
2020,36005043501,"Census Tract 435.01, Bronx County, New York",336,0,336,336,757,32500,2012,2016,1067,44,55,0,177,27,136,336,121
2020,36005043502,"Census Tract 435.02, Bronx County, New York",0,0,0,0,0,NA,NA,NA,NA,NA,0,0,0,0,0,0,0
2020,36005043503,"Census Tract 435.03, Bronx County, New York",0,0,0,0,0,NA,NA,NA,NA,NA,0,0,0,0,0,0,0
2012,36005043600,"Census Tract 436, Bronx County, New York",727,33,694,344,820,43603,1943,2004,1472,38.8,46,27,283,0,51,694,112
2013,36005043600,"Census Tract 436, Bronx County, New York",725,47,678,310,763,26667,1939,2005,1219,44.3,44,39,264,0,24,678,89
2014,36005043600,"Census Tract 436, Bronx County, New York",752,30,722,318,773,21111,1939,2006,1139,50,84,54,234,0,30,722,126
2015,36005043600,"Census Tract 436, Bronx County, New York",724,27,697,276,682,26471,1939,2007,1208,43.7,66,25,188,0,46,697,110
2016,36005043600,"Census Tract 436, Bronx County, New York",731,18,713,292,645,37143,1943,2008,1329,34.2,66,21,190,0,58,713,99
2017,36005043600,"Census Tract 436, Bronx County, New York",729,25,704,260,610,48333,1944,2009,1254,31.9,77,24,195,0,14,704,65
2018,36005043600,"Census Tract 436, Bronx County, New York",732,15,717,351,750,51354,1943,2009,1309,30.5,154,0,289,0,34,717,121
2019,36005043600,"Census Tract 436, Bronx County, New York",733,16,717,354,814,29593,1943,2013,1301,41.5,84,28,264,0,0,717,153
2020,36005043600,"Census Tract 436, Bronx County, New York",717,17,700,312,675,43722,0,2015,1253,32.2,102,30,260,0,0,700,156
2012,36005044200,"Census Tract 442, Bronx County, New York",1285,73,1212,653,1595,27899,1949,2004,1011,48.2,93,26,507,0,132,1212,286
2013,36005044200,"Census Tract 442, Bronx County, New York",1275,40,1235,683,1642,28375,1947,2004,1111,50,77,22,548,0,113,1235,325
2014,36005044200,"Census Tract 442, Bronx County, New York",1316,55,1261,779,1833,22098,1939,2007,1135,50,53,15,549,0,215,1261,299
2015,36005044200,"Census Tract 442, Bronx County, New York",1270,73,1197,742,1989,17455,1940,2009,1151,50,93,17,515,0,204,1197,342
2016,36005044200,"Census Tract 442, Bronx County, New York",1295,73,1222,795,2049,NA,1942,2011,1198,50,78,16,607,0,163,1222,374
2017,36005044200,"Census Tract 442, Bronx County, New York",1316,49,1267,768,1798,NA,1942,2012,1303,49.4,61,11,538,0,221,1267,302
2018,36005044200,"Census Tract 442, Bronx County, New York",1370,52,1318,884,2416,33302,1942,2013,1390,44.6,205,10,651,0,244,1318,386
2019,36005044200,"Census Tract 442, Bronx County, New York",1404,58,1346,851,2335,29704,1942,2014,1387,44.9,218,0,601,0,255,1346,398
2020,36005044200,"Census Tract 442, Bronx County, New York",1372,60,1312,647,1811,37019,0,2015,1471,46.8,222,0,450,0,226,1312,549
2012,36005044400,"Census Tract 444, Bronx County, New York",1368,70,1298,583,1631,53398,1953,2003,1401,32.4,133,8,487,0,112,1298,204
2013,36005044400,"Census Tract 444, Bronx County, New York",1364,95,1269,579,1679,55074,1949,2004,1459,31.7,126,0,507,0,122,1269,180
2014,36005044400,"Census Tract 444, Bronx County, New York",1348,111,1237,532,1524,45000,1949,2005,1444,33.1,128,16,457,0,59,1237,199
2015,36005044400,"Census Tract 444, Bronx County, New York",1343,151,1192,503,1434,34766,1951,2006,1436,36.7,130,25,427,0,51,1192,196
2016,36005044400,"Census Tract 444, Bronx County, New York",1382,142,1240,517,1450,33750,1952,2007,1428,38,106,28,451,0,38,1240,231
2017,36005044400,"Census Tract 444, Bronx County, New York",1388,100,1288,511,1581,52361,1960,2008,1577,36,131,28,448,0,35,1288,166
2018,36005044400,"Census Tract 444, Bronx County, New York",1381,74,1307,522,1586,57917,1961,2009,1569,34.9,121,26,436,0,60,1307,166
2019,36005044400,"Census Tract 444, Bronx County, New York",1404,79,1325,493,1505,69107,1961,2009,1609,27.7,112,11,411,0,71,1325,103
2020,36005044400,"Census Tract 444, Bronx County, New York",1484,49,1435,549,1554,64408,1942,2005,1655,23.8,114,0,333,0,85,1435,228
2012,36005044800,"Census Tract 448, Bronx County, New York",704,24,680,171,489,45913,1949,2005,1738,42.1,89,0,137,0,27,680,27
2013,36005044800,"Census Tract 448, Bronx County, New York",712,36,676,140,374,19766,1947,2006,1704,50,62,0,112,0,26,676,41
2014,36005044800,"Census Tract 448, Bronx County, New York",694,51,643,154,362,19961,1959,2008,1605,45.7,63,0,130,0,22,643,33
2015,36005044800,"Census Tract 448, Bronx County, New York",697,30,667,164,436,46000,1965,2008,1605,24.4,84,0,140,0,20,667,27
2016,36005044800,"Census Tract 448, Bronx County, New York",704,51,653,179,439,55329,1965,2007,1598,23.8,106,0,157,0,18,653,30
2017,36005044800,"Census Tract 448, Bronx County, New York",707,67,640,143,340,81042,1965,2003,1622,21.4,105,0,121,0,16,640,34
2018,36005044800,"Census Tract 448, Bronx County, New York",706,61,645,165,353,103958,1962,2006,1596,18.5,117,15,121,0,23,645,35
2019,36005044800,"Census Tract 448, Bronx County, New York",714,60,654,153,499,155066,1972,2007,1741,14.2,96,14,132,0,0,654,28
2020,36005044800,"Census Tract 448, Bronx County, New York",747,86,661,201,507,NA,1992,2011,1239,35.5,77,12,181,0,0,661,100
2012,36005044901,"Census Tract 449.01, Bronx County, New York",896,125,771,399,752,60417,1950,2002,1022,24.4,134,302,25,0,63,771,39
2013,36005044901,"Census Tract 449.01, Bronx County, New York",873,164,709,361,688,61685,1951,2004,1157,25.4,150,282,0,0,66,709,46
2014,36005044901,"Census Tract 449.01, Bronx County, New York",847,124,723,396,751,62500,1952,2005,1244,26.1,144,293,0,0,80,723,84
2015,36005044901,"Census Tract 449.01, Bronx County, New York",809,92,717,419,731,62169,1948,2005,1198,25.5,149,324,9,0,55,717,104
2016,36005044901,"Census Tract 449.01, Bronx County, New York",766,74,692,405,717,62656,1948,2006,1249,26.3,145,348,13,0,32,692,120
2017,36005044901,"Census Tract 449.01, Bronx County, New York",832,72,760,458,808,64342,1949,2008,1331,26,175,357,31,0,50,760,115
2018,36005044901,"Census Tract 449.01, Bronx County, New York",842,19,823,484,846,59038,1946,2009,1331,30.4,167,363,36,0,63,823,132
2019,36005044901,"Census Tract 449.01, Bronx County, New York",863,19,844,463,821,65750,1944,2008,1372,30.3,143,351,38,0,74,844,98
2020,36005044901,"Census Tract 449.01, Bronx County, New York",805,39,766,397,717,54766,1941,2012,1515,35.3,173,317,26,0,26,766,61
2012,36005044902,"Census Tract 449.02, Bronx County, New York",943,101,842,694,1673,54000,1945,2003,1261,28.1,296,564,7,0,99,842,102
2013,36005044902,"Census Tract 449.02, Bronx County, New York",946,64,882,669,1705,54792,1950,2004,1320,28.9,309,566,0,0,83,882,102
2014,36005044902,"Census Tract 449.02, Bronx County, New York",942,87,855,640,1486,48250,1945,2005,1362,30.7,275,559,0,0,57,855,91
2015,36005044902,"Census Tract 449.02, Bronx County, New York",905,79,826,546,1246,50703,1945,2005,1312,31.4,241,487,0,0,59,826,69
2016,36005044902,"Census Tract 449.02, Bronx County, New York",890,59,831,531,1206,53828,1939,2009,1283,28.5,280,445,16,4,66,831,75
2017,36005044902,"Census Tract 449.02, Bronx County, New York",896,52,844,501,986,45125,1942,2009,1185,29,275,449,23,10,19,844,64
2018,36005044902,"Census Tract 449.02, Bronx County, New York",886,65,821,501,1059,52614,0,2010,1261,30.1,238,418,46,10,27,821,85
2019,36005044902,"Census Tract 449.02, Bronx County, New York",896,40,856,470,1059,70676,1944,2012,1335,26.7,231,371,48,12,39,856,98
2020,36005044902,"Census Tract 449.02, Bronx County, New York",907,25,882,568,1311,73333,1948,2014,1458,26.1,274,365,57,10,136,882,87
2012,36005045101,"Census Tract 451.01, Bronx County, New York",925,99,826,599,1085,59848,1949,2003,1256,24.3,148,519,22,12,46,826,42
2013,36005045101,"Census Tract 451.01, Bronx County, New York",923,142,781,581,1028,61313,1952,2004,1256,25.1,148,533,18,6,24,781,33
2014,36005045101,"Census Tract 451.01, Bronx County, New York",906,155,751,536,950,59208,1943,2006,1391,26.3,204,466,15,9,46,751,38
2015,36005045101,"Census Tract 451.01, Bronx County, New York",843,81,762,525,1004,60679,1946,2007,1379,24.4,217,420,21,29,55,762,31
2016,36005045101,"Census Tract 451.01, Bronx County, New York",816,74,742,498,976,65000,1943,2010,1419,24.2,242,401,17,31,49,742,36
2017,36005045101,"Census Tract 451.01, Bronx County, New York",825,70,755,507,993,63264,1946,2011,1488,26.2,236,413,13,33,48,755,44
2018,36005045101,"Census Tract 451.01, Bronx County, New York",842,88,754,512,958,87917,1942,2011,1476,24.6,251,403,21,23,65,754,27
2019,36005045101,"Census Tract 451.01, Bronx County, New York",839,94,745,480,833,84167,1946,2011,1461,24.1,259,397,24,28,31,745,22
2020,36005045101,"Census Tract 451.01, Bronx County, New York",951,92,859,626,953,53250,0,2010,1324,23,471,569,15,15,27,859,25
2012,36005045102,"Census Tract 451.02, Bronx County, New York",979,141,838,453,1010,54399,1950,2004,1195,24.5,118,359,4,12,78,838,38
2013,36005045102,"Census Tract 451.02, Bronx County, New York",974,110,864,493,1049,55150,1951,2005,1211,24.3,147,387,4,17,85,864,56
2014,36005045102,"Census Tract 451.02, Bronx County, New York",979,120,859,480,1036,52000,1953,2006,1254,28.7,174,394,5,19,62,859,60
2015,36005045102,"Census Tract 451.02, Bronx County, New York",938,79,859,494,1082,55962,1953,2007,1236,27.1,198,391,5,12,86,859,72
2016,36005045102,"Census Tract 451.02, Bronx County, New York",908,44,864,498,1039,82955,1953,2010,1399,22.9,245,425,11,3,59,864,20
2017,36005045102,"Census Tract 451.02, Bronx County, New York",882,35,847,492,869,65389,1954,2011,1392,24.6,227,426,8,24,34,847,39
2018,36005045102,"Census Tract 451.02, Bronx County, New York",878,40,838,490,845,68229,1952,2011,1472,24.3,243,407,33,20,30,838,23
2019,36005045102,"Census Tract 451.02, Bronx County, New York",878,9,869,515,902,68958,1952,2013,1505,23.7,287,385,49,15,66,869,34
2020,36005045102,"Census Tract 451.02, Bronx County, New York",864,9,855,516,1117,80205,1950,2015,1627,27.4,302,390,46,12,68,855,30
2012,36005045600,"Census Tract 456, Bronx County, New York",1096,47,1049,521,1559,35750,1959,2003,1287,39.8,147,21,333,0,141,1049,230
2013,36005045600,"Census Tract 456, Bronx County, New York",1076,76,1000,400,1100,32097,1961,2005,1281,41.1,103,21,246,0,84,1000,175
2014,36005045600,"Census Tract 456, Bronx County, New York",1054,95,959,347,966,24028,1958,2005,1354,50,75,27,188,0,102,959,180
2015,36005045600,"Census Tract 456, Bronx County, New York",1111,137,974,325,779,NA,1950,2008,1359,38.6,112,40,219,7,29,974,104
2016,36005045600,"Census Tract 456, Bronx County, New York",1136,181,955,280,681,22357,1943,2010,1398,50,87,45,179,1,55,955,56
2017,36005045600,"Census Tract 456, Bronx County, New York",1143,159,984,249,774,28042,1946,2011,1463,50,36,22,173,7,50,984,60
2018,36005045600,"Census Tract 456, Bronx County, New York",1152,131,1021,272,883,36250,1949,2012,1448,51,92,24,214,16,55,1021,38
2019,36005045600,"Census Tract 456, Bronx County, New York",1127,139,988,279,880,31385,1946,2012,1400,51,76,11,228,0,77,988,32
2020,36005045600,"Census Tract 456, Bronx County, New York",1172,95,1077,322,1003,92833,1949,2012,1992,24.8,97,0,217,0,145,1077,29
2012,36005045800,"Census Tract 458, Bronx County, New York",2167,109,2058,2058,6255,21561,1955,1998,550,27.3,189,15,1011,0,1103,2058,850
2013,36005045800,"Census Tract 458, Bronx County, New York",2098,135,1963,1963,5673,20691,1956,2001,525,28.7,190,42,905,0,1032,1963,894
2014,36005045800,"Census Tract 458, Bronx County, New York",2050,192,1858,1858,5287,19632,1955,2002,538,31.3,216,37,928,0,959,1858,910
2015,36005045800,"Census Tract 458, Bronx County, New York",2056,126,1930,1930,5243,16161,1955,2003,485,32.1,203,30,930,32,1083,1930,1084
2016,36005045800,"Census Tract 458, Bronx County, New York",2080,97,1983,1983,5211,19768,1954,2004,480,31.3,290,13,936,29,1166,1983,979
2017,36005045800,"Census Tract 458, Bronx County, New York",2080,85,1995,1995,5506,24421,1954,2003,502,30.3,175,13,915,27,1267,1995,883
2018,36005045800,"Census Tract 458, Bronx County, New York",2075,41,2034,2034,5605,24341,1953,2004,553,31,260,20,984,33,1262,2034,953
2019,36005045800,"Census Tract 458, Bronx County, New York",2058,18,2040,2040,5744,24341,1954,2003,483,30.5,183,24,927,28,1253,2040,853
2020,36005045800,"Census Tract 458, Bronx County, New York",2056,20,2036,2036,5538,26791,1954,2004,571,29.6,304,26,1055,0,1076,2036,749
2012,36005046000,"Census Tract 460, Bronx County, New York",1032,70,962,688,2048,38462,1958,2003,796,27.4,141,11,612,5,118,962,174
2013,36005046000,"Census Tract 460, Bronx County, New York",1000,91,909,690,1999,37791,1959,2004,858,28,159,9,573,4,177,909,184
2014,36005046000,"Census Tract 460, Bronx County, New York",1007,81,926,701,1667,38032,1960,2003,825,25.9,151,10,531,4,192,926,229
2015,36005046000,"Census Tract 460, Bronx County, New York",1024,82,942,732,1890,30071,1961,2006,898,29.1,132,6,488,4,276,942,294
2016,36005046000,"Census Tract 460, Bronx County, New York",1020,49,971,804,2091,29567,1963,2006,925,29,88,0,542,0,315,971,320
2017,36005046000,"Census Tract 460, Bronx County, New York",1044,50,994,773,2072,29146,1963,2006,930,28.3,101,0,473,0,342,994,330
2018,36005046000,"Census Tract 460, Bronx County, New York",1069,0,1069,876,2397,27941,1965,2007,799,28.7,108,15,590,0,358,1069,399
2019,36005046000,"Census Tract 460, Bronx County, New York",1072,51,1021,847,2483,30222,1967,2008,1305,29.9,129,24,635,0,298,1021,368
2020,36005046000,"Census Tract 460, Bronx County, New York",1051,50,1001,880,2426,36968,1963,2008,811,26.5,178,48,699,0,248,1001,350
2012,36005046201,"Census Tract 462.01, Bronx County, New York",12099,403,11696,5733,12391,38447,1966,1995,871,26.5,1425,1020,3236,98,1501,11696,1169
2013,36005046201,"Census Tract 462.01, Bronx County, New York",12489,398,12091,6832,15106,36687,1966,1997,900,27.9,1698,1092,3586,188,2072,12091,1227
2014,36005046201,"Census Tract 462.01, Bronx County, New York",12799,521,12278,7547,17045,41024,1967,1998,933,26.3,2078,1054,4097,130,2339,12278,1069
2015,36005046201,"Census Tract 462.01, Bronx County, New York",12840,524,12316,7634,17314,37870,1967,1997,930,27,1972,1135,4254,149,2174,12316,1032
2016,36005046201,"Census Tract 462.01, Bronx County, New York",12954,271,12683,7540,17271,39931,1967,1998,937,26,1838,1083,4095,163,2302,12683,960
2017,36005046201,"Census Tract 462.01, Bronx County, New York",13033,265,12768,7582,16436,38853,1967,2000,960,27,1564,1034,4035,161,2406,12768,1046
2018,36005046201,"Census Tract 462.01, Bronx County, New York",13028,201,12827,7440,15327,43174,1967,1999,994,26.1,1974,1213,4089,259,1866,12827,1212
2019,36005046201,"Census Tract 462.01, Bronx County, New York",13036,38,12998,7093,14021,40007,1966,1999,987,26.7,1399,1044,3753,302,1977,12998,1403
2012,36005046202,"Census Tract 462.02, Bronx County, New York",2661,217,2444,1681,4657,23839,1970,2003,721,35.1,240,11,1034,60,639,2444,604
2013,36005046202,"Census Tract 462.02, Bronx County, New York",2626,210,2416,1653,4551,23995,1971,2003,916,39.8,363,30,1070,43,557,2416,502
2014,36005046202,"Census Tract 462.02, Bronx County, New York",2644,146,2498,1689,4870,23653,1971,2003,985,39.1,363,41,1056,32,555,2498,587
2015,36005046202,"Census Tract 462.02, Bronx County, New York",2674,100,2574,1686,4941,25478,1971,2006,1150,40.6,223,13,1102,50,542,2574,633
2016,36005046202,"Census Tract 462.02, Bronx County, New York",2624,86,2538,1670,5151,24522,1969,2007,1058,33.9,257,14,1090,69,489,2538,712
2017,36005046202,"Census Tract 462.02, Bronx County, New York",2671,47,2624,1632,5081,25120,1965,2007,1138,30.8,295,16,1005,45,573,2624,666
2018,36005046202,"Census Tract 462.02, Bronx County, New York",2757,52,2705,1725,5408,26379,1965,2007,1162,28.2,236,0,996,46,703,2705,696
2019,36005046202,"Census Tract 462.02, Bronx County, New York",2804,84,2720,1772,5558,34776,1966,2009,1260,31.5,330,0,1121,56,637,2720,546
2020,36005046203,"Census Tract 462.03, Bronx County, New York",3193,0,3193,1657,2952,25982,1964,1992,925,29.7,348,508,359,0,686,3193,349
2020,36005046204,"Census Tract 462.04, Bronx County, New York",2424,0,2424,1155,3201,74893,1967,2006,1160,19.2,342,114,692,23,326,2424,168
2020,36005046205,"Census Tract 462.05, Bronx County, New York",1909,0,1909,1195,1899,31427,1967,2000,1041,33.4,275,0,629,187,457,1909,171
2020,36005046206,"Census Tract 462.06, Bronx County, New York",1998,0,1998,1152,1641,35455,1965,2003,872,30.6,199,269,613,0,270,1998,101
2020,36005046207,"Census Tract 462.07, Bronx County, New York",2977,0,2977,1026,2498,60851,1965,1994,1083,22.9,126,90,639,126,171,2977,518
2020,36005046208,"Census Tract 462.08, Bronx County, New York",1494,34,1460,831,2443,66048,1987,2012,1694,31.2,218,0,773,0,191,1460,162
2020,36005046209,"Census Tract 462.09, Bronx County, New York",1494,47,1447,1278,4075,29079,1964,2014,1027,32.1,338,0,755,51,393,1447,490
2012,36005048400,"Census Tract 484, Bronx County, New York",1239,117,1122,495,1430,49574,1985,2007,1381,32.4,132,17,430,31,30,1122,84
2013,36005048400,"Census Tract 484, Bronx County, New York",1249,125,1124,482,1242,66563,1988,2007,1318,23.5,142,8,452,0,36,1124,63
2014,36005048400,"Census Tract 484, Bronx County, New York",1288,114,1174,512,1347,68750,1990,2009,1396,23.7,154,10,472,11,42,1174,88
2015,36005048400,"Census Tract 484, Bronx County, New York",1296,72,1224,477,1454,68639,1993,2008,1353,24,153,0,423,11,69,1224,84
2016,36005048400,"Census Tract 484, Bronx County, New York",1303,109,1194,469,1409,65923,1985,2008,1445,29.7,122,0,395,11,87,1194,80
2017,36005048400,"Census Tract 484, Bronx County, New York",1330,96,1234,481,1522,66127,1975,2007,1374,27.7,99,0,384,10,104,1234,100
2018,36005048400,"Census Tract 484, Bronx County, New York",1327,81,1246,535,1726,65250,1972,2008,1348,27.9,141,7,432,9,107,1246,82
2019,36005048400,"Census Tract 484, Bronx County, New York",1359,76,1283,647,2081,68609,1971,2009,1438,27.4,145,7,478,0,124,1283,51
2020,36005048401,"Census Tract 484.01, Bronx County, New York",1345,73,1272,667,1924,62454,1967,2012,1394,30.6,155,8,451,0,149,1272,56
2020,36005048402,"Census Tract 484.02, Bronx County, New York",0,0,0,0,0,NA,NA,NA,NA,NA,0,0,0,0,0,0,0
2012,36005050400,"Census Tract 504, Bronx County, New York",20,11,9,7,18,NA,NA,NA,NA,NA,7,0,7,0,0,9,0
2013,36005050400,"Census Tract 504, Bronx County, New York",21,11,10,7,19,NA,NA,NA,NA,NA,7,0,7,0,0,10,0
2014,36005050400,"Census Tract 504, Bronx County, New York",26,11,15,8,20,NA,NA,NA,NA,NA,8,0,8,0,0,15,0
2015,36005050400,"Census Tract 504, Bronx County, New York",29,11,18,14,45,NA,1944,2004,964,32.5,7,0,10,0,7,18,0
2016,36005050400,"Census Tract 504, Bronx County, New York",32,11,21,16,45,NA,1945,2005,967,32.5,8,0,12,0,8,21,0
2017,36005050400,"Census Tract 504, Bronx County, New York",40,0,40,35,121,NA,1960,2016,875,23,0,0,16,0,35,40,13
2018,36005050400,"Census Tract 504, Bronx County, New York",54,0,54,50,202,NA,1958,2015,900,22.8,0,0,17,0,50,54,19
2019,36005050400,"Census Tract 504, Bronx County, New York",0,0,0,0,0,NA,NA,NA,NA,NA,0,0,0,0,0,0,0
2020,36005050400,"Census Tract 504, Bronx County, New York",0,0,0,0,0,NA,NA,NA,NA,NA,0,0,0,0,0,0,0
2012,36005051600,"Census Tract 516, Bronx County, New York",2101,123,1978,885,1213,26895,1960,2004,1276,35.9,340,686,0,14,185,1978,172
2013,36005051600,"Census Tract 516, Bronx County, New York",2150,153,1997,929,1366,41616,1939,2004,1311,29.7,437,781,16,0,132,1997,210
2014,36005051600,"Census Tract 516, Bronx County, New York",2216,154,2062,887,1268,63550,1939,2005,1336,27.7,407,776,19,0,92,2062,134
2015,36005051600,"Census Tract 516, Bronx County, New York",2136,223,1913,695,1117,NA,1939,2008,1365,29.3,342,630,16,17,32,1913,147
2016,36005051600,"Census Tract 516, Bronx County, New York",2106,327,1779,632,1053,NA,1946,2009,1226,31.1,256,467,19,32,114,1779,135
2017,36005051600,"Census Tract 516, Bronx County, New York",2059,206,1853,690,1385,46667,1952,2009,1257,29.7,267,484,21,31,131,1853,189
2018,36005051600,"Census Tract 516, Bronx County, New York",2041,264,1777,557,1159,45396,1963,2011,1170,30.9,220,414,0,34,86,1777,160
2019,36005051600,"Census Tract 516, Bronx County, New York",2095,244,1851,725,1776,44279,1951,2013,1426,36.1,366,316,0,37,352,1851,170
2020,36005051601,"Census Tract 516.01, Bronx County, New York",2058,184,1874,720,1616,49521,1958,2015,1439,34.2,345,332,0,14,319,1874,116
2020,36005051602,"Census Tract 516.02, Bronx County, New York",0,0,0,0,0,NA,NA,NA,NA,NA,0,0,0,0,0,0,0
2012,36047000100,"Census Tract 1, Kings County, New York",2451,332,2119,1020,1559,69239,1939,2002,1418,24.8,828,672,105,120,140,2119,174
2013,36047000100,"Census Tract 1, Kings County, New York",2455,349,2106,1067,1617,63750,1939,2003,1464,26.8,847,765,62,77,130,2106,224
2014,36047000100,"Census Tract 1, Kings County, New York",2458,369,2089,1099,1628,61083,1939,2004,1494,27.7,830,708,78,73,187,2089,174
2015,36047000100,"Census Tract 1, Kings County, New York",2446,284,2162,1127,1626,47774,1939,2006,1434,28.8,765,763,67,56,163,2162,172
2016,36047000100,"Census Tract 1, Kings County, New York",2427,226,2201,1194,1839,65957,1939,2009,1478,28.9,874,803,57,155,85,2201,156
2017,36047000100,"Census Tract 1, Kings County, New York",2441,257,2184,1140,1892,69737,1939,2010,1899,31.1,790,755,50,161,80,2184,136
2018,36047000100,"Census Tract 1, Kings County, New York",2495,163,2332,1242,2076,82791,1948,2011,1914,27.1,757,735,201,182,68,2332,143
2019,36047000100,"Census Tract 1, Kings County, New York",2490,186,2304,1131,1868,90917,1945,2011,1659,25.8,753,732,178,159,35,2304,127
2020,36047000100,"Census Tract 1, Kings County, New York",2649,280,2369,1191,1997,101307,1951,2013,1433,18.2,850,708,180,150,148,2369,118
2012,36047000200,"Census Tract 2, Kings County, New York",416,59,357,270,981,33810,1939,2005,1241,37.1,20,26,23,20,211,357,95
2013,36047000200,"Census Tract 2, Kings County, New York",430,59,371,327,1392,32865,1939,2005,1228,39.9,5,11,21,0,300,371,100
2014,36047000200,"Census Tract 2, Kings County, New York",425,71,354,296,1300,33452,1939,2006,1286,41.6,5,8,20,0,275,354,108
2015,36047000200,"Census Tract 2, Kings County, New York",449,28,421,356,1578,33333,1939,2006,1344,43.8,6,8,22,0,333,421,142
2016,36047000200,"Census Tract 2, Kings County, New York",441,27,414,338,1380,47955,1939,2005,1327,37.1,25,15,0,6,312,414,117
2017,36047000200,"Census Tract 2, Kings County, New York",418,41,377,315,1288,34097,1939,2005,1235,39.3,33,13,0,14,281,377,112
2018,36047000200,"Census Tract 2, Kings County, New York",408,47,361,297,1034,37788,0,2005,1241,39.8,41,33,0,15,249,361,109
2019,36047000200,"Census Tract 2, Kings County, New York",375,44,331,281,978,55966,0,2007,1497,34.6,64,46,0,15,220,331,96
2020,36047000200,"Census Tract 2, Kings County, New York",366,26,340,296,831,52325,1950,2003,1689,35,71,55,0,14,227,340,117
2012,36047000301,"Census Tract 3.01, Kings County, New York",2391,272,2119,1001,1500,77841,1939,2003,1729,19.8,751,913,30,4,54,2119,96
2013,36047000301,"Census Tract 3.01, Kings County, New York",2319,373,1946,932,1556,71591,1939,2003,1903,25.4,688,814,22,7,70,1946,68
2014,36047000301,"Census Tract 3.01, Kings County, New York",2252,407,1845,799,1406,78355,1939,2006,1996,23.6,594,716,0,0,64,1845,59
2015,36047000301,"Census Tract 3.01, Kings County, New York",2275,416,1859,832,1730,109118,1939,2009,1955,23,570,669,22,46,72,1859,119
2016,36047000301,"Census Tract 3.01, Kings County, New York",2271,395,1876,776,1648,135283,1939,2011,2023,23.4,532,614,19,36,54,1876,96
2017,36047000301,"Census Tract 3.01, Kings County, New York",2191,326,1865,649,1513,150375,1939,2011,2321,23.9,526,479,17,51,43,1865,81
2018,36047000301,"Census Tract 3.01, Kings County, New York",2163,290,1873,618,1301,152278,0,2012,2223,20.1,518,475,23,62,20,1873,90
2019,36047000301,"Census Tract 3.01, Kings County, New York",2103,295,1808,668,1261,123375,0,2012,2201,23.9,573,548,24,53,0,1808,124
2020,36047000301,"Census Tract 3.01, Kings County, New York",2026,240,1786,787,1453,157212,0,2015,2695,22,727,706,15,13,11,1786,78
2012,36047000501,"Census Tract 5.01, Kings County, New York",1927,154,1773,884,1597,77838,1939,2005,1886,26,711,735,69,23,57,1773,152
2013,36047000501,"Census Tract 5.01, Kings County, New York",1948,167,1781,963,1702,77979,1939,2007,1980,26,662,747,89,34,93,1781,182
2014,36047000501,"Census Tract 5.01, Kings County, New York",1982,163,1819,995,1821,87917,1939,2008,1902,24.7,702,780,99,60,56,1819,132
2015,36047000501,"Census Tract 5.01, Kings County, New York",2024,226,1798,991,1848,89152,1939,2010,1853,24.8,681,735,85,84,98,1798,142
2016,36047000501,"Census Tract 5.01, Kings County, New York",2007,232,1775,991,1817,118893,1939,2010,1894,23.1,662,726,65,107,95,1775,143
2017,36047000501,"Census Tract 5.01, Kings County, New York",2008,236,1772,1006,1739,121548,1939,2011,1859,23.3,684,700,42,145,120,1772,149
2018,36047000501,"Census Tract 5.01, Kings County, New York",1996,208,1788,962,1606,123578,0,2011,1909,22.4,723,705,35,131,100,1788,125
2019,36047000501,"Census Tract 5.01, Kings County, New York",1963,194,1769,962,1500,115313,0,2012,2035,25.7,701,668,28,156,109,1769,163
2020,36047000501,"Census Tract 5.01, Kings County, New York",2070,136,1934,811,1290,126092,0,2015,2315,25.3,658,563,23,132,77,1934,124
2012,36047000502,"Census Tract 5.02, Kings County, New York",1667,284,1383,865,1280,89464,1939,2003,1746,25.2,717,734,40,50,0,1383,44
2013,36047000502,"Census Tract 5.02, Kings County, New York",1702,263,1439,788,1197,90625,1939,2005,1904,28.2,657,598,33,80,30,1439,71
2014,36047000502,"Census Tract 5.02, Kings County, New York",1674,218,1456,821,1286,73625,1939,2005,1910,29.7,657,647,61,73,32,1456,125
2015,36047000502,"Census Tract 5.02, Kings County, New York",1675,205,1470,839,1290,90223,1939,2007,1979,28,744,601,82,107,36,1470,121
2016,36047000502,"Census Tract 5.02, Kings County, New York",1672,144,1528,1016,1604,100185,1939,2009,1998,23.4,922,787,89,90,46,1528,137
2017,36047000502,"Census Tract 5.02, Kings County, New York",1677,117,1560,964,1518,105208,1939,2010,2067,24.2,868,766,74,70,49,1560,109
2018,36047000502,"Census Tract 5.02, Kings County, New York",1655,133,1522,955,1431,106779,0,2010,2239,23.8,836,791,88,53,22,1522,91
2019,36047000502,"Census Tract 5.02, Kings County, New York",1639,105,1534,870,1361,150852,0,2012,2317,20.6,804,756,47,52,27,1534,30
2020,36047000502,"Census Tract 5.02, Kings County, New York",1534,70,1464,914,1504,149808,0,2014,2262,21.6,845,830,21,48,26,1464,37
2012,36047000700,"Census Tract 7, Kings County, New York",2087,253,1834,1131,1819,100787,1939,2005,1871,23.5,998,877,62,79,64,1834,82
2013,36047000700,"Census Tract 7, Kings County, New York",2169,269,1900,1066,1823,113306,1939,2006,1909,22.8,954,904,36,21,56,1900,91
2014,36047000700,"Census Tract 7, Kings County, New York",2186,286,1900,1172,1961,128030,1939,2009,2001,23.5,1064,847,32,106,139,1900,90
2015,36047000700,"Census Tract 7, Kings County, New York",2141,178,1963,1157,2073,123110,1939,2011,2138,23.8,1032,863,32,130,132,1963,106
2016,36047000700,"Census Tract 7, Kings County, New York",2111,232,1879,1079,2144,126027,1939,2010,2115,24.3,939,758,31,132,148,1879,113
2017,36047000700,"Census Tract 7, Kings County, New York",2063,282,1781,991,2086,131728,1939,2011,2336,24.2,894,722,22,115,122,1781,112
2018,36047000700,"Census Tract 7, Kings County, New York",2087,312,1775,1088,2211,135357,0,2012,2358,23.6,952,786,23,119,150,1775,147
2019,36047000700,"Census Tract 7, Kings County, New York",2004,367,1637,925,2003,133194,0,2013,2356,20,789,766,12,37,88,1637,153
2020,36047000700,"Census Tract 7, Kings County, New York",2028,359,1669,978,2100,149565,0,2015,2700,21.6,859,855,10,10,82,1669,134
2012,36047000900,"Census Tract 9, Kings County, New York",2212,94,2118,1488,2620,82727,1977,2006,2001,24.7,1278,1227,49,103,89,2118,197
2013,36047000900,"Census Tract 9, Kings County, New York",2167,117,2050,1422,2638,106500,1972,2007,2001,22.8,1234,1168,32,114,57,2050,152
2014,36047000900,"Census Tract 9, Kings County, New York",2103,176,1927,1284,2322,108409,1974,2010,2001,23.7,1108,937,64,175,79,1927,116
2015,36047000900,"Census Tract 9, Kings County, New York",2089,221,1868,1234,2324,116603,1971,2011,2460,24.4,1097,869,35,217,84,1868,115
2016,36047000900,"Census Tract 9, Kings County, New York",2158,265,1893,1279,2415,145125,1973,2012,2722,24.3,1196,947,42,202,70,1893,112
2017,36047000900,"Census Tract 9, Kings County, New York",2218,265,1953,1271,2508,161356,1980,2013,3045,23.7,1193,957,67,171,62,1953,105
2018,36047000900,"Census Tract 9, Kings County, New York",2289,241,2048,1282,2505,164200,1985,2014,3057,23.9,1212,943,88,159,109,2048,123
2019,36047000900,"Census Tract 9, Kings County, New York",2254,156,2098,1362,2665,168298,1999,2016,3087,24.2,1275,1079,53,104,126,2098,101
2020,36047000900,"Census Tract 9, Kings County, New York",2389,105,2284,1570,2763,156705,1969,2017,3077,22.4,1494,1112,62,67,86,2284,34
2012,36047001100,"Census Tract 11, Kings County, New York",211,0,211,200,342,103095,2004,2011,2001,28.6,161,126,10,48,4,211,15
2013,36047001100,"Census Tract 11, Kings County, New York",359,46,313,313,580,120208,2006,2011,2001,24.8,274,198,51,48,4,313,15
2014,36047001100,"Census Tract 11, Kings County, New York",443,61,382,382,701,103500,2009,2011,2001,27.5,341,245,41,56,22,382,22
2015,36047001100,"Census Tract 11, Kings County, New York",603,62,541,541,967,107946,2008,NA,2682,28.4,468,338,59,90,30,541,44
2016,36047001100,"Census Tract 11, Kings County, New York",689,79,610,590,1097,113281,2010,NA,2867,28.4,544,359,73,99,49,610,45
2017,36047001100,"Census Tract 11, Kings County, New York",752,97,655,638,1215,125714,2011,2014,2947,27.4,557,404,66,79,78,655,70
2018,36047001100,"Census Tract 11, Kings County, New York",836,79,757,730,1319,135167,NA,2014,3042,26.1,649,467,44,99,85,757,63
2019,36047001100,"Census Tract 11, Kings County, New York",917,107,810,764,1369,137337,2011,2015,3180,26.1,666,446,72,133,79,810,72
2020,36047001100,"Census Tract 11, Kings County, New York",931,113,818,734,1364,160500,NA,2016,3222,24.5,657,448,61,116,87,818,60
2012,36047001300,"Census Tract 13, Kings County, New York",1030,124,906,194,458,86071,1957,2003,1707,23,134,123,23,38,10,906,33
2013,36047001300,"Census Tract 13, Kings County, New York",1038,155,883,134,319,98182,1957,2003,1765,23.1,107,90,17,27,0,883,18
2014,36047001300,"Census Tract 13, Kings County, New York",1045,157,888,149,380,100114,1958,2004,1963,24.1,112,80,26,37,6,888,16
2015,36047001300,"Census Tract 13, Kings County, New York",1068,192,876,153,337,87109,1957,2007,2188,27.4,137,95,23,29,6,876,21
2016,36047001300,"Census Tract 13, Kings County, New York",1053,166,887,142,312,86528,1957,2010,2204,29,125,85,27,24,14,887,23
2017,36047001300,"Census Tract 13, Kings County, New York",1059,145,914,119,228,92386,1957,2012,2198,26.8,103,64,27,23,12,914,31
2018,36047001300,"Census Tract 13, Kings County, New York",1049,117,932,107,215,94063,1958,2012,2266,28,91,58,25,13,16,932,33
2019,36047001300,"Census Tract 13, Kings County, New York",1084,171,913,97,155,96875,1957,2012,2439,29.1,76,59,21,11,11,913,40
2020,36047001300,"Census Tract 13, Kings County, New York",1212,191,1021,202,326,NA,18,2020,3501,34.3,154,112,20,29,25,1021,140
2012,36047001500,"Census Tract 15, Kings County, New York",2613,851,1762,1531,3246,55208,1961,2008,1731,26.8,809,517,496,263,250,1762,341
2013,36047001500,"Census Tract 15, Kings County, New York",2970,895,2075,1705,3534,64958,1995,2011,1878,27.1,940,562,521,372,246,2075,368
2014,36047001500,"Census Tract 15, Kings County, New York",3189,815,2374,1896,3993,66905,2001,2011,2001,27.3,1070,673,532,351,313,2374,382
2015,36047001500,"Census Tract 15, Kings County, New York",3246,619,2627,2125,4674,66079,2001,2011,2156,26.7,1204,720,616,335,417,2627,465
2016,36047001500,"Census Tract 15, Kings County, New York",3190,406,2784,2215,4951,68674,2000,NA,2253,26,1316,737,624,433,372,2784,432
2017,36047001500,"Census Tract 15, Kings County, New York",3511,326,3185,2556,5807,72683,2001,2013,2500,25.7,1650,857,662,574,435,3185,564
2018,36047001500,"Census Tract 15, Kings County, New York",3921,257,3664,3078,6513,71923,2004,2014,2688,26.9,1943,1039,893,554,533,3664,742
2019,36047001500,"Census Tract 15, Kings County, New York",4493,305,4188,3662,7609,69309,2007,2016,2805,26.9,2391,1205,1013,880,528,4188,849
2020,36047001501,"Census Tract 15.01, Kings County, New York",2479,189,2290,2183,4584,71023,2002,2015,2624,27.3,1239,621,891,288,372,2290,461
2020,36047001502,"Census Tract 15.02, Kings County, New York",2370,140,2230,1817,3211,90788,18,2017,3159,29.5,1535,585,213,757,230,2230,522
2012,36047001800,"Census Tract 18, Kings County, New York",0,0,0,0,0,NA,NA,NA,NA,NA,0,0,0,0,0,0,0
2013,36047001800,"Census Tract 18, Kings County, New York",0,0,0,0,0,NA,NA,NA,NA,NA,0,0,0,0,0,0,0
2014,36047001800,"Census Tract 18, Kings County, New York",0,0,0,0,0,NA,NA,NA,NA,NA,0,0,0,0,0,0,0
2015,36047001800,"Census Tract 18, Kings County, New York",0,0,0,0,0,NA,NA,NA,NA,NA,0,0,0,0,0,0,0
2016,36047001800,"Census Tract 18, Kings County, New York",0,0,0,0,0,NA,NA,NA,NA,NA,0,0,0,0,0,0,0
2017,36047001800,"Census Tract 18, Kings County, New York",0,0,0,0,0,NA,NA,NA,NA,NA,0,0,0,0,0,0,0
2018,36047001800,"Census Tract 18, Kings County, New York",0,0,0,0,0,NA,NA,NA,NA,NA,0,0,0,0,0,0,0
2019,36047001800,"Census Tract 18, Kings County, New York",0,0,0,0,0,NA,NA,NA,NA,NA,0,0,0,0,0,0,0
2020,36047001801,"Census Tract 18.01, Kings County, New York",0,0,0,0,0,NA,NA,NA,NA,NA,0,0,0,0,0,0,0
2020,36047001802,"Census Tract 18.02, Kings County, New York",0,0,0,0,0,NA,NA,NA,NA,NA,0,0,0,0,0,0,0
2020,36047001803,"Census Tract 18.03, Kings County, New York",0,0,0,0,0,NA,NA,NA,NA,NA,0,0,0,0,0,0,0
2020,36047001804,"Census Tract 18.04, Kings County, New York",0,0,0,0,0,NA,NA,NA,NA,NA,0,0,0,0,0,0,0
2012,36047002000,"Census Tract 20, Kings County, New York",529,61,468,276,922,34167,1939,2004,1314,36.4,23,23,11,27,215,468,78
2013,36047002000,"Census Tract 20, Kings County, New York",494,70,424,270,805,38500,1939,2004,1321,28.2,24,29,18,4,228,424,41
2014,36047002000,"Census Tract 20, Kings County, New York",494,61,433,304,898,51087,1939,2003,1366,27.2,44,31,27,5,253,433,45
2015,36047002000,"Census Tract 20, Kings County, New York",481,68,413,320,1023,54750,1939,2003,1425,28.9,54,28,13,25,262,413,68
2016,36047002000,"Census Tract 20, Kings County, New York",457,94,363,305,1049,51442,1939,2001,1299,31.9,40,14,14,21,264,363,83
2017,36047002000,"Census Tract 20, Kings County, New York",455,74,381,316,1025,57500,1939,2004,1199,25.3,40,9,38,22,278,381,75
2018,36047002000,"Census Tract 20, Kings County, New York",494,87,407,317,1082,40341,0,2007,1321,35.8,53,13,33,29,268,407,114
2019,36047002000,"Census Tract 20, Kings County, New York",464,71,393,306,1116,38214,0,2006,1250,38.2,66,10,26,26,270,393,134
2020,36047002000,"Census Tract 20, Kings County, New York",428,40,388,309,1248,39375,1956,2007,1336,34.3,57,26,31,0,283,388,125
2012,36047002100,"Census Tract 21, Kings County, New York",1667,215,1452,793,1660,133750,2001,2006,2001,22.2,628,635,0,33,125,1452,54
2013,36047002100,"Census Tract 21, Kings County, New York",1728,171,1557,838,1771,171944,2001,2009,2001,19.9,684,639,45,15,132,1557,34
2014,36047002100,"Census Tract 21, Kings County, New York",1777,202,1575,908,1832,185417,1990,2011,2001,19.3,708,766,29,11,90,1575,24
2015,36047002100,"Census Tract 21, Kings County, New York",1882,157,1725,1037,2229,182639,1993,2012,3213,19.9,826,858,47,37,76,1725,55
2016,36047002100,"Census Tract 21, Kings County, New York",2100,234,1866,1152,2460,177143,1990,2012,3261,20.9,976,955,64,61,56,1866,46
2017,36047002100,"Census Tract 21, Kings County, New York",2258,265,1993,1215,2614,178917,1953,NA,3300,21.6,1060,957,95,97,35,1993,42
2018,36047002100,"Census Tract 21, Kings County, New York",2366,254,2112,1231,2651,185380,1958,2014,3439,20.2,1092,1006,86,100,25,2112,47
2019,36047002100,"Census Tract 21, Kings County, New York",2502,342,2160,1275,2700,199861,2001,2015,3501,20.8,1195,1035,97,99,33,2160,61
2020,36047002100,"Census Tract 21, Kings County, New York",2444,382,2062,1093,2289,231091,2002,2016,3501,19.5,1072,869,98,95,32,2062,24
2012,36047002200,"Census Tract 22, Kings County, New York",1725,151,1574,1131,2939,33469,1939,2003,966,34.9,252,189,6,226,628,1574,314
2013,36047002200,"Census Tract 22, Kings County, New York",1726,150,1576,1153,3329,35074,1939,2003,1123,33.9,252,120,22,239,785,1576,365
2014,36047002200,"Census Tract 22, Kings County, New York",1697,110,1587,1144,3328,29024,1939,2004,1129,32.7,271,188,39,247,701,1587,435
2015,36047002200,"Census Tract 22, Kings County, New York",1741,83,1658,1204,3659,35000,1939,2005,1139,34.8,243,171,43,228,798,1658,465
2016,36047002200,"Census Tract 22, Kings County, New York",1737,69,1668,1185,3624,41708,1949,2006,1184,30.7,216,168,46,163,839,1668,456
2017,36047002200,"Census Tract 22, Kings County, New York",1682,44,1638,1160,3525,37226,1955,2007,1259,35.1,169,184,53,167,782,1638,484
2018,36047002200,"Census Tract 22, Kings County, New York",1654,59,1595,1132,3460,41447,1954,2008,1300,32.9,197,181,78,183,708,1595,428
2019,36047002200,"Census Tract 22, Kings County, New York",1712,87,1625,1122,3381,41914,1960,2009,1370,31.6,200,206,99,155,662,1625,371
2020,36047002200,"Census Tract 22, Kings County, New York",1636,66,1570,1050,3126,41481,1960,2011,1448,31.8,252,269,87,115,579,1570,368
2012,36047002300,"Census Tract 23, Kings County, New York",1623,21,1602,1585,3650,16390,1954,2001,387,30.6,101,19,937,104,559,1602,756
2013,36047002300,"Census Tract 23, Kings County, New York",1607,46,1561,1551,3867,16839,1954,2001,387,28.1,129,26,882,106,570,1561,729
2014,36047002300,"Census Tract 23, Kings County, New York",1608,50,1558,1521,4281,20794,1953,2002,403,25.1,90,47,929,177,403,1558,705
2015,36047002300,"Census Tract 23, Kings County, New York",1619,60,1559,1531,4275,19405,1954,2002,429,26.2,70,42,966,155,405,1559,721
2016,36047002300,"Census Tract 23, Kings County, New York",1637,48,1589,1554,4335,18211,1954,2001,425,27.7,137,36,976,144,446,1589,769
2017,36047002300,"Census Tract 23, Kings County, New York",1644,43,1601,1560,4643,19777,1954,2000,428,26.8,187,34,910,157,484,1601,722
2018,36047002300,"Census Tract 23, Kings County, New York",1652,40,1612,1545,4227,19712,1954,2001,459,28.6,218,40,910,144,458,1612,751
2019,36047002300,"Census Tract 23, Kings County, New York",1671,49,1622,1564,4113,18433,1954,2002,488,30.4,239,25,891,127,531,1622,802
2020,36047002300,"Census Tract 23, Kings County, New York",1505,30,1475,1404,3997,19188,1954,2002,548,31.6,244,24,732,140,534,1475,736
2012,36047002901,"Census Tract 29.01, Kings County, New York",1360,208,1152,1142,2619,11196,1944,2002,326,31.5,94,0,769,83,293,1152,749
2013,36047002901,"Census Tract 29.01, Kings County, New York",1317,65,1252,1243,2924,12738,1945,2002,348,32.1,99,0,825,101,371,1252,800
2014,36047002901,"Census Tract 29.01, Kings County, New York",1301,63,1238,1221,2898,15081,1946,2001,386,29.7,78,0,759,129,392,1238,715
2015,36047002901,"Census Tract 29.01, Kings County, New York",1304,66,1238,1224,3039,17851,1946,2003,445,28.2,88,20,733,193,361,1238,618
2016,36047002901,"Census Tract 29.01, Kings County, New York",1325,18,1307,1298,3550,21335,1947,2002,509,27.5,88,22,794,170,380,1307,569
2017,36047002901,"Census Tract 29.01, Kings County, New York",1320,0,1320,1312,3759,23176,1947,2005,604,27.7,96,20,783,196,342,1320,542
2018,36047002901,"Census Tract 29.01, Kings County, New York",1349,0,1349,1327,4037,30208,1947,2006,673,27.1,112,33,800,216,218,1349,484
2019,36047002901,"Census Tract 29.01, Kings County, New York",1383,0,1383,1372,4031,29853,1945,2009,655,28.4,92,34,837,214,248,1383,509
2020,36047002901,"Census Tract 29.01, Kings County, New York",1493,22,1471,1459,4185,22887,1947,2010,612,30.9,117,24,898,228,226,1471,694
2012,36047003000,"Census Tract 30, Kings County, New York",740,17,723,312,748,51250,1939,2006,1342,29.5,211,205,28,49,20,723,53
2013,36047003000,"Census Tract 30, Kings County, New York",771,20,751,296,832,52417,1939,2007,1340,28.2,181,194,26,35,41,751,71
2014,36047003000,"Census Tract 30, Kings County, New York",729,36,693,247,768,51198,1939,2011,1315,25.5,124,153,27,15,46,693,87
2015,36047003000,"Census Tract 30, Kings County, New York",732,37,695,295,891,56250,1939,2011,1352,23.8,160,167,28,16,59,695,90
2016,36047003000,"Census Tract 30, Kings County, New York",707,18,689,301,849,65313,1939,2011,1423,24.7,163,136,22,33,71,689,53
2017,36047003000,"Census Tract 30, Kings County, New York",703,18,685,311,895,69676,1939,2011,1463,22.4,191,128,28,49,64,685,93
2018,36047003000,"Census Tract 30, Kings County, New York",699,69,630,295,695,80163,0,2011,1548,23.3,193,122,32,52,50,630,87
2019,36047003000,"Census Tract 30, Kings County, New York",763,51,712,301,587,83203,0,2011,1517,22.7,186,124,51,48,45,712,85
2020,36047003000,"Census Tract 30, Kings County, New York",736,52,684,319,627,72188,0,2012,1415,23.5,191,128,46,106,28,684,77
2012,36047003100,"Census Tract 31, Kings County, New York",1000,122,878,427,715,63028,1961,2003,1385,26.4,235,93,177,69,73,878,50
2013,36047003100,"Census Tract 31, Kings County, New York",1028,121,907,446,736,63050,1961,2004,1401,24.9,286,105,162,97,70,907,50
2014,36047003100,"Census Tract 31, Kings County, New York",1087,117,970,460,800,66875,1963,2005,1454,24.3,321,133,167,67,82,970,64
2015,36047003100,"Census Tract 31, Kings County, New York",1098,79,1019,461,899,66063,1966,2010,1661,26,354,159,130,79,89,1019,62
2016,36047003100,"Census Tract 31, Kings County, New York",1089,72,1017,420,883,66667,1971,2011,1905,26.4,360,179,123,74,47,1017,54
2017,36047003100,"Census Tract 31, Kings County, New York",1108,96,1012,343,716,74375,2010,2012,2234,26.9,308,175,70,63,33,1012,51
2018,36047003100,"Census Tract 31, Kings County, New York",1157,84,1073,401,886,128194,2011,2013,2675,26.7,347,253,58,36,42,1073,54
2019,36047003100,"Census Tract 31, Kings County, New York",1228,89,1139,507,1201,151705,2011,2015,2831,20.9,456,308,61,63,51,1139,67
2020,36047003101,"Census Tract 31.01, Kings County, New York",1367,110,1257,636,1434,155625,2012,2016,3219,21.2,498,388,42,132,53,1257,76
2020,36047003102,"Census Tract 31.02, Kings County, New York",0,0,0,0,0,NA,NA,NA,NA,NA,0,0,0,0,0,0,0
2012,36047003300,"Census Tract 33, Kings County, New York",1466,69,1397,1224,2236,83088,1939,2007,1835,29.5,851,738,129,116,215,1397,243
2013,36047003300,"Census Tract 33, Kings County, New York",1593,95,1498,1303,2396,85529,1939,2009,1973,28.3,887,785,166,134,206,1498,220
2014,36047003300,"Census Tract 33, Kings County, New York",1700,119,1581,1293,2334,98472,1939,2011,2001,27.1,895,757,182,132,199,1581,213
2015,36047003300,"Census Tract 33, Kings County, New York",1751,130,1621,1241,2273,103125,1947,2011,2099,25.9,821,683,191,104,237,1621,222
2016,36047003300,"Census Tract 33, Kings County, New York",1737,143,1594,1184,2179,111600,1972,2012,2266,24,817,631,222,81,239,1594,211
2017,36047003300,"Census Tract 33, Kings County, New York",1960,187,1773,1278,2319,116250,1988,2013,2625,24.6,941,646,365,87,168,1773,191
2018,36047003300,"Census Tract 33, Kings County, New York",2157,249,1908,1489,2696,132264,2002,2015,2728,24.8,1163,772,394,104,167,1908,202
2019,36047003300,"Census Tract 33, Kings County, New York",2395,235,2160,1775,3194,133551,2005,2016,2768,25.3,1330,747,581,212,173,2160,281
2020,36047003300,"Census Tract 33, Kings County, New York",2461,243,2218,1929,3642,134178,2007,NA,2850,23.4,1487,797,623,213,162,2218,268
2012,36047003400,"Census Tract 34, Kings County, New York",1436,87,1349,652,1621,86944,1939,2005,1345,23.4,328,514,0,53,85,1349,106
2013,36047003400,"Census Tract 34, Kings County, New York",1492,24,1468,763,1922,88366,1939,2005,1331,23,367,570,0,60,111,1468,116
2014,36047003400,"Census Tract 34, Kings County, New York",1503,57,1446,729,1548,44904,1939,2006,1368,29.1,317,599,12,25,60,1446,174
2015,36047003400,"Census Tract 34, Kings County, New York",1513,153,1360,621,1401,49511,1939,2006,1357,25.2,249,433,12,17,128,1360,180
2016,36047003400,"Census Tract 34, Kings County, New York",1488,215,1273,614,1277,49091,1939,2008,1315,26.8,290,382,24,28,165,1273,162
2017,36047003400,"Census Tract 34, Kings County, New York",1535,222,1313,632,1333,57222,1939,2009,1323,25.8,298,381,41,18,178,1313,178
2018,36047003400,"Census Tract 34, Kings County, New York",1490,253,1237,579,1373,51569,0,2009,1401,27.5,297,346,63,16,167,1237,229
2019,36047003400,"Census Tract 34, Kings County, New York",1431,209,1222,570,1419,72688,0,2011,1460,25.3,292,328,51,20,182,1222,187
2020,36047003400,"Census Tract 34, Kings County, New York",1430,125,1305,592,1573,72500,0,2013,1477,23.1,326,354,54,24,170,1305,137
2012,36047003500,"Census Tract 35, Kings County, New York",889,139,750,580,979,39485,1942,2003,955,29.9,210,88,356,31,95,750,23
2013,36047003500,"Census Tract 35, Kings County, New York",878,92,786,610,1038,45703,1946,2003,1116,32.7,286,153,308,54,86,786,52
2014,36047003500,"Census Tract 35, Kings County, New York",880,94,786,578,1079,48750,1939,2004,1285,32.5,348,156,304,39,56,786,64
2015,36047003500,"Census Tract 35, Kings County, New York",880,102,778,566,1025,55972,1939,2006,1297,31.4,339,177,310,18,63,778,75
2016,36047003500,"Census Tract 35, Kings County, New York",906,94,812,590,1073,51875,1939,2006,1202,29.9,312,168,330,5,83,812,99
2017,36047003500,"Census Tract 35, Kings County, New York",942,86,856,624,1147,70357,1939,2008,1383,26.5,387,216,310,7,70,856,94
2018,36047003500,"Census Tract 35, Kings County, New York",1073,105,968,703,1262,80913,1956,2010,1442,27.6,437,231,327,15,99,968,109
2019,36047003500,"Census Tract 35, Kings County, New York",1120,120,1000,776,1354,100833,1950,2013,1771,26.2,487,310,283,64,105,1000,102
2020,36047003500,"Census Tract 35, Kings County, New York",1198,83,1115,913,1578,128173,1967,2015,1970,24.6,588,351,309,98,134,1115,146
2012,36047003600,"Census Tract 36, Kings County, New York",1916,122,1794,1248,2730,52813,1939,2001,1222,27.9,471,838,43,78,262,1794,163
2013,36047003600,"Census Tract 36, Kings County, New York",1917,115,1802,1160,2694,48409,1939,2002,1280,28.6,431,733,42,117,239,1802,145
2014,36047003600,"Census Tract 36, Kings County, New York",1937,113,1824,1104,2669,56938,1939,2004,1360,28,522,725,37,103,189,1824,132
2015,36047003600,"Census Tract 36, Kings County, New York",1913,108,1805,1008,2516,57256,1939,2008,1381,26.6,627,683,41,67,161,1805,158
2016,36047003600,"Census Tract 36, Kings County, New York",1872,89,1783,932,2256,58529,1939,2009,1412,26.4,564,698,32,50,108,1783,178
2017,36047003600,"Census Tract 36, Kings County, New York",1879,65,1814,924,2078,55278,1939,2010,1425,30.5,503,760,21,46,77,1814,216
2018,36047003600,"Census Tract 36, Kings County, New York",1912,116,1796,912,1780,57417,0,2011,1450,30.2,498,766,19,19,98,1796,195
2019,36047003600,"Census Tract 36, Kings County, New York",1901,148,1753,942,1845,55000,0,2011,1496,29.5,470,727,30,65,110,1753,233
2020,36047003600,"Census Tract 36, Kings County, New York",1925,125,1800,1104,2037,61023,0,2010,1496,29.5,537,816,36,75,152,1800,265
2012,36047003700,"Census Tract 37, Kings County, New York",292,40,252,210,353,70081,1939,2009,1862,31.1,128,98,25,22,65,252,47
2013,36047003700,"Census Tract 37, Kings County, New York",395,27,368,314,559,74457,1967,2011,1848,24.6,250,224,3,19,68,368,48
2014,36047003700,"Census Tract 37, Kings County, New York",499,45,454,371,664,100859,2002,2011,2001,26.7,315,253,18,18,75,454,75
2015,36047003700,"Census Tract 37, Kings County, New York",587,40,547,427,798,93906,2005,2012,2581,27.1,363,297,17,24,71,547,78
2016,36047003700,"Census Tract 37, Kings County, New York",676,59,617,456,849,125500,2010,NA,2646,24.9,395,327,31,26,54,617,71
2017,36047003700,"Census Tract 37, Kings County, New York",623,51,572,412,819,130938,2010,2013,2755,24.6,376,329,36,11,12,572,41
2018,36047003700,"Census Tract 37, Kings County, New York",930,87,843,639,1243,145313,2012,2015,2866,24.1,583,436,84,59,31,843,61
2019,36047003700,"Census Tract 37, Kings County, New York",1318,134,1184,980,1829,151500,2014,2018,3198,23.7,856,618,136,107,78,1184,81
2020,36047003700,"Census Tract 37, Kings County, New York",1560,163,1397,1202,2144,128958,18,NA,3054,28,964,597,175,214,87,1397,120
2012,36047003800,"Census Tract 38, Kings County, New York",704,67,637,164,340,78438,1939,2005,1490,21.8,86,154,0,10,0,637,60
2013,36047003800,"Census Tract 38, Kings County, New York",733,72,661,199,401,90250,1941,2007,1546,19.9,105,188,0,11,0,661,56
2014,36047003800,"Census Tract 38, Kings County, New York",742,74,668,227,437,85938,1939,2009,1525,21.3,121,203,0,12,12,668,14
2015,36047003800,"Census Tract 38, Kings County, New York",749,82,667,253,467,85688,1939,2010,1519,22,143,220,0,14,11,667,18
2016,36047003800,"Census Tract 38, Kings County, New York",744,124,620,256,489,72500,1941,2008,1479,23.6,123,215,0,15,16,620,46
2017,36047003800,"Census Tract 38, Kings County, New York",736,116,620,242,470,81250,1943,2010,1509,24.8,113,208,0,5,19,620,52
2018,36047003800,"Census Tract 38, Kings County, New York",736,112,624,214,405,62500,1942,2006,1405,27,103,180,0,5,18,624,54
2019,36047003800,"Census Tract 38, Kings County, New York",732,127,605,199,378,69464,1947,2008,1678,29.6,123,161,0,18,7,605,65
2020,36047003800,"Census Tract 38, Kings County, New York",667,108,559,198,398,65862,1951,2010,1755,42.7,106,150,5,43,0,559,58
2012,36047003900,"Census Tract 39, Kings County, New York",1207,142,1065,790,1385,48971,1939,2005,1536,29.2,533,297,149,143,139,1065,226
2013,36047003900,"Census Tract 39, Kings County, New York",1215,100,1115,818,1479,61250,1939,2006,1532,29.1,564,306,165,127,184,1115,218
2014,36047003900,"Census Tract 39, Kings County, New York",1194,91,1103,789,1538,80662,1939,2008,1649,28.2,571,354,176,93,145,1103,126
2015,36047003900,"Census Tract 39, Kings County, New York",1211,51,1160,852,1544,79375,1939,2010,1521,25.1,625,399,187,108,138,1160,105
2016,36047003900,"Census Tract 39, Kings County, New York",1286,66,1220,881,1481,82813,1939,2011,1380,23.4,637,434,225,90,110,1220,108
2017,36047003900,"Census Tract 39, Kings County, New York",1254,70,1184,856,1522,76563,1939,2012,1574,22.9,556,438,192,82,117,1184,98
2018,36047003900,"Census Tract 39, Kings County, New York",1283,107,1176,869,1499,79844,0,2014,1685,22.9,575,448,186,113,122,1176,73
2019,36047003900,"Census Tract 39, Kings County, New York",1317,213,1104,788,1346,82279,0,2015,1713,22.9,510,404,163,106,107,1104,61
2020,36047003900,"Census Tract 39, Kings County, New York",1234,204,1030,707,1349,91645,0,NA,1825,23.9,448,353,146,92,106,1030,105
2012,36047004100,"Census Tract 41, Kings County, New York",1645,118,1527,1043,1873,82665,1939,2005,1825,27.8,815,809,30,48,140,1527,106
2013,36047004100,"Census Tract 41, Kings County, New York",1646,107,1539,1044,1758,85547,1939,2006,1988,27.6,855,775,63,67,125,1539,94
2014,36047004100,"Census Tract 41, Kings County, New York",1637,134,1503,987,1738,88988,1939,2009,1981,27.4,838,731,78,79,99,1503,46
2015,36047004100,"Census Tract 41, Kings County, New York",1611,134,1477,969,1735,97083,1939,2010,2060,27.6,839,723,98,108,40,1477,19
2016,36047004100,"Census Tract 41, Kings County, New York",1609,197,1412,901,1697,103750,1939,2011,2044,24.9,733,590,118,137,56,1412,19
2017,36047004100,"Census Tract 41, Kings County, New York",1640,220,1420,947,1834,105341,1939,2011,2171,25.5,762,577,124,156,78,1420,28
2018,36047004100,"Census Tract 41, Kings County, New York",1678,303,1375,877,1874,116573,0,2012,2320,24,709,591,96,93,83,1375,50
2019,36047004100,"Census Tract 41, Kings County, New York",1641,282,1359,867,1797,126106,0,2014,2533,23.3,726,635,55,93,70,1359,59
2020,36047004100,"Census Tract 41, Kings County, New York",1607,295,1312,865,1908,167750,0,2016,2889,22.1,760,638,22,108,85,1312,137
2012,36047004300,"Census Tract 43, Kings County, New York",1564,142,1422,979,1633,78179,1939,2005,1464,25.9,671,654,36,51,240,1422,166
2013,36047004300,"Census Tract 43, Kings County, New York",1658,147,1511,990,1589,61371,1939,2007,1379,26.9,684,620,32,59,270,1511,161
2014,36047004300,"Census Tract 43, Kings County, New York",1703,211,1492,1025,1746,75089,1939,2011,1702,26.7,730,662,45,74,230,1492,162
2015,36047004300,"Census Tract 43, Kings County, New York",1709,140,1569,1139,1983,95875,1939,2011,1768,24.5,810,789,48,59,228,1569,189
2016,36047004300,"Census Tract 43, Kings County, New York",1750,154,1596,1157,2048,119219,1939,2011,1968,24.3,872,769,72,96,199,1596,136
2017,36047004300,"Census Tract 43, Kings County, New York",1731,156,1575,1095,2010,112422,1939,NA,2133,23.9,868,708,106,99,180,1575,130
2018,36047004300,"Census Tract 43, Kings County, New York",1763,132,1631,1189,2263,128047,0,2012,2249,23.5,879,782,141,116,153,1631,182
2019,36047004300,"Census Tract 43, Kings County, New York",1823,109,1714,1229,2396,128274,1960,NA,2259,23.7,905,778,181,106,175,1714,191
2020,36047004300,"Census Tract 43, Kings County, New York",1803,93,1710,1257,2386,131816,1977,2015,2504,23.6,933,742,261,126,142,1710,221
2012,36047004400,"Census Tract 44, Kings County, New York",1049,39,1010,256,473,38750,1939,2002,1073,30.1,91,204,0,19,30,1010,57
2013,36047004400,"Census Tract 44, Kings County, New York",1025,60,965,265,526,56042,1939,2004,1250,30.2,109,198,0,18,46,965,60
2014,36047004400,"Census Tract 44, Kings County, New York",1044,62,982,265,503,63750,1939,2008,1344,24.9,117,177,0,10,65,982,56
2015,36047004400,"Census Tract 44, Kings County, New York",1040,65,975,277,528,64750,1939,2010,1371,25.3,120,203,0,0,60,975,42
2016,36047004400,"Census Tract 44, Kings County, New York",1015,72,943,282,510,59000,1939,2011,1362,28.7,130,215,0,0,58,943,49
2017,36047004400,"Census Tract 44, Kings County, New York",1028,84,944,236,404,63864,1939,2011,1392,27.7,122,198,0,0,29,944,27
2018,36047004400,"Census Tract 44, Kings County, New York",1053,67,986,199,324,57417,0,2012,1410,32.3,121,173,0,0,17,986,32
2019,36047004400,"Census Tract 44, Kings County, New York",1038,48,990,221,426,59598,0,2013,1450,31.9,161,221,0,0,0,990,64
2020,36047004400,"Census Tract 44, Kings County, New York",1023,63,960,228,399,59861,0,2014,1601,31.9,187,211,17,0,0,960,54
2012,36047004500,"Census Tract 45, Kings County, New York",1828,71,1757,1071,1706,81761,1939,2004,1876,28.5,873,903,9,95,50,1757,17
2013,36047004500,"Census Tract 45, Kings County, New York",1778,62,1716,1068,1774,83846,1939,2006,2001,28.2,822,901,8,47,95,1716,56
2014,36047004500,"Census Tract 45, Kings County, New York",1777,50,1727,1091,1870,80990,1939,2008,2001,27.8,832,934,7,37,87,1727,64
2015,36047004500,"Census Tract 45, Kings County, New York",1757,103,1654,1034,1780,120789,1939,2011,2094,23.4,860,910,7,39,66,1654,70
2016,36047004500,"Census Tract 45, Kings County, New York",1782,111,1671,1032,1915,117143,1939,2011,2192,22.5,825,929,7,16,67,1671,83
2017,36047004500,"Census Tract 45, Kings County, New York",1798,113,1685,946,1915,138889,1939,2012,2419,21.2,763,841,0,30,63,1685,85
2018,36047004500,"Census Tract 45, Kings County, New York",1805,134,1671,1010,2010,145216,0,2012,2441,21.9,852,836,32,117,33,1671,87
2019,36047004500,"Census Tract 45, Kings County, New York",1799,150,1649,969,1951,146985,0,2013,2468,22.2,816,777,36,105,59,1649,85
2020,36047004500,"Census Tract 45, Kings County, New York",1686,122,1564,944,2246,141000,0,2015,2625,23.4,750,717,31,115,57,1564,92
2012,36047004600,"Census Tract 46, Kings County, New York",530,35,495,178,330,22941,1939,2006,1432,22.5,51,140,0,28,10,495,63
2013,36047004600,"Census Tract 46, Kings County, New York",550,40,510,145,253,24631,1939,2007,1462,25.5,43,117,0,23,5,510,47
2014,36047004600,"Census Tract 46, Kings County, New York",562,66,496,155,308,57125,1939,2004,1273,20.3,75,101,0,42,12,496,48
2015,36047004600,"Census Tract 46, Kings County, New York",576,66,510,127,235,76042,1939,2010,1101,25.2,84,75,0,45,7,510,18
2016,36047004600,"Census Tract 46, Kings County, New York",563,61,502,120,233,58636,1939,2011,1153,29.5,75,63,0,40,17,502,25
2017,36047004600,"Census Tract 46, Kings County, New York",559,37,522,106,206,58409,1939,2000,1139,28.3,65,61,0,26,19,522,32
2018,36047004600,"Census Tract 46, Kings County, New York",547,56,491,93,185,58542,0,2008,1240,30.5,57,49,0,25,19,491,31
2019,36047004600,"Census Tract 46, Kings County, New York",544,43,501,82,180,37500,0,2012,1694,51,31,39,0,9,34,501,38
2020,36047004600,"Census Tract 46, Kings County, New York",627,89,538,128,205,NA,0,1998,1442,51,24,94,0,5,29,538,81
2012,36047004700,"Census Tract 47, Kings County, New York",686,111,575,326,624,61087,1950,2004,1234,26,193,161,70,0,63,575,49
2013,36047004700,"Census Tract 47, Kings County, New York",717,76,641,385,814,59375,1985,2005,1469,27.5,190,154,117,5,89,641,52
2014,36047004700,"Census Tract 47, Kings County, New York",773,70,703,432,915,87045,1989,2008,1443,25.5,214,180,130,24,75,703,75
2015,36047004700,"Census Tract 47, Kings County, New York",815,28,787,494,1026,69583,1983,2010,1601,27.1,274,252,123,28,83,787,75
2016,36047004700,"Census Tract 47, Kings County, New York",906,62,844,550,1248,78125,1986,2011,1710,26,318,265,141,33,101,844,62
2017,36047004700,"Census Tract 47, Kings County, New York",889,92,797,520,1172,82708,1986,2011,1871,24,341,285,119,32,79,797,53
2018,36047004700,"Census Tract 47, Kings County, New York",877,101,776,524,1130,81029,1982,2012,1710,24,331,265,125,30,93,776,86
2019,36047004700,"Census Tract 47, Kings County, New York",886,116,770,505,1040,90729,1977,2012,1629,23.7,361,260,112,22,92,770,88
2020,36047004700,"Census Tract 47, Kings County, New York",829,94,735,472,991,94375,1972,2012,1685,24.3,357,196,77,41,129,735,76
2012,36047004900,"Census Tract 49, Kings County, New York",1129,229,900,659,1115,65815,1939,2004,1534,27.5,546,546,0,54,44,900,66
2013,36047004900,"Census Tract 49, Kings County, New York",1116,204,912,650,1200,73056,1939,2005,1611,27.4,517,504,7,49,74,912,69
2014,36047004900,"Census Tract 49, Kings County, New York",1101,191,910,680,1270,85000,1939,2006,1720,26.5,546,524,8,35,94,910,65
2015,36047004900,"Census Tract 49, Kings County, New York",1096,115,981,661,1298,104864,1939,2010,1922,23.2,580,480,8,69,83,981,42
2016,36047004900,"Census Tract 49, Kings County, New York",1108,117,991,623,1291,103565,1939,2011,1914,24.1,538,444,9,82,88,991,71
2017,36047004900,"Census Tract 49, Kings County, New York",1105,119,986,529,1072,120724,1939,2012,2219,23.7,429,332,9,69,99,986,51
2018,36047004900,"Census Tract 49, Kings County, New York",1073,76,997,564,1201,143438,0,2013,2544,24.8,467,391,28,70,60,997,60
2019,36047004900,"Census Tract 49, Kings County, New York",1056,80,976,555,1136,113973,0,2014,2486,26.7,450,363,43,69,67,976,63
2020,36047004900,"Census Tract 49, Kings County, New York",1054,58,996,573,1049,116713,0,2016,2387,26.8,463,422,39,46,28,996,48
2012,36047005000,"Census Tract 50, Kings County, New York",1122,59,1063,491,863,62584,1939,2003,1430,27.1,229,400,10,41,40,1063,47
2013,36047005000,"Census Tract 50, Kings County, New York",1124,51,1073,556,881,55119,1939,2002,1478,27.3,248,425,9,43,79,1073,22
2014,36047005000,"Census Tract 50, Kings County, New York",1146,53,1093,572,972,59375,1939,2004,1506,29.4,227,433,10,29,100,1093,24
2015,36047005000,"Census Tract 50, Kings County, New York",1176,92,1084,563,1006,62458,1939,2007,1577,28.2,287,395,9,28,131,1084,35
2016,36047005000,"Census Tract 50, Kings County, New York",1194,146,1048,539,1023,81875,1939,2010,1681,24.7,354,361,8,35,130,1048,42
2017,36047005000,"Census Tract 50, Kings County, New York",1197,218,979,469,953,86298,1939,2011,1784,24.4,281,306,0,47,108,979,41
2018,36047005000,"Census Tract 50, Kings County, New York",1199,231,968,444,918,93250,0,2011,1759,23.7,300,309,0,43,82,968,52
2019,36047005000,"Census Tract 50, Kings County, New York",1198,210,988,383,766,108875,0,2011,1791,21.9,283,287,0,26,59,988,53
2020,36047005000,"Census Tract 50, Kings County, New York",1135,169,966,378,694,81667,0,2013,1576,21.9,254,328,0,24,13,966,42
2012,36047005100,"Census Tract 51, Kings County, New York",1063,112,951,529,1048,88958,1939,2005,1744,23.1,401,341,0,79,88,951,63
2013,36047005100,"Census Tract 51, Kings County, New York",1077,107,970,573,1075,95764,1939,2008,1888,23.8,410,396,0,45,111,970,50
2014,36047005100,"Census Tract 51, Kings County, New York",1113,94,1019,597,1219,93042,1939,2008,2001,25,417,379,0,50,148,1019,92
2015,36047005100,"Census Tract 51, Kings County, New York",1085,96,989,579,1211,88036,1939,2009,2101,25.3,415,357,0,39,156,989,102
2016,36047005100,"Census Tract 51, Kings County, New York",1124,20,1104,700,1484,95985,1939,2010,2285,24.3,518,392,0,61,204,1104,105
2017,36047005100,"Census Tract 51, Kings County, New York",1122,21,1101,661,1440,99306,1939,2010,2499,25.5,508,382,0,84,173,1101,76
2018,36047005100,"Census Tract 51, Kings County, New York",1110,26,1084,534,1246,97432,0,2011,2756,27,434,298,17,62,146,1084,90
2019,36047005100,"Census Tract 51, Kings County, New York",1108,61,1047,517,1064,103173,1950,2013,2696,26.1,399,353,20,54,80,1047,53
2020,36047005100,"Census Tract 51, Kings County, New York",1166,82,1084,574,1321,127593,0,2015,2737,26.5,444,414,21,83,67,1084,56
2012,36047005201,"Census Tract 52.01, Kings County, New York",1103,51,1052,868,1137,15260,1961,2003,494,30.2,353,681,18,119,50,1052,409
2013,36047005201,"Census Tract 52.01, Kings County, New York",1128,87,1041,840,1098,14811,1963,2003,525,30.8,314,631,19,138,52,1041,386
2014,36047005201,"Census Tract 52.01, Kings County, New York",1140,83,1057,871,1102,14359,1965,2005,536,30.2,318,624,19,194,34,1057,412
2015,36047005201,"Census Tract 52.01, Kings County, New York",1126,81,1045,868,1096,14679,1968,2007,575,29.3,322,541,20,223,84,1045,359
2016,36047005201,"Census Tract 52.01, Kings County, New York",1094,103,991,823,1023,14425,1969,2010,520,29.8,276,505,28,205,85,991,369
2017,36047005201,"Census Tract 52.01, Kings County, New York",1157,116,1041,839,1028,15881,1967,2010,508,28.5,303,538,10,198,80,1041,347
2018,36047005201,"Census Tract 52.01, Kings County, New York",1158,87,1071,895,1120,16190,1967,2011,417,28.5,327,539,11,235,98,1071,399
2019,36047005201,"Census Tract 52.01, Kings County, New York",1168,102,1066,855,1113,15613,1971,2011,379,27.2,364,497,18,235,90,1066,360
2020,36047005201,"Census Tract 52.01, Kings County, New York",1106,142,964,753,1024,16738,1969,2011,489,25.5,354,442,21,231,44,964,281
2012,36047005202,"Census Tract 52.02, Kings County, New York",1466,118,1348,660,1153,60556,1953,2003,1417,29.1,320,574,11,0,65,1348,70
2013,36047005202,"Census Tract 52.02, Kings County, New York",1477,128,1349,729,1305,58105,1952,2004,1499,29.3,337,663,9,9,42,1349,114
2014,36047005202,"Census Tract 52.02, Kings County, New York",1497,71,1426,787,1350,50865,1951,2008,1511,29.7,369,631,91,21,57,1426,104
2015,36047005202,"Census Tract 52.02, Kings County, New York",1516,63,1453,748,1262,57979,1939,2009,1686,37.8,402,550,85,25,107,1453,114
2016,36047005202,"Census Tract 52.02, Kings County, New York",1510,84,1426,686,1130,57722,1947,2011,1672,32.5,360,514,70,28,88,1426,137
2017,36047005202,"Census Tract 52.02, Kings County, New York",1523,111,1412,728,1156,61823,1939,2010,1683,31.4,408,569,67,30,71,1412,134
2018,36047005202,"Census Tract 52.02, Kings County, New York",1506,155,1351,747,1190,65750,1942,2011,1739,31,393,589,72,13,88,1351,150
2019,36047005202,"Census Tract 52.02, Kings County, New York",1495,171,1324,704,1162,70769,1944,2011,1789,28.1,373,590,21,0,89,1324,155
2020,36047005202,"Census Tract 52.02, Kings County, New York",1543,206,1337,602,998,72167,1941,2012,1742,25.4,291,528,5,6,45,1337,127
2012,36047005300,"Census Tract 53, Kings County, New York",1071,138,933,774,1878,59948,1939,2005,1323,26.1,355,345,142,13,244,933,128
2013,36047005300,"Census Tract 53, Kings County, New York",1059,148,911,762,1974,61429,1939,2005,1442,35.3,344,285,136,20,297,911,181
2014,36047005300,"Census Tract 53, Kings County, New York",1087,82,1005,755,1856,65515,1939,2007,1440,32,412,305,109,36,245,1005,176
2015,36047005300,"Census Tract 53, Kings County, New York",1071,134,937,663,1674,60694,1939,2010,1506,34.2,340,334,74,30,173,937,167
2016,36047005300,"Census Tract 53, Kings County, New York",1084,102,982,694,1681,67667,1939,2010,1608,32.7,391,358,82,31,177,982,148
2017,36047005300,"Census Tract 53, Kings County, New York",1072,118,954,646,1642,73333,1939,2010,1665,31.7,359,352,73,18,175,954,153
2018,36047005300,"Census Tract 53, Kings County, New York",1075,117,958,633,1368,83224,0,2011,1835,29,380,370,73,14,150,958,121
2019,36047005300,"Census Tract 53, Kings County, New York",1045,131,914,625,1404,88542,0,2012,1945,27.9,387,430,63,2,124,914,125
2020,36047005301,"Census Tract 53.01, Kings County, New York",966,64,902,585,1286,98750,0,2012,1969,28.9,385,414,62,5,103,902,126
2020,36047005302,"Census Tract 53.02, Kings County, New York",32,0,32,32,65,126250,0,2017,2250,22.5,27,27,0,0,5,32,0
2020,36047005303,"Census Tract 53.03, Kings County, New York",0,0,0,0,0,NA,NA,NA,NA,NA,0,0,0,0,0,0,0
2012,36047005400,"Census Tract 54, Kings County, New York",1858,133,1725,1174,2461,53162,1942,2004,1326,24.4,631,892,25,75,207,1725,156
2013,36047005400,"Census Tract 54, Kings County, New York",1842,194,1648,1131,2297,50489,1942,2004,1370,24.5,549,872,11,65,186,1648,219
2014,36047005400,"Census Tract 54, Kings County, New York",1860,209,1651,1162,2352,46628,1943,2005,1395,27.9,536,931,10,52,171,1651,269
2015,36047005400,"Census Tract 54, Kings County, New York",1867,212,1655,1199,2351,50878,1942,2007,1427,29.6,535,900,21,50,220,1655,256
2016,36047005400,"Census Tract 54, Kings County, New York",1837,222,1615,1142,2221,53088,1943,2009,1452,27.3,541,935,11,32,144,1615,271
2017,36047005400,"Census Tract 54, Kings County, New York",1823,265,1558,1099,2067,52415,1941,2010,1471,29.8,521,870,10,0,189,1558,278
2018,36047005400,"Census Tract 54, Kings County, New York",1812,209,1603,1068,2000,70972,1943,2011,1493,24.9,551,881,11,26,120,1603,192
2019,36047005400,"Census Tract 54, Kings County, New York",1803,189,1614,1124,2039,75543,0,2012,1582,27,641,871,10,77,129,1614,168
2020,36047005400,"Census Tract 54, Kings County, New York",1768,136,1632,1126,2118,71905,0,2012,1660,26.8,594,805,130,74,93,1632,189
2012,36047005601,"Census Tract 56.01, Kings County, New York",1458,50,1408,945,1687,39271,1945,2003,1231,32.2,413,682,68,104,131,1408,139
2013,36047005601,"Census Tract 56.01, Kings County, New York",1482,72,1410,952,1605,36929,1947,2003,1268,35.3,388,685,103,62,156,1410,136
2014,36047005601,"Census Tract 56.01, Kings County, New York",1541,78,1463,997,1651,37872,1953,2004,1346,41.2,422,693,76,86,182,1463,140
2015,36047005601,"Census Tract 56.01, Kings County, New York",1532,93,1439,984,1570,39583,1957,2005,1358,34.7,448,787,38,33,117,1439,136
2016,36047005601,"Census Tract 56.01, Kings County, New York",1528,115,1413,954,1559,54091,1957,2008,1439,30.8,483,758,39,37,106,1413,138
2017,36047005601,"Census Tract 56.01, Kings County, New York",1540,164,1376,872,1417,62418,1957,2010,1562,24.8,487,743,53,0,63,1376,136
2018,36047005601,"Census Tract 56.01, Kings County, New York",1536,146,1390,874,1589,63690,1955,2011,1654,31.1,462,729,54,11,66,1390,136
2019,36047005601,"Census Tract 56.01, Kings County, New York",1489,156,1333,756,1475,80857,1953,2011,1763,24.7,429,621,35,11,89,1333,129
2020,36047005601,"Census Tract 56.01, Kings County, New York",1413,147,1266,640,1268,79500,1950,2012,1806,27.1,347,480,54,29,64,1266,112
2012,36047005602,"Census Tract 56.02, Kings County, New York",959,104,855,548,1201,41136,1945,2002,1210,31.8,236,361,0,28,159,855,69
2013,36047005602,"Census Tract 56.02, Kings County, New York",923,35,888,578,1255,42396,1946,2002,1254,31.8,261,380,0,27,171,888,43
2014,36047005602,"Census Tract 56.02, Kings County, New York",947,53,894,570,1234,48095,1942,2003,1252,30.7,252,405,0,33,132,894,71
2015,36047005602,"Census Tract 56.02, Kings County, New York",941,64,877,521,970,44911,1939,2007,1229,31.4,264,396,0,20,105,877,88
2016,36047005602,"Census Tract 56.02, Kings County, New York",912,72,840,454,816,57813,1942,2010,1307,26.7,259,376,11,13,65,840,79
2017,36047005602,"Census Tract 56.02, Kings County, New York",942,96,846,503,982,61838,1944,2011,1371,30.8,282,408,11,14,73,846,76
2018,36047005602,"Census Tract 56.02, Kings County, New York",995,126,869,524,976,58889,0,2011,1383,32.5,298,424,24,15,61,869,117
2019,36047005602,"Census Tract 56.02, Kings County, New York",1001,143,858,481,880,61406,1941,2012,1404,32.7,266,369,25,18,71,858,75
2020,36047005602,"Census Tract 56.02, Kings County, New York",1070,155,915,434,846,68750,0,2013,1486,30.1,232,295,23,25,77,915,49
2012,36047005800,"Census Tract 58, Kings County, New York",1684,61,1623,1279,2253,46396,1939,2004,1207,31.2,650,1043,9,73,133,1623,248
2013,36047005800,"Census Tract 58, Kings County, New York",1704,109,1595,1226,2281,46536,1939,2005,1215,32.4,583,967,0,87,151,1595,243
2014,36047005800,"Census Tract 58, Kings County, New York",1712,177,1535,1206,2477,42600,1939,2007,1285,34.3,534,828,10,185,163,1535,270
2015,36047005800,"Census Tract 58, Kings County, New York",1722,236,1486,1159,2352,44702,1939,2009,1315,33.4,580,809,9,211,97,1486,247
2016,36047005800,"Census Tract 58, Kings County, New York",1693,242,1451,1102,2250,41618,1939,2010,1311,33,560,731,9,191,122,1451,281
2017,36047005800,"Census Tract 58, Kings County, New York",1705,295,1410,1068,2332,44000,1939,2011,1375,32.2,458,706,42,153,132,1410,302
2018,36047005800,"Census Tract 58, Kings County, New York",1647,273,1374,1033,2178,45797,0,2011,1427,34.5,429,672,53,143,138,1374,316
2019,36047005800,"Census Tract 58, Kings County, New York",1611,208,1403,1048,1954,60357,0,2012,1460,28.7,486,810,26,51,128,1403,250
2020,36047005800,"Census Tract 58, Kings County, New York",1520,195,1325,983,1967,53065,0,2012,1458,32.3,389,706,31,50,165,1325,221
2012,36047005900,"Census Tract 59, Kings County, New York",694,89,605,564,1294,59167,1939,2005,1420,32,307,314,33,45,162,605,94
2013,36047005900,"Census Tract 59, Kings County, New York",649,88,561,509,1127,60337,1939,2006,1477,29.7,306,332,35,40,92,561,93
2014,36047005900,"Census Tract 59, Kings County, New York",665,40,625,570,1156,61250,1939,2008,1740,32.3,361,392,51,22,93,625,87
2015,36047005900,"Census Tract 59, Kings County, New York",676,36,640,580,1295,65714,1939,2010,1802,30.6,385,403,59,12,95,640,75
2016,36047005900,"Census Tract 59, Kings County, New York",676,65,611,549,1247,66797,1939,2011,1886,31.5,349,375,37,0,125,611,82
2017,36047005900,"Census Tract 59, Kings County, New York",672,66,606,537,1193,72292,1939,2012,1805,28.2,329,401,24,0,112,606,52
2018,36047005900,"Census Tract 59, Kings County, New York",645,89,556,509,1126,73438,0,2012,1825,28.1,300,348,44,13,111,556,50
2019,36047005900,"Census Tract 59, Kings County, New York",642,81,561,517,1094,69896,0,2012,1891,29.6,290,357,46,16,107,561,43
2020,36047005900,"Census Tract 59, Kings County, New York",617,80,537,495,983,82875,0,2012,2151,27.6,329,334,42,19,112,537,32
2012,36047006000,"Census Tract 60, Kings County, New York",1245,82,1163,796,1619,52177,1939,NA,1232,27.9,354,595,17,44,140,1163,116
2013,36047006000,"Census Tract 60, Kings County, New York",1243,114,1129,805,1826,51875,1939,2005,1307,28.2,376,582,19,37,151,1129,105
2014,36047006000,"Census Tract 60, Kings County, New York",1210,62,1148,823,1861,64107,1939,2006,1360,28.6,364,568,0,78,151,1148,170
2015,36047006000,"Census Tract 60, Kings County, New York",1199,93,1106,742,1626,50556,1939,2008,1373,32.4,311,486,0,81,154,1106,216
2016,36047006000,"Census Tract 60, Kings County, New York",1181,218,963,697,1658,65547,1939,2010,1429,25.9,292,449,0,90,142,963,163
2017,36047006000,"Census Tract 60, Kings County, New York",1182,224,958,696,1959,75694,1939,2011,1606,24.3,330,408,0,111,163,958,148
2018,36047006000,"Census Tract 60, Kings County, New York",1170,159,1011,700,2219,75893,0,2012,1615,23.4,295,390,0,109,173,1011,157
2019,36047006000,"Census Tract 60, Kings County, New York",1196,164,1032,708,2337,95962,0,2012,1796,23.1,305,370,0,87,236,1032,98
2020,36047006000,"Census Tract 60, Kings County, New York",1230,141,1089,740,2473,77857,0,2012,1762,22.9,319,388,0,54,261,1089,55
2012,36047006200,"Census Tract 62, Kings County, New York",1223,104,1119,820,1810,42007,1939,2005,1222,33.6,467,529,19,91,158,1119,195
2013,36047006200,"Census Tract 62, Kings County, New York",1288,68,1220,884,1874,40100,1939,2005,1220,34.6,467,479,50,110,221,1220,229
2014,36047006200,"Census Tract 62, Kings County, New York",1315,123,1192,905,2103,43271,1939,2007,1403,33.9,429,498,35,106,266,1192,183
2015,36047006200,"Census Tract 62, Kings County, New York",1336,148,1188,923,2090,43643,1939,2008,1401,34.8,440,517,49,42,315,1188,168
2016,36047006200,"Census Tract 62, Kings County, New York",1317,165,1152,878,2120,50429,1939,2010,1470,32.3,473,498,69,57,254,1152,145
2017,36047006200,"Census Tract 62, Kings County, New York",1290,141,1149,873,2058,55208,1939,2011,1483,31.1,410,521,60,40,252,1149,147
2018,36047006200,"Census Tract 62, Kings County, New York",1244,142,1102,808,1806,63661,0,2011,1497,32.3,421,526,43,36,203,1102,150
2019,36047006200,"Census Tract 62, Kings County, New York",1201,73,1128,818,1805,68214,0,2012,1633,30.1,481,515,51,66,200,1128,193
2020,36047006200,"Census Tract 62, Kings County, New York",1176,111,1065,802,1855,65500,0,2013,1636,32,532,512,47,72,184,1065,164
2012,36047006300,"Census Tract 63, Kings County, New York",976,46,930,733,1340,84436,1939,2004,2001,25.8,504,601,11,21,100,930,68
2013,36047006300,"Census Tract 63, Kings County, New York",952,77,875,675,1268,85074,1939,2005,2001,24.8,500,570,0,26,79,875,65
2014,36047006300,"Census Tract 63, Kings County, New York",968,69,899,684,1407,91136,1939,2006,2001,26.5,496,537,0,28,110,899,65
2015,36047006300,"Census Tract 63, Kings County, New York",957,102,855,637,1387,98977,1939,2008,2207,24.3,483,498,0,29,98,855,52
2016,36047006300,"Census Tract 63, Kings County, New York",977,130,847,608,1265,109167,1939,2010,2293,21.1,444,494,0,32,72,847,44
2017,36047006300,"Census Tract 63, Kings County, New York",1009,128,881,597,1248,113542,1939,2011,2374,21.3,464,490,0,26,52,881,19
2018,36047006300,"Census Tract 63, Kings County, New York",1002,85,917,642,1260,120000,0,2012,2525,22.4,467,524,26,22,39,917,44
2019,36047006300,"Census Tract 63, Kings County, New York",961,87,874,629,1283,123456,0,2012,2400,22.4,466,527,27,28,18,874,56
2020,36047006300,"Census Tract 63, Kings County, New York",983,57,926,644,1217,113250,0,2014,2475,23.6,489,508,26,11,70,926,58
2012,36047006400,"Census Tract 64, Kings County, New York",1536,17,1519,991,2162,43708,1939,2003,1152,31.7,450,728,20,81,136,1519,151
2013,36047006400,"Census Tract 64, Kings County, New York",1519,20,1499,928,2188,34815,1939,2004,1225,37.1,328,712,31,79,73,1499,181
2014,36047006400,"Census Tract 64, Kings County, New York",1501,117,1384,744,1620,39797,1939,2005,1259,35.3,226,597,45,37,36,1384,173
2015,36047006400,"Census Tract 64, Kings County, New York",1515,143,1372,702,1469,50741,1939,2006,1291,33.3,224,603,38,28,24,1372,142
2016,36047006400,"Census Tract 64, Kings County, New York",1539,192,1347,698,1401,50078,1939,2008,1286,34.2,256,539,49,33,77,1347,158
2017,36047006400,"Census Tract 64, Kings County, New York",1596,235,1361,630,1379,69167,1939,2010,1383,26.8,326,507,41,27,46,1361,151
2018,36047006400,"Census Tract 64, Kings County, New York",1613,292,1321,613,1314,72708,0,2011,1417,24,313,473,45,24,62,1321,129
2019,36047006400,"Census Tract 64, Kings County, New York",1595,259,1336,664,1450,77368,0,2011,1429,25.2,378,555,15,17,67,1336,138
2020,36047006400,"Census Tract 64, Kings County, New York",1510,211,1299,730,1624,81510,0,2011,1528,21.7,385,636,15,17,62,1299,201
2012,36047006500,"Census Tract 65, Kings County, New York",2770,226,2544,1773,3209,88264,1939,2005,1913,24,1149,1588,15,0,124,2544,203
2013,36047006500,"Census Tract 65, Kings County, New York",2677,287,2390,1660,3172,98663,1939,2007,2001,25.2,1127,1462,14,0,133,2390,184
2014,36047006500,"Census Tract 65, Kings County, New York",2605,180,2425,1734,3379,101111,1939,2010,2001,24.8,1236,1573,15,0,93,2425,134
2015,36047006500,"Census Tract 65, Kings County, New York",2623,230,2393,1648,3266,100741,1939,2010,2106,25.3,1172,1464,36,14,82,2393,130
2016,36047006500,"Census Tract 65, Kings County, New York",2623,161,2462,1656,3389,102143,1939,2011,2138,25,1209,1519,29,17,58,2462,126
2017,36047006500,"Census Tract 65, Kings County, New York",2619,196,2423,1499,3175,110563,1939,2011,2250,22.7,1192,1402,12,18,34,2423,167
2018,36047006500,"Census Tract 65, Kings County, New York",2680,244,2436,1454,3170,146607,0,2012,2357,21.3,1185,1367,8,28,0,2436,183
2019,36047006500,"Census Tract 65, Kings County, New York",2727,260,2467,1425,3214,154816,0,2013,2618,21.8,1215,1295,10,30,35,2467,241
2020,36047006500,"Census Tract 65, Kings County, New York",2610,210,2400,1325,2977,158972,0,2014,2570,21.6,1076,1118,0,13,63,2400,210
2012,36047006600,"Census Tract 66, Kings County, New York",1658,173,1485,1158,2659,50125,1939,2003,1264,31.2,442,916,42,54,164,1485,196
2013,36047006600,"Census Tract 66, Kings County, New York",1614,139,1475,1148,2608,54471,1939,2004,1250,29.1,487,835,46,62,209,1475,180
2014,36047006600,"Census Tract 66, Kings County, New York",1677,124,1553,1207,2907,58359,1939,2004,1279,26.5,515,911,28,75,202,1553,210
2015,36047006600,"Census Tract 66, Kings County, New York",1676,157,1519,1198,2859,58750,1939,2005,1322,27.4,451,869,32,83,223,1519,203
2016,36047006600,"Census Tract 66, Kings County, New York",1663,226,1437,1135,2717,56033,1939,2007,1384,27.7,453,843,9,57,207,1437,148
2017,36047006600,"Census Tract 66, Kings County, New York",1671,193,1478,1149,2608,56144,1939,2009,1437,29.6,488,812,0,68,244,1478,113
2018,36047006600,"Census Tract 66, Kings County, New York",1730,184,1546,1266,2930,61563,1942,2011,1517,28.6,624,827,24,83,297,1546,218
2019,36047006600,"Census Tract 66, Kings County, New York",1702,133,1569,1199,2581,58493,0,2012,1604,29.1,664,763,18,80,304,1569,253
2020,36047006600,"Census Tract 66, Kings County, New York",1778,132,1646,1235,2635,58531,0,2015,1578,29.3,776,802,69,67,311,1646,245
2012,36047006700,"Census Tract 67, Kings County, New York",1677,175,1502,1048,2024,111750,1939,2004,2001,21.8,821,862,21,19,146,1502,86
2013,36047006700,"Census Tract 67, Kings County, New York",1649,104,1545,1019,2128,120950,1939,2006,2001,19.7,868,905,21,0,93,1545,63
2014,36047006700,"Census Tract 67, Kings County, New York",1631,68,1563,943,2079,133859,1939,2008,2001,19.5,813,807,34,32,70,1563,69
2015,36047006700,"Census Tract 67, Kings County, New York",1606,4,1602,1006,2344,129667,1939,2010,2132,19.9,820,861,29,32,76,1602,78
2016,36047006700,"Census Tract 67, Kings County, New York",1618,67,1551,908,2181,134706,1939,2010,1994,19.7,661,744,30,45,81,1551,76
2017,36047006700,"Census Tract 67, Kings County, New York",1614,57,1557,900,2126,145714,1939,2011,2318,20.5,697,729,12,74,77,1557,73
2018,36047006700,"Census Tract 67, Kings County, New York",1587,64,1523,837,1936,148912,0,2013,2413,21,651,605,32,78,113,1523,64
2019,36047006700,"Census Tract 67, Kings County, New York",1549,86,1463,811,1875,151656,0,2014,2492,20.8,624,635,34,46,88,1463,49
2020,36047006700,"Census Tract 67, Kings County, New York",1623,98,1525,840,1703,110093,0,2015,2393,20.7,706,615,34,36,76,1525,110
2012,36047006800,"Census Tract 68, Kings County, New York",2010,64,1946,1554,4072,31288,1939,2004,1194,41.6,505,810,0,213,531,1946,439
2013,36047006800,"Census Tract 68, Kings County, New York",2013,121,1892,1472,4213,31556,1939,2004,1199,38.5,487,784,19,244,425,1892,448
2014,36047006800,"Census Tract 68, Kings County, New York",2012,110,1902,1543,4320,31425,1939,2005,1219,39.6,441,735,23,238,540,1902,538
2015,36047006800,"Census Tract 68, Kings County, New York",1998,123,1875,1507,4348,37314,1939,2005,1329,36.8,499,713,21,254,470,1875,464
2016,36047006800,"Census Tract 68, Kings County, New York",1984,174,1810,1371,3627,40132,1939,2006,1341,36.2,446,734,16,148,412,1810,361
2017,36047006800,"Census Tract 68, Kings County, New York",1970,195,1775,1312,3515,40962,1939,2007,1365,35.3,428,675,25,147,380,1775,345
2018,36047006800,"Census Tract 68, Kings County, New York",1996,173,1823,1409,3776,41971,0,2010,1396,37.4,444,694,11,148,475,1823,401
2019,36047006800,"Census Tract 68, Kings County, New York",1983,210,1773,1326,3511,44451,0,2012,1428,33.9,451,683,20,167,384,1773,318
2020,36047006800,"Census Tract 68, Kings County, New York",1903,209,1694,1275,3316,55609,0,2013,1442,32.8,432,599,61,164,405,1694,194
2012,36047006900,"Census Tract 69, Kings County, New York",1793,150,1643,1207,2477,98185,1939,2005,2001,25.7,948,884,18,38,198,1643,142
2013,36047006900,"Census Tract 69, Kings County, New York",1779,121,1658,1162,2405,98811,1939,2006,2001,26.5,958,821,6,28,211,1658,163
2014,36047006900,"Census Tract 69, Kings County, New York",1767,82,1685,1164,2514,101803,1939,2007,2001,24.4,919,767,26,37,252,1685,118
2015,36047006900,"Census Tract 69, Kings County, New York",1718,96,1622,1093,2211,115982,1939,2010,2235,22.8,870,769,53,25,212,1622,121
2016,36047006900,"Census Tract 69, Kings County, New York",1704,80,1624,1132,2207,119500,1939,2011,2226,22.1,896,822,66,18,191,1624,118
2017,36047006900,"Census Tract 69, Kings County, New York",1753,67,1686,1145,2259,122917,1939,NA,2279,22.2,936,821,74,33,181,1686,97
2018,36047006900,"Census Tract 69, Kings County, New York",1808,110,1698,1151,2234,133065,0,2013,2434,21.3,944,851,70,46,145,1698,95
2019,36047006900,"Census Tract 69, Kings County, New York",1763,105,1658,1127,2346,141813,0,2014,2586,21,1020,907,52,46,83,1658,87
2020,36047006901,"Census Tract 69.01, Kings County, New York",897,52,845,610,1148,124457,0,2016,2823,24.8,582,535,0,47,23,845,39
2020,36047006902,"Census Tract 69.02, Kings County, New York",930,27,903,634,1434,140000,0,2016,2951,22.6,562,436,99,18,49,903,140
2012,36047007000,"Census Tract 70, Kings County, New York",1103,67,1036,680,1760,50833,1939,2001,1088,29.8,228,491,26,109,52,1036,115
2013,36047007000,"Census Tract 70, Kings County, New York",1116,85,1031,622,1528,34327,1956,2002,1059,33.1,240,410,28,111,63,1031,165
2014,36047007000,"Census Tract 70, Kings County, New York",1105,105,1000,579,1650,34115,1959,2004,1113,38.2,202,358,24,107,82,1000,169
2015,36047007000,"Census Tract 70, Kings County, New York",1105,116,989,507,1377,33875,1963,2006,1125,50,205,300,14,105,97,989,141
2016,36047007000,"Census Tract 70, Kings County, New York",1091,115,976,500,1398,41667,1960,2006,1182,50,245,302,25,93,88,976,148
2017,36047007000,"Census Tract 70, Kings County, New York",1136,91,1045,478,1231,43790,1949,2007,1238,31.9,244,292,37,55,103,1045,168
2018,36047007000,"Census Tract 70, Kings County, New York",1129,81,1048,394,1048,44847,1949,2007,1435,25.1,202,261,20,26,97,1048,112
2019,36047007000,"Census Tract 70, Kings County, New York",1111,60,1051,403,807,60536,0,2010,1490,24.9,242,251,27,43,90,1051,76
2020,36047007000,"Census Tract 70, Kings County, New York",1184,96,1088,404,762,92333,0,2011,1601,23.3,265,224,26,39,65,1088,92
2012,36047007100,"Census Tract 71, Kings County, New York",1842,89,1753,1481,3901,29830,1945,1997,567,23.7,274,218,738,23,601,1753,463
2013,36047007100,"Census Tract 71, Kings County, New York",1798,104,1694,1443,3986,26739,1945,1997,575,25.6,260,245,588,38,601,1694,562
2014,36047007100,"Census Tract 71, Kings County, New York",1828,99,1729,1436,3870,25262,1945,2000,535,26.5,301,254,537,47,630,1729,597
2015,36047007100,"Census Tract 71, Kings County, New York",1833,70,1763,1505,4131,28052,1945,1999,603,26,426,259,518,26,675,1763,529
2016,36047007100,"Census Tract 71, Kings County, New York",1827,75,1752,1497,4134,26419,1946,2001,589,24.9,410,245,531,62,680,1752,563
2017,36047007100,"Census Tract 71, Kings County, New York",1885,130,1755,1528,4085,31285,1947,2000,629,24.3,432,224,533,60,753,1755,492
2018,36047007100,"Census Tract 71, Kings County, New York",1885,123,1762,1549,4311,34652,1950,2002,655,24.3,422,205,564,58,735,1762,448
2019,36047007100,"Census Tract 71, Kings County, New York",1906,103,1803,1534,4222,35907,1953,2001,662,24.6,382,169,615,75,689,1803,469
2020,36047007100,"Census Tract 71, Kings County, New York",1920,192,1728,1452,3641,34620,1955,2002,779,26.9,311,150,612,126,588,1728,505
2012,36047007200,"Census Tract 72, Kings County, New York",633,12,621,586,1835,35641,1939,2003,1168,38.9,70,137,13,185,264,621,183
2013,36047007200,"Census Tract 72, Kings County, New York",628,12,616,564,1976,33023,1939,2004,1178,41,36,120,4,165,275,616,224
2014,36047007200,"Census Tract 72, Kings County, New York",627,14,613,595,2245,36832,1939,2005,1210,37.4,19,106,15,165,318,613,224
2015,36047007200,"Census Tract 72, Kings County, New York",645,12,633,617,2304,36929,1939,2006,1321,39.3,33,78,20,152,371,633,226
2016,36047007200,"Census Tract 72, Kings County, New York",612,10,602,577,2082,36250,1939,2007,1321,45.6,26,80,20,135,346,602,196
2017,36047007200,"Census Tract 72, Kings County, New York",619,23,596,547,1965,36289,1940,2007,1305,46.6,56,78,24,117,334,596,197
2018,36047007200,"Census Tract 72, Kings County, New York",613,21,592,525,1708,41140,0,2007,1347,44.1,83,92,26,83,332,592,177
2019,36047007200,"Census Tract 72, Kings County, New York",607,24,583,508,1665,40946,1941,2008,1405,47.6,123,61,21,89,344,583,148
2020,36047007200,"Census Tract 72, Kings County, New York",565,36,529,449,1473,48179,1943,2009,1366,34.6,127,66,21,77,299,529,116
2012,36047007400,"Census Tract 74, Kings County, New York",1637,54,1583,1331,4956,30828,1939,2003,1183,37.9,155,110,19,290,923,1583,506
2013,36047007400,"Census Tract 74, Kings County, New York",1672,130,1542,1260,5004,31509,1939,2004,1186,37.3,139,93,47,179,988,1542,460
2014,36047007400,"Census Tract 74, Kings County, New York",1644,226,1418,1171,4738,34137,1939,2005,1334,37.9,140,95,62,188,872,1418,387
2015,36047007400,"Census Tract 74, Kings County, New York",1651,199,1452,1144,4942,41667,1939,2006,1442,37.6,145,83,65,180,840,1452,416
2016,36047007400,"Census Tract 74, Kings County, New York",1601,208,1393,1142,4855,32396,1939,2007,1471,44.2,93,102,55,172,841,1393,540
2017,36047007400,"Census Tract 74, Kings County, New York",1631,213,1418,1164,4844,31336,1939,2006,1500,45.2,78,80,64,223,833,1418,556
2018,36047007400,"Census Tract 74, Kings County, New York",1620,177,1443,1117,4151,28355,0,2007,1557,47.9,108,78,33,288,722,1443,572
2019,36047007400,"Census Tract 74, Kings County, New York",1565,122,1443,1044,3875,28793,0,2005,1647,51,154,114,15,253,677,1443,580
2020,36047007400,"Census Tract 74, Kings County, New York",1641,103,1538,1251,4159,47188,0,2007,1646,37.2,384,69,17,350,832,1538,444
2012,36047007500,"Census Tract 75, Kings County, New York",2277,154,2123,1341,2848,85017,1939,2003,1835,27.9,1024,991,0,131,219,2123,126
2013,36047007500,"Census Tract 75, Kings County, New York",2207,127,2080,1276,2698,96250,1939,2005,2001,26.5,1064,967,0,160,149,2080,85
2014,36047007500,"Census Tract 75, Kings County, New York",2259,170,2089,1380,3038,117984,1939,2009,2001,22.5,1137,986,0,210,160,2089,81
2015,36047007500,"Census Tract 75, Kings County, New York",2233,172,2061,1343,2803,118125,1939,2011,2154,19.8,1100,1015,0,179,119,2061,90
2016,36047007500,"Census Tract 75, Kings County, New York",2232,217,2015,1210,2403,119500,1939,2011,2281,19.7,1009,972,0,170,43,2015,100
2017,36047007500,"Census Tract 75, Kings County, New York",2213,243,1970,1119,2287,140923,1939,2012,2318,18.9,928,912,0,150,36,1970,41
2018,36047007500,"Census Tract 75, Kings County, New York",2265,210,2055,1104,2150,124811,0,2012,2246,20,912,883,0,95,89,2055,107
2019,36047007500,"Census Tract 75, Kings County, New York",2291,210,2081,1006,1946,119697,0,2013,2386,23.2,872,789,21,57,125,2081,142
2020,36047007500,"Census Tract 75, Kings County, New York",2287,210,2077,1221,2583,148188,0,2014,2533,20,1129,1033,18,44,109,2077,125
2012,36047007600,"Census Tract 76, Kings County, New York",1556,138,1418,1046,2904,29932,1939,2004,1135,35.1,270,110,157,116,766,1418,452
2013,36047007600,"Census Tract 76, Kings County, New York",1535,191,1344,961,2774,32933,1939,2005,1182,36,238,144,103,95,660,1344,404
2014,36047007600,"Census Tract 76, Kings County, New York",1511,170,1341,967,3061,31250,1939,2008,1209,40.4,212,124,86,101,675,1341,454
2015,36047007600,"Census Tract 76, Kings County, New York",1505,140,1365,1075,3560,30779,1939,2009,1273,43.5,230,143,76,133,732,1365,476
2016,36047007600,"Census Tract 76, Kings County, New York",1499,130,1369,1020,3545,30575,1939,2010,1294,50,244,169,26,111,723,1369,485
2017,36047007600,"Census Tract 76, Kings County, New York",1562,183,1379,1043,3729,32629,1939,2011,1405,50,263,192,10,108,734,1379,475
2018,36047007600,"Census Tract 76, Kings County, New York",1528,126,1402,1026,3516,34402,0,2011,1465,49.7,292,223,19,95,697,1402,421
2019,36047007600,"Census Tract 76, Kings County, New York",1528,127,1401,1051,3438,38290,0,2011,1491,44.4,266,228,44,63,742,1401,377
2020,36047007600,"Census Tract 76, Kings County, New York",1505,123,1382,1024,3532,39265,0,2011,1532,45.9,374,214,39,88,703,1382,426
2012,36047007700,"Census Tract 77, Kings County, New York",2157,309,1848,1213,2617,82083,1939,2003,1869,25.3,776,852,53,94,178,1848,193
2013,36047007700,"Census Tract 77, Kings County, New York",2159,292,1867,1224,2736,98077,1939,2004,1983,22.6,867,850,32,98,190,1867,159
2014,36047007700,"Census Tract 77, Kings County, New York",2156,307,1849,1185,2495,106292,1939,2005,1960,21.9,786,806,8,96,250,1849,146
2015,36047007700,"Census Tract 77, Kings County, New York",2142,269,1873,1206,2646,121852,1939,2008,2102,21.3,815,854,7,76,242,1873,133
2016,36047007700,"Census Tract 77, Kings County, New York",2169,200,1969,1324,2933,124695,1941,2010,2166,22.3,934,809,8,123,332,1969,195
2017,36047007700,"Census Tract 77, Kings County, New York",2264,198,2066,1365,3068,126037,1944,2011,2207,23.9,919,799,40,146,328,2066,162
2018,36047007700,"Census Tract 77, Kings County, New York",2340,201,2139,1411,2952,106289,0,2011,2233,23.6,891,777,68,209,254,2139,247
2019,36047007700,"Census Tract 77, Kings County, New York",2492,260,2232,1373,2845,109883,1946,2012,2296,23.5,848,709,98,215,194,2232,239
2020,36047007700,"Census Tract 77, Kings County, New York",2714,287,2427,1350,2640,106300,0,2015,2402,22.8,926,727,58,178,140,2427,203
2012,36047007800,"Census Tract 78, Kings County, New York",1720,101,1619,1307,4083,32089,1939,2003,1139,28.3,186,146,52,156,982,1619,404
2013,36047007800,"Census Tract 78, Kings County, New York",1664,57,1607,1264,4231,30643,1939,2004,1245,31.6,195,100,63,100,1024,1607,432
2014,36047007800,"Census Tract 78, Kings County, New York",1673,53,1620,1267,4250,33309,1939,2004,1271,34.9,179,114,52,68,1058,1620,389
2015,36047007800,"Census Tract 78, Kings County, New York",1617,63,1554,1252,4357,39709,1939,2005,1288,34.2,195,120,30,64,1062,1554,365
2016,36047007800,"Census Tract 78, Kings County, New York",1604,68,1536,1158,4085,40513,1939,2005,1358,37.8,245,138,45,51,970,1536,318
2017,36047007800,"Census Tract 78, Kings County, New York",1539,57,1482,1106,3884,39219,1939,2006,1487,37.4,229,139,48,50,917,1482,349
2018,36047007800,"Census Tract 78, Kings County, New York",1558,70,1488,1152,3937,46196,0,2006,1450,31.1,243,218,59,30,896,1488,297
2019,36047007800,"Census Tract 78, Kings County, New York",1564,99,1465,1178,4141,41923,0,2008,1477,31,258,196,49,24,939,1465,264
2020,36047007800,"Census Tract 78, Kings County, New York",1510,101,1409,1187,4027,71575,1950,2010,1469,27.2,407,346,49,17,797,1409,258
2012,36047008000,"Census Tract 80, Kings County, New York",1467,90,1377,980,2873,29583,1939,2003,1098,36.6,208,144,18,124,695,1377,418
2013,36047008000,"Census Tract 80, Kings County, New York",1463,106,1357,975,2878,31745,1939,2003,1195,36.1,212,112,18,85,759,1357,338
2014,36047008000,"Census Tract 80, Kings County, New York",1393,86,1307,904,2732,32674,1939,2005,1361,37.9,234,129,29,101,644,1307,331
2015,36047008000,"Census Tract 80, Kings County, New York",1351,62,1289,857,2705,43403,1939,2006,1371,35.6,233,121,29,95,611,1289,211
2016,36047008000,"Census Tract 80, Kings County, New York",1292,56,1236,845,2666,46285,1939,2006,1559,35.7,281,171,5,48,611,1236,215
2017,36047008000,"Census Tract 80, Kings County, New York",1261,53,1208,812,2500,52634,1939,2007,1595,30.5,265,210,9,56,537,1208,225
2018,36047008000,"Census Tract 80, Kings County, New York",1246,39,1207,777,2374,54063,0,2010,1615,29.9,261,215,6,70,473,1207,223
2019,36047008000,"Census Tract 80, Kings County, New York",1212,78,1134,721,2203,61689,0,2011,1627,27.5,248,202,10,65,430,1134,153
2020,36047008000,"Census Tract 80, Kings County, New York",1341,133,1208,756,2332,64265,0,2012,1720,29.3,262,246,12,29,455,1208,194
2012,36047008200,"Census Tract 82, Kings County, New York",1564,148,1416,1115,3380,41106,1939,2003,1187,30.7,162,140,74,76,882,1416,357
2013,36047008200,"Census Tract 82, Kings County, New York",1533,154,1379,1131,3571,35903,1939,2003,1209,31.5,186,154,77,134,828,1379,453
2014,36047008200,"Census Tract 82, Kings County, New York",1538,158,1380,1148,3445,35694,1939,2004,1230,32.7,196,133,84,143,841,1380,495
2015,36047008200,"Census Tract 82, Kings County, New York",1530,107,1423,1187,3288,28552,1939,2005,1261,37.7,226,160,84,130,862,1423,502
2016,36047008200,"Census Tract 82, Kings County, New York",1469,33,1436,1179,3415,32199,1939,2007,1352,37.1,307,198,56,147,796,1436,486
2017,36047008200,"Census Tract 82, Kings County, New York",1434,26,1408,1224,3529,33182,1939,2008,1430,37.7,353,252,59,133,783,1408,519
2018,36047008200,"Census Tract 82, Kings County, New York",1428,31,1397,1228,3303,34886,0,2010,1351,34.7,386,252,80,133,765,1397,406
2019,36047008200,"Census Tract 82, Kings County, New York",1367,70,1297,1107,2999,37481,0,2010,1426,32.5,416,294,82,113,630,1297,324
2020,36047008200,"Census Tract 82, Kings County, New York",1513,121,1392,1156,2786,37826,1941,2009,1365,32.9,455,217,77,116,752,1392,245
2012,36047008400,"Census Tract 84, Kings County, New York",1186,136,1050,827,3029,32005,1939,2002,1215,42.7,139,86,0,33,678,1050,334
2013,36047008400,"Census Tract 84, Kings County, New York",1193,124,1069,742,2699,33991,1939,2003,1217,45.2,166,72,9,74,545,1069,298
2014,36047008400,"Census Tract 84, Kings County, New York",1168,122,1046,727,2935,40679,1955,2004,1354,42.3,105,104,11,6,587,1046,251
2015,36047008400,"Census Tract 84, Kings County, New York",1169,109,1060,795,3039,43438,1939,2004,1278,34.6,144,126,10,29,611,1060,286
2016,36047008400,"Census Tract 84, Kings County, New York",1176,89,1087,852,2990,42355,1939,2004,1266,36.3,204,147,18,55,591,1087,302
2017,36047008400,"Census Tract 84, Kings County, New York",1168,31,1137,846,2978,46695,1939,2006,1246,33.5,229,130,21,74,589,1137,217
2018,36047008400,"Census Tract 84, Kings County, New York",1156,0,1156,900,3104,46777,0,2007,1327,32.9,231,137,11,51,668,1156,251
2019,36047008400,"Census Tract 84, Kings County, New York",1187,18,1169,942,2946,45925,0,2011,1485,34.7,231,124,27,63,694,1169,241
2020,36047008400,"Census Tract 84, Kings County, New York",1268,28,1240,978,2908,41918,1945,2012,1509,37.6,208,105,25,38,785,1240,168
2012,36047008500,"Census Tract 85, Kings County, New York",3071,111,2960,2929,7174,17344,1953,1999,409,28.4,204,107,1324,45,1534,2960,1534
2013,36047008500,"Census Tract 85, Kings County, New York",3061,119,2942,2903,6994,18588,1953,2001,406,28.4,233,93,1312,79,1524,2942,1567
2014,36047008500,"Census Tract 85, Kings County, New York",3051,79,2972,2954,6636,13892,1952,2002,409,30,242,94,1437,98,1495,2972,1752
2015,36047008500,"Census Tract 85, Kings County, New York",3087,75,3012,2992,6896,13783,1952,2003,360,29.2,215,93,1528,187,1361,3012,1734
2016,36047008500,"Census Tract 85, Kings County, New York",3089,25,3064,3048,7265,14092,1952,2003,395,29.3,165,86,1421,203,1473,3064,1632
2017,36047008500,"Census Tract 85, Kings County, New York",3140,26,3114,3114,7559,13207,1952,2004,387,29.4,134,56,1531,197,1525,3114,1802
2018,36047008500,"Census Tract 85, Kings County, New York",3130,27,3103,3103,7555,12492,1952,2003,421,29.3,124,60,1523,194,1446,3103,1837
2019,36047008500,"Census Tract 85, Kings County, New York",3140,21,3119,3119,7793,15283,1951,2003,431,29.1,150,16,1666,188,1397,3119,1659
2020,36047008500,"Census Tract 85, Kings County, New York",3213,137,3076,3076,7577,17649,1949,2005,479,29.6,363,0,1669,156,1480,3076,1697
2012,36047008600,"Census Tract 86, Kings County, New York",0,0,0,0,0,NA,NA,NA,NA,NA,0,0,0,0,0,0,0
2013,36047008600,"Census Tract 86, Kings County, New York",0,0,0,0,0,NA,NA,NA,NA,NA,0,0,0,0,0,0,0
2014,36047008600,"Census Tract 86, Kings County, New York",0,0,0,0,0,NA,NA,NA,NA,NA,0,0,0,0,0,0,0
2015,36047008600,"Census Tract 86, Kings County, New York",0,0,0,0,0,NA,NA,NA,NA,NA,0,0,0,0,0,0,0
2016,36047008600,"Census Tract 86, Kings County, New York",0,0,0,0,0,NA,NA,NA,NA,NA,0,0,0,0,0,0,0
2017,36047008600,"Census Tract 86, Kings County, New York",0,0,0,0,0,NA,NA,NA,NA,NA,0,0,0,0,0,0,0
2018,36047008600,"Census Tract 86, Kings County, New York",0,0,0,0,0,NA,NA,NA,NA,NA,0,0,0,0,0,0,0
2019,36047008600,"Census Tract 86, Kings County, New York",0,0,0,0,0,NA,NA,NA,NA,NA,0,0,0,0,0,0,0
2020,36047008600,"Census Tract 86, Kings County, New York",0,0,0,0,0,NA,NA,NA,NA,NA,0,0,0,0,0,0,0
2012,36047008800,"Census Tract 88, Kings County, New York",1242,80,1162,773,2409,36891,1939,2005,1311,38.2,179,229,0,44,478,1162,246
2013,36047008800,"Census Tract 88, Kings County, New York",1245,114,1131,754,2247,37600,1939,2004,1354,38.7,154,197,0,58,467,1131,196
2014,36047008800,"Census Tract 88, Kings County, New York",1216,107,1109,691,2133,37060,1939,2006,1386,42.6,147,121,0,46,508,1109,212
2015,36047008800,"Census Tract 88, Kings County, New York",1255,72,1183,734,2265,39947,1939,2007,1481,39.8,202,167,33,26,486,1183,143
2016,36047008800,"Census Tract 88, Kings County, New York",1305,51,1254,702,2088,50673,1939,2008,1436,36.5,228,161,25,36,469,1254,170
2017,36047008800,"Census Tract 88, Kings County, New York",1268,84,1184,636,1675,58393,1939,2008,1539,29.6,290,183,21,31,378,1184,118
2018,36047008800,"Census Tract 88, Kings County, New York",1226,75,1151,557,1304,61183,0,2012,1482,29.2,288,214,38,48,239,1151,146
2019,36047008800,"Census Tract 88, Kings County, New York",1184,102,1082,598,1278,63636,0,2012,1607,29.8,230,183,68,57,280,1082,102
2020,36047008800,"Census Tract 88, Kings County, New York",1186,147,1039,704,1486,77518,1949,2012,1697,28.7,184,148,205,73,267,1039,91
2012,36047009000,"Census Tract 90, Kings County, New York",933,41,892,758,2642,31193,1939,2005,1195,44.8,154,96,18,335,309,892,306
2013,36047009000,"Census Tract 90, Kings County, New York",961,17,944,807,2878,31950,1939,2005,1163,40.2,134,78,0,364,339,944,315
2014,36047009000,"Census Tract 90, Kings County, New York",967,65,902,752,2869,35640,1939,2006,1303,41.8,104,74,0,267,388,902,246
2015,36047009000,"Census Tract 90, Kings County, New York",976,95,881,727,2714,37380,1939,2009,1324,41.6,116,77,29,241,360,881,208
2016,36047009000,"Census Tract 90, Kings County, New York",962,72,890,724,2652,39758,1939,2011,1343,41.2,129,86,42,259,329,890,179
2017,36047009000,"Census Tract 90, Kings County, New York",985,79,906,717,2670,39708,1939,2011,1343,40.2,126,93,49,213,370,906,178
2018,36047009000,"Census Tract 90, Kings County, New York",951,88,863,668,2232,41582,0,2012,1419,41.1,117,98,53,166,374,863,153
2019,36047009000,"Census Tract 90, Kings County, New York",934,52,882,674,2302,48194,0,2012,1542,36.5,126,94,55,166,383,882,168
2020,36047009001,"Census Tract 90.01, Kings County, New York",493,35,458,353,1179,76607,0,2013,1726,31.1,67,52,33,42,259,458,127
2020,36047009002,"Census Tract 90.02, Kings County, New York",438,12,426,336,1060,50349,0,2013,1500,44.8,55,50,9,99,178,426,18
2012,36047009200,"Census Tract 92, Kings County, New York",1687,102,1585,1334,4094,33362,1939,2004,1151,43,256,176,78,406,624,1585,424
2013,36047009200,"Census Tract 92, Kings County, New York",1677,57,1620,1361,4370,36890,1939,2005,1212,38.9,231,171,63,425,669,1620,433
2014,36047009200,"Census Tract 92, Kings County, New York",1702,80,1622,1396,4581,35709,1939,2006,1251,39.4,270,121,56,523,652,1622,498
2015,36047009200,"Census Tract 92, Kings County, New York",1707,50,1657,1408,4644,35000,1939,2008,1242,46.4,267,147,72,603,567,1657,611
2016,36047009200,"Census Tract 92, Kings County, New York",1710,43,1667,1351,4374,32806,1939,2010,1243,50,217,95,79,636,545,1667,660
2017,36047009200,"Census Tract 92, Kings County, New York",1723,44,1679,1342,4555,33654,1939,2011,1256,45.5,247,126,74,606,541,1679,692
2018,36047009200,"Census Tract 92, Kings County, New York",1743,45,1698,1355,4454,37232,0,2011,1278,44.5,296,160,122,550,544,1698,570
2019,36047009200,"Census Tract 92, Kings County, New York",1713,46,1667,1283,4061,39602,0,2011,1299,42.1,296,157,131,485,532,1667,514
2020,36047009201,"Census Tract 92.01, Kings County, New York",600,33,567,375,1346,54391,0,2013,1461,26.9,62,61,0,189,125,567,147
2020,36047009202,"Census Tract 92.02, Kings County, New York",1168,35,1133,950,2931,33194,0,2011,1407,41.5,211,87,105,213,551,1133,378
2012,36047009400,"Census Tract 94, Kings County, New York",1691,119,1572,1188,3893,50735,1939,2003,1060,27.2,319,354,35,498,258,1572,354
2013,36047009400,"Census Tract 94, Kings County, New York",1701,126,1575,1128,4061,34135,1939,2005,1099,32.7,222,267,20,576,223,1575,529
2014,36047009400,"Census Tract 94, Kings County, New York",1702,107,1595,1180,4317,37917,1939,2006,1183,34.2,240,263,37,569,288,1595,558
2015,36047009400,"Census Tract 94, Kings County, New York",1653,132,1521,1171,4452,38272,1939,2008,1239,36.2,239,225,30,610,299,1521,527
2016,36047009400,"Census Tract 94, Kings County, New York",1613,103,1510,1138,4136,41447,1944,2010,1319,36.5,299,196,52,654,236,1510,523
2017,36047009400,"Census Tract 94, Kings County, New York",1564,90,1474,1097,4087,42253,1948,2010,1353,35.9,249,161,40,600,296,1474,428
2018,36047009400,"Census Tract 94, Kings County, New York",1587,95,1492,1170,4070,43178,1944,2011,1318,34.7,237,210,34,596,311,1492,356
2019,36047009400,"Census Tract 94, Kings County, New York",1553,110,1443,1105,3754,45694,0,2011,1339,39.5,200,202,19,595,265,1443,318
2020,36047009401,"Census Tract 94.01, Kings County, New York",697,85,612,411,1452,35982,0,2012,1198,32.4,101,37,45,214,115,612,151
2020,36047009402,"Census Tract 94.02, Kings County, New York",827,27,800,652,2176,55603,0,2012,1545,40.7,217,184,0,369,83,800,164
2012,36047009600,"Census Tract 96, Kings County, New York",1974,98,1876,1448,4929,39657,1939,2003,1244,36.3,220,224,102,258,899,1876,439
2013,36047009600,"Census Tract 96, Kings County, New York",1953,84,1869,1488,4901,38663,1939,2004,1257,36.8,208,156,45,314,966,1869,391
2014,36047009600,"Census Tract 96, Kings County, New York",1978,106,1872,1530,5338,37685,1939,2006,1252,36.9,184,200,28,402,883,1872,465
2015,36047009600,"Census Tract 96, Kings County, New York",1987,146,1841,1516,4939,32283,1939,2009,1231,39.7,218,205,60,440,775,1841,587
2016,36047009600,"Census Tract 96, Kings County, New York",1965,99,1866,1527,5033,36470,1939,2010,1339,42.1,183,193,76,399,819,1866,554
2017,36047009600,"Census Tract 96, Kings County, New York",2001,87,1914,1496,5308,38831,1939,2011,1450,39.1,221,179,100,383,778,1914,499
2018,36047009600,"Census Tract 96, Kings County, New York",1939,84,1855,1428,5136,37619,0,2011,1464,39.9,230,195,90,377,735,1855,537
2019,36047009600,"Census Tract 96, Kings County, New York",1905,99,1806,1367,4951,39063,0,2011,1525,40.7,209,172,123,356,708,1806,489
2020,36047009600,"Census Tract 96, Kings County, New York",1931,53,1878,1301,4328,42393,0,2012,1616,37.3,296,282,96,341,599,1878,369
2012,36047009800,"Census Tract 98, Kings County, New York",1946,115,1831,1488,6071,30926,1939,2004,1073,36.9,115,53,40,512,915,1831,639
2013,36047009800,"Census Tract 98, Kings County, New York",1962,122,1840,1540,6487,26076,1939,2005,1127,39.2,95,81,75,550,891,1840,773
2014,36047009800,"Census Tract 98, Kings County, New York",1980,121,1859,1514,6197,25781,1939,2006,1134,40.2,113,69,61,523,903,1859,822
2015,36047009800,"Census Tract 98, Kings County, New York",1978,130,1848,1584,6975,27974,1939,2007,1228,39.8,80,67,58,571,926,1848,878
2016,36047009800,"Census Tract 98, Kings County, New York",1916,135,1781,1547,6963,32159,1939,2008,1303,39.4,94,85,77,585,845,1781,808
2017,36047009800,"Census Tract 98, Kings County, New York",1820,128,1692,1388,6083,34450,1939,2007,1227,38.2,88,77,56,477,807,1692,691
2018,36047009800,"Census Tract 98, Kings County, New York",1818,121,1697,1308,5617,43284,0,2007,1375,37.6,97,55,25,417,807,1697,593
2019,36047009800,"Census Tract 98, Kings County, New York",1805,118,1687,1345,5383,45033,0,2009,1405,36.6,101,40,49,404,847,1687,586
2020,36047009800,"Census Tract 98, Kings County, New York",1770,94,1676,1339,4946,56926,0,2010,1485,31.4,124,35,55,416,837,1676,436
2012,36047010000,"Census Tract 100, Kings County, New York",2014,121,1893,1624,5744,25525,1939,2004,1027,34.3,204,122,110,689,763,1893,708
2013,36047010000,"Census Tract 100, Kings County, New York",1965,114,1851,1514,5148,25405,1939,2005,1011,35.2,198,117,60,638,718,1851,739
2014,36047010000,"Census Tract 100, Kings County, New York",1968,154,1814,1479,5246,26097,1939,2006,1079,36.4,161,110,42,624,718,1814,733
2015,36047010000,"Census Tract 100, Kings County, New York",1905,152,1753,1377,4967,28456,1939,2010,1063,34,108,109,19,639,603,1753,694
2016,36047010000,"Census Tract 100, Kings County, New York",1885,163,1722,1353,5324,30605,1939,2011,1202,34.1,127,115,0,624,599,1722,673
2017,36047010000,"Census Tract 100, Kings County, New York",1878,170,1708,1320,5082,35774,1939,2010,1210,30.8,95,123,9,584,603,1708,585
2018,36047010000,"Census Tract 100, Kings County, New York",1852,209,1643,1330,5083,44643,0,2011,1277,29.7,120,144,9,564,612,1643,478
2019,36047010000,"Census Tract 100, Kings County, New York",1839,192,1647,1268,4566,51090,0,2011,1287,29,141,80,64,522,601,1647,441
2020,36047010000,"Census Tract 100, Kings County, New York",2009,275,1734,1272,4657,51029,0,2012,1481,32.3,222,111,94,440,639,1734,427
2012,36047010100,"Census Tract 101, Kings County, New York",1591,47,1544,1113,2989,39750,1939,2005,1165,37.1,392,313,51,24,725,1544,252
2013,36047010100,"Census Tract 101, Kings County, New York",1576,63,1513,1105,2957,38862,1939,2004,1157,37.8,382,302,53,43,699,1513,279
2014,36047010100,"Census Tract 101, Kings County, New York",1575,82,1493,1097,2999,40651,1939,2006,1224,36.2,347,281,42,24,725,1493,260
2015,36047010100,"Census Tract 101, Kings County, New York",1597,89,1508,1107,3249,36534,1939,2007,1182,34.6,308,246,41,71,711,1508,306
2016,36047010100,"Census Tract 101, Kings County, New York",1562,102,1460,1077,3011,46397,1939,2010,1228,30.2,306,249,17,113,658,1460,277
2017,36047010100,"Census Tract 101, Kings County, New York",1562,105,1457,1036,2981,56053,1939,2010,1382,29.5,263,233,39,124,576,1457,271
2018,36047010100,"Census Tract 101, Kings County, New York",1532,115,1417,1003,2672,58750,0,2011,1491,29.7,317,240,40,118,545,1417,235
2019,36047010100,"Census Tract 101, Kings County, New York",1548,133,1415,964,2579,67875,0,2011,1513,28.6,316,243,45,129,503,1415,213
2020,36047010100,"Census Tract 101, Kings County, New York",1691,197,1494,1086,2567,94342,1945,2014,1906,25,558,244,38,58,688,1494,161
2012,36047010200,"Census Tract 102, Kings County, New York",1557,118,1439,1041,3408,38102,1939,2004,1150,32.7,146,113,42,481,398,1439,276
2013,36047010200,"Census Tract 102, Kings County, New York",1521,108,1413,1048,3531,41324,1939,2005,1167,30.4,184,116,28,508,388,1413,264
2014,36047010200,"Census Tract 102, Kings County, New York",1490,122,1368,1036,3777,43650,1939,2007,1234,30.3,148,89,17,572,350,1368,290
2015,36047010200,"Census Tract 102, Kings County, New York",1491,127,1364,1039,3840,41935,1939,2008,1171,32,134,107,10,569,345,1364,325
2016,36047010200,"Census Tract 102, Kings County, New York",1471,119,1352,1009,3801,48942,1939,2009,1221,31.6,136,117,22,509,365,1352,351
2017,36047010200,"Census Tract 102, Kings County, New York",1464,160,1304,969,3710,54125,1939,2007,1242,28.7,145,130,12,514,325,1304,307
2018,36047010200,"Census Tract 102, Kings County, New York",1466,170,1296,953,3847,55297,0,2008,1291,30.9,136,68,13,555,330,1296,271
2019,36047010200,"Census Tract 102, Kings County, New York",1426,187,1239,890,3320,55183,0,2009,1294,30.4,140,68,10,500,322,1239,215
2020,36047010200,"Census Tract 102, Kings County, New York",1330,86,1244,937,3424,58602,0,2012,1567,27.7,152,117,23,508,312,1244,165
2012,36047010400,"Census Tract 104, Kings County, New York",1728,122,1606,1327,4545,24566,1939,2003,1093,44.3,185,146,19,1013,139,1606,618
2013,36047010400,"Census Tract 104, Kings County, New York",1784,144,1640,1357,5099,27137,1939,2004,1100,41.1,152,111,18,1007,206,1640,599
2014,36047010400,"Census Tract 104, Kings County, New York",1794,136,1658,1342,4716,29353,1939,2005,1101,39.4,233,117,9,941,262,1658,568
2015,36047010400,"Census Tract 104, Kings County, New York",1762,120,1642,1328,4754,30263,1939,2007,1112,42.4,234,146,18,950,185,1642,521
2016,36047010400,"Census Tract 104, Kings County, New York",1743,101,1642,1322,4894,30445,1939,2010,1188,43.6,294,130,19,971,152,1642,496
2017,36047010400,"Census Tract 104, Kings County, New York",1676,90,1586,1205,4428,35230,1939,2011,1207,40.4,254,109,10,875,160,1586,410
2018,36047010400,"Census Tract 104, Kings County, New York",1684,169,1515,1114,4197,38152,0,2012,1289,38.6,271,101,11,872,86,1515,411
2019,36047010400,"Census Tract 104, Kings County, New York",1609,214,1395,989,3647,38356,0,2012,1284,37.9,224,88,10,758,80,1395,332
2020,36047010401,"Census Tract 104.01, Kings County, New York",768,175,593,434,1785,47727,0,2011,1339,32.6,97,55,0,327,52,593,69
2020,36047010402,"Census Tract 104.02, Kings County, New York",792,145,647,491,1755,28986,0,2014,1215,41,119,21,0,400,31,647,247
2012,36047010600,"Census Tract 106, Kings County, New York",1663,135,1528,1180,4640,28562,1939,2004,1061,41.5,39,88,29,885,188,1528,608
2013,36047010600,"Census Tract 106, Kings County, New York",1640,120,1520,1170,4679,33622,1939,2005,1115,37.7,43,111,28,875,138,1520,636
2014,36047010600,"Census Tract 106, Kings County, New York",1582,121,1461,1196,4783,26477,1939,2006,1146,41.8,30,71,17,923,170,1461,621
2015,36047010600,"Census Tract 106, Kings County, New York",1542,119,1423,1231,5055,33628,1939,2007,1192,40.3,166,106,23,901,177,1423,544
2016,36047010600,"Census Tract 106, Kings County, New York",1481,98,1383,1136,4361,33547,1939,2009,1147,41.6,170,92,47,787,199,1383,553
2017,36047010600,"Census Tract 106, Kings County, New York",1393,78,1315,1054,3969,36528,1939,2010,1252,38.7,148,85,18,788,136,1315,408
2018,36047010600,"Census Tract 106, Kings County, New York",1314,99,1215,939,3474,40331,0,2010,1413,36.7,184,77,35,727,111,1215,393
2019,36047010600,"Census Tract 106, Kings County, New York",1317,102,1215,928,3435,43947,1950,2012,1455,33.7,180,60,35,686,158,1215,415
2020,36047010601,"Census Tract 106.01, Kings County, New York",735,41,694,560,1975,42269,1949,2013,1500,38,56,5,50,394,144,694,203
2020,36047010602,"Census Tract 106.02, Kings County, New York",611,61,550,328,1037,52500,0,2005,971,30.8,32,7,0,321,0,550,195
2012,36047010800,"Census Tract 108, Kings County, New York",1592,175,1417,1138,3673,30370,1939,2005,1083,40,164,126,69,704,238,1417,460
2013,36047010800,"Census Tract 108, Kings County, New York",1569,174,1395,1142,3780,27500,1939,2005,1074,41.8,169,129,39,687,273,1395,514
2014,36047010800,"Census Tract 108, Kings County, New York",1565,181,1384,1104,3613,28250,1939,2006,1087,41.6,166,122,26,715,215,1384,464
2015,36047010800,"Census Tract 108, Kings County, New York",1519,206,1313,1048,3328,25743,1939,2007,1019,41.5,211,136,30,697,186,1313,439
2016,36047010800,"Census Tract 108, Kings County, New York",1432,134,1298,971,3029,25868,1939,2008,1028,39.8,205,108,20,671,182,1298,445
2017,36047010800,"Census Tract 108, Kings County, New York",1441,88,1353,1007,3219,37804,1939,2009,1166,38.9,186,145,21,636,215,1353,400
2018,36047010800,"Census Tract 108, Kings County, New York",1457,167,1290,972,2946,46779,0,2010,1278,37.9,177,146,23,602,212,1290,346
2019,36047010800,"Census Tract 108, Kings County, New York",1423,132,1291,970,3085,48147,0,2011,1318,37.9,148,135,38,541,256,1291,344
2020,36047010801,"Census Tract 108.01, Kings County, New York",626,31,595,391,1406,50087,0,2014,1547,37.6,95,78,0,218,95,595,145
2020,36047010802,"Census Tract 108.02, Kings County, New York",810,73,737,610,1722,51667,0,2010,1263,30.6,81,90,33,341,146,737,225
2012,36047011000,"Census Tract 110, Kings County, New York",768,52,716,517,1826,32083,1939,2005,1197,42.2,92,167,0,102,248,716,231
2013,36047011000,"Census Tract 110, Kings County, New York",763,47,716,538,1894,35446,1939,2006,1316,43.3,83,124,0,97,317,716,228
2014,36047011000,"Census Tract 110, Kings County, New York",750,70,680,490,1824,38889,1939,2008,1377,45.8,49,100,0,120,265,680,166
2015,36047011000,"Census Tract 110, Kings County, New York",742,76,666,460,1787,36447,1939,2009,1299,47.8,53,120,0,129,200,666,182
2016,36047011000,"Census Tract 110, Kings County, New York",729,69,660,437,1662,50347,1939,2010,1453,45.3,62,97,0,89,234,660,166
2017,36047011000,"Census Tract 110, Kings County, New York",699,72,627,408,1661,45000,1939,2011,1485,46.1,62,118,0,92,185,627,154
2018,36047011000,"Census Tract 110, Kings County, New York",682,76,606,379,1505,42344,0,2011,1567,48.8,72,135,0,90,140,606,144
2019,36047011000,"Census Tract 110, Kings County, New York",661,62,599,363,1617,44632,1962,2011,1607,43.3,51,128,0,68,159,599,149
2020,36047011000,"Census Tract 110, Kings County, New York",665,34,631,338,1340,48393,1962,2012,1614,32.7,49,103,0,67,159,631,124
2012,36047011200,"Census Tract 112, Kings County, New York",2096,17,2079,1791,5280,26686,1939,2001,994,33.4,306,778,25,155,833,2079,713
2013,36047011200,"Census Tract 112, Kings County, New York",2067,36,2031,1701,5156,25571,1939,2002,1041,37.7,297,736,31,196,738,2031,709
2014,36047011200,"Census Tract 112, Kings County, New York",2088,89,1999,1674,5537,26420,1939,2004,1080,37.6,231,641,45,224,773,1999,748
2015,36047011200,"Census Tract 112, Kings County, New York",2102,118,1984,1613,5351,26419,1939,2005,1094,37.5,247,627,51,205,737,1984,715
2016,36047011200,"Census Tract 112, Kings County, New York",2098,135,1963,1693,5727,26218,1939,2006,1127,38.3,262,634,63,322,685,1963,708
2017,36047011200,"Census Tract 112, Kings County, New York",2120,137,1983,1750,5728,27725,1940,2009,1202,42,277,590,61,390,725,1983,656
2018,36047011200,"Census Tract 112, Kings County, New York",2050,157,1893,1644,5230,26948,1947,2010,1252,39.7,255,623,67,357,606,1893,741
2019,36047011200,"Census Tract 112, Kings County, New York",2040,114,1926,1611,4850,29030,1946,2010,1229,35.6,219,559,66,360,643,1926,668
2020,36047011200,"Census Tract 112, Kings County, New York",2190,84,2106,1796,4871,38333,1944,2012,1294,33.6,345,615,70,414,687,2106,622
2012,36047011400,"Census Tract 114, Kings County, New York",1340,100,1240,983,3091,38555,1939,2004,946,27.3,356,519,40,258,166,1240,296
2013,36047011400,"Census Tract 114, Kings County, New York",1311,150,1161,905,2894,42125,1939,2005,1025,28.3,272,431,60,240,174,1161,291
2014,36047011400,"Census Tract 114, Kings County, New York",1307,146,1161,836,2784,42403,1939,2006,1068,30.4,284,357,70,241,164,1161,284
2015,36047011400,"Census Tract 114, Kings County, New York",1300,126,1174,841,2826,41359,1939,2009,1146,36.1,285,369,89,197,161,1174,245
2016,36047011400,"Census Tract 114, Kings County, New York",1287,100,1187,822,2897,44182,1939,2010,1159,35.1,292,317,94,245,156,1187,296
2017,36047011400,"Census Tract 114, Kings County, New York",1287,161,1126,797,2910,43498,1939,2010,1258,37.4,262,353,84,211,137,1126,308
2018,36047011400,"Census Tract 114, Kings County, New York",1236,166,1070,773,2732,36823,0,2010,1247,41.7,266,318,77,190,170,1070,274
2019,36047011400,"Census Tract 114, Kings County, New York",1183,228,955,724,2538,42440,0,2011,1342,40.1,242,360,58,198,108,955,248
2020,36047011400,"Census Tract 114, Kings County, New York",1089,183,906,709,2715,50884,0,2012,1511,36.8,192,318,46,173,197,906,288
2012,36047011600,"Census Tract 116, Kings County, New York",1405,95,1310,1004,3173,21424,1939,2003,947,34,127,184,44,549,227,1310,471
2013,36047011600,"Census Tract 116, Kings County, New York",1372,125,1247,955,3378,28948,1939,2003,1002,33.8,148,156,60,539,200,1247,401
2014,36047011600,"Census Tract 116, Kings County, New York",1345,102,1243,1017,3450,30082,1939,2005,1035,33.5,147,183,58,600,186,1243,390
2015,36047011600,"Census Tract 116, Kings County, New York",1352,122,1230,1033,3476,31617,1939,2007,1094,33.6,139,188,57,596,201,1230,375
2016,36047011600,"Census Tract 116, Kings County, New York",1277,57,1220,1064,3589,31447,1939,2009,1150,35.1,117,179,42,707,145,1220,393
2017,36047011600,"Census Tract 116, Kings County, New York",1211,135,1076,872,3038,33944,1939,2010,1272,36.7,106,158,23,590,109,1076,313
2018,36047011600,"Census Tract 116, Kings County, New York",1209,121,1088,864,2677,27500,0,2012,1385,45.5,76,169,11,581,114,1088,334
2019,36047011600,"Census Tract 116, Kings County, New York",1206,130,1076,828,2662,33579,0,2013,1482,43.6,89,129,9,570,120,1076,264
2020,36047011600,"Census Tract 116, Kings County, New York",1242,218,1024,797,2672,40011,0,2016,1507,43.4,96,111,10,605,71,1024,287
2012,36047011700,"Census Tract 117, Kings County, New York",1285,62,1223,949,1787,61133,1939,2006,1433,28.4,579,574,11,70,253,1223,121
2013,36047011700,"Census Tract 117, Kings County, New York",1310,77,1233,943,1832,63015,1939,2008,1556,27.7,604,643,6,58,187,1233,164
2014,36047011700,"Census Tract 117, Kings County, New York",1368,123,1245,916,1871,68571,1939,2011,1709,28.1,625,560,21,68,199,1245,162
2015,36047011700,"Census Tract 117, Kings County, New York",1333,93,1240,963,1930,67644,1941,2011,1655,28.6,638,612,38,77,186,1240,152
2016,36047011700,"Census Tract 117, Kings County, New York",1303,94,1209,895,1931,74241,1939,2011,1711,30.9,622,531,59,44,238,1209,141
2017,36047011700,"Census Tract 117, Kings County, New York",1341,110,1231,836,1829,77457,1941,2012,1972,30.7,557,477,53,49,214,1231,144
2018,36047011700,"Census Tract 117, Kings County, New York",1302,169,1133,735,1578,90850,0,2013,2022,29.2,481,431,47,34,176,1133,186
2019,36047011700,"Census Tract 117, Kings County, New York",1278,118,1160,766,1765,96892,0,2014,1894,27.1,485,455,74,40,158,1160,184
2020,36047011700,"Census Tract 117, Kings County, New York",1273,120,1153,782,2116,102500,0,2015,1860,25.7,508,405,45,51,237,1153,128
2012,36047011800,"Census Tract 118, Kings County, New York",674,40,634,456,1776,31711,1939,2005,1267,47.8,4,13,26,285,132,634,185
2013,36047011800,"Census Tract 118, Kings County, New York",713,33,680,494,1981,31279,1939,2005,1318,49.8,5,16,24,311,143,680,175
2014,36047011800,"Census Tract 118, Kings County, New York",686,29,657,488,1557,22778,1939,2005,1272,50,22,42,0,284,162,657,178
2015,36047011800,"Census Tract 118, Kings County, New York",680,36,644,493,1594,NA,1939,2006,1276,50,31,47,0,307,139,644,189
2016,36047011800,"Census Tract 118, Kings County, New York",626,39,587,484,1687,25104,1939,2009,1232,50,29,31,0,345,108,587,216
2017,36047011800,"Census Tract 118, Kings County, New York",620,43,577,465,1634,28107,1939,2009,1304,50,34,34,0,349,82,577,194
2018,36047011800,"Census Tract 118, Kings County, New York",603,35,568,474,1588,35313,0,2011,1365,40.5,66,39,0,352,83,568,150
2019,36047011800,"Census Tract 118, Kings County, New York",609,9,600,489,1652,52083,0,2012,1449,39.9,87,44,0,372,67,600,133
2020,36047011800,"Census Tract 118, Kings County, New York",590,13,577,476,1602,47292,0,2014,1488,40.5,107,42,0,372,56,577,110
2012,36047011900,"Census Tract 119, Kings County, New York",774,7,767,567,1321,71484,1939,2005,1458,27.6,317,327,64,7,157,767,38
2013,36047011900,"Census Tract 119, Kings County, New York",788,36,752,559,1191,65521,1939,2006,1385,29.1,352,360,42,21,124,752,71
2014,36047011900,"Census Tract 119, Kings County, New York",824,34,790,592,1432,79091,1939,2008,1503,28.5,372,342,33,32,168,790,53
2015,36047011900,"Census Tract 119, Kings County, New York",772,55,717,513,1115,80536,1939,2010,1621,28.1,342,329,42,39,89,717,58
2016,36047011900,"Census Tract 119, Kings County, New York",781,61,720,551,1185,74821,1939,2011,1626,28.5,345,328,59,40,108,720,72
2017,36047011900,"Census Tract 119, Kings County, New York",733,80,653,499,1090,84940,1939,2012,1856,26.1,347,340,50,40,58,653,61
2018,36047011900,"Census Tract 119, Kings County, New York",677,73,604,420,909,93500,0,2012,1981,25.9,307,300,36,24,47,604,49
2019,36047011900,"Census Tract 119, Kings County, New York",645,70,575,401,829,88173,0,2012,1928,26.6,288,312,41,13,30,575,55
2020,36047011901,"Census Tract 119.01, Kings County, New York",674,85,589,362,772,98125,0,2013,2089,24.4,247,285,34,4,34,589,54
2020,36047011902,"Census Tract 119.02, Kings County, New York",0,0,0,0,0,NA,NA,NA,NA,NA,0,0,0,0,0,0,0
2012,36047012000,"Census Tract 120, Kings County, New York",341,27,314,284,1333,23750,1939,2006,1317,50,17,18,0,248,18,314,161
2013,36047012000,"Census Tract 120, Kings County, New York",332,28,304,261,1290,51607,1939,2005,1301,37.7,21,23,0,219,19,304,146
2014,36047012000,"Census Tract 120, Kings County, New York",350,40,310,240,1081,50938,1939,2007,1218,40,16,27,0,195,18,310,140
2015,36047012000,"Census Tract 120, Kings County, New York",370,30,340,264,981,26429,1939,2010,1264,50,4,26,0,196,38,340,138
2016,36047012000,"Census Tract 120, Kings County, New York",377,29,348,255,947,30938,1939,2011,1291,50,7,16,0,192,43,348,127
2017,36047012000,"Census Tract 120, Kings County, New York",364,41,323,229,741,26150,1939,2011,1367,50,10,23,0,131,69,323,91
2018,36047012000,"Census Tract 120, Kings County, New York",360,39,321,237,796,30221,0,2011,1375,51,15,18,0,151,64,321,77
2019,36047012000,"Census Tract 120, Kings County, New York",339,35,304,228,815,32069,1942,2011,1412,51,19,11,0,143,70,304,70
2020,36047012000,"Census Tract 120, Kings County, New York",364,12,352,182,693,NA,1941,2011,1402,42.8,39,13,0,113,56,352,52
2012,36047012100,"Census Tract 121, Kings County, New York",833,0,833,445,900,62344,1939,2004,1554,26.8,248,271,4,55,111,833,92
2013,36047012100,"Census Tract 121, Kings County, New York",824,56,768,394,805,61750,1939,2005,1576,28.1,246,239,11,43,96,768,74
2014,36047012100,"Census Tract 121, Kings County, New York",815,66,749,471,1032,81625,1939,2007,1790,24.8,317,319,10,44,93,749,42
2015,36047012100,"Census Tract 121, Kings County, New York",820,73,747,493,1073,91563,1939,2010,2043,27.2,382,351,9,40,88,747,56
2016,36047012100,"Census Tract 121, Kings County, New York",809,68,741,485,1057,100170,1939,2011,2046,25.4,366,349,10,46,77,741,55
2017,36047012100,"Census Tract 121, Kings County, New York",860,76,784,526,1234,104211,1939,2012,2173,25.9,388,381,0,39,100,784,73
2018,36047012100,"Census Tract 121, Kings County, New York",874,24,850,581,1354,114250,0,2012,2357,25.3,397,401,0,51,115,850,65
2019,36047012100,"Census Tract 121, Kings County, New York",890,45,845,574,1265,116000,0,2013,2369,26.4,403,390,6,64,99,845,69
2020,36047012100,"Census Tract 121, Kings County, New York",871,57,814,530,1094,108750,0,2015,2796,26.9,388,401,6,49,58,814,45
2012,36047012200,"Census Tract 122, Kings County, New York",1603,118,1485,1087,3656,35290,1939,2005,1269,43.7,199,201,42,316,528,1485,400
2013,36047012200,"Census Tract 122, Kings County, New York",1651,156,1495,1132,3764,28956,1939,2005,1233,50,171,197,17,359,551,1495,450
2014,36047012200,"Census Tract 122, Kings County, New York",1673,138,1535,1148,3828,29442,1939,2007,1204,50,161,212,16,293,617,1535,481
2015,36047012200,"Census Tract 122, Kings County, New York",1697,175,1522,1225,4753,30557,1940,2007,1228,43.1,165,114,20,451,632,1522,558
2016,36047012200,"Census Tract 122, Kings County, New York",1672,109,1563,1321,4947,33625,1940,2007,1192,40.1,178,102,0,539,670,1563,580
2017,36047012200,"Census Tract 122, Kings County, New York",1679,69,1610,1362,5096,37132,1942,2008,1241,38.1,221,139,0,489,725,1610,562
2018,36047012200,"Census Tract 122, Kings County, New York",1601,66,1535,1284,4894,44186,0,2009,1290,35.3,241,146,0,487,651,1535,523
2019,36047012200,"Census Tract 122, Kings County, New York",1574,69,1505,1311,4855,49589,0,2009,1378,33.1,257,148,0,530,622,1505,498
2020,36047012200,"Census Tract 122, Kings County, New York",1621,58,1563,1280,4052,39554,0,2010,1419,34.9,187,129,50,389,738,1563,536
2012,36047012600,"Census Tract 126, Kings County, New York",986,76,910,602,1771,25403,1939,2004,1180,46.1,140,245,44,100,230,910,293
2013,36047012600,"Census Tract 126, Kings County, New York",973,74,899,587,1922,25691,1939,2004,1283,49.2,181,236,10,128,207,899,314
2014,36047012600,"Census Tract 126, Kings County, New York",971,72,899,619,1824,32992,1939,2004,1255,45.5,215,232,8,143,235,899,240
2015,36047012600,"Census Tract 126, Kings County, New York",933,59,874,577,1820,31125,1939,2006,1277,43.9,185,221,17,148,189,874,233
2016,36047012600,"Census Tract 126, Kings County, New York",957,57,900,619,1985,34750,1939,2007,1370,42.2,231,230,25,168,192,900,193
2017,36047012600,"Census Tract 126, Kings County, New York",972,77,895,605,1951,39271,1939,2009,1361,39.2,227,237,28,166,180,895,168
2018,36047012600,"Census Tract 126, Kings County, New York",956,97,859,574,1854,42045,0,2010,1399,35.7,249,222,43,126,186,859,177
2019,36047012600,"Census Tract 126, Kings County, New York",949,79,870,599,1935,42788,0,2011,1427,38.7,231,233,41,135,191,870,209
2020,36047012600,"Census Tract 126, Kings County, New York",929,87,842,586,1845,49773,0,2011,1482,43.5,203,236,43,116,197,842,170
2012,36047012700,"Census Tract 127, Kings County, New York",1546,56,1490,1397,3222,27364,1961,2000,603,27.1,257,257,570,17,626,1490,453
2013,36047012700,"Census Tract 127, Kings County, New York",1569,41,1528,1377,3201,24754,1958,2002,617,26.6,358,246,598,52,519,1528,453
2014,36047012700,"Census Tract 127, Kings County, New York",1584,64,1520,1347,3273,43594,1963,2004,661,25.6,426,325,555,77,432,1520,447
2015,36047012700,"Census Tract 127, Kings County, New York",1652,38,1614,1428,3356,NA,1965,2006,905,24.3,515,376,568,101,395,1614,391
2016,36047012700,"Census Tract 127, Kings County, New York",1679,51,1628,1413,3347,52886,1965,2008,824,23.7,581,412,470,111,449,1628,371
2017,36047012700,"Census Tract 127, Kings County, New York",1734,113,1621,1410,3930,47262,1966,2009,698,23.6,583,402,513,118,402,1621,435
2018,36047012700,"Census Tract 127, Kings County, New York",1767,124,1643,1447,4148,36813,1966,2008,638,24.6,566,396,516,92,441,1643,505
2019,36047012700,"Census Tract 127, Kings County, New York",1778,175,1603,1372,3598,38056,1966,2008,690,24.4,523,357,491,102,415,1603,442
2020,36047012700,"Census Tract 127, Kings County, New York",1783,161,1622,1312,3147,41181,1964,2008,804,25.5,520,273,490,150,411,1622,464
2012,36047012801,"Census Tract 128.01, Kings County, New York",778,0,778,535,1337,42396,1942,2001,1235,35,173,318,0,107,89,778,125
2013,36047012801,"Census Tract 128.01, Kings County, New York",780,18,762,517,1312,32311,1945,2002,1215,37.3,173,299,0,114,87,762,109
2014,36047012801,"Census Tract 128.01, Kings County, New York",772,33,739,467,1098,30724,1944,2004,1169,33.4,139,260,0,89,96,739,133
2015,36047012801,"Census Tract 128.01, Kings County, New York",779,30,749,496,1339,45000,1943,2009,1280,29.9,148,271,0,141,64,749,161
2016,36047012801,"Census Tract 128.01, Kings County, New York",770,31,739,509,1352,53510,1942,2011,1346,28.7,129,253,27,141,69,739,158
2017,36047012801,"Census Tract 128.01, Kings County, New York",772,40,732,457,1405,35766,1939,2012,1347,34.7,126,214,13,189,41,732,218
2018,36047012801,"Census Tract 128.01, Kings County, New York",772,18,754,495,1467,37153,0,2012,1357,34.5,132,204,20,229,42,754,228
2019,36047012801,"Census Tract 128.01, Kings County, New York",777,20,757,512,1557,35882,0,2012,1369,39.1,183,207,19,258,36,757,250
2020,36047012801,"Census Tract 128.01, Kings County, New York",834,36,798,545,1535,41696,1943,2014,1488,36.6,225,246,20,228,56,798,194
2012,36047012901,"Census Tract 129.01, Kings County, New York",1079,154,925,641,1739,82933,1939,2005,1919,27,451,397,52,51,141,925,74
2013,36047012901,"Census Tract 129.01, Kings County, New York",1073,160,913,663,1894,82543,1939,2006,2001,33,472,447,39,42,135,913,93
2014,36047012901,"Census Tract 129.01, Kings County, New York",1084,95,989,756,2067,75389,1939,2008,2001,33.9,545,504,36,38,178,989,95
2015,36047012901,"Census Tract 129.01, Kings County, New York",1068,90,978,763,1961,76862,1939,2010,2168,32.5,588,535,70,30,128,978,81
2016,36047012901,"Census Tract 129.01, Kings County, New York",1036,38,998,702,1643,80809,1939,2011,2191,30.9,562,471,76,37,118,998,62
2017,36047012901,"Census Tract 129.01, Kings County, New York",1076,43,1033,713,1533,87969,1939,2011,2299,30.1,574,501,90,28,94,1033,74
2018,36047012901,"Census Tract 129.01, Kings County, New York",1089,8,1081,719,1565,94750,0,2012,2318,28,586,473,97,43,90,1081,91
2019,36047012901,"Census Tract 129.01, Kings County, New York",1090,63,1027,681,1502,103068,0,2013,2487,25.4,566,401,112,58,90,1027,99
2020,36047012901,"Census Tract 129.01, Kings County, New York",1001,90,911,559,1295,155156,0,2016,2664,21.7,476,356,40,61,82,911,44
2012,36047012902,"Census Tract 129.02, Kings County, New York",1040,192,848,585,1305,80046,1939,2005,1864,26.8,416,335,78,79,86,848,77
2013,36047012902,"Census Tract 129.02, Kings County, New York",985,147,838,625,1404,76776,1939,2006,1951,28.2,435,335,88,75,117,838,86
2014,36047012902,"Census Tract 129.02, Kings County, New York",959,142,817,573,1294,79375,1939,2009,2001,27.8,394,338,69,52,111,817,75
2015,36047012902,"Census Tract 129.02, Kings County, New York",962,116,846,574,1288,79551,1939,2011,2080,28.9,421,323,69,33,147,846,41
2016,36047012902,"Census Tract 129.02, Kings County, New York",974,137,837,606,1259,87159,1939,2012,2167,27.8,458,364,54,46,123,837,21
2017,36047012902,"Census Tract 129.02, Kings County, New York",963,131,832,612,1468,96875,1939,2012,2299,26,495,373,38,21,146,832,25
2018,36047012902,"Census Tract 129.02, Kings County, New York",1031,114,917,680,1647,98250,0,2014,2320,25.9,534,406,69,32,134,917,82
2019,36047012902,"Census Tract 129.02, Kings County, New York",1183,132,1051,788,1679,112027,0,NA,2389,27.3,648,447,147,35,116,1051,74
2020,36047012902,"Census Tract 129.02, Kings County, New York",1301,133,1168,947,1967,114390,1940,NA,2518,28.1,760,418,171,82,217,1168,107
2012,36047013000,"Census Tract 130, Kings County, New York",1971,73,1898,1462,3920,43750,1939,2004,1227,33.9,634,885,58,153,361,1898,405
2013,36047013000,"Census Tract 130, Kings County, New York",2037,158,1879,1449,3742,38993,1939,2003,1216,30.7,429,832,77,147,378,1879,381
2014,36047013000,"Census Tract 130, Kings County, New York",2040,193,1847,1460,3856,33519,1939,2005,1237,34.1,537,864,64,194,324,1847,402
2015,36047013000,"Census Tract 130, Kings County, New York",2058,159,1899,1495,4179,42468,1939,2006,1213,28.4,451,822,48,164,465,1899,366
2016,36047013000,"Census Tract 130, Kings County, New York",2020,160,1860,1426,3972,43281,1939,2007,1292,29.8,514,724,69,192,452,1860,332
2017,36047013000,"Census Tract 130, Kings County, New York",1974,211,1763,1283,3876,52820,1939,2010,1344,31.3,474,652,71,191,348,1763,359
2018,36047013000,"Census Tract 130, Kings County, New York",1945,256,1689,1264,3809,51989,0,NA,1405,31.4,536,616,83,211,317,1689,348
2019,36047013000,"Census Tract 130, Kings County, New York",1945,258,1687,1301,3561,70993,0,2011,1445,23.6,533,647,142,170,298,1687,188
2020,36047013000,"Census Tract 130, Kings County, New York",1825,268,1557,1184,3463,70700,0,2012,1560,23.9,470,569,131,111,323,1557,156
2012,36047013100,"Census Tract 131, Kings County, New York",2051,189,1862,1202,2514,80833,1939,2005,1869,26,824,746,82,51,237,1862,148
2013,36047013100,"Census Tract 131, Kings County, New York",2026,175,1851,1254,2698,81750,1939,2005,1846,24.9,888,745,162,83,272,1851,187
2014,36047013100,"Census Tract 131, Kings County, New York",1974,194,1780,1125,2355,81424,1939,2007,1860,25.5,827,615,186,69,265,1780,174
2015,36047013100,"Census Tract 131, Kings County, New York",1975,158,1817,1170,2515,89375,1939,2010,1801,24.5,890,639,198,62,261,1817,161
2016,36047013100,"Census Tract 131, Kings County, New York",1991,164,1827,1143,2439,111705,1939,2011,2051,23.3,908,597,215,96,199,1827,110
2017,36047013100,"Census Tract 131, Kings County, New York",1983,134,1849,1163,2448,99950,1939,2012,2171,24.4,911,620,142,121,227,1849,103
2018,36047013100,"Census Tract 131, Kings County, New York",1986,163,1823,1150,2511,128750,0,2013,2283,23.4,904,649,88,77,275,1823,114
2019,36047013100,"Census Tract 131, Kings County, New York",1963,103,1860,1176,2521,131250,0,2014,2305,23.4,875,712,86,86,238,1860,146
2020,36047013100,"Census Tract 131, Kings County, New York",2055,79,1976,1221,2577,118042,0,2015,2308,23.7,906,634,157,134,306,1976,239
2012,36047013200,"Census Tract 132, Kings County, New York",729,0,729,458,1333,37931,1939,2005,1247,39.5,80,194,12,159,89,729,91
2013,36047013200,"Census Tract 132, Kings County, New York",699,0,699,422,1245,52568,1939,2006,1241,35,110,167,13,148,89,699,76
2014,36047013200,"Census Tract 132, Kings County, New York",704,35,669,371,1055,54760,1941,2006,1248,28.3,110,154,14,115,83,669,87
2015,36047013200,"Census Tract 132, Kings County, New York",743,33,710,399,1296,64408,1939,2006,1265,25.7,131,180,10,105,99,710,102
2016,36047013200,"Census Tract 132, Kings County, New York",725,42,683,410,1310,56100,1939,2008,1279,27.8,147,151,21,137,110,683,122
2017,36047013200,"Census Tract 132, Kings County, New York",721,65,656,399,1246,39602,1939,2008,1322,34.4,125,152,12,131,116,656,120
2018,36047013200,"Census Tract 132, Kings County, New York",751,70,681,399,1316,38355,0,2009,1343,37.9,110,131,28,144,124,681,129
2019,36047013200,"Census Tract 132, Kings County, New York",765,39,726,432,1385,44565,0,2011,1385,35,134,168,30,142,122,726,122
2020,36047013200,"Census Tract 132, Kings County, New York",721,26,695,383,1302,61125,0,2012,1434,29.4,119,140,23,141,102,695,116
2012,36047013300,"Census Tract 133, Kings County, New York",1964,290,1674,940,2133,102870,1939,2004,2001,23.6,786,714,86,97,19,1674,73
2013,36047013300,"Census Tract 133, Kings County, New York",1975,224,1751,938,2146,108889,1939,2006,2001,23.5,787,668,81,118,46,1751,88
2014,36047013300,"Census Tract 133, Kings County, New York",1987,259,1728,924,2084,126488,1939,2007,2001,22.2,775,691,75,75,57,1728,73
2015,36047013300,"Census Tract 133, Kings County, New York",1989,165,1824,1063,2338,144484,1939,2009,2184,19.8,917,797,124,61,53,1824,48
2016,36047013300,"Census Tract 133, Kings County, New York",1984,87,1897,1142,2520,129306,1939,2010,2128,20.1,916,853,146,34,70,1897,85
2017,36047013300,"Census Tract 133, Kings County, New York",1966,125,1841,1123,2396,151597,1939,2011,2248,18.7,884,858,94,77,76,1841,86
2018,36047013300,"Census Tract 133, Kings County, New York",1953,127,1826,1140,2476,154426,0,2011,2307,18.6,916,874,115,73,58,1826,86
2019,36047013300,"Census Tract 133, Kings County, New York",1888,85,1803,1167,2632,169306,0,2012,2406,17.8,961,902,116,74,55,1803,87
2020,36047013300,"Census Tract 133, Kings County, New York",1942,148,1794,1092,2528,138750,0,2014,2641,21.1,900,825,42,64,121,1794,109
2012,36047013400,"Census Tract 134, Kings County, New York",1568,126,1442,803,2154,49967,1939,2005,1190,26.6,329,570,0,54,152,1442,118
2013,36047013400,"Census Tract 134, Kings County, New York",1586,122,1464,842,2167,49357,1939,2005,1212,29,356,574,0,101,145,1464,128
2014,36047013400,"Census Tract 134, Kings County, New York",1569,123,1446,804,1928,51285,1939,2006,1270,28.7,325,504,0,62,202,1446,120
2015,36047013400,"Census Tract 134, Kings County, New York",1591,120,1471,835,1940,51302,1939,2007,1306,28.4,344,569,0,55,187,1471,113
2016,36047013400,"Census Tract 134, Kings County, New York",1555,105,1450,800,1971,54386,1939,2009,1382,29.1,424,645,0,42,93,1450,140
2017,36047013400,"Census Tract 134, Kings County, New York",1542,48,1494,759,1797,68750,1939,2009,1498,25.9,386,587,0,40,102,1494,168
2018,36047013400,"Census Tract 134, Kings County, New York",1554,58,1496,760,1907,72647,0,2010,1590,24,438,554,13,22,116,1496,155
2019,36047013400,"Census Tract 134, Kings County, New York",1599,105,1494,823,2326,72474,0,2012,1679,25.3,477,568,13,93,120,1494,125
2020,36047013400,"Census Tract 134, Kings County, New York",1512,127,1385,845,2565,71479,0,2013,1747,30.9,516,509,13,154,121,1385,150
2012,36047013500,"Census Tract 135, Kings County, New York",1648,82,1566,870,2129,97955,1939,2005,1952,25.4,664,488,101,85,169,1566,25
2013,36047013500,"Census Tract 135, Kings County, New York",1645,81,1564,929,2132,92820,1939,2007,2001,26.6,702,536,69,70,201,1564,70
2014,36047013500,"Census Tract 135, Kings County, New York",1634,82,1552,860,2029,94016,1939,2008,2001,27.4,649,543,79,37,152,1552,87
2015,36047013500,"Census Tract 135, Kings County, New York",1626,98,1528,843,1951,102958,1939,2010,2250,26.7,608,522,88,38,146,1528,117
2016,36047013500,"Census Tract 135, Kings County, New York",1625,109,1516,830,1831,94605,1939,2011,2330,30.2,653,527,66,35,139,1516,152
2017,36047013500,"Census Tract 135, Kings County, New York",1626,119,1507,728,1505,97583,1939,2011,2576,31.2,574,465,56,45,123,1507,148
2018,36047013500,"Census Tract 135, Kings County, New York",1609,123,1486,667,1572,94659,0,2011,2585,31,516,452,57,68,81,1486,141
2019,36047013500,"Census Tract 135, Kings County, New York",1626,137,1489,667,1627,113750,0,2013,2726,28.2,555,437,56,90,74,1489,110
2020,36047013500,"Census Tract 135, Kings County, New York",1684,187,1497,674,1684,165500,0,2015,2722,22.9,627,484,30,86,54,1497,55
2012,36047013600,"Census Tract 136, Kings County, New York",1673,132,1541,715,1560,57875,1939,2004,1297,26.8,500,602,25,23,65,1541,316
2013,36047013600,"Census Tract 136, Kings County, New York",1685,150,1535,737,1781,57135,1939,2005,1344,29.1,474,586,25,27,99,1535,247
2014,36047013600,"Census Tract 136, Kings County, New York",1684,190,1494,799,2057,64089,1939,2006,1376,26.4,459,657,23,45,74,1494,275
2015,36047013600,"Census Tract 136, Kings County, New York",1685,196,1489,772,2011,64167,1939,2008,1404,27,445,509,19,71,173,1489,218
2016,36047013600,"Census Tract 136, Kings County, New York",1661,156,1505,841,2207,63580,1939,2010,1491,27.9,427,550,34,72,164,1505,220
2017,36047013600,"Census Tract 136, Kings County, New York",1572,159,1413,821,2229,64653,1939,2010,1616,28.5,358,553,20,69,161,1413,198
2018,36047013600,"Census Tract 136, Kings County, New York",1544,184,1360,737,1954,62404,0,2011,1657,29.2,337,476,19,86,143,1360,185
2019,36047013600,"Census Tract 136, Kings County, New York",1511,154,1357,647,1520,63920,0,2012,1696,30.9,357,372,31,52,176,1357,125
2020,36047013600,"Census Tract 136, Kings County, New York",1540,137,1403,744,1882,59318,0,2012,1718,34.6,353,434,32,42,224,1403,129
2012,36047013700,"Census Tract 137, Kings County, New York",1530,127,1403,960,1960,63953,1939,2003,1638,27.1,595,673,108,35,147,1403,144
2013,36047013700,"Census Tract 137, Kings County, New York",1509,140,1369,927,1994,71583,1939,2004,1659,25.8,617,627,82,37,173,1369,154
2014,36047013700,"Census Tract 137, Kings County, New York",1493,126,1367,988,2178,87143,1939,2005,1663,25.6,664,693,97,0,203,1367,152
2015,36047013700,"Census Tract 137, Kings County, New York",1508,107,1401,1046,2201,93021,1939,2008,1779,26.8,729,680,91,60,191,1401,197
2016,36047013700,"Census Tract 137, Kings County, New York",1580,93,1487,1143,2442,96771,1939,2010,1793,28.2,761,712,88,73,261,1487,239
2017,36047013700,"Census Tract 137, Kings County, New York",1572,113,1459,1131,2414,98264,1939,2011,1842,27.7,738,657,102,103,253,1459,247
2018,36047013700,"Census Tract 137, Kings County, New York",1619,122,1497,1123,2343,101438,0,2011,2033,26.6,746,659,138,104,201,1497,223
2019,36047013700,"Census Tract 137, Kings County, New York",1609,113,1496,1100,2297,106000,0,2012,2176,25.9,726,621,173,127,163,1496,230
2020,36047013700,"Census Tract 137, Kings County, New York",1750,224,1526,1118,2312,101618,0,2014,2314,24.4,776,622,169,71,248,1526,174
2012,36047013800,"Census Tract 138, Kings County, New York",1418,103,1315,993,2749,48844,1939,2004,1363,28.7,330,776,12,28,157,1315,148
2013,36047013800,"Census Tract 138, Kings County, New York",1444,106,1338,1025,3087,65104,1939,2004,1394,25.7,430,803,0,33,167,1338,221
2014,36047013800,"Census Tract 138, Kings County, New York",1470,127,1343,1062,2868,60086,1939,2005,1431,28.6,488,823,0,43,154,1343,230
2015,36047013800,"Census Tract 138, Kings County, New York",1504,165,1339,1053,2632,49440,1942,2007,1491,28.6,467,764,11,76,155,1339,232
2016,36047013800,"Census Tract 138, Kings County, New York",1454,198,1256,1005,2526,55950,1939,2008,1437,27,484,692,10,68,177,1256,236
2017,36047013800,"Census Tract 138, Kings County, New York",1494,234,1260,991,2396,57401,1939,2009,1457,28.6,511,669,32,65,163,1260,221
2018,36047013800,"Census Tract 138, Kings County, New York",1455,237,1218,945,2166,60074,0,2011,1516,27.9,480,643,42,62,137,1218,171
2019,36047013800,"Census Tract 138, Kings County, New York",1440,179,1261,954,2093,57425,0,2011,1498,27.3,487,644,58,64,166,1261,174
2020,36047013800,"Census Tract 138, Kings County, New York",1406,152,1254,899,2080,67723,0,2012,1581,25.3,520,531,81,26,242,1254,128
2012,36047013900,"Census Tract 139, Kings County, New York",1684,108,1576,1190,2602,64318,1939,2003,1555,28.3,746,715,124,106,226,1576,170
2013,36047013900,"Census Tract 139, Kings County, New York",1654,142,1512,1095,2483,68750,1939,2004,1590,27.1,721,663,145,95,170,1512,129
2014,36047013900,"Census Tract 139, Kings County, New York",1629,201,1428,1040,2389,73430,1939,2005,1690,27.2,665,652,137,76,164,1428,135
2015,36047013900,"Census Tract 139, Kings County, New York",1615,190,1425,1034,2506,84063,1939,2006,1805,23.9,645,622,128,86,202,1425,74
2016,36047013900,"Census Tract 139, Kings County, New York",1625,226,1399,1031,2517,97457,1939,2010,2012,23.7,668,662,102,91,189,1399,74
2017,36047013900,"Census Tract 139, Kings County, New York",1628,239,1389,968,2254,105521,1939,2011,2160,25.9,738,639,121,73,162,1389,121
2018,36047013900,"Census Tract 139, Kings County, New York",1621,212,1409,1007,2244,114258,0,2011,2259,25.1,800,661,149,64,174,1409,108
2019,36047013900,"Census Tract 139, Kings County, New York",1619,160,1459,1106,2539,123750,0,2012,2396,25,840,744,160,57,187,1459,82
2020,36047013900,"Census Tract 139, Kings County, New York",1573,137,1436,1080,2464,128438,0,2015,2471,26.1,807,729,174,40,151,1436,55
2012,36047014000,"Census Tract 140, Kings County, New York",909,158,751,459,1045,32314,1939,2003,1111,37,104,344,0,9,106,751,151
2013,36047014000,"Census Tract 140, Kings County, New York",878,115,763,428,1003,47857,1939,2004,1167,30.3,140,332,0,0,96,763,93
2014,36047014000,"Census Tract 140, Kings County, New York",853,81,772,439,993,47813,1939,2005,1222,34.8,158,339,0,0,100,772,94
2015,36047014000,"Census Tract 140, Kings County, New York",831,67,764,455,1001,44514,1939,2006,1316,41.1,145,358,0,15,82,764,154
2016,36047014000,"Census Tract 140, Kings County, New York",801,43,758,435,913,44671,1939,2006,1232,32.9,213,354,26,21,34,758,161
2017,36047014000,"Census Tract 140, Kings County, New York",792,25,767,473,1003,57750,1939,2009,1341,25,232,330,42,41,60,767,111
2018,36047014000,"Census Tract 140, Kings County, New York",815,14,801,472,1005,68000,0,2009,1338,24.8,226,325,49,42,56,801,141
2019,36047014000,"Census Tract 140, Kings County, New York",848,19,829,518,1031,67636,0,2011,1352,26.7,244,333,72,44,69,829,153
2020,36047014000,"Census Tract 140, Kings County, New York",859,19,840,476,922,60071,0,2013,1376,29.4,219,335,61,21,59,840,140
2012,36047014100,"Census Tract 141, Kings County, New York",1429,142,1287,682,1575,59767,1944,2005,1725,28.6,473,351,32,38,216,1287,125
2013,36047014100,"Census Tract 141, Kings County, New York",1555,164,1391,721,1820,71130,1939,2007,1726,27.3,461,349,46,60,207,1391,80
2014,36047014100,"Census Tract 141, Kings County, New York",1605,120,1485,874,2125,70948,1939,2008,1746,26.9,556,413,49,61,259,1485,98
2015,36047014100,"Census Tract 141, Kings County, New York",1591,95,1496,988,2302,56806,1939,2011,1807,28.8,683,462,105,86,260,1496,118
2016,36047014100,"Census Tract 141, Kings County, New York",1590,135,1455,952,2026,63000,1947,2011,1787,31.1,655,446,112,73,248,1455,112
2017,36047014100,"Census Tract 141, Kings County, New York",1552,171,1381,881,1884,81250,1954,2012,1991,29.4,670,465,120,62,177,1381,134
2018,36047014100,"Census Tract 141, Kings County, New York",1558,199,1359,957,1934,83750,1950,2012,2173,30.1,721,502,121,70,211,1359,163
2019,36047014100,"Census Tract 141, Kings County, New York",1489,187,1302,927,1755,87413,0,2014,2252,30.6,692,504,120,60,211,1302,167
2020,36047014101,"Census Tract 141.01, Kings County, New York",495,70,425,254,524,104167,0,2016,2695,29.3,221,173,25,13,36,425,43
2020,36047014102,"Census Tract 141.02, Kings County, New York",935,157,778,535,1151,111417,1986,2015,2162,25.6,352,230,34,72,170,778,93
2012,36047014200,"Census Tract 142, Kings County, New York",1414,46,1368,1040,2014,43607,1939,2004,1253,32.3,442,665,18,72,257,1368,190
2013,36047014200,"Census Tract 142, Kings County, New York",1382,43,1339,1046,2243,44601,1939,2005,1271,32.2,424,745,9,56,204,1339,220
2014,36047014200,"Census Tract 142, Kings County, New York",1389,46,1343,1054,2327,48300,1939,2006,1312,30.5,449,785,19,52,161,1343,277
2015,36047014200,"Census Tract 142, Kings County, New York",1352,46,1306,1068,2465,58167,1939,2007,1358,29,509,840,19,56,142,1306,212
2016,36047014200,"Census Tract 142, Kings County, New York",1391,76,1315,1040,2411,57059,1939,2009,1425,29.3,533,805,20,29,177,1315,200
2017,36047014200,"Census Tract 142, Kings County, New York",1440,139,1301,1003,2312,58162,1939,2011,1510,30.9,537,712,23,45,205,1301,189
2018,36047014200,"Census Tract 142, Kings County, New York",1439,170,1269,907,1854,58750,0,2012,1580,32.1,454,624,23,42,200,1269,158
2019,36047014200,"Census Tract 142, Kings County, New York",1483,237,1246,825,1980,57802,0,2013,1725,32.8,406,509,11,48,223,1246,149
2020,36047014200,"Census Tract 142, Kings County, New York",1435,166,1269,751,1727,67534,0,2016,1736,31.7,380,480,29,60,164,1269,166
2012,36047014300,"Census Tract 143, Kings County, New York",1673,154,1519,1163,2799,51131,1939,2003,1377,29.3,582,377,95,133,535,1519,269
2013,36047014300,"Census Tract 143, Kings County, New York",1669,137,1532,1165,2814,59398,1939,2005,1425,29.3,604,440,55,125,491,1532,281
2014,36047014300,"Census Tract 143, Kings County, New York",1687,153,1534,1108,2605,60081,1939,2006,1658,37.8,562,440,57,118,454,1534,308
2015,36047014300,"Census Tract 143, Kings County, New York",1661,140,1521,1069,2300,59958,1939,2009,1737,35.4,575,475,49,88,424,1521,290
2016,36047014300,"Census Tract 143, Kings County, New York",1570,161,1409,988,2338,71885,1939,2011,1833,29.7,557,422,52,108,379,1409,237
2017,36047014300,"Census Tract 143, Kings County, New York",1569,156,1413,1028,2396,90203,1939,2011,1947,28.2,606,485,65,106,381,1413,189
2018,36047014300,"Census Tract 143, Kings County, New York",1580,171,1409,1059,2350,92396,0,2012,2077,28.1,647,487,99,95,397,1409,168
2019,36047014300,"Census Tract 143, Kings County, New York",1604,136,1468,1104,2485,96250,1941,2013,2118,27.2,740,522,97,113,377,1468,166
2020,36047014300,"Census Tract 143, Kings County, New York",1480,135,1345,1044,2408,105455,1947,2014,2297,25.3,738,502,121,126,314,1345,116
2012,36047014500,"Census Tract 145, Kings County, New York",1835,170,1665,1305,3453,53011,1939,2005,1365,30,553,600,98,39,560,1665,324
2013,36047014500,"Census Tract 145, Kings County, New York",1879,137,1742,1362,3522,55855,1939,2005,1381,29.1,644,643,124,49,538,1742,287
2014,36047014500,"Census Tract 145, Kings County, New York",1830,99,1731,1407,3693,56458,1939,2009,1479,30.6,685,745,80,41,542,1731,270
2015,36047014500,"Census Tract 145, Kings County, New York",1854,97,1757,1411,3431,59789,1939,2011,1465,28.8,717,739,58,26,589,1757,275
2016,36047014500,"Census Tract 145, Kings County, New York",1840,76,1764,1365,3374,60825,1939,2011,1586,30.7,725,776,32,37,517,1764,259
2017,36047014500,"Census Tract 145, Kings County, New York",1806,89,1717,1356,2947,65568,1939,2012,1726,32.1,796,859,26,13,434,1717,217
2018,36047014500,"Census Tract 145, Kings County, New York",1826,127,1699,1362,2783,68158,0,2012,1776,31.8,771,889,9,19,411,1699,173
2019,36047014500,"Census Tract 145, Kings County, New York",1885,158,1727,1351,2687,75321,0,2013,1816,30,773,847,22,30,423,1727,191
2020,36047014500,"Census Tract 145, Kings County, New York",1905,157,1748,1417,2799,87542,0,2014,2107,31.9,947,1003,25,83,276,1748,186
2012,36047014700,"Census Tract 147, Kings County, New York",910,64,846,672,1678,54756,1939,2006,1544,30.7,390,388,8,16,210,846,123
2013,36047014700,"Census Tract 147, Kings County, New York",946,101,845,682,1690,57727,1939,2007,1561,29.4,358,388,5,12,228,845,100
2014,36047014700,"Census Tract 147, Kings County, New York",954,115,839,692,1687,64333,1939,2009,1664,28,341,374,23,18,240,839,115
2015,36047014700,"Census Tract 147, Kings County, New York",933,114,819,609,1407,69904,1941,2011,1791,27.1,341,370,24,30,163,819,89
2016,36047014700,"Census Tract 147, Kings County, New York",957,94,863,596,1389,71894,1939,2011,1727,27.2,341,323,34,24,213,863,114
2017,36047014700,"Census Tract 147, Kings County, New York",973,104,869,567,1514,79375,1939,2011,1828,26.2,341,293,35,28,202,869,95
2018,36047014700,"Census Tract 147, Kings County, New York",960,69,891,565,1432,82188,1941,2012,1879,31,389,339,39,21,163,891,109
2019,36047014700,"Census Tract 147, Kings County, New York",942,73,869,520,1290,96875,0,2013,1916,28,337,317,19,13,173,869,80
2020,36047014700,"Census Tract 147, Kings County, New York",973,85,888,516,1276,96705,1943,2015,1953,25.8,360,322,17,7,176,888,87
2012,36047014800,"Census Tract 148, Kings County, New York",533,55,478,159,311,63060,1939,2005,1568,33.9,44,159,0,0,0,478,5
2013,36047014800,"Census Tract 148, Kings County, New York",531,39,492,149,302,65040,1939,2005,1641,34.2,34,149,0,0,0,492,10
2014,36047014800,"Census Tract 148, Kings County, New York",536,5,531,187,364,24313,1939,2006,1425,50,72,187,0,0,0,531,38
2015,36047014800,"Census Tract 148, Kings County, New York",529,21,508,147,297,23250,1939,2006,1441,50,39,141,0,6,0,508,38
2016,36047014800,"Census Tract 148, Kings County, New York",527,33,494,156,325,23704,1939,2006,1519,50,40,148,0,8,0,494,44
2017,36047014800,"Census Tract 148, Kings County, New York",539,61,478,133,305,35893,1939,2010,1313,45.5,49,118,0,8,0,478,46
2018,36047014800,"Census Tract 148, Kings County, New York",523,49,474,143,357,41875,0,2013,1375,39.3,62,114,0,9,13,474,49
2019,36047014800,"Census Tract 148, Kings County, New York",486,53,433,127,332,NA,0,2012,1578,33,34,63,0,12,46,433,40
2020,36047014800,"Census Tract 148, Kings County, New York",475,39,436,147,408,34375,0,2011,1645,38.3,37,66,0,11,64,436,34
2012,36047014900,"Census Tract 149, Kings County, New York",2294,95,2199,1461,2828,69637,1939,2005,1828,27.6,1192,1078,59,118,230,2199,187
2013,36047014900,"Census Tract 149, Kings County, New York",2342,145,2197,1289,2619,85462,1939,2006,1927,27.4,1062,961,68,114,175,2197,116
2014,36047014900,"Census Tract 149, Kings County, New York",2374,139,2235,1224,2373,92167,1939,2010,1864,25.3,920,978,89,85,105,2235,64
2015,36047014900,"Census Tract 149, Kings County, New York",2367,94,2273,1161,2148,91653,1941,2011,1887,25.1,795,836,72,81,187,2273,80
2016,36047014900,"Census Tract 149, Kings County, New York",2443,182,2261,1136,2150,96250,1939,2011,1962,25.2,791,809,37,85,219,2261,126
2017,36047014900,"Census Tract 149, Kings County, New York",2491,176,2315,1120,2389,107917,1942,2012,2237,23.9,832,836,17,37,230,2315,134
2018,36047014900,"Census Tract 149, Kings County, New York",2469,245,2224,1182,2539,108654,1946,2013,2309,23.7,923,845,18,40,265,2224,108
2019,36047014900,"Census Tract 149, Kings County, New York",2380,243,2137,1170,2766,125500,0,2014,2438,24.7,916,831,0,82,243,2137,136
2020,36047014901,"Census Tract 149.01, Kings County, New York",642,68,574,324,740,NA,0,2016,2396,25.8,270,284,0,0,40,574,34
2020,36047014902,"Census Tract 149.02, Kings County, New York",1913,60,1853,1293,2752,129594,0,2016,2383,24.9,1174,1100,0,31,132,1853,67
2012,36047015000,"Census Tract 150, Kings County, New York",647,13,634,169,530,74219,1939,2003,1391,23.4,37,140,0,17,12,634,10
2013,36047015000,"Census Tract 150, Kings County, New York",672,55,617,191,588,85855,1939,2006,1315,21.9,58,151,0,25,15,617,48
2014,36047015000,"Census Tract 150, Kings County, New York",659,62,597,188,577,88095,1939,2006,1408,23.1,54,135,0,27,26,597,63
2015,36047015000,"Census Tract 150, Kings County, New York",656,78,578,172,493,64063,1939,2008,1388,24.2,50,127,0,33,12,578,70
2016,36047015000,"Census Tract 150, Kings County, New York",637,63,574,192,410,51833,1939,2010,1375,32.2,68,149,0,28,15,574,74
2017,36047015000,"Census Tract 150, Kings County, New York",665,60,605,217,430,54732,1939,2011,1445,32.4,64,167,0,32,18,605,87
2018,36047015000,"Census Tract 150, Kings County, New York",681,58,623,230,425,51250,0,2011,1447,35.3,60,174,0,32,24,623,69
2019,36047015000,"Census Tract 150, Kings County, New York",694,65,629,252,460,41932,0,2011,1477,39.3,89,185,0,44,23,629,71
2020,36047015000,"Census Tract 150, Kings County, New York",673,60,613,276,590,42368,1941,2013,1913,42.8,122,199,0,36,41,613,65
2012,36047015100,"Census Tract 151, Kings County, New York",1670,157,1513,794,1801,82000,1939,2004,2001,29.3,561,588,0,46,113,1513,62
2013,36047015100,"Census Tract 151, Kings County, New York",1647,91,1556,779,1676,76927,1939,2005,1898,28.2,539,566,5,47,114,1556,76
2014,36047015100,"Census Tract 151, Kings County, New York",1671,88,1583,850,1895,85054,1939,2007,2001,28.4,593,547,43,82,136,1583,91
2015,36047015100,"Census Tract 151, Kings County, New York",1653,38,1615,788,1873,115417,1939,2010,2170,25.7,613,525,38,90,109,1615,123
2016,36047015100,"Census Tract 151, Kings County, New York",1679,39,1640,841,1895,106607,1939,2011,2203,25.1,655,532,79,62,120,1640,113
2017,36047015100,"Census Tract 151, Kings County, New York",1698,24,1674,808,1732,104038,1939,2012,2273,25.3,640,479,78,71,111,1674,118
2018,36047015100,"Census Tract 151, Kings County, New York",1696,16,1680,857,1897,112321,0,2013,2567,25,684,550,82,67,87,1680,104
2019,36047015100,"Census Tract 151, Kings County, New York",1701,18,1683,789,1834,120474,0,2013,2516,25.1,616,524,52,50,72,1683,102
2020,36047015100,"Census Tract 151, Kings County, New York",1805,71,1734,862,1904,96667,0,2016,2474,24.7,680,617,50,92,55,1734,70
2012,36047015200,"Census Tract 152, Kings County, New York",941,62,879,314,816,49091,1946,2005,1176,34,142,219,8,50,45,879,76
2013,36047015200,"Census Tract 152, Kings County, New York",959,42,917,328,804,48790,1955,2008,1431,37.7,124,201,14,31,86,917,58
2014,36047015200,"Census Tract 152, Kings County, New York",969,51,918,331,782,44531,1953,2009,1418,39.5,114,212,6,53,55,918,70
2015,36047015200,"Census Tract 152, Kings County, New York",954,87,867,369,872,42841,1958,2010,1348,41.6,121,216,6,51,85,867,73
2016,36047015200,"Census Tract 152, Kings County, New York",960,83,877,387,961,44946,1956,2011,1469,41.8,122,221,6,58,89,877,53
2017,36047015200,"Census Tract 152, Kings County, New York",964,96,868,381,854,46010,1956,2011,1543,39.9,130,198,7,63,101,868,50
2018,36047015200,"Census Tract 152, Kings County, New York",959,131,828,327,697,50391,1952,2010,1434,36.9,137,169,8,86,57,828,49
2019,36047015200,"Census Tract 152, Kings County, New York",981,102,879,347,837,52639,1957,2009,1509,36,127,184,9,56,90,879,92
2020,36047015200,"Census Tract 152, Kings County, New York",1039,81,958,445,1074,43580,1953,2014,1857,44.7,125,177,68,79,121,958,146
2012,36047015300,"Census Tract 153, Kings County, New York",1340,203,1137,681,1494,95917,1939,2004,1817,25.3,576,496,11,100,66,1137,31
2013,36047015300,"Census Tract 153, Kings County, New York",1296,145,1151,675,1546,103309,1939,2005,1874,24.3,568,516,11,75,66,1151,30
2014,36047015300,"Census Tract 153, Kings County, New York",1264,128,1136,706,1619,95000,1939,2006,1897,24.8,649,579,18,76,28,1136,47
2015,36047015300,"Census Tract 153, Kings County, New York",1309,139,1170,741,1731,100486,1939,2008,1960,24,680,560,16,57,94,1170,41
2016,36047015300,"Census Tract 153, Kings County, New York",1239,107,1132,706,1555,113148,1939,2010,2128,20.8,613,486,24,60,112,1132,29
2017,36047015300,"Census Tract 153, Kings County, New York",1221,59,1162,654,1405,111406,1939,2010,2084,19.1,591,490,17,37,95,1162,16
2018,36047015300,"Census Tract 153, Kings County, New York",1229,110,1119,637,1303,96546,0,2011,2011,22.6,542,455,18,42,105,1119,41
2019,36047015300,"Census Tract 153, Kings County, New York",1179,80,1099,618,1249,105278,0,2011,2032,22.4,512,432,11,56,103,1099,34
2020,36047015300,"Census Tract 153, Kings County, New York",1194,53,1141,722,1256,82143,0,2011,1961,25.4,472,463,50,40,162,1141,45
2012,36047015400,"Census Tract 154, Kings County, New York",0,0,0,0,0,NA,NA,NA,NA,NA,0,0,0,0,0,0,0
2013,36047015400,"Census Tract 154, Kings County, New York",0,0,0,0,0,NA,NA,NA,NA,NA,0,0,0,0,0,0,0
2014,36047015400,"Census Tract 154, Kings County, New York",0,0,0,0,0,NA,NA,NA,NA,NA,0,0,0,0,0,0,0
2015,36047015400,"Census Tract 154, Kings County, New York",0,0,0,0,0,NA,NA,NA,NA,NA,0,0,0,0,0,0,0
2016,36047015400,"Census Tract 154, Kings County, New York",0,0,0,0,0,NA,NA,NA,NA,NA,0,0,0,0,0,0,0
2017,36047015400,"Census Tract 154, Kings County, New York",0,0,0,0,0,NA,NA,NA,NA,NA,0,0,0,0,0,0,0
2018,36047015400,"Census Tract 154, Kings County, New York",0,0,0,0,0,NA,NA,NA,NA,NA,0,0,0,0,0,0,0
2019,36047015400,"Census Tract 154, Kings County, New York",11,0,11,0,0,NA,NA,NA,NA,NA,0,0,0,0,0,11,11
2020,36047015400,"Census Tract 154, Kings County, New York",10,0,10,0,0,NA,NA,NA,NA,NA,0,0,0,0,0,10,10
2012,36047015500,"Census Tract 155, Kings County, New York",1618,164,1454,828,1969,91875,1939,2006,1971,24.4,757,655,9,36,80,1454,53
2013,36047015500,"Census Tract 155, Kings County, New York",1641,209,1432,829,1895,93513,1939,2007,1963,23.6,761,656,0,40,75,1432,64
2014,36047015500,"Census Tract 155, Kings County, New York",1657,170,1487,822,1826,92772,1939,2011,2001,24.1,761,581,21,87,45,1487,109
2015,36047015500,"Census Tract 155, Kings County, New York",1630,146,1484,799,1723,94099,1939,2011,2099,25.4,747,588,16,71,34,1484,89
2016,36047015500,"Census Tract 155, Kings County, New York",1641,109,1532,838,1801,106552,1939,2011,2126,24.2,750,602,20,83,45,1532,101
2017,36047015500,"Census Tract 155, Kings County, New York",1621,116,1505,801,1789,121597,1939,2011,2226,22.3,684,582,35,74,55,1505,124
2018,36047015500,"Census Tract 155, Kings County, New York",1631,87,1544,783,1799,127917,0,2012,2249,23.3,666,542,53,75,67,1544,118
2019,36047015500,"Census Tract 155, Kings County, New York",1640,93,1547,701,1607,135353,0,2014,2317,21.4,598,528,43,30,79,1547,90
2020,36047015500,"Census Tract 155, Kings County, New York",1659,85,1574,684,1586,129091,0,2015,2295,19.9,541,463,51,29,122,1574,109
2012,36047015700,"Census Tract 157, Kings County, New York",2052,48,2004,1138,2317,102035,1939,2007,2001,24.7,1005,996,80,48,36,2004,39
2013,36047015700,"Census Tract 157, Kings County, New York",2034,49,1985,1123,2180,107734,1939,2009,2001,24.2,998,1002,40,62,19,1985,50
2014,36047015700,"Census Tract 157, Kings County, New York",2103,76,2027,1108,2166,105625,1939,2011,2001,23.7,1040,1016,14,61,17,2027,40
2015,36047015700,"Census Tract 157, Kings County, New York",2134,88,2046,1088,2042,102308,1939,2011,2016,22.8,1022,923,19,86,19,2046,56
2016,36047015700,"Census Tract 157, Kings County, New York",2139,129,2010,1058,1963,100096,1939,NA,2129,22.2,975,885,13,93,0,2010,62
2017,36047015700,"Census Tract 157, Kings County, New York",2112,159,1953,900,1588,92440,1939,2012,2072,22.1,809,725,0,101,0,1953,64
2018,36047015700,"Census Tract 157, Kings County, New York",2133,147,1986,980,1832,93849,0,2013,2096,24.7,887,741,20,146,0,1986,68
2019,36047015700,"Census Tract 157, Kings County, New York",2127,110,2017,1034,2114,106293,0,2015,2409,23.5,974,753,21,163,16,2017,71
2020,36047015700,"Census Tract 157, Kings County, New York",2163,85,2078,1190,2425,152815,0,2016,2714,23,1131,978,32,104,46,2078,68
2012,36047015900,"Census Tract 159, Kings County, New York",2850,269,2581,1232,2260,70357,1939,2004,1912,30.4,1024,969,79,32,131,2581,119
2013,36047015900,"Census Tract 159, Kings County, New York",2923,343,2580,1221,2273,87341,1939,2007,1965,24.4,1032,960,124,18,102,2580,77
2014,36047015900,"Census Tract 159, Kings County, New York",2922,368,2554,1279,2412,85917,1939,2008,2001,26.7,1052,957,140,19,155,2554,103
2015,36047015900,"Census Tract 159, Kings County, New York",2896,374,2522,1207,2368,106172,1939,2010,2140,23.5,998,895,139,24,118,2522,121
2016,36047015900,"Census Tract 159, Kings County, New York",2863,401,2462,1086,2122,89423,1939,2011,2122,23,898,901,75,22,53,2462,157
2017,36047015900,"Census Tract 159, Kings County, New York",2815,315,2500,1165,2430,130201,1939,2012,2440,22.5,919,943,76,25,48,2500,202
2018,36047015900,"Census Tract 159, Kings County, New York",2723,311,2412,1126,2412,123214,0,2014,2420,23.7,869,852,18,80,97,2412,162
2019,36047015900,"Census Tract 159, Kings County, New York",2603,357,2246,1078,2171,139181,0,2015,2583,21.9,894,818,0,129,57,2246,128
2020,36047015900,"Census Tract 159, Kings County, New York",2662,321,2341,1219,2296,137257,0,2016,2381,22.6,1031,884,0,136,102,2341,170
2012,36047016000,"Census Tract 160, Kings County, New York",1895,93,1802,1421,3324,58955,1939,2004,1267,27.8,719,736,123,159,396,1802,264
2013,36047016000,"Census Tract 160, Kings County, New York",1970,107,1863,1465,3579,57153,1939,2004,1274,27.8,792,815,116,165,333,1863,273
2014,36047016000,"Census Tract 160, Kings County, New York",2002,138,1864,1501,3550,58669,1939,2005,1311,28.3,780,755,119,197,382,1864,260
2015,36047016000,"Census Tract 160, Kings County, New York",1939,135,1804,1442,3645,57500,1939,2007,1317,28.3,726,814,124,168,336,1804,234
2016,36047016000,"Census Tract 160, Kings County, New York",1885,221,1664,1308,3145,54565,1939,2007,1341,30.6,613,789,75,115,339,1664,203
2017,36047016000,"Census Tract 160, Kings County, New York",1877,257,1620,1236,2976,62574,1939,2008,1412,27.8,644,712,65,152,303,1620,186
2018,36047016000,"Census Tract 160, Kings County, New York",1826,253,1573,1203,3023,70793,1941,2010,1528,26.4,638,620,70,127,384,1573,207
2019,36047016000,"Census Tract 160, Kings County, New York",1761,259,1502,1135,3006,76211,0,2011,1621,24.6,604,643,85,144,255,1502,146
2020,36047016000,"Census Tract 160, Kings County, New York",1899,287,1612,1226,3130,79375,0,2012,1618,24.3,617,691,69,165,216,1612,186
2012,36047016100,"Census Tract 161, Kings County, New York",1497,125,1372,805,1639,93523,1939,2005,1920,25.7,624,512,166,8,95,1372,71
2013,36047016100,"Census Tract 161, Kings County, New York",1538,106,1432,799,1634,95781,1939,2006,1922,26.1,661,554,119,8,106,1432,94
2014,36047016100,"Census Tract 161, Kings County, New York",1538,77,1461,889,1807,86719,1939,2008,1952,25.4,740,596,138,5,133,1461,121
2015,36047016100,"Census Tract 161, Kings County, New York",1500,98,1402,863,1826,96250,1939,2010,1936,25.7,744,600,73,18,141,1402,115
2016,36047016100,"Census Tract 161, Kings County, New York",1521,139,1382,842,1946,105526,1939,NA,2121,24.8,736,586,83,38,103,1382,147
2017,36047016100,"Census Tract 161, Kings County, New York",1511,113,1398,845,1911,108059,1939,2011,2129,24.8,720,569,101,43,101,1398,179
2018,36047016100,"Census Tract 161, Kings County, New York",1522,140,1382,865,1899,116932,0,2012,2214,22.7,694,598,108,42,71,1382,171
2019,36047016100,"Census Tract 161, Kings County, New York",1539,128,1411,849,1967,131544,0,2012,2220,21.9,630,531,88,50,112,1411,128
2020,36047016100,"Census Tract 161, Kings County, New York",1630,139,1491,820,1734,147656,0,2013,2322,20.6,660,542,92,31,117,1491,61
2012,36047016200,"Census Tract 162, Kings County, New York",1143,36,1107,520,1085,52833,1946,2005,1387,29.1,347,305,55,68,78,1107,71
2013,36047016200,"Census Tract 162, Kings County, New York",1161,36,1125,598,1251,50795,1947,2006,1416,28.9,387,332,74,98,63,1125,91
2014,36047016200,"Census Tract 162, Kings County, New York",1152,38,1114,645,1379,58385,1947,2008,1448,28.4,376,391,72,92,72,1114,112
2015,36047016200,"Census Tract 162, Kings County, New York",1157,32,1125,714,1483,62143,1951,2010,1455,26.8,425,489,54,99,64,1125,138
2016,36047016200,"Census Tract 162, Kings County, New York",1136,63,1073,721,1418,60481,1956,2011,1566,28,423,594,27,60,32,1073,135
2017,36047016200,"Census Tract 162, Kings County, New York",1136,95,1041,738,1374,73714,1965,2011,1596,24.3,443,604,44,37,59,1041,134
2018,36047016200,"Census Tract 162, Kings County, New York",1198,97,1101,762,1420,74057,1960,2011,1525,23.9,395,627,38,7,91,1101,119
2019,36047016200,"Census Tract 162, Kings County, New York",1244,90,1154,780,1346,82386,1961,2012,1598,22.9,418,568,81,6,130,1154,161
2020,36047016200,"Census Tract 162, Kings County, New York",1276,132,1144,761,1253,75078,1955,2014,1561,26,479,554,62,3,123,1144,124
2012,36047016300,"Census Tract 163, Kings County, New York",1489,160,1329,792,1549,59514,1939,2001,1554,27.5,398,326,277,76,110,1329,107
2013,36047016300,"Census Tract 163, Kings County, New York",1473,106,1367,847,1620,63586,1939,2002,1625,26.2,435,380,266,82,115,1367,125
2014,36047016300,"Census Tract 163, Kings County, New York",1492,146,1346,858,1652,61313,1939,2005,1642,28,468,410,213,113,106,1346,122
2015,36047016300,"Census Tract 163, Kings County, New York",1484,135,1349,777,1609,65170,1939,2006,1649,27.2,435,364,215,104,72,1349,52
2016,36047016300,"Census Tract 163, Kings County, New York",1502,93,1409,843,1730,67107,1939,2007,1652,26.1,521,429,248,63,67,1409,54
2017,36047016300,"Census Tract 163, Kings County, New York",1478,113,1365,873,1823,79886,1939,2011,1763,26.9,598,524,189,71,40,1365,108
2018,36047016300,"Census Tract 163, Kings County, New York",1557,143,1414,927,1854,78717,0,2012,1823,28.5,693,547,186,87,56,1414,132
2019,36047016300,"Census Tract 163, Kings County, New York",1628,96,1532,1010,2056,85833,0,2014,2020,28.5,759,611,242,34,64,1532,133
2020,36047016300,"Census Tract 163, Kings County, New York",1670,125,1545,1125,2462,82656,0,2016,2141,30.5,794,689,301,35,41,1545,161
2012,36047016400,"Census Tract 164, Kings County, New York",257,0,257,256,919,84583,1987,2006,2001,40.5,87,127,83,0,101,257,0
2013,36047016400,"Census Tract 164, Kings County, New York",237,41,196,189,696,54877,1988,2007,2001,43.1,55,102,62,0,76,196,16
2014,36047016400,"Census Tract 164, Kings County, New York",283,49,234,230,836,58750,1986,2011,2001,42.8,83,128,70,5,79,234,26
2015,36047016400,"Census Tract 164, Kings County, New York",241,52,189,189,637,97760,1994,2012,3004,37.7,112,113,25,7,37,189,17
2016,36047016400,"Census Tract 164, Kings County, New York",251,66,185,185,619,97679,1991,NA,3028,38.2,111,109,24,8,36,185,20
2017,36047016400,"Census Tract 164, Kings County, New York",327,80,247,247,748,90875,1992,2013,3196,42.1,180,117,44,22,53,247,27
2018,36047016400,"Census Tract 164, Kings County, New York",342,38,304,304,895,104722,1997,2015,3264,34.3,200,73,130,21,69,304,0
2019,36047016400,"Census Tract 164, Kings County, New York",376,41,335,309,1022,106570,2001,2016,3279,34.1,203,87,129,22,60,335,0
2020,36047016400,"Census Tract 164, Kings County, New York",342,40,302,275,1069,109832,2002,2016,3294,33.4,161,98,120,27,30,302,0
2012,36047016500,"Census Tract 165, Kings County, New York",2618,42,2576,1447,2398,76708,1939,2005,1752,23,1124,869,171,108,289,2576,129
2013,36047016500,"Census Tract 165, Kings County, New York",2618,18,2600,1469,2484,68368,1939,2007,1989,26.8,1177,948,156,140,210,2600,285
2014,36047016500,"Census Tract 165, Kings County, New York",2645,18,2627,1452,2463,67845,1939,2009,2001,31.7,1169,954,117,117,248,2627,267
2015,36047016500,"Census Tract 165, Kings County, New York",2624,32,2592,1493,2874,79338,1939,2011,2237,31.2,1270,1014,82,183,183,2592,239
2016,36047016500,"Census Tract 165, Kings County, New York",2508,17,2491,1447,2934,92305,1939,2011,2419,28.6,1177,1055,33,144,180,2491,251
2017,36047016500,"Census Tract 165, Kings County, New York",2533,79,2454,1269,2691,113594,1939,2011,2597,25.1,1037,906,51,169,122,2454,207
2018,36047016500,"Census Tract 165, Kings County, New York",2569,125,2444,1040,2401,150375,0,2012,3084,24,913,692,60,156,109,2444,154
2019,36047016500,"Census Tract 165, Kings County, New York",2488,127,2361,940,2189,159077,0,2012,3128,23.1,818,668,54,142,53,2361,187
2020,36047016500,"Census Tract 165, Kings County, New York",2429,108,2321,796,1678,162362,0,2016,2918,20.1,693,585,21,80,57,2321,179
2012,36047016600,"Census Tract 166, Kings County, New York",796,35,761,78,116,12386,1939,2004,1241,29.8,9,60,0,0,18,761,58
2013,36047016600,"Census Tract 166, Kings County, New York",776,52,724,60,100,48393,1939,2008,1188,28.2,0,40,0,0,20,724,45
2014,36047016600,"Census Tract 166, Kings County, New York",784,67,717,70,231,51053,1939,2011,1921,42.1,6,37,0,0,33,717,59
2015,36047016600,"Census Tract 166, Kings County, New York",738,70,668,70,241,51429,1939,2012,2034,43.2,19,42,0,0,28,668,36
2016,36047016600,"Census Tract 166, Kings County, New York",723,58,665,57,191,NA,1939,2011,1614,28.8,22,45,0,0,12,665,19
2017,36047016600,"Census Tract 166, Kings County, New York",711,60,651,66,191,54000,1939,2012,1563,29.3,15,53,0,0,13,651,30
2018,36047016600,"Census Tract 166, Kings County, New York",762,68,694,84,220,57188,0,2013,1232,28.1,32,67,0,0,17,694,21
2019,36047016600,"Census Tract 166, Kings County, New York",754,91,663,68,182,NA,0,2013,1455,25.6,36,64,0,0,4,663,14
2020,36047016600,"Census Tract 166, Kings County, New York",781,83,698,85,207,117344,1941,2014,1716,20.5,51,72,0,8,5,698,24
2012,36047016700,"Census Tract 167, Kings County, New York",2218,97,2121,1251,2646,73351,1939,2004,1752,24.4,793,869,12,126,221,2121,174
2013,36047016700,"Census Tract 167, Kings County, New York",2207,90,2117,1318,2793,73032,1939,2006,1783,24.8,934,888,11,190,185,2117,208
2014,36047016700,"Census Tract 167, Kings County, New York",2263,150,2113,1371,2821,82076,1939,2006,1857,23.3,1038,961,20,161,210,2113,134
2015,36047016700,"Census Tract 167, Kings County, New York",2272,145,2127,1398,3252,84861,1939,2008,1866,24.1,1114,1033,23,185,155,2127,123
2016,36047016700,"Census Tract 167, Kings County, New York",2289,165,2124,1324,3114,105641,1939,2011,2036,22.5,1158,1076,20,132,94,2124,108
2017,36047016700,"Census Tract 167, Kings County, New York",2291,159,2132,1263,3165,116298,1939,2010,2141,21.3,1152,1008,78,105,71,2132,67
2018,36047016700,"Census Tract 167, Kings County, New York",2271,133,2138,1224,2912,143750,0,2011,2318,21,1099,948,71,96,129,2138,48
2019,36047016700,"Census Tract 167, Kings County, New York",2254,104,2150,1218,2878,143854,0,2013,2425,22.2,1088,927,77,100,114,2150,57
2020,36047016700,"Census Tract 167, Kings County, New York",2453,167,2286,1221,2528,134574,0,2014,2027,22.5,1068,945,61,119,96,2286,84
2012,36047016800,"Census Tract 168, Kings County, New York",723,43,680,155,312,28009,1952,2003,1215,47.6,61,130,0,13,12,680,64
2013,36047016800,"Census Tract 168, Kings County, New York",726,89,637,162,308,28125,1953,2003,1183,49.2,40,131,0,17,14,637,80
2014,36047016800,"Census Tract 168, Kings County, New York",747,68,679,145,318,29279,1951,2003,1278,45.8,37,113,0,17,15,679,85
2015,36047016800,"Census Tract 168, Kings County, New York",749,68,681,141,310,NA,1951,2002,1256,29.3,58,89,0,16,36,681,64
2016,36047016800,"Census Tract 168, Kings County, New York",768,53,715,154,366,67333,1954,2005,1382,25.4,53,100,0,19,35,715,61
2017,36047016800,"Census Tract 168, Kings County, New York",775,82,693,167,314,NA,1957,2005,1162,45,57,123,0,0,18,693,46
2018,36047016800,"Census Tract 168, Kings County, New York",767,41,726,181,316,NA,1956,2005,1149,46.2,61,137,0,0,22,726,46
2019,36047016800,"Census Tract 168, Kings County, New York",785,35,750,200,331,32794,1956,2010,1174,45.2,56,143,0,17,12,750,28
2020,36047016800,"Census Tract 168, Kings County, New York",805,38,767,245,455,85670,1964,2016,NA,29.2,129,209,0,16,0,767,28
2012,36047016900,"Census Tract 169, Kings County, New York",2277,184,2093,1405,2867,52608,1939,2003,1274,24.7,630,721,75,357,276,2093,442
2013,36047016900,"Census Tract 169, Kings County, New York",2279,111,2168,1515,3091,53536,1939,2003,1473,26.4,786,760,86,356,337,2168,501
2014,36047016900,"Census Tract 169, Kings County, New York",2245,108,2137,1640,3445,63654,1939,2005,1705,27.8,965,1022,66,285,267,2137,431
2015,36047016900,"Census Tract 169, Kings County, New York",2225,86,2139,1524,3371,73088,1939,2009,1737,26.8,997,987,43,216,251,2139,425
2016,36047016900,"Census Tract 169, Kings County, New York",2191,76,2115,1583,3286,92981,1939,2010,1933,26.9,1161,1146,44,170,198,2115,352
2017,36047016900,"Census Tract 169, Kings County, New York",2211,34,2177,1703,3439,76712,1939,2011,1919,27.5,1229,1138,44,191,297,2177,373
2018,36047016900,"Census Tract 169, Kings County, New York",2192,58,2134,1612,3254,81048,0,2011,1909,27.6,1191,1176,37,161,175,2134,309
2019,36047016900,"Census Tract 169, Kings County, New York",2152,60,2092,1524,2895,88500,0,2011,1966,25.8,1171,1048,38,175,195,2092,258
2020,36047016900,"Census Tract 169, Kings County, New York",2112,54,2058,1587,3284,105876,0,2014,2108,26.5,1249,1215,17,175,144,2058,301
2012,36047017000,"Census Tract 170, Kings County, New York",1263,78,1185,518,1551,49722,1939,2004,1222,28.2,117,296,0,136,86,1185,177
2013,36047017000,"Census Tract 170, Kings County, New York",1260,92,1168,470,1442,48103,1939,2005,1284,27.9,106,260,0,129,81,1168,183
2014,36047017000,"Census Tract 170, Kings County, New York",1244,78,1166,516,1546,49375,1939,2006,1274,25.7,170,266,0,159,91,1166,192
2015,36047017000,"Census Tract 170, Kings County, New York",1267,49,1218,580,1883,71667,1939,2011,1488,24.7,222,312,27,127,114,1218,200
2016,36047017000,"Census Tract 170, Kings County, New York",1261,59,1202,569,1793,65972,1939,2011,1576,28.1,193,300,27,118,124,1202,180
2017,36047017000,"Census Tract 170, Kings County, New York",1244,87,1157,551,1593,60509,1939,2011,1594,35.3,161,321,23,81,126,1157,145
2018,36047017000,"Census Tract 170, Kings County, New York",1240,99,1141,584,1849,64400,0,2011,1620,32.5,185,302,19,143,120,1141,130
2019,36047017000,"Census Tract 170, Kings County, New York",1238,106,1132,553,1713,41089,0,2012,1628,39.1,160,312,13,122,106,1132,111
2020,36047017000,"Census Tract 170, Kings County, New York",1206,162,1044,390,1031,37500,1944,2011,1600,46.1,179,208,0,133,49,1044,113
2012,36047017100,"Census Tract 171, Kings County, New York",1685,120,1565,727,1481,88958,1939,2005,1841,27.3,527,597,26,75,29,1565,60
2013,36047017100,"Census Tract 171, Kings County, New York",1688,112,1576,740,1574,75000,1939,2005,2001,29.6,510,604,24,69,29,1576,56
2014,36047017100,"Census Tract 171, Kings County, New York",1712,109,1603,809,1845,97537,1939,2006,2001,26.5,547,696,0,49,54,1603,38
2015,36047017100,"Census Tract 171, Kings County, New York",1676,115,1561,786,1884,96029,1939,2009,2020,24.6,591,649,0,47,83,1561,36
2016,36047017100,"Census Tract 171, Kings County, New York",1656,101,1555,762,1937,113077,1939,2010,2071,23.8,611,649,0,33,74,1555,66
2017,36047017100,"Census Tract 171, Kings County, New York",1711,125,1586,781,1997,109519,1939,2011,2180,24.4,651,641,0,37,94,1586,65
2018,36047017100,"Census Tract 171, Kings County, New York",1719,110,1609,773,1899,115650,0,2012,2256,25.6,647,575,0,38,160,1609,69
2019,36047017100,"Census Tract 171, Kings County, New York",1669,120,1549,669,1722,118375,0,2012,2343,26.5,588,468,0,55,134,1549,104
2020,36047017100,"Census Tract 171, Kings County, New York",1736,127,1609,844,2133,99028,0,2013,2232,30,755,547,0,47,239,1609,77
2012,36047017200,"Census Tract 172, Kings County, New York",1069,78,991,443,1406,41417,1939,2006,1167,21.6,101,242,74,89,73,991,81
2013,36047017200,"Census Tract 172, Kings County, New York",1147,66,1081,495,1486,52098,1941,2007,1211,22.5,101,238,59,137,90,1081,55
2014,36047017200,"Census Tract 172, Kings County, New York",1174,73,1101,494,1572,51083,1939,2009,1205,24.2,71,223,12,183,76,1101,32
2015,36047017200,"Census Tract 172, Kings County, New York",1136,13,1123,544,1633,42188,1945,2010,1265,28.5,114,212,16,219,124,1123,66
2016,36047017200,"Census Tract 172, Kings County, New York",1182,11,1171,613,1707,51763,1952,2010,1339,28.1,136,216,0,175,215,1171,70
2017,36047017200,"Census Tract 172, Kings County, New York",1145,72,1073,533,1601,50260,1953,2010,1320,35.3,129,228,0,137,137,1073,107
2018,36047017200,"Census Tract 172, Kings County, New York",1144,77,1067,510,1363,54500,1955,2009,1360,27.9,132,220,0,108,164,1067,98
2019,36047017200,"Census Tract 172, Kings County, New York",1159,106,1053,588,1740,64722,1950,2013,1466,33.8,176,253,0,171,152,1053,94
2020,36047017200,"Census Tract 172, Kings County, New York",1169,94,1075,625,1810,71510,1947,2013,1615,29.7,144,287,0,135,174,1075,73
2012,36047017400,"Census Tract 174, Kings County, New York",737,30,707,336,851,46296,1940,2005,1146,32.2,99,174,0,77,71,707,103
2013,36047017400,"Census Tract 174, Kings County, New York",765,27,738,304,771,62685,1942,2005,1279,30.9,97,180,0,79,33,738,64
2014,36047017400,"Census Tract 174, Kings County, New York",781,26,755,278,636,42500,1950,2006,1243,32.1,87,176,0,47,44,755,77
2015,36047017400,"Census Tract 174, Kings County, New York",750,42,708,241,569,42969,1956,2007,1255,28.9,72,151,0,48,29,708,72
2016,36047017400,"Census Tract 174, Kings County, New York",748,46,702,195,450,59583,1957,2006,1279,22.5,65,126,0,31,24,702,45
2017,36047017400,"Census Tract 174, Kings County, New York",759,60,699,167,506,95982,1954,2006,1372,17.8,58,102,0,26,39,699,45
2018,36047017400,"Census Tract 174, Kings County, New York",768,47,721,221,629,77938,1951,2007,1445,22.4,64,133,0,40,48,721,69
2019,36047017400,"Census Tract 174, Kings County, New York",759,50,709,232,714,79674,0,2011,1534,21,90,152,0,37,43,709,66
2020,36047017400,"Census Tract 174, Kings County, New York",771,35,736,221,612,95583,0,2011,1665,25.4,103,165,0,34,22,736,54
2012,36047017500,"Census Tract 175, Kings County, New York",11,0,11,11,23,NA,1939,NA,NA,NA,11,0,0,0,11,11,0
2013,36047017500,"Census Tract 175, Kings County, New York",0,0,0,0,0,NA,NA,NA,NA,NA,0,0,0,0,0,0,0
2014,36047017500,"Census Tract 175, Kings County, New York",0,0,0,0,0,NA,NA,NA,NA,NA,0,0,0,0,0,0,0
2015,36047017500,"Census Tract 175, Kings County, New York",0,0,0,0,0,NA,NA,NA,NA,NA,0,0,0,0,0,0,0
2016,36047017500,"Census Tract 175, Kings County, New York",0,0,0,0,0,NA,NA,NA,NA,NA,0,0,0,0,0,0,0
2017,36047017500,"Census Tract 175, Kings County, New York",0,0,0,0,0,NA,NA,NA,NA,NA,0,0,0,0,0,0,0
2018,36047017500,"Census Tract 175, Kings County, New York",0,0,0,0,0,NA,NA,NA,NA,NA,0,0,0,0,0,0,0
2019,36047017500,"Census Tract 175, Kings County, New York",0,0,0,0,0,NA,NA,NA,NA,NA,0,0,0,0,0,0,0
2020,36047017500,"Census Tract 175, Kings County, New York",0,0,0,0,0,NA,NA,NA,NA,NA,0,0,0,0,0,0,0
2012,36047017600,"Census Tract 176, Kings County, New York",922,165,757,452,1016,26682,1943,1999,1081,41.4,55,374,0,57,21,757,103
2013,36047017600,"Census Tract 176, Kings County, New York",900,111,789,457,1049,30341,1946,2000,1254,41.5,87,367,0,41,49,789,105
2014,36047017600,"Census Tract 176, Kings County, New York",934,87,847,509,1294,41926,1943,2002,1136,32.9,126,368,0,46,95,847,100
2015,36047017600,"Census Tract 176, Kings County, New York",937,74,863,497,1324,53508,1946,2004,1194,30.2,150,334,0,55,108,863,95
2016,36047017600,"Census Tract 176, Kings County, New York",912,51,861,457,1240,50313,1947,2005,1150,30,150,286,0,70,101,861,121
2017,36047017600,"Census Tract 176, Kings County, New York",920,47,873,457,1249,60134,1950,2009,1232,30.5,148,265,15,58,119,873,130
2018,36047017600,"Census Tract 176, Kings County, New York",954,59,895,485,1302,58438,1950,2010,1368,32,173,278,16,74,103,895,143
2019,36047017600,"Census Tract 176, Kings County, New York",966,80,886,424,1037,53529,1953,2011,1484,31.7,115,258,17,53,83,886,125
2020,36047017600,"Census Tract 176, Kings County, New York",980,106,874,391,916,54330,1954,2013,1561,33.2,104,229,16,40,94,874,98
2012,36047017700,"Census Tract 177, Kings County, New York",0,0,0,0,0,NA,NA,NA,NA,NA,0,0,0,0,0,0,0
2013,36047017700,"Census Tract 177, Kings County, New York",0,0,0,0,0,NA,NA,NA,NA,NA,0,0,0,0,0,0,0
2014,36047017700,"Census Tract 177, Kings County, New York",0,0,0,0,0,NA,NA,NA,NA,NA,0,0,0,0,0,0,0
2015,36047017700,"Census Tract 177, Kings County, New York",0,0,0,0,0,NA,NA,NA,NA,NA,0,0,0,0,0,0,0
2016,36047017700,"Census Tract 177, Kings County, New York",0,0,0,0,0,NA,NA,NA,NA,NA,0,0,0,0,0,0,0
2017,36047017700,"Census Tract 177, Kings County, New York",0,0,0,0,0,NA,NA,NA,NA,NA,0,0,0,0,0,0,0
2018,36047017700,"Census Tract 177, Kings County, New York",0,0,0,0,0,NA,NA,NA,NA,NA,0,0,0,0,0,0,0
2019,36047017700,"Census Tract 177, Kings County, New York",0,0,0,0,0,NA,NA,NA,NA,NA,0,0,0,0,0,0,0
2020,36047017700,"Census Tract 177, Kings County, New York",0,0,0,0,0,NA,NA,NA,NA,NA,0,0,0,0,0,0,0
2012,36047017800,"Census Tract 178, Kings County, New York",852,65,787,450,1206,47625,1939,2003,1138,29.5,118,246,0,108,76,787,108
2013,36047017800,"Census Tract 178, Kings County, New York",863,68,795,471,1313,28375,1945,2004,1184,34.9,163,223,0,118,99,795,132
2014,36047017800,"Census Tract 178, Kings County, New York",950,83,867,561,1844,39861,1942,2006,1257,31.9,156,217,0,142,162,867,151
2015,36047017800,"Census Tract 178, Kings County, New York",940,60,880,636,2166,51912,1950,2007,1296,32.2,197,259,0,154,178,880,193
2016,36047017800,"Census Tract 178, Kings County, New York",967,49,918,682,2301,57083,1952,2008,1363,30.8,220,248,23,147,218,918,171
2017,36047017800,"Census Tract 178, Kings County, New York",930,47,883,605,2011,58375,1939,2010,1355,31.2,154,234,23,125,208,883,146
2018,36047017800,"Census Tract 178, Kings County, New York",967,48,919,617,2048,61146,0,2011,1355,30.7,150,211,35,122,249,919,147
2019,36047017800,"Census Tract 178, Kings County, New York",955,73,882,576,1922,64519,0,2012,1402,30,139,224,30,110,212,882,112
2020,36047017800,"Census Tract 178, Kings County, New York",983,87,896,587,1854,64009,0,2012,1445,29,145,221,31,128,197,896,109
2012,36047017900,"Census Tract 179, Kings County, New York",1593,89,1504,1031,2438,47701,1977,2004,1155,29.6,437,261,559,24,166,1504,268
2013,36047017900,"Census Tract 179, Kings County, New York",1621,109,1512,1048,2471,42905,1975,2004,1125,27.8,418,290,595,26,167,1512,271
2014,36047017900,"Census Tract 179, Kings County, New York",1651,132,1519,1091,2667,43519,1975,2004,1170,28.7,423,320,551,35,255,1519,226
2015,36047017900,"Census Tract 179, Kings County, New York",1644,105,1539,1155,2611,36467,1977,2005,1135,30.6,443,300,619,51,268,1539,304
2016,36047017900,"Census Tract 179, Kings County, New York",1670,130,1540,1108,2473,34333,1977,2006,1028,27.5,398,276,595,48,260,1540,307
2017,36047017900,"Census Tract 179, Kings County, New York",1690,109,1581,1175,2700,31988,1976,2006,1081,26.9,414,259,707,68,219,1581,304
2018,36047017900,"Census Tract 179, Kings County, New York",1706,107,1599,1174,2449,32455,1977,2007,1131,27.2,442,253,675,64,212,1599,304
2019,36047017900,"Census Tract 179, Kings County, New York",1726,69,1657,1228,2486,32471,1977,2009,1216,27.2,496,271,703,77,211,1657,379
2020,36047017900,"Census Tract 179, Kings County, New York",1662,96,1566,1022,1984,43661,1977,2011,1318,26.6,488,282,478,83,200,1566,358
2012,36047018000,"Census Tract 180, Kings County, New York",1086,53,1033,557,1510,24301,1939,2001,1234,46.1,42,320,0,171,66,1033,209
2013,36047018000,"Census Tract 180, Kings County, New York",1044,87,957,602,1864,28125,1939,2003,1260,43,53,401,0,109,92,957,223
2014,36047018000,"Census Tract 180, Kings County, New York",1078,67,1011,667,2126,48586,1939,2005,1241,32.9,61,401,0,131,135,1011,237
2015,36047018000,"Census Tract 180, Kings County, New York",1105,59,1046,685,2273,52321,1939,2005,1373,31.3,69,419,9,72,194,1046,196
2016,36047018000,"Census Tract 180, Kings County, New York",1156,60,1096,681,2089,51917,1939,2007,1295,31.3,113,385,8,102,194,1096,134
2017,36047018000,"Census Tract 180, Kings County, New York",1146,154,992,627,1817,35964,1939,2007,1320,33.9,115,299,6,147,171,992,122
2018,36047018000,"Census Tract 180, Kings County, New York",1199,152,1047,620,1855,54583,0,2009,1370,30.7,116,278,7,131,201,1047,106
2019,36047018000,"Census Tract 180, Kings County, New York",1207,123,1084,564,1633,39896,0,2010,1393,34.9,144,218,6,134,198,1084,124
2020,36047018000,"Census Tract 180, Kings County, New York",1212,147,1065,544,1657,48856,0,2009,1415,39.1,246,257,0,138,134,1065,109
2012,36047018100,"Census Tract 181, Kings County, New York",2349,205,2144,1583,2463,76893,1939,2004,1551,24,1219,685,531,225,107,2144,112
2013,36047018100,"Census Tract 181, Kings County, New York",2325,286,2039,1467,2339,78232,1939,2006,1569,23.4,1104,762,464,97,122,2039,139
2014,36047018100,"Census Tract 181, Kings County, New York",2256,355,1901,1279,2148,82047,1939,2007,1507,21.9,1018,685,291,85,238,1901,120
2015,36047018100,"Census Tract 181, Kings County, New York",2254,377,1877,1175,1869,80295,1939,2009,1490,22.6,972,580,284,83,241,1877,112
2016,36047018100,"Census Tract 181, Kings County, New York",2206,350,1856,1183,1904,79579,1939,2011,1668,23.8,932,624,288,93,178,1856,128
2017,36047018100,"Census Tract 181, Kings County, New York",2296,384,1912,1199,1951,80042,1939,2011,1720,24.4,935,622,253,101,204,1912,107
2018,36047018100,"Census Tract 181, Kings County, New York",2246,272,1974,1186,2011,86250,0,2012,1823,25.1,856,602,252,118,185,1974,87
2019,36047018100,"Census Tract 181, Kings County, New York",2272,241,2031,1315,2127,89653,0,2015,2114,27,1038,699,305,147,71,2031,101
2020,36047018100,"Census Tract 181, Kings County, New York",2213,244,1969,1438,2551,105781,0,2016,2273,24,1153,917,240,130,70,1969,118
2012,36047018200,"Census Tract 182, Kings County, New York",1130,75,1055,640,1749,32146,1939,2004,1117,38.3,112,223,0,245,161,1055,174
2013,36047018200,"Census Tract 182, Kings County, New York",1162,155,1007,681,2043,35810,1939,2005,1126,36.2,92,188,0,312,170,1007,144
2014,36047018200,"Census Tract 182, Kings County, New York",1182,129,1053,715,2124,34818,1942,2007,1230,38.7,158,232,15,313,146,1053,183
2015,36047018200,"Census Tract 182, Kings County, New York",1236,92,1144,761,2262,37261,1943,2008,1277,36.3,135,226,28,326,181,1144,183
2016,36047018200,"Census Tract 182, Kings County, New York",1216,95,1121,698,2014,40882,1945,2009,1336,37.9,129,267,30,254,147,1121,190
2017,36047018200,"Census Tract 182, Kings County, New York",1229,81,1148,735,2113,37279,1941,2010,1364,39.4,154,302,26,291,109,1148,217
2018,36047018200,"Census Tract 182, Kings County, New York",1243,37,1206,766,2015,43421,0,2011,1410,37.1,173,352,30,256,121,1206,223
2019,36047018200,"Census Tract 182, Kings County, New York",1246,45,1201,725,1892,47917,0,2011,1410,35.3,153,315,10,244,147,1201,198
2020,36047018200,"Census Tract 182, Kings County, New York",1147,38,1109,587,1610,44950,0,2012,1395,36.1,102,286,0,212,75,1109,156
2012,36047018300,"Census Tract 183, Kings County, New York",1450,206,1244,833,1511,80221,1939,NA,1888,25,614,441,208,79,88,1244,103
2013,36047018300,"Census Tract 183, Kings County, New York",1450,188,1262,839,1584,90711,1939,2006,1956,24.1,568,413,153,100,146,1262,63
2014,36047018300,"Census Tract 183, Kings County, New York",1434,171,1263,901,1749,89479,1939,2007,2001,25.4,664,474,138,95,171,1263,77
2015,36047018300,"Census Tract 183, Kings County, New York",1416,137,1279,975,1829,92575,1939,2008,1961,25.2,733,546,193,94,133,1279,97
2016,36047018300,"Census Tract 183, Kings County, New York",1383,70,1313,927,1787,92161,1939,2010,2030,24.6,736,567,155,68,117,1313,122
2017,36047018300,"Census Tract 183, Kings County, New York",1329,61,1268,903,1773,100819,1939,2012,2219,23.3,787,634,121,56,76,1268,105
2018,36047018300,"Census Tract 183, Kings County, New York",1313,98,1215,827,1635,110694,0,2013,2381,23.6,782,598,92,70,65,1215,117
2019,36047018300,"Census Tract 183, Kings County, New York",1317,91,1226,826,1518,125763,0,2014,2310,22.1,793,589,133,55,22,1226,138
2020,36047018300,"Census Tract 183, Kings County, New York",1311,149,1162,769,1617,136250,0,2016,2548,22.8,737,493,34,50,103,1162,95
2012,36047018400,"Census Tract 184, Kings County, New York",846,164,682,181,406,44271,1939,2003,1399,30,37,117,8,56,0,682,25
2013,36047018400,"Census Tract 184, Kings County, New York",857,96,761,193,412,41250,1939,2002,1284,35.3,34,127,10,56,0,761,24
2014,36047018400,"Census Tract 184, Kings County, New York",854,84,770,212,481,42692,1942,2005,1385,32.5,59,109,9,94,0,770,32
2015,36047018400,"Census Tract 184, Kings County, New York",872,66,806,213,589,41518,1944,2006,1375,29.6,68,105,14,94,0,806,60
2016,36047018400,"Census Tract 184, Kings County, New York",900,42,858,223,586,42132,1943,2006,1375,31.5,65,114,0,109,0,858,74
2017,36047018400,"Census Tract 184, Kings County, New York",899,6,893,245,756,51705,1941,2011,1562,31,81,107,0,138,0,893,81
2018,36047018400,"Census Tract 184, Kings County, New York",886,26,860,288,897,45114,1942,2011,1524,33.7,88,129,0,152,0,860,93
2019,36047018400,"Census Tract 184, Kings County, New York",876,28,848,282,770,33409,1946,2011,1566,34.8,71,134,0,129,12,848,104
2020,36047018400,"Census Tract 184, Kings County, New York",880,56,824,246,597,41250,1948,2011,1498,34.8,50,131,0,98,12,824,78
2012,36047018501,"Census Tract 185.01, Kings County, New York",1777,361,1416,1353,3259,18922,1949,2003,445,28,129,121,795,51,421,1416,637
2013,36047018501,"Census Tract 185.01, Kings County, New York",1765,186,1579,1524,3758,20579,1950,2003,459,27.8,69,85,920,74,463,1579,681
2014,36047018501,"Census Tract 185.01, Kings County, New York",1766,103,1663,1592,4058,19425,1951,2003,447,28.8,103,61,986,91,475,1663,731
2015,36047018501,"Census Tract 185.01, Kings County, New York",1809,113,1696,1636,4181,16481,1950,2003,452,31,131,79,950,94,510,1696,866
2016,36047018501,"Census Tract 185.01, Kings County, New York",1841,53,1788,1710,4398,21083,1948,2002,477,28.3,154,71,958,152,560,1788,786
2017,36047018501,"Census Tract 185.01, Kings County, New York",1837,65,1772,1695,4612,23486,1944,2002,499,26.9,174,126,1026,174,411,1772,717
2018,36047018501,"Census Tract 185.01, Kings County, New York",1858,78,1780,1739,4393,24119,1944,2003,472,29,218,117,1137,84,457,1780,773
2019,36047018501,"Census Tract 185.01, Kings County, New York",1869,77,1792,1769,3979,25736,1944,2003,492,31.2,266,160,1131,75,457,1792,729
2020,36047018501,"Census Tract 185.01, Kings County, New York",1890,52,1838,1651,3795,31772,1945,2005,725,30.3,297,133,1117,61,477,1838,531
2012,36047018600,"Census Tract 186, Kings County, New York",759,32,727,299,579,36932,1939,2003,1057,34.9,97,155,18,54,72,727,49
2013,36047018600,"Census Tract 186, Kings County, New York",731,32,699,256,601,54688,1939,2004,1177,33.9,74,107,19,57,73,699,30
2014,36047018600,"Census Tract 186, Kings County, New York",718,29,689,254,683,54792,1939,2004,1361,41.5,86,105,18,72,59,689,47
2015,36047018600,"Census Tract 186, Kings County, New York",703,32,671,308,823,53000,1939,2004,1357,43.8,100,143,21,80,64,671,68
2016,36047018600,"Census Tract 186, Kings County, New York",719,40,679,270,914,58036,1939,2006,1432,42.1,85,133,19,93,25,679,88
2017,36047018600,"Census Tract 186, Kings County, New York",717,27,690,292,905,40833,1939,2005,1369,39.7,105,178,0,90,24,690,79
2018,36047018600,"Census Tract 186, Kings County, New York",760,26,734,373,1122,39866,0,2006,1425,41.2,119,230,0,97,46,734,111
2019,36047018600,"Census Tract 186, Kings County, New York",752,26,726,352,1025,42083,0,2006,1452,38.5,112,243,0,79,30,726,102
2020,36047018600,"Census Tract 186, Kings County, New York",768,23,745,365,1196,56806,0,2008,1489,31.9,86,187,0,108,70,745,62
2012,36047018700,"Census Tract 187, Kings County, New York",644,65,579,455,1021,80694,1939,2004,1777,25,285,277,36,22,120,579,60
2013,36047018700,"Census Tract 187, Kings County, New York",646,59,587,429,986,92813,1939,2007,1803,21.4,309,259,32,28,110,587,39
2014,36047018700,"Census Tract 187, Kings County, New York",661,69,592,393,935,75179,1939,2010,1858,29.8,238,184,40,40,129,592,46
2015,36047018700,"Census Tract 187, Kings County, New York",667,119,548,419,936,72361,1939,2011,1941,27,231,192,62,40,115,548,57
2016,36047018700,"Census Tract 187, Kings County, New York",685,94,591,439,925,49777,1969,2011,2042,30,248,177,100,57,89,591,108
2017,36047018700,"Census Tract 187, Kings County, New York",709,75,634,502,1132,50476,1970,2012,2019,29.2,291,203,124,52,109,634,126
2018,36047018700,"Census Tract 187, Kings County, New York",729,67,662,530,1204,52500,1971,2012,1770,28.6,295,242,125,52,103,662,135
2019,36047018700,"Census Tract 187, Kings County, New York",571,50,521,422,1077,91429,0,2013,2213,27.4,258,231,42,57,58,521,50
2020,36047018700,"Census Tract 187, Kings County, New York",526,10,516,370,968,70000,0,2015,2138,26.8,256,235,43,53,39,516,49
2012,36047018800,"Census Tract 188, Kings County, New York",1011,24,987,373,1109,50391,1939,2004,1430,29.7,73,256,0,106,11,987,77
2013,36047018800,"Census Tract 188, Kings County, New York",1047,19,1028,429,1302,46953,1939,2006,1527,31.3,92,274,0,110,45,1028,94
2014,36047018800,"Census Tract 188, Kings County, New York",1063,41,1022,428,1176,49531,1939,2009,1401,30.2,119,287,0,69,72,1022,127
2015,36047018800,"Census Tract 188, Kings County, New York",1048,57,991,436,1227,50308,1942,2011,1409,28.6,104,288,0,74,74,991,128
2016,36047018800,"Census Tract 188, Kings County, New York",1049,74,975,482,1371,51354,1942,2011,1396,28.8,108,308,0,79,95,975,102
2017,36047018800,"Census Tract 188, Kings County, New York",1043,98,945,476,1357,49531,1940,2011,1434,32.8,89,296,0,56,117,945,99
2018,36047018800,"Census Tract 188, Kings County, New York",1037,105,932,460,1214,51250,0,2012,1524,35.4,100,272,0,95,86,932,99
2019,36047018800,"Census Tract 188, Kings County, New York",1055,88,967,473,1248,59728,0,2012,1579,31.8,117,209,0,155,83,967,95
2020,36047018800,"Census Tract 188, Kings County, New York",1188,78,1110,637,1411,NA,0,2014,1641,39.7,135,384,0,120,104,1110,81
2012,36047019000,"Census Tract 190, Kings County, New York",1721,118,1603,1165,3695,35675,1939,2005,1080,34,188,504,36,313,339,1603,348
2013,36047019000,"Census Tract 190, Kings County, New York",1745,80,1665,1237,4037,37986,1939,2006,1113,32.5,228,591,33,312,325,1665,398
2014,36047019000,"Census Tract 190, Kings County, New York",1743,155,1588,1172,3861,39860,1939,2007,1161,31.1,213,512,35,305,347,1588,408
2015,36047019000,"Census Tract 190, Kings County, New York",1720,172,1548,1126,3572,39909,1939,2009,1154,30.4,220,489,23,296,318,1548,368
2016,36047019000,"Census Tract 190, Kings County, New York",1733,183,1550,1120,3459,40093,1939,2010,1184,30.4,255,448,32,319,329,1550,355
2017,36047019000,"Census Tract 190, Kings County, New York",1645,162,1483,991,3019,40332,1939,2011,1221,32.5,259,395,26,259,320,1483,315
2018,36047019000,"Census Tract 190, Kings County, New York",1666,160,1506,974,2944,39097,0,2011,1422,34.6,290,309,29,283,362,1506,293
2019,36047019000,"Census Tract 190, Kings County, New York",1635,79,1556,1003,2939,48693,0,2011,1527,33.8,390,322,33,268,378,1556,246
2020,36047019000,"Census Tract 190, Kings County, New York",1574,63,1511,996,2773,48241,1952,2012,1462,33.4,395,243,8,428,303,1511,239
2012,36047019100,"Census Tract 191, Kings County, New York",1139,196,943,646,1646,44444,1939,2004,1641,34.5,318,248,185,13,184,943,308
2013,36047019100,"Census Tract 191, Kings County, New York",1182,243,939,602,1540,51667,1939,2006,1766,33.7,361,310,120,13,134,939,263
2014,36047019100,"Census Tract 191, Kings County, New York",1185,189,996,643,1589,77946,1939,2009,1955,29.9,381,298,145,12,159,996,209
2015,36047019100,"Census Tract 191, Kings County, New York",1221,156,1065,743,1697,NA,1939,2011,1940,32.2,412,344,186,14,167,1065,180
2016,36047019100,"Census Tract 191, Kings County, New York",1232,219,1013,707,1541,81616,1939,2012,2261,29.4,499,337,180,14,150,1013,164
2017,36047019100,"Census Tract 191, Kings County, New York",1261,216,1045,689,1574,85481,1965,2013,2553,28.9,534,387,88,39,135,1045,140
2018,36047019100,"Census Tract 191, Kings County, New York",1260,186,1074,811,1869,95163,1967,2014,2586,27.8,628,481,125,74,99,1074,167
2019,36047019100,"Census Tract 191, Kings County, New York",1369,256,1113,757,1818,89570,1965,2015,2596,31.1,564,486,79,87,105,1113,180
2020,36047019100,"Census Tract 191, Kings County, New York",1403,261,1142,810,1931,102174,1964,2016,2657,28,627,442,78,145,145,1142,121
2012,36047019200,"Census Tract 192, Kings County, New York",876,146,730,389,1241,32887,1939,2003,1042,40.2,44,135,31,60,163,730,280
2013,36047019200,"Census Tract 192, Kings County, New York",884,119,765,466,1662,28947,1939,2002,970,40.8,53,203,29,116,118,765,237
2014,36047019200,"Census Tract 192, Kings County, New York",920,102,818,485,1793,29681,1939,2004,991,39.8,70,226,0,148,111,818,211
2015,36047019200,"Census Tract 192, Kings County, New York",921,70,851,521,1885,29173,1939,2005,1064,38.4,68,237,0,171,127,851,202
2016,36047019200,"Census Tract 192, Kings County, New York",947,40,907,535,1939,29838,1939,2008,1111,35.9,43,205,0,203,151,907,172
2017,36047019200,"Census Tract 192, Kings County, New York",940,75,865,508,2080,31471,1939,2009,1229,38.9,55,183,0,220,130,865,145
2018,36047019200,"Census Tract 192, Kings County, New York",882,86,796,460,1700,31377,1951,2012,1306,45.1,50,134,0,224,133,796,148
2019,36047019200,"Census Tract 192, Kings County, New York",877,95,782,449,1606,30692,1960,2012,1236,48.3,66,104,0,167,206,782,172
2020,36047019200,"Census Tract 192, Kings County, New York",806,103,703,458,1723,37823,1969,2014,1440,47.3,89,107,0,159,199,703,150
2012,36047019300,"Census Tract 193, Kings County, New York",2302,173,2129,1163,2341,31713,1962,2002,1098,40.9,391,352,594,34,206,2129,390
2013,36047019300,"Census Tract 193, Kings County, New York",2212,151,2061,1130,1973,29457,1962,2001,1195,36.1,366,346,592,50,175,2061,331
2014,36047019300,"Census Tract 193, Kings County, New York",2296,141,2155,1116,2241,40489,1961,2000,1170,35.1,385,379,572,47,165,2155,261
2015,36047019300,"Census Tract 193, Kings County, New York",2301,158,2143,1077,2263,45762,1962,2000,1203,35.3,306,291,623,58,138,2143,240
2016,36047019300,"Census Tract 193, Kings County, New York",2332,183,2149,1058,2146,36250,1960,2003,1108,34.5,271,211,639,83,159,2149,277
2017,36047019300,"Census Tract 193, Kings County, New York",2366,145,2221,1089,2261,41906,1961,2004,1149,30.5,354,194,641,52,202,2221,374
2018,36047019300,"Census Tract 193, Kings County, New York",2466,192,2274,1075,2334,44495,1963,2007,1119,34.6,355,199,629,62,207,2274,428
2019,36047019300,"Census Tract 193, Kings County, New York",2462,151,2311,1184,2356,46250,1963,2009,1149,33.8,440,234,653,88,227,2311,480
2020,36047019300,"Census Tract 193, Kings County, New York",2677,129,2548,1201,2218,44799,1962,2011,1183,33.1,543,300,551,88,277,2548,447
2012,36047019400,"Census Tract 194, Kings County, New York",1240,34,1206,828,2409,34573,1939,2004,1135,36.8,77,350,37,323,118,1206,122
2013,36047019400,"Census Tract 194, Kings County, New York",1203,51,1152,755,2198,36132,1939,2004,1124,32.3,51,307,35,284,129,1152,120
2014,36047019400,"Census Tract 194, Kings County, New York",1223,67,1156,785,2191,36128,1939,2006,1124,32.9,74,327,24,276,158,1156,143
2015,36047019400,"Census Tract 194, Kings County, New York",1241,79,1162,838,2569,38720,1939,2006,1233,34.8,159,282,23,305,220,1162,156
2016,36047019400,"Census Tract 194, Kings County, New York",1258,74,1184,796,2459,38801,1939,2008,1267,38,162,266,23,264,236,1184,191
2017,36047019400,"Census Tract 194, Kings County, New York",1240,92,1148,850,2838,39907,1939,2010,1251,40.2,156,283,0,308,252,1148,210
2018,36047019400,"Census Tract 194, Kings County, New York",1250,91,1159,800,2745,40000,0,2010,1270,40.9,184,234,0,313,245,1159,219
2019,36047019400,"Census Tract 194, Kings County, New York",1245,106,1139,763,2845,41469,0,2010,1395,40.3,203,174,0,286,296,1139,284
2020,36047019400,"Census Tract 194, Kings County, New York",1240,139,1101,597,2056,39946,0,2011,1403,47.4,134,145,0,269,183,1101,257
2012,36047019500,"Census Tract 195, Kings County, New York",1980,186,1794,1143,2615,59017,1939,2004,1373,26.7,569,409,384,36,282,1794,289
2013,36047019500,"Census Tract 195, Kings County, New York",1956,157,1799,1046,2632,59958,1939,2004,1392,28.2,519,414,324,21,308,1799,210
2014,36047019500,"Census Tract 195, Kings County, New York",1898,166,1732,1068,2544,61354,1939,2005,1548,28.6,543,466,337,10,216,1732,214
2015,36047019500,"Census Tract 195, Kings County, New York",1882,89,1793,1087,2627,75951,1939,2010,1657,27.1,578,484,394,12,155,1793,183
2016,36047019500,"Census Tract 195, Kings County, New York",1909,133,1776,1049,2306,71067,1939,2010,1710,30.2,562,461,371,13,147,1776,191
2017,36047019500,"Census Tract 195, Kings County, New York",1904,65,1839,990,2166,73472,1939,2010,1701,29.9,574,425,349,14,132,1839,166
2018,36047019500,"Census Tract 195, Kings County, New York",1925,84,1841,969,2065,88005,1941,2010,1726,28.2,598,434,332,0,161,1841,177
2019,36047019500,"Census Tract 195, Kings County, New York",1901,161,1740,809,1515,96250,0,2012,2039,27.3,534,471,212,0,105,1740,158
2020,36047019500,"Census Tract 195, Kings County, New York",1933,244,1689,656,1153,92000,0,2012,1968,27.1,446,407,145,0,88,1689,254
2012,36047019600,"Census Tract 196, Kings County, New York",1610,76,1534,1113,3454,39328,1939,2004,1156,33.5,169,506,80,291,298,1534,353
2013,36047019600,"Census Tract 196, Kings County, New York",1615,72,1543,1065,3563,35274,1939,2006,1194,36.1,170,406,65,313,339,1543,397
2014,36047019600,"Census Tract 196, Kings County, New York",1667,115,1552,1065,3454,38820,1939,2008,1189,34.7,198,423,51,312,330,1552,359
2015,36047019600,"Census Tract 196, Kings County, New York",1690,162,1528,979,3010,40801,1939,2009,1245,33.4,212,445,28,265,269,1528,321
2016,36047019600,"Census Tract 196, Kings County, New York",1635,145,1490,981,3091,36250,1939,2010,1289,43.5,171,425,0,267,270,1490,397
2017,36047019600,"Census Tract 196, Kings County, New York",1607,145,1462,1004,2929,32355,1939,2010,1263,44.1,224,410,0,266,308,1462,386
2018,36047019600,"Census Tract 196, Kings County, New York",1559,139,1420,967,2537,34750,1943,2010,1346,46.4,210,473,0,202,270,1420,378
2019,36047019600,"Census Tract 196, Kings County, New York",1519,94,1425,993,2561,38938,0,2012,1416,45,171,374,0,198,397,1425,377
2020,36047019600,"Census Tract 196, Kings County, New York",1456,43,1413,902,2460,38438,0,2013,1525,44.1,175,289,45,191,356,1413,336
2012,36047019700,"Census Tract 197, Kings County, New York",1818,236,1582,737,1402,67426,1939,2003,1579,23.9,490,329,293,34,47,1582,184
2013,36047019700,"Census Tract 197, Kings County, New York",1762,198,1564,743,1426,67250,1939,2004,1601,23.7,532,330,281,33,44,1564,202
2014,36047019700,"Census Tract 197, Kings County, New York",1755,139,1616,787,1454,66010,1939,2006,1770,27.1,537,333,306,81,46,1616,232
2015,36047019700,"Census Tract 197, Kings County, New York",1697,106,1591,800,1559,80278,1939,2008,1929,26.6,631,362,240,113,51,1591,239
2016,36047019700,"Census Tract 197, Kings County, New York",1758,79,1679,913,1722,80293,1939,2010,1815,26.6,671,462,288,95,71,1679,252
2017,36047019700,"Census Tract 197, Kings County, New York",1763,46,1717,881,1537,71713,1939,2010,1800,29.3,644,440,273,105,66,1717,252
2018,36047019700,"Census Tract 197, Kings County, New York",1775,83,1692,876,1515,84417,0,2010,2040,28.3,615,459,254,106,70,1692,219
2019,36047019700,"Census Tract 197, Kings County, New York",1771,133,1638,743,1339,85508,0,2010,1869,25.7,557,412,217,60,65,1638,138
2020,36047019700,"Census Tract 197, Kings County, New York",1894,136,1758,796,1385,101133,0,2012,2173,22.1,640,418,241,40,127,1758,112
2012,36047019800,"Census Tract 198, Kings County, New York",723,13,710,315,713,57813,1939,2004,1260,22.3,88,285,0,23,7,710,81
2013,36047019800,"Census Tract 198, Kings County, New York",738,30,708,322,747,57273,1939,2003,1156,19.3,115,293,0,23,6,708,59
2014,36047019800,"Census Tract 198, Kings County, New York",738,45,693,345,837,57404,1939,2003,1274,24.4,120,296,0,32,17,693,70
2015,36047019800,"Census Tract 198, Kings County, New York",727,59,668,367,965,49250,1939,2004,1290,26.1,124,274,0,71,22,668,102
2016,36047019800,"Census Tract 198, Kings County, New York",717,51,666,340,786,47845,1939,2004,1435,29,56,239,0,62,39,666,128
2017,36047019800,"Census Tract 198, Kings County, New York",689,61,628,341,837,46763,1940,2006,1464,32.3,46,239,0,61,41,628,120
2018,36047019800,"Census Tract 198, Kings County, New York",660,56,604,329,830,45707,1942,2010,1523,33.2,57,203,0,80,46,604,107
2019,36047019800,"Census Tract 198, Kings County, New York",660,46,614,297,807,51250,0,2012,1538,33.2,52,153,0,76,61,614,91
2020,36047019800,"Census Tract 198, Kings County, New York",654,28,626,275,737,59297,0,2012,1491,33,43,159,0,56,47,626,83
2012,36047019900,"Census Tract 199, Kings County, New York",1534,224,1310,1005,1806,58028,1939,2004,1403,26.7,620,419,346,81,120,1310,140
2013,36047019900,"Census Tract 199, Kings County, New York",1550,291,1259,1015,1930,58159,1939,2005,1453,27.2,634,467,351,77,142,1259,120
2014,36047019900,"Census Tract 199, Kings County, New York",1612,277,1335,1105,2166,59688,1939,2006,1438,29.8,702,469,424,75,136,1335,180
2015,36047019900,"Census Tract 199, Kings County, New York",1641,248,1393,1137,2218,61339,1939,2007,1396,28.6,712,440,446,126,122,1393,197
2016,36047019900,"Census Tract 199, Kings County, New York",1689,215,1474,1151,2437,68194,1939,2010,1686,29.5,717,565,423,62,91,1474,180
2017,36047019900,"Census Tract 199, Kings County, New York",1681,103,1578,1227,2646,77480,1939,2011,1833,28.9,820,609,434,80,111,1578,190
2018,36047019900,"Census Tract 199, Kings County, New York",1671,69,1602,1251,2305,81005,0,2011,1814,28.2,856,619,409,84,137,1602,214
2019,36047019900,"Census Tract 199, Kings County, New York",1593,53,1540,1194,2299,86771,0,2012,2043,26.5,842,617,328,79,178,1540,205
2020,36047019900,"Census Tract 199, Kings County, New York",1981,210,1771,1361,2499,115451,0,2015,2306,24.4,1141,780,389,47,184,1771,225
2012,36047020000,"Census Tract 200, Kings County, New York",823,86,737,342,1124,65547,1939,2004,1439,28.8,40,169,0,57,116,737,79
2013,36047020000,"Census Tract 200, Kings County, New York",813,87,726,325,972,66734,1939,2005,1446,26.9,67,192,0,25,108,726,104
2014,36047020000,"Census Tract 200, Kings County, New York",829,83,746,364,1028,58250,1939,2006,1592,29,98,194,0,40,130,746,112
2015,36047020000,"Census Tract 200, Kings County, New York",828,58,770,375,1005,52198,1939,2007,1506,29.2,107,197,0,49,129,770,131
2016,36047020000,"Census Tract 200, Kings County, New York",802,28,774,339,868,51550,1939,2011,1313,29.9,97,210,0,40,89,774,127
2017,36047020000,"Census Tract 200, Kings County, New York",820,56,764,369,931,53882,1939,2009,1395,30.8,93,210,0,44,115,764,134
2018,36047020000,"Census Tract 200, Kings County, New York",853,77,776,397,1204,60023,0,2011,1401,32.6,74,184,0,76,137,776,123
2019,36047020000,"Census Tract 200, Kings County, New York",850,95,755,328,1039,60909,0,2010,1503,27.9,40,163,0,64,101,755,100
2020,36047020000,"Census Tract 200, Kings County, New York",800,110,690,317,952,63438,0,2011,1685,28.1,34,140,0,82,95,690,92
2012,36047020100,"Census Tract 201, Kings County, New York",1910,195,1715,1214,2135,73615,1939,2004,1563,24.6,879,539,487,76,70,1715,161
2013,36047020100,"Census Tract 201, Kings County, New York",1922,176,1746,1276,2353,74844,1939,2005,1594,26.3,918,571,521,66,84,1746,159
2014,36047020100,"Census Tract 201, Kings County, New York",1945,222,1723,1198,2285,78611,1939,2007,1696,25.6,821,528,482,57,136,1723,131
2015,36047020100,"Census Tract 201, Kings County, New York",1924,221,1703,1141,2306,76153,1939,2010,1761,28.1,763,630,355,30,118,1703,158
2016,36047020100,"Census Tract 201, Kings County, New York",1900,216,1684,1087,2207,84491,1939,2011,2003,25.6,777,640,299,18,91,1684,101
2017,36047020100,"Census Tract 201, Kings County, New York",1898,238,1660,1120,2266,87500,1939,2011,2014,24.6,800,634,346,25,79,1660,88
2018,36047020100,"Census Tract 201, Kings County, New York",1921,208,1713,1103,2193,101198,0,2013,2207,24.5,819,661,275,37,83,1713,107
2019,36047020100,"Census Tract 201, Kings County, New York",1964,173,1791,1215,2383,118493,0,2014,2343,24.9,898,733,328,51,23,1791,124
2020,36047020100,"Census Tract 201, Kings County, New York",1985,101,1884,1248,2346,103000,0,2014,2321,27.4,985,672,384,50,22,1884,154
2012,36047020200,"Census Tract 202, Kings County, New York",694,100,594,152,400,46364,1939,2002,1329,37.5,16,104,0,48,0,594,39
2013,36047020200,"Census Tract 202, Kings County, New York",712,63,649,158,478,50250,1939,2003,1291,36.1,30,109,0,49,0,649,34
2014,36047020200,"Census Tract 202, Kings County, New York",701,85,616,172,564,50259,1939,2003,1299,33.8,15,100,0,72,0,616,31
2015,36047020200,"Census Tract 202, Kings County, New York",703,57,646,189,693,79063,1939,2008,1198,22.8,23,113,0,76,0,646,28
2016,36047020200,"Census Tract 202, Kings County, New York",723,66,657,182,648,73333,1939,2010,1301,25.8,22,120,0,62,0,657,28
2017,36047020200,"Census Tract 202, Kings County, New York",760,89,671,219,737,64276,1942,2010,1400,26.5,25,136,0,83,0,671,63
2018,36047020200,"Census Tract 202, Kings County, New York",723,91,632,228,701,65833,1942,2011,1476,26.8,39,147,0,81,0,632,86
2019,36047020200,"Census Tract 202, Kings County, New York",727,87,640,231,729,NA,1943,2011,1641,37.3,50,135,6,69,27,640,98
2020,36047020200,"Census Tract 202, Kings County, New York",715,101,614,229,754,NA,1944,2010,1713,51,70,133,6,70,26,614,113
2012,36047020300,"Census Tract 203, Kings County, New York",821,90,731,521,1028,78938,1952,2005,1838,35.3,352,269,103,69,80,731,156
2013,36047020300,"Census Tract 203, Kings County, New York",801,85,716,501,1002,86641,1945,2007,2001,33,399,271,87,55,74,716,116
2014,36047020300,"Census Tract 203, Kings County, New York",759,105,654,472,985,97750,1943,2009,2001,30.6,359,260,85,46,85,654,102
2015,36047020300,"Census Tract 203, Kings County, New York",754,99,655,442,975,97778,1939,2011,2010,25.1,322,253,94,42,47,655,88
2016,36047020300,"Census Tract 203, Kings County, New York",747,80,667,439,953,96528,1939,2011,2021,28.8,299,215,126,50,47,667,81
2017,36047020300,"Census Tract 203, Kings County, New York",764,98,666,435,936,98472,1939,2012,2084,26,305,204,105,58,63,666,67
2018,36047020300,"Census Tract 203, Kings County, New York",791,112,679,437,959,87292,0,2012,2130,26.8,285,185,123,52,77,679,49
2019,36047020300,"Census Tract 203, Kings County, New York",818,131,687,432,929,106429,1946,2013,2302,23.9,319,196,94,50,81,687,45
2020,36047020300,"Census Tract 203, Kings County, New York",814,121,693,467,1105,128250,1940,2015,2622,24,390,243,63,65,70,693,48
2012,36047020400,"Census Tract 204, Kings County, New York",639,64,575,134,341,53542,1939,2003,1185,26.4,53,130,0,4,0,575,62
2013,36047020400,"Census Tract 204, Kings County, New York",654,67,587,153,365,55417,1939,2004,1176,20.3,68,149,0,4,0,587,48
2014,36047020400,"Census Tract 204, Kings County, New York",676,51,625,169,384,51917,1939,2003,1185,23.3,74,160,0,9,0,625,60
2015,36047020400,"Census Tract 204, Kings County, New York",667,44,623,151,443,51065,1957,2007,1539,19.6,44,107,0,44,0,623,55
2016,36047020400,"Census Tract 204, Kings County, New York",695,37,658,173,506,51958,1956,2008,1629,40.2,45,134,0,39,0,658,64
2017,36047020400,"Census Tract 204, Kings County, New York",690,23,667,167,439,65221,1958,2011,1617,23.1,39,123,0,38,6,667,61
2018,36047020400,"Census Tract 204, Kings County, New York",704,6,698,164,459,67000,1945,2012,1792,28.3,24,112,0,46,6,698,85
2019,36047020400,"Census Tract 204, Kings County, New York",662,6,656,158,415,68684,1951,2013,1873,26.1,35,114,0,32,12,656,75
2020,36047020400,"Census Tract 204, Kings County, New York",687,15,672,134,304,107917,1959,2015,1987,24.9,55,118,0,5,11,672,70
2012,36047020500,"Census Tract 205, Kings County, New York",1432,119,1313,988,1834,72981,1939,2005,1690,27.7,702,515,300,29,122,1313,80
2013,36047020500,"Census Tract 205, Kings County, New York",1418,118,1300,899,1726,74044,1939,2007,1822,28.4,631,495,192,72,121,1300,91
2014,36047020500,"Census Tract 205, Kings County, New York",1472,157,1315,931,1780,74338,1939,2011,1848,28.2,683,545,245,45,56,1315,91
2015,36047020500,"Census Tract 205, Kings County, New York",1484,162,1322,930,1856,71375,1939,2010,1872,27.3,644,495,258,67,55,1322,61
2016,36047020500,"Census Tract 205, Kings County, New York",1480,165,1315,927,1806,70461,1939,2011,1988,28.3,646,517,235,62,69,1315,57
2017,36047020500,"Census Tract 205, Kings County, New York",1506,147,1359,901,1797,75843,1939,2011,1986,27.9,626,541,227,41,39,1359,81
2018,36047020500,"Census Tract 205, Kings County, New York",1528,132,1396,925,1818,85884,0,2012,2059,24.9,684,537,210,93,26,1396,105
2019,36047020500,"Census Tract 205, Kings County, New York",1526,111,1415,958,2031,112917,0,2014,2262,24.4,730,575,162,142,45,1415,95
2020,36047020500,"Census Tract 205, Kings County, New York",1514,76,1438,910,1780,114706,0,2016,2390,26.2,720,473,153,205,52,1438,105
2012,36047020600,"Census Tract 206, Kings County, New York",869,56,813,341,924,58472,1939,2003,1346,28.4,98,223,7,94,17,813,59
2013,36047020600,"Census Tract 206, Kings County, New York",871,62,809,325,809,57981,1939,2002,1293,28.9,85,224,11,72,18,809,64
2014,36047020600,"Census Tract 206, Kings County, New York",891,52,839,362,896,49883,1939,2002,1299,28,101,239,8,83,32,839,65
2015,36047020600,"Census Tract 206, Kings County, New York",914,69,845,330,846,63365,1939,2006,1329,23.8,121,231,12,42,45,845,80
2016,36047020600,"Census Tract 206, Kings County, New York",905,68,837,373,1069,62702,1939,2007,1378,24.5,124,231,10,62,70,837,84
2017,36047020600,"Census Tract 206, Kings County, New York",904,76,828,346,915,56023,1939,2008,1290,24.9,127,185,6,41,114,828,72
2018,36047020600,"Census Tract 206, Kings County, New York",925,71,854,328,852,59375,0,2010,1392,24,131,153,0,40,135,854,65
2019,36047020600,"Census Tract 206, Kings County, New York",910,79,831,316,803,100703,0,2012,1484,23.1,150,138,0,46,127,831,73
2020,36047020600,"Census Tract 206, Kings County, New York",871,47,824,290,862,92500,0,2013,1574,24.3,97,89,0,66,129,824,72
2012,36047020700,"Census Tract 207, Kings County, New York",2298,200,2098,1268,2706,82375,1939,2003,1561,23.7,865,745,314,83,154,2098,138
2013,36047020700,"Census Tract 207, Kings County, New York",2275,180,2095,1320,2730,90809,1939,2004,1680,24,891,763,335,80,188,2095,96
2014,36047020700,"Census Tract 207, Kings County, New York",2244,156,2088,1326,2688,91852,1939,2004,1735,23.7,904,727,379,76,196,2088,94
2015,36047020700,"Census Tract 207, Kings County, New York",2231,151,2080,1363,2909,87123,1939,2006,1651,25.9,833,658,493,61,270,2080,98
2016,36047020700,"Census Tract 207, Kings County, New York",2211,94,2117,1321,2474,85521,1939,2009,1789,26.4,836,749,393,19,274,2117,126
2017,36047020700,"Census Tract 207, Kings County, New York",2231,52,2179,1294,2426,89891,1939,2011,1845,23.8,885,763,375,0,204,2179,123
2018,36047020700,"Census Tract 207, Kings County, New York",2175,50,2125,1271,2323,92457,0,2012,1881,24.4,854,731,382,14,188,2125,116
2019,36047020700,"Census Tract 207, Kings County, New York",2308,53,2255,1341,2422,97558,0,2013,2041,24.1,950,749,396,26,244,2255,78
2020,36047020700,"Census Tract 207, Kings County, New York",2444,152,2292,1281,2101,99035,0,2013,2180,21.8,1031,728,318,77,155,2292,124
2012,36047020800,"Census Tract 208, Kings County, New York",1103,117,986,617,1595,47147,1939,2004,1193,36.3,144,373,7,165,80,986,105
2013,36047020800,"Census Tract 208, Kings County, New York",1121,114,1007,601,1604,50404,1939,2005,1247,36.5,198,337,8,170,93,1007,108
2014,36047020800,"Census Tract 208, Kings County, New York",1136,120,1016,631,1816,46760,1939,2006,1254,37.3,182,314,17,239,65,1016,190
2015,36047020800,"Census Tract 208, Kings County, New York",1145,112,1033,634,1790,50556,1939,2007,1235,35.8,217,268,18,228,81,1033,195
2016,36047020800,"Census Tract 208, Kings County, New York",1082,86,996,563,1438,40188,1939,2008,1183,37.2,173,261,20,196,46,996,227
2017,36047020800,"Census Tract 208, Kings County, New York",1032,55,977,487,1319,41193,1939,2010,1176,41.9,138,202,12,152,66,977,215
2018,36047020800,"Census Tract 208, Kings County, New York",1047,30,1017,583,1580,NA,0,2012,1236,42.5,140,175,26,224,40,1017,154
2019,36047020800,"Census Tract 208, Kings County, New York",998,41,957,562,1582,43036,0,2012,1351,41.1,157,184,13,213,37,957,89
2020,36047020800,"Census Tract 208, Kings County, New York",1130,89,1041,607,1605,52098,0,2015,1427,32.3,209,270,10,225,29,1041,76
2012,36047021000,"Census Tract 210, Kings County, New York",1469,41,1428,836,2648,46250,1939,2004,1155,33.7,207,406,0,316,110,1428,266
2013,36047021000,"Census Tract 210, Kings County, New York",1506,45,1461,892,2885,44100,1939,2004,1179,34.3,211,358,0,397,126,1461,267
2014,36047021000,"Census Tract 210, Kings County, New York",1523,39,1484,971,3312,40337,1939,2006,1237,37.5,210,371,19,397,156,1484,352
2015,36047021000,"Census Tract 210, Kings County, New York",1527,69,1458,956,3164,35776,1939,2007,1205,40.6,177,401,20,354,154,1458,367
2016,36047021000,"Census Tract 210, Kings County, New York",1524,115,1409,1028,3220,33750,1939,2008,1294,42.2,173,451,22,333,201,1409,342
2017,36047021000,"Census Tract 210, Kings County, New York",1468,77,1391,977,3090,31582,1939,2009,1314,45.2,186,385,24,317,234,1391,352
2018,36047021000,"Census Tract 210, Kings County, New York",1435,99,1336,932,2796,35952,0,2010,1376,42.6,199,379,22,282,235,1336,351
2019,36047021000,"Census Tract 210, Kings County, New York",1392,99,1293,859,2604,39281,1942,2012,1408,38.3,234,329,14,322,176,1293,278
2020,36047021000,"Census Tract 210, Kings County, New York",1355,36,1319,859,2436,37699,1943,2012,1402,44.1,196,376,21,316,126,1319,350
2012,36047021100,"Census Tract 211, Kings County, New York",580,84,496,401,1014,42292,1939,2002,1186,33.6,60,65,191,0,178,496,59
2013,36047021100,"Census Tract 211, Kings County, New York",565,86,479,385,897,44792,1941,2004,1030,30.8,126,78,217,0,105,479,60
2014,36047021100,"Census Tract 211, Kings County, New York",682,133,549,460,1041,44750,1941,2009,1292,31.3,161,82,267,5,137,549,69
2015,36047021100,"Census Tract 211, Kings County, New York",708,94,614,509,1076,NA,1948,2009,1226,31.4,188,105,251,12,170,614,100
2016,36047021100,"Census Tract 211, Kings County, New York",769,93,676,544,1178,41000,1951,2010,1223,33.5,202,124,253,9,179,676,117
2017,36047021100,"Census Tract 211, Kings County, New York",827,92,735,582,1333,52333,1955,2011,1247,29.1,238,166,248,9,183,735,90
2018,36047021100,"Census Tract 211, Kings County, New York",877,88,789,636,1409,51818,1953,2012,1253,28.8,237,182,253,13,227,789,118
2019,36047021100,"Census Tract 211, Kings County, New York",1072,76,996,786,1628,39608,1972,2012,1069,28.7,245,175,380,22,237,996,236
2020,36047021100,"Census Tract 211, Kings County, New York",1346,126,1220,932,1919,57692,1953,2013,1390,27.9,374,252,451,29,209,1220,182
2012,36047021200,"Census Tract 212, Kings County, New York",1549,176,1373,1053,3457,33689,1939,2004,1127,35.1,291,351,19,590,90,1373,309
2013,36047021200,"Census Tract 212, Kings County, New York",1560,132,1428,1092,3889,29757,1939,2005,1134,45.6,211,348,21,624,99,1428,427
2014,36047021200,"Census Tract 212, Kings County, New York",1565,135,1430,1119,3962,30880,1939,2005,1131,44.9,222,444,22,613,50,1430,369
2015,36047021200,"Census Tract 212, Kings County, New York",1579,120,1459,1099,3842,30444,1939,2007,1173,50,191,393,20,594,89,1459,395
2016,36047021200,"Census Tract 212, Kings County, New York",1587,141,1446,1057,3858,35797,1939,2007,1270,50,145,355,21,578,104,1446,357
2017,36047021200,"Census Tract 212, Kings County, New York",1556,129,1427,1045,3566,39126,1939,2010,1304,50,132,412,0,468,144,1427,347
2018,36047021200,"Census Tract 212, Kings County, New York",1493,124,1369,926,2998,37700,0,2011,1356,51,129,311,0,413,187,1369,255
2019,36047021200,"Census Tract 212, Kings County, New York",1462,145,1317,849,2665,37648,1951,2012,1399,45,161,250,0,365,214,1317,243
2020,36047021200,"Census Tract 212, Kings County, New York",1504,150,1354,962,2727,35459,1951,2013,1405,44.4,199,290,0,454,209,1354,258
2012,36047021300,"Census Tract 213, Kings County, New York",1971,149,1822,1746,4170,46604,1939,2000,1052,26.9,479,269,1337,36,144,1822,366
2013,36047021300,"Census Tract 213, Kings County, New York",1962,75,1887,1837,4216,41373,1939,2001,1094,29.4,536,344,1397,26,149,1887,449
2014,36047021300,"Census Tract 213, Kings County, New York",1973,53,1920,1875,4172,42132,1939,2002,1156,31.4,598,421,1383,22,69,1920,410
2015,36047021300,"Census Tract 213, Kings County, New York",2001,72,1929,1918,4206,38480,1939,2003,1188,35.5,614,423,1427,0,114,1929,463
2016,36047021300,"Census Tract 213, Kings County, New York",2020,65,1955,1938,4136,40783,1939,2004,1290,34.8,742,417,1457,0,102,1955,415
2017,36047021300,"Census Tract 213, Kings County, New York",2016,67,1949,1922,4104,41953,1939,2006,1302,34.8,750,461,1381,0,115,1949,425
2018,36047021300,"Census Tract 213, Kings County, New York",2017,61,1956,1920,4137,51974,0,2009,1378,31.6,770,463,1321,0,134,1956,368
2019,36047021300,"Census Tract 213, Kings County, New York",2054,76,1978,1938,4073,52981,0,2009,1387,31.7,757,410,1388,0,155,1978,338
2020,36047021300,"Census Tract 213, Kings County, New York",1971,61,1910,1854,4105,72782,0,2010,1603,27,738,507,1202,0,168,1910,268
2012,36047021400,"Census Tract 214, Kings County, New York",645,61,584,413,1637,41761,1939,2004,1147,27.6,92,158,0,206,37,584,173
2013,36047021400,"Census Tract 214, Kings County, New York",639,58,581,424,1739,33750,1939,2005,1173,35.4,85,169,0,204,40,581,181
2014,36047021400,"Census Tract 214, Kings County, New York",630,36,594,428,1847,42500,1939,2006,1277,38.8,76,180,0,209,39,594,177
2015,36047021400,"Census Tract 214, Kings County, New York",623,48,575,413,1702,50583,1939,2006,1283,28.6,84,193,0,198,22,575,155
2016,36047021400,"Census Tract 214, Kings County, New York",603,51,552,389,1629,48819,1939,2007,1321,29.7,61,159,0,206,24,552,168
2017,36047021400,"Census Tract 214, Kings County, New York",597,63,534,357,1416,47614,1939,2007,1344,32.7,39,146,0,185,26,534,173
2018,36047021400,"Census Tract 214, Kings County, New York",576,56,520,296,1201,53636,1961,2008,1389,30.5,33,101,0,164,31,520,150
2019,36047021400,"Census Tract 214, Kings County, New York",578,54,524,317,1231,NA,1947,2007,1440,45.4,17,112,0,153,52,524,163
2020,36047021400,"Census Tract 214, Kings County, New York",556,42,514,325,1309,53250,1952,2015,1387,37.5,40,89,0,122,84,514,149
2012,36047021500,"Census Tract 215, Kings County, New York",2734,183,2551,1942,3772,50479,1939,2002,1239,28.7,1142,693,801,93,325,2551,399
2013,36047021500,"Census Tract 215, Kings County, New York",2721,215,2506,1834,3905,42181,1939,2001,1231,32,993,505,845,116,332,2506,353
2014,36047021500,"Census Tract 215, Kings County, New York",2716,246,2470,1816,3797,49205,1939,2003,1263,29.6,965,533,936,93,255,2470,243
2015,36047021500,"Census Tract 215, Kings County, New York",2703,314,2389,1723,3571,47364,1939,2006,1235,30.4,847,519,842,148,206,2389,251
2016,36047021500,"Census Tract 215, Kings County, New York",2739,298,2441,1726,3493,47542,1939,2006,1307,30.4,863,494,870,171,157,2441,390
2017,36047021500,"Census Tract 215, Kings County, New York",2734,282,2452,1744,3715,46265,1939,2005,1321,29.9,873,493,892,132,181,2452,382
2018,36047021500,"Census Tract 215, Kings County, New York",2696,243,2453,1726,3632,63625,0,2008,1580,27,908,599,792,122,153,2453,428
2019,36047021500,"Census Tract 215, Kings County, New York",2695,204,2491,1689,3355,53110,0,2010,1570,35.3,937,663,753,133,76,2491,423
2020,36047021500,"Census Tract 215, Kings County, New York",2880,272,2608,1772,3517,71402,0,2009,1468,28.1,1066,683,693,116,98,2608,398
2012,36047021600,"Census Tract 216, Kings County, New York",1094,89,1005,674,2922,31900,1939,2004,1259,44.1,150,440,0,194,40,1005,270
2013,36047021600,"Census Tract 216, Kings County, New York",1096,49,1047,720,3028,34435,1939,2004,1318,46.4,157,474,0,176,70,1047,294
2014,36047021600,"Census Tract 216, Kings County, New York",1108,50,1058,757,3412,32660,1939,2004,1342,50,167,546,0,141,70,1058,334
2015,36047021600,"Census Tract 216, Kings County, New York",1072,0,1072,744,3181,31679,1939,2003,1332,47,179,513,0,127,104,1072,333
2016,36047021600,"Census Tract 216, Kings County, New York",1023,14,1009,689,3156,31250,1939,2003,1364,48.2,114,516,0,119,54,1009,307
2017,36047021600,"Census Tract 216, Kings County, New York",956,14,942,638,3064,36635,1939,2003,1390,40.2,94,489,0,97,52,942,212
2018,36047021600,"Census Tract 216, Kings County, New York",897,38,859,568,3097,37581,0,2004,1446,47.2,95,421,0,103,44,859,232
2019,36047021600,"Census Tract 216, Kings County, New York",898,62,836,569,2561,36134,1943,2007,1647,43.7,71,340,0,89,140,836,205
2020,36047021600,"Census Tract 216, Kings County, New York",923,75,848,661,2858,33781,0,2008,1557,44.9,145,404,0,110,147,848,283
2012,36047021700,"Census Tract 217, Kings County, New York",1687,132,1555,1404,3167,34615,1939,2000,947,29.5,552,287,852,79,137,1555,280
2013,36047021700,"Census Tract 217, Kings County, New York",1690,187,1503,1386,2954,43514,1939,2001,993,29.6,685,362,780,85,109,1503,254
2014,36047021700,"Census Tract 217, Kings County, New York",1712,190,1522,1385,3253,54330,1939,2004,1129,29,753,400,734,83,136,1522,264
2015,36047021700,"Census Tract 217, Kings County, New York",1745,167,1578,1452,3602,53007,1939,2006,1118,28.2,762,360,735,122,218,1578,285
2016,36047021700,"Census Tract 217, Kings County, New York",1819,171,1648,1511,3551,54301,1939,2008,1185,27.7,824,334,778,132,240,1648,333
2017,36047021700,"Census Tract 217, Kings County, New York",1787,112,1675,1529,3659,55495,1939,2008,1196,25.6,764,341,774,125,297,1675,334
2018,36047021700,"Census Tract 217, Kings County, New York",1791,99,1692,1477,3505,62813,0,2008,1199,23.8,671,345,771,114,280,1692,391
2019,36047021700,"Census Tract 217, Kings County, New York",1802,118,1684,1449,3217,59781,0,2008,1176,23.1,661,335,765,122,268,1684,392
2020,36047021700,"Census Tract 217, Kings County, New York",1865,140,1725,1410,2679,60517,0,2004,1243,25.8,681,377,829,75,126,1725,358
2012,36047021800,"Census Tract 218, Kings County, New York",1062,43,1019,756,3347,30643,1939,2002,1272,46.4,171,586,0,85,85,1019,401
2013,36047021800,"Census Tract 218, Kings County, New York",1105,33,1072,791,3529,30362,1939,2003,1287,47.7,155,591,0,80,120,1072,447
2014,36047021800,"Census Tract 218, Kings County, New York",1060,54,1006,682,3008,24722,1939,2004,1326,50,75,515,0,69,98,1006,437
2015,36047021800,"Census Tract 218, Kings County, New York",1025,28,997,609,2669,19965,1939,2004,1376,50,110,448,0,63,98,997,399
2016,36047021800,"Census Tract 218, Kings County, New York",1003,27,976,600,2662,19702,1939,2006,1434,50,72,427,0,61,112,976,428
2017,36047021800,"Census Tract 218, Kings County, New York",1002,67,935,510,2087,16231,1939,2006,1467,50,45,432,0,10,68,935,375
2018,36047021800,"Census Tract 218, Kings County, New York",977,125,852,504,2024,17094,0,2005,1539,51,50,458,0,10,36,852,350
2019,36047021800,"Census Tract 218, Kings County, New York",991,127,864,490,1757,19345,0,2000,1448,51,70,446,0,19,25,864,270
2020,36047021800,"Census Tract 218, Kings County, New York",993,181,812,516,1704,29625,1940,2005,1478,51,50,401,0,29,58,812,153
2012,36047021900,"Census Tract 219, Kings County, New York",1723,139,1584,1361,3228,35379,1939,2003,1156,32.8,472,311,900,88,127,1584,433
2013,36047021900,"Census Tract 219, Kings County, New York",1691,181,1510,1280,2986,37674,1939,2005,1184,33.2,495,305,781,92,137,1510,369
2014,36047021900,"Census Tract 219, Kings County, New York",1673,213,1460,1249,3194,42575,1939,2005,1204,32.9,470,328,733,69,133,1460,355
2015,36047021900,"Census Tract 219, Kings County, New York",1679,255,1424,1190,2884,50063,1939,2007,1302,29.5,519,362,642,91,96,1424,308
2016,36047021900,"Census Tract 219, Kings County, New York",1715,267,1448,1207,2842,56108,1939,2008,1340,29.5,567,348,646,98,111,1448,236
2017,36047021900,"Census Tract 219, Kings County, New York",1745,219,1526,1298,2869,57368,1939,2010,1314,28.2,608,396,667,108,136,1526,251
2018,36047021900,"Census Tract 219, Kings County, New York",1772,231,1541,1314,2876,63771,0,2011,1428,27.2,657,424,663,132,119,1541,264
2019,36047021900,"Census Tract 219, Kings County, New York",1819,246,1573,1332,2848,78148,0,2012,1661,26.3,720,496,613,141,100,1573,190
2020,36047021900,"Census Tract 219, Kings County, New York",1806,195,1611,1304,2669,90000,0,2015,1752,24.6,773,515,532,145,127,1611,194
2012,36047022000,"Census Tract 220, Kings County, New York",1451,172,1279,1001,3256,26534,1939,2004,1256,50,183,763,0,92,146,1279,428
2013,36047022000,"Census Tract 220, Kings County, New York",1424,148,1276,921,3155,26938,1939,2004,1222,49.3,141,757,0,61,103,1276,438
2014,36047022000,"Census Tract 220, Kings County, New York",1421,145,1276,854,3284,24527,1939,2004,1393,50,138,671,0,69,114,1276,448
2015,36047022000,"Census Tract 220, Kings County, New York",1390,175,1215,845,3051,28157,1939,2005,1489,48.4,107,631,0,72,142,1215,408
2016,36047022000,"Census Tract 220, Kings County, New York",1370,92,1278,903,3385,29979,1939,2005,1557,47.9,146,746,29,36,92,1278,432
2017,36047022000,"Census Tract 220, Kings County, New York",1362,67,1295,891,3622,23750,1941,2003,1680,50,164,785,32,27,47,1295,471
2018,36047022000,"Census Tract 220, Kings County, New York",1330,163,1167,769,3268,23114,1950,2006,1702,51,138,646,25,43,55,1167,472
2019,36047022000,"Census Tract 220, Kings County, New York",1307,119,1188,863,3867,30361,1943,2009,1584,51,207,661,55,57,51,1188,518
2020,36047022000,"Census Tract 220, Kings County, New York",1436,103,1333,1055,4124,33909,1950,2009,1470,39.4,189,734,52,34,207,1333,508
2012,36047022100,"Census Tract 221, Kings County, New York",1714,185,1529,1178,2652,40260,1939,2004,1195,34.2,517,345,636,9,203,1529,285
2013,36047022100,"Census Tract 221, Kings County, New York",1715,99,1616,1214,2574,42188,1939,2005,1258,33.1,562,383,648,9,186,1616,331
2014,36047022100,"Census Tract 221, Kings County, New York",1737,69,1668,1336,2910,36923,1939,2006,1194,31.5,570,437,714,18,205,1668,342
2015,36047022100,"Census Tract 221, Kings County, New York",1727,113,1614,1340,2844,35679,1939,2009,1193,31.9,623,435,740,29,180,1614,367
2016,36047022100,"Census Tract 221, Kings County, New York",1745,120,1625,1369,2780,36706,1939,2009,1188,32.8,584,382,775,27,176,1625,389
2017,36047022100,"Census Tract 221, Kings County, New York",1740,99,1641,1395,2984,47813,1939,2010,1282,31.3,649,409,761,30,153,1641,327
2018,36047022100,"Census Tract 221, Kings County, New York",1779,152,1627,1432,2995,45417,0,2010,1311,30.6,679,408,781,58,178,1627,283
2019,36047022100,"Census Tract 221, Kings County, New York",1794,210,1584,1363,2852,50216,0,2010,1412,31.8,692,463,690,48,156,1584,352
2020,36047022100,"Census Tract 221, Kings County, New York",1738,194,1544,1173,2378,48109,0,2012,1480,34.3,597,421,560,27,139,1544,354
2012,36047022200,"Census Tract 222, Kings County, New York",1254,116,1138,893,3289,29523,1939,2003,1232,46.6,184,783,0,0,110,1138,341
2013,36047022200,"Census Tract 222, Kings County, New York",1235,134,1101,888,3532,27449,1939,2003,1211,50,189,735,11,0,153,1101,347
2014,36047022200,"Census Tract 222, Kings County, New York",1273,119,1154,988,3891,27719,1939,2004,1214,50,251,815,9,0,173,1154,382
2015,36047022200,"Census Tract 222, Kings County, New York",1273,146,1127,944,3789,27571,1939,2005,1263,50,204,813,10,0,131,1127,372
2016,36047022200,"Census Tract 222, Kings County, New York",1199,91,1108,910,3441,24879,1939,2006,1324,50,180,787,11,3,120,1108,372
2017,36047022200,"Census Tract 222, Kings County, New York",1188,66,1122,823,3157,25967,1939,2005,1354,50,155,740,12,5,78,1122,385
2018,36047022200,"Census Tract 222, Kings County, New York",1208,130,1078,800,2915,23875,0,2005,1371,51,165,753,0,2,45,1078,351
2019,36047022200,"Census Tract 222, Kings County, New York",1181,155,1026,763,2953,21745,1943,2004,1383,51,115,703,0,1,59,1026,386
2020,36047022200,"Census Tract 222, Kings County, New York",1169,150,1019,796,3143,22988,1945,2006,1371,51,86,662,0,8,126,1019,455
2012,36047022400,"Census Tract 224, Kings County, New York",1441,142,1299,994,3916,31000,1939,2003,1223,50,113,605,29,114,264,1299,366
2013,36047022400,"Census Tract 224, Kings County, New York",1460,137,1323,1049,4385,34405,1939,2003,1374,46.8,135,623,32,106,309,1323,443
2014,36047022400,"Census Tract 224, Kings County, New York",1483,125,1358,1070,4639,35045,1939,2004,1402,45.6,124,657,19,108,305,1358,454
2015,36047022400,"Census Tract 224, Kings County, New York",1457,166,1291,1004,4785,35637,1939,2005,1519,47.5,132,623,22,112,269,1291,482
2016,36047022400,"Census Tract 224, Kings County, New York",1450,108,1342,1045,4826,38512,1939,2005,1483,45.7,175,650,26,176,219,1342,510
2017,36047022400,"Census Tract 224, Kings County, New York",1413,148,1265,1007,4844,37875,1939,2007,1542,44.5,209,633,0,173,201,1265,526
2018,36047022400,"Census Tract 224, Kings County, New York",1422,146,1276,1029,4734,45671,0,2009,1493,38.6,266,603,0,227,199,1276,386
2019,36047022400,"Census Tract 224, Kings County, New York",1393,54,1339,1069,4580,45417,0,2007,1460,38.8,324,697,0,219,158,1339,308
2020,36047022400,"Census Tract 224, Kings County, New York",1408,98,1310,901,3431,39554,1945,2009,1382,38.9,223,603,0,113,195,1310,221
2012,36047022600,"Census Tract 226, Kings County, New York",702,57,645,465,1959,44776,1939,2004,1230,30.6,46,85,0,29,341,645,84
2013,36047022600,"Census Tract 226, Kings County, New York",689,59,630,438,1855,36927,1939,2004,1338,35.7,29,54,0,34,339,630,92
2014,36047022600,"Census Tract 226, Kings County, New York",650,65,585,375,1724,39375,1939,2004,1341,42.4,45,51,0,61,250,585,106
2015,36047022600,"Census Tract 226, Kings County, New York",637,71,566,431,2084,42991,1939,2005,1313,39.4,58,74,0,33,297,566,121
2016,36047022600,"Census Tract 226, Kings County, New York",623,58,565,461,2068,39226,1939,2008,1311,41.6,52,87,0,24,336,565,138
2017,36047022600,"Census Tract 226, Kings County, New York",616,37,579,464,1992,45806,1939,2010,1418,43.7,77,148,0,34,271,579,115
2018,36047022600,"Census Tract 226, Kings County, New York",600,57,543,434,1673,44107,0,2011,1432,46.7,79,143,0,43,241,543,110
2019,36047022600,"Census Tract 226, Kings County, New York",610,17,593,473,1802,NA,0,2012,1449,45,87,149,0,31,282,593,133
2020,36047022600,"Census Tract 226, Kings County, New York",584,41,543,356,1327,29492,0,2012,1536,44.9,46,110,0,11,223,543,72
2012,36047022700,"Census Tract 227, Kings County, New York",1669,302,1367,1033,2293,40219,1939,2003,1108,31.9,395,269,609,30,144,1367,339
2013,36047022700,"Census Tract 227, Kings County, New York",1627,316,1311,1006,2361,43427,1939,2004,1256,27.3,374,259,588,58,121,1311,297
2014,36047022700,"Census Tract 227, Kings County, New York",1633,305,1328,1059,2565,44384,1939,2004,1321,29,384,305,616,52,118,1328,268
2015,36047022700,"Census Tract 227, Kings County, New York",1670,243,1427,1122,2728,46814,1939,2006,1345,28.9,412,365,601,49,132,1427,230
2016,36047022700,"Census Tract 227, Kings County, New York",1787,276,1511,1184,2807,56321,1939,2007,1438,27,525,427,638,67,65,1511,190
2017,36047022700,"Census Tract 227, Kings County, New York",1808,315,1493,1219,2761,62379,1939,2010,1504,27.4,540,463,576,80,95,1493,219
2018,36047022700,"Census Tract 227, Kings County, New York",1981,336,1645,1261,2552,66146,0,2011,1701,28.6,572,489,605,51,108,1645,178
2019,36047022700,"Census Tract 227, Kings County, New York",2093,381,1712,1241,2380,83661,1950,2014,1875,24.9,672,540,478,77,112,1712,198
2020,36047022700,"Census Tract 227, Kings County, New York",2074,372,1702,1211,2347,87480,1956,2015,2009,23.5,698,516,441,102,133,1702,164
2012,36047022800,"Census Tract 228, Kings County, New York",895,150,745,546,2483,31282,1939,2002,1276,36.7,96,227,9,152,154,745,175
2013,36047022800,"Census Tract 228, Kings County, New York",896,141,755,547,2580,31458,1939,2001,1322,39.3,93,181,6,155,201,755,187
2014,36047022800,"Census Tract 228, Kings County, New York",927,142,785,535,2341,23672,1939,2002,1370,50,83,212,12,113,187,785,238
2015,36047022800,"Census Tract 228, Kings County, New York",918,114,804,570,2215,22311,1939,2003,1300,50,89,255,8,126,166,804,279
2016,36047022800,"Census Tract 228, Kings County, New York",919,120,799,536,1970,24231,1939,2004,1328,50,103,269,11,116,125,799,284
2017,36047022800,"Census Tract 228, Kings County, New York",934,74,860,553,2138,26821,1939,2004,1342,50,106,256,21,128,133,860,286
2018,36047022800,"Census Tract 228, Kings County, New York",932,87,845,562,2103,25637,0,2006,1326,48.3,110,294,24,122,107,845,328
2019,36047022800,"Census Tract 228, Kings County, New York",933,71,862,585,2188,30162,0,2007,1305,42.4,127,306,52,112,97,862,308
2020,36047022800,"Census Tract 228, Kings County, New York",904,45,859,545,2220,30154,0,2010,1259,43.2,147,285,27,151,61,859,250
2012,36047022900,"Census Tract 229, Kings County, New York",1791,297,1494,1117,2418,47713,1939,2005,1345,29.8,506,295,587,59,172,1494,228
2013,36047022900,"Census Tract 229, Kings County, New York",1800,248,1552,1113,2293,51701,1939,2005,1367,29.2,576,343,572,54,140,1552,192
2014,36047022900,"Census Tract 229, Kings County, New York",1854,226,1628,1186,2457,47440,1939,2007,1387,29,605,383,608,70,118,1628,217
2015,36047022900,"Census Tract 229, Kings County, New York",1851,177,1674,1305,2763,45505,1939,2010,1505,29.8,706,418,669,90,102,1674,325
2016,36047022900,"Census Tract 229, Kings County, New York",1914,179,1735,1359,2805,49095,1939,2011,1629,32.1,779,429,696,87,104,1735,304
2017,36047022900,"Census Tract 229, Kings County, New York",1967,158,1809,1437,2877,59209,1939,2011,1792,31.5,928,550,671,58,125,1809,292
2018,36047022900,"Census Tract 229, Kings County, New York",1944,174,1770,1377,2699,62225,0,2012,2073,30.9,913,546,609,60,126,1770,291
2019,36047022900,"Census Tract 229, Kings County, New York",1881,157,1724,1256,2433,69423,0,2013,2114,30.3,919,594,457,49,118,1724,277
2020,36047022900,"Census Tract 229, Kings County, New York",1895,151,1744,1279,2578,86218,0,2015,2245,31.2,919,611,349,35,106,1744,318
2012,36047023000,"Census Tract 230, Kings County, New York",1154,134,1020,804,3172,23692,1939,2002,1133,50,73,481,14,44,265,1020,407
2013,36047023000,"Census Tract 230, Kings County, New York",1081,91,990,812,3296,24441,1939,2003,1268,50,66,507,8,41,256,990,388
2014,36047023000,"Census Tract 230, Kings County, New York",1068,77,991,776,3330,28854,1939,2006,1428,50,85,506,9,57,195,991,357
2015,36047023000,"Census Tract 230, Kings County, New York",1035,85,950,748,3145,30349,1939,2005,1198,50,109,478,9,48,204,950,324
2016,36047023000,"Census Tract 230, Kings County, New York",1031,71,960,746,3292,33438,1939,2007,1327,50,126,503,9,44,173,960,330
2017,36047023000,"Census Tract 230, Kings County, New York",1001,52,949,740,3322,35455,1939,2007,1400,50,152,505,0,54,164,949,294
2018,36047023000,"Census Tract 230, Kings County, New York",994,59,935,701,3099,35764,0,2009,1313,35,136,513,16,65,86,935,300
2019,36047023000,"Census Tract 230, Kings County, New York",1009,80,929,694,3059,35500,0,2008,1314,35.6,129,528,24,23,110,929,245
2020,36047023000,"Census Tract 230, Kings County, New York",993,61,932,646,3290,29575,0,2012,1398,51,131,459,25,61,93,932,282
2012,36047023100,"Census Tract 231, Kings County, New York",1633,152,1481,1044,2426,59286,1939,2006,1208,29.9,668,418,439,75,15,1481,321
2013,36047023100,"Census Tract 231, Kings County, New York",1651,228,1423,1029,2322,60493,1939,2009,1327,30.7,645,487,344,36,26,1423,305
2014,36047023100,"Census Tract 231, Kings County, New York",1651,193,1458,1133,2520,60650,1939,2010,1470,30.2,691,487,405,80,51,1458,335
2015,36047023100,"Census Tract 231, Kings County, New York",1654,167,1487,1096,2309,61442,1939,2011,1599,28.9,711,498,350,73,60,1487,320
2016,36047023100,"Census Tract 231, Kings County, New York",1639,142,1497,1039,2167,58342,1939,2011,1510,28.3,608,442,375,51,99,1497,305
2017,36047023100,"Census Tract 231, Kings County, New York",1664,163,1501,1007,1879,62465,1939,2011,1576,27.4,618,485,361,39,107,1501,197
2018,36047023100,"Census Tract 231, Kings County, New York",1711,111,1600,1079,2093,66420,0,2010,1589,27.3,646,523,402,42,132,1600,252
2019,36047023100,"Census Tract 231, Kings County, New York",1704,90,1614,1056,2043,79091,0,2011,1615,25.3,604,577,381,0,106,1614,190
2020,36047023100,"Census Tract 231, Kings County, New York",1768,123,1645,1091,2133,94154,0,2014,1573,24,557,564,373,11,166,1645,154
2012,36047023200,"Census Tract 232, Kings County, New York",1684,110,1574,1136,5029,21469,1939,2003,1117,50,141,908,9,140,88,1574,698
2013,36047023200,"Census Tract 232, Kings County, New York",1645,132,1513,1134,4839,21563,1939,2003,1080,50,128,861,7,143,130,1513,692
2014,36047023200,"Census Tract 232, Kings County, New York",1605,150,1455,1055,4601,23054,1939,2003,1081,48.2,99,807,6,93,155,1455,611
2015,36047023200,"Census Tract 232, Kings County, New York",1547,176,1371,966,4070,23538,1939,2003,1134,50,94,712,6,61,193,1371,554
2016,36047023200,"Census Tract 232, Kings County, New York",1509,142,1367,926,3876,23750,1939,2004,1138,48.5,101,679,23,62,185,1367,538
2017,36047023200,"Census Tract 232, Kings County, New York",1464,197,1267,870,3474,24375,1944,2004,1185,50,114,542,30,113,215,1267,497
2018,36047023200,"Census Tract 232, Kings County, New York",1368,167,1201,811,3862,34612,1950,2005,1452,51,104,500,31,100,211,1201,486
2019,36047023200,"Census Tract 232, Kings County, New York",1394,170,1224,864,3884,28864,1955,2007,1531,51,111,563,33,93,190,1224,527
2020,36047023200,"Census Tract 232, Kings County, New York",1442,290,1152,850,4316,36293,1961,2007,1540,51,133,583,41,109,140,1152,454
2012,36047023300,"Census Tract 233, Kings County, New York",2010,178,1832,1569,3846,35254,1943,2002,771,26.6,489,237,1038,101,225,1832,447
2013,36047023300,"Census Tract 233, Kings County, New York",2013,174,1839,1592,4300,32025,1946,2001,790,29.1,484,202,965,137,303,1839,542
2014,36047023300,"Census Tract 233, Kings County, New York",2068,229,1839,1597,4026,33407,1956,2003,830,28.7,484,231,901,139,299,1839,434
2015,36047023300,"Census Tract 233, Kings County, New York",2141,237,1904,1664,4180,30233,1957,2002,798,29.4,507,294,952,93,326,1904,519
2016,36047023300,"Census Tract 233, Kings County, New York",2206,209,1997,1687,4090,30613,1961,2003,834,29.4,540,351,957,80,362,1997,502
2017,36047023300,"Census Tract 233, Kings County, New York",2235,177,2058,1688,4211,30430,1962,2005,842,30.4,441,337,976,102,364,2058,554
2018,36047023300,"Census Tract 233, Kings County, New York",2247,141,2106,1650,4215,36310,1963,2007,1105,31.1,493,385,933,92,277,2106,528
2019,36047023300,"Census Tract 233, Kings County, New York",2261,40,2221,1717,4679,48359,1963,2010,1308,30.4,532,452,962,128,244,2221,587
2020,36047023300,"Census Tract 233, Kings County, New York",2194,75,2119,1630,4762,47639,1965,2011,1506,30.7,601,566,798,113,237,2119,536
2012,36047023400,"Census Tract 234, Kings County, New York",1521,80,1441,1161,4116,28368,1939,2002,1215,50,181,1118,0,0,43,1441,500
2013,36047023400,"Census Tract 234, Kings County, New York",1495,92,1403,1148,4346,22377,1939,2003,1312,50,131,1121,0,0,18,1403,544
2014,36047023400,"Census Tract 234, Kings County, New York",1479,58,1421,1182,4641,22937,1939,2004,1312,50,111,1165,0,0,8,1421,605
2015,36047023400,"Census Tract 234, Kings County, New York",1477,94,1383,1136,4424,23491,1945,2004,1314,50,135,1098,0,0,33,1383,631
2016,36047023400,"Census Tract 234, Kings County, New York",1456,132,1324,1111,4413,25114,1949,2007,1394,50,162,1079,0,0,23,1324,552
2017,36047023400,"Census Tract 234, Kings County, New York",1466,235,1231,1008,4115,26438,1947,2008,1411,50,124,966,0,0,39,1231,526
2018,36047023400,"Census Tract 234, Kings County, New York",1460,252,1208,1030,4163,28793,1945,2009,1553,51,149,978,0,0,52,1208,539
2019,36047023400,"Census Tract 234, Kings County, New York",1475,305,1170,1032,4214,32237,0,2010,1584,51,187,974,0,0,58,1170,479
2020,36047023400,"Census Tract 234, Kings County, New York",1508,266,1242,1132,4536,24777,0,2010,1581,51,216,1072,0,0,47,1242,523
2012,36047023500,"Census Tract 235, Kings County, New York",1230,108,1122,817,2620,32893,1949,2005,1252,34.3,264,272,197,16,344,1122,349
2013,36047023500,"Census Tract 235, Kings County, New York",1278,137,1141,841,2877,40273,1957,2006,1447,40.9,287,339,145,36,341,1141,411
2014,36047023500,"Census Tract 235, Kings County, New York",1347,140,1207,842,2750,28947,1957,2006,1301,41.6,279,329,164,59,313,1207,437
2015,36047023500,"Census Tract 235, Kings County, New York",1409,130,1279,978,3027,40318,1950,2008,1370,41.1,359,355,197,82,321,1279,468
2016,36047023500,"Census Tract 235, Kings County, New York",1420,141,1279,937,2890,29750,1951,2009,1344,50,337,342,182,87,303,1279,487
2017,36047023500,"Census Tract 235, Kings County, New York",1516,167,1349,991,2848,37478,1950,2011,1450,42.4,393,366,188,89,310,1349,407
2018,36047023500,"Census Tract 235, Kings County, New York",1550,131,1419,1034,2990,49792,1951,2011,1647,39.3,446,390,205,83,321,1419,367
2019,36047023500,"Census Tract 235, Kings County, New York",1632,139,1493,1131,3461,54886,1949,2013,1806,38.8,530,508,204,70,323,1493,329
2020,36047023500,"Census Tract 235, Kings County, New York",1565,134,1431,1131,4019,41319,1989,2015,2108,51,443,663,116,92,273,1431,468
2012,36047023600,"Census Tract 236, Kings County, New York",1741,133,1608,1350,4515,30021,1939,2001,1271,50,210,1254,0,64,32,1608,567
2013,36047023600,"Census Tract 236, Kings County, New York",1697,85,1612,1412,4480,23867,1939,2002,1330,50,283,1359,0,21,32,1612,650
2014,36047023600,"Census Tract 236, Kings County, New York",1730,105,1625,1411,4631,22988,1939,2002,1375,50,325,1334,8,43,26,1625,650
2015,36047023600,"Census Tract 236, Kings County, New York",1742,87,1655,1459,4939,21910,1939,2004,1363,50,333,1306,12,71,23,1655,734
2016,36047023600,"Census Tract 236, Kings County, New York",1684,99,1585,1439,4927,22208,1939,2005,1414,50,306,1308,13,70,0,1585,759
2017,36047023600,"Census Tract 236, Kings County, New York",1669,131,1538,1402,5023,20843,1939,2005,1431,50,300,1275,16,58,0,1538,806
2018,36047023600,"Census Tract 236, Kings County, New York",1702,170,1532,1381,5347,23520,0,2006,1437,51,187,1240,14,68,0,1532,807
2019,36047023600,"Census Tract 236, Kings County, New York",1631,161,1470,1370,5311,25968,0,2009,1552,51,144,1255,0,46,0,1470,747
2020,36047023600,"Census Tract 236, Kings County, New York",1498,124,1374,1283,5141,27672,0,2009,1629,51,218,1217,0,26,0,1374,641
2012,36047023800,"Census Tract 238, Kings County, New York",1388,99,1289,935,2620,22875,1939,2002,1159,50,237,935,0,0,0,1289,310
2013,36047023800,"Census Tract 238, Kings County, New York",1387,73,1314,875,2462,20372,1939,2004,1196,50,167,861,0,0,0,1314,346
2014,36047023800,"Census Tract 238, Kings County, New York",1357,51,1306,889,3006,23472,1939,2005,1338,50,189,852,0,0,23,1306,374
2015,36047023800,"Census Tract 238, Kings County, New York",1362,61,1301,882,2997,22400,1939,2005,1378,50,149,839,0,0,24,1301,374
2016,36047023800,"Census Tract 238, Kings County, New York",1355,64,1291,865,2937,22378,1939,2006,1418,50,127,807,0,0,41,1291,370
2017,36047023800,"Census Tract 238, Kings County, New York",1347,103,1244,802,2843,22790,1939,2007,1432,50,112,738,0,0,40,1244,376
2018,36047023800,"Census Tract 238, Kings County, New York",1316,119,1197,812,2919,24485,0,2007,1413,51,106,751,0,0,52,1197,323
2019,36047023800,"Census Tract 238, Kings County, New York",1337,163,1174,780,2613,28793,0,2010,1387,51,106,700,0,0,25,1174,271
2020,36047023800,"Census Tract 238, Kings County, New York",1307,241,1066,763,3009,31099,1941,2012,1403,51,107,689,0,0,24,1066,311
2012,36047024000,"Census Tract 240, Kings County, New York",1418,107,1311,954,2935,31964,1939,2002,1158,40.3,161,807,30,15,102,1311,326
2013,36047024000,"Census Tract 240, Kings County, New York",1374,138,1236,949,2992,27054,1939,2003,1189,48,109,841,0,18,90,1236,357
2014,36047024000,"Census Tract 240, Kings County, New York",1379,114,1265,1007,3472,24849,1940,2003,1263,50,142,917,0,16,58,1265,445
2015,36047024000,"Census Tract 240, Kings County, New York",1396,135,1261,957,3396,NA,1940,2004,1341,50,136,925,0,6,22,1261,457
2016,36047024000,"Census Tract 240, Kings County, New York",1396,174,1222,994,3363,27398,1943,2005,1325,50,160,952,12,0,22,1222,430
2017,36047024000,"Census Tract 240, Kings County, New York",1400,108,1292,996,3520,28313,1946,2004,1368,50,200,960,12,0,11,1292,472
2018,36047024000,"Census Tract 240, Kings County, New York",1442,106,1336,951,3105,31094,1949,2003,1367,51,247,910,12,0,12,1336,446
2019,36047024000,"Census Tract 240, Kings County, New York",1477,115,1362,954,3257,30694,1949,2009,1431,51,260,845,12,0,88,1362,497
2020,36047024000,"Census Tract 240, Kings County, New York",1619,232,1387,1081,3841,23638,1947,2015,1402,51,237,963,11,0,97,1387,639
2012,36047024100,"Census Tract 241, Kings County, New York",1141,271,870,747,1511,31438,1944,2005,1388,35.2,314,267,221,72,215,870,247
2013,36047024100,"Census Tract 241, Kings County, New York",1161,253,908,773,1676,37841,1945,2006,1410,35.2,348,330,210,58,204,908,252
2014,36047024100,"Census Tract 241, Kings County, New York",1177,199,978,863,1816,52228,1944,2007,1561,30.8,428,372,226,102,199,978,204
2015,36047024100,"Census Tract 241, Kings County, New York",1133,194,939,796,1577,53152,1948,2010,1678,28,383,449,182,64,144,939,185
2016,36047024100,"Census Tract 241, Kings County, New York",1146,98,1048,885,1859,55755,1948,2011,1812,30.1,449,497,180,84,130,1048,213
2017,36047024100,"Census Tract 241, Kings County, New York",1094,111,983,836,1836,58571,1950,2012,2012,32.8,454,517,137,65,96,983,203
2018,36047024100,"Census Tract 241, Kings County, New York",1137,101,1036,878,1997,68534,1943,2013,2072,33.4,437,535,128,65,147,1036,205
2019,36047024100,"Census Tract 241, Kings County, New York",1179,162,1017,826,1958,58944,1946,2014,2106,35.6,373,513,120,38,153,1017,258
2020,36047024100,"Census Tract 241, Kings County, New York",1189,112,1077,901,2287,68063,1949,2016,2201,34.9,415,520,194,46,136,1077,247
2012,36047024200,"Census Tract 242, Kings County, New York",886,80,806,524,2035,35688,1947,2002,1230,44.5,168,440,4,28,52,806,101
2013,36047024200,"Census Tract 242, Kings County, New York",896,64,832,577,2195,32066,1946,2002,1294,48.4,118,504,4,40,29,832,157
2014,36047024200,"Census Tract 242, Kings County, New York",855,57,798,505,1845,31687,1945,2003,1259,48.8,112,402,5,62,36,798,198
2015,36047024200,"Census Tract 242, Kings County, New York",882,66,816,523,1964,30920,1951,2004,1375,50,86,433,3,55,32,816,217
2016,36047024200,"Census Tract 242, Kings County, New York",876,67,809,463,1673,33750,1946,2005,1409,43.2,38,374,0,51,38,809,187
2017,36047024200,"Census Tract 242, Kings County, New York",819,59,760,424,1670,41250,1939,2005,1502,41.1,40,352,0,46,26,760,169
2018,36047024200,"Census Tract 242, Kings County, New York",826,75,751,409,1523,47218,0,2006,1572,41.4,42,305,0,61,43,751,143
2019,36047024200,"Census Tract 242, Kings County, New York",848,87,761,454,1760,47813,1944,2007,1605,41.2,45,351,0,45,58,761,144
2020,36047024200,"Census Tract 242, Kings County, New York",827,105,722,377,1531,49063,1947,2010,1564,48.9,39,262,0,62,53,722,141
2012,36047024300,"Census Tract 243, Kings County, New York",1914,173,1741,1281,2786,30189,1939,2003,1076,33.7,382,246,944,31,185,1741,477
2013,36047024300,"Census Tract 243, Kings County, New York",1915,134,1781,1300,2690,31625,1939,2004,1055,32.5,441,320,847,37,212,1781,458
2014,36047024300,"Census Tract 243, Kings County, New York",1983,212,1771,1328,2830,40921,1939,2005,1165,30.1,520,371,767,39,237,1771,350
2015,36047024300,"Census Tract 243, Kings County, New York",1979,234,1745,1301,2861,39479,1939,2007,1218,29.4,508,378,670,31,278,1745,372
2016,36047024300,"Census Tract 243, Kings County, New York",1966,208,1758,1292,2803,46288,1939,2010,1075,30.4,558,379,622,33,284,1758,414
2017,36047024300,"Census Tract 243, Kings County, New York",1899,288,1611,1245,2655,49492,1939,2011,1122,28.8,607,448,472,21,291,1611,360
2018,36047024300,"Census Tract 243, Kings County, New York",1982,291,1691,1206,2379,48409,0,2011,1155,29.7,570,415,493,16,270,1691,332
2019,36047024300,"Census Tract 243, Kings County, New York",1987,256,1731,1287,2571,48750,0,2012,1243,29.9,565,380,579,35,302,1731,404
2020,36047024300,"Census Tract 243, Kings County, New York",2093,210,1883,1235,2186,39271,0,2013,1235,29.3,567,366,571,46,269,1883,389
2012,36047024400,"Census Tract 244, Kings County, New York",1017,54,963,566,1693,30000,1939,2004,1183,39.8,71,365,0,88,113,963,193
2013,36047024400,"Census Tract 244, Kings County, New York",1049,80,969,571,1805,25439,1939,2005,1156,38.6,65,389,8,75,99,969,264
2014,36047024400,"Census Tract 244, Kings County, New York",1076,67,1009,570,1932,24535,1939,2009,1139,42.4,108,295,11,121,143,1009,316
2015,36047024400,"Census Tract 244, Kings County, New York",1032,56,976,474,1756,24352,1939,2010,1300,46.1,93,269,8,92,105,976,293
2016,36047024400,"Census Tract 244, Kings County, New York",1025,42,983,534,2009,27105,1939,2010,1387,45.9,110,303,8,97,126,983,298
2017,36047024400,"Census Tract 244, Kings County, New York",1029,61,968,514,2185,31154,1939,2011,1470,46.4,98,296,11,102,105,968,292
2018,36047024400,"Census Tract 244, Kings County, New York",1024,96,928,512,2228,37353,0,2011,1595,49.7,73,295,0,82,122,928,274
2019,36047024400,"Census Tract 244, Kings County, New York",966,125,841,428,1830,44722,0,2012,1675,30.8,70,261,0,66,91,841,206
2020,36047024400,"Census Tract 244, Kings County, New York",1057,114,943,573,2107,43835,0,2014,1603,43.5,158,292,0,95,175,943,209
2012,36047024500,"Census Tract 245, Kings County, New York",2053,440,1613,1053,2392,36128,1939,2005,1123,37.7,293,103,821,83,43,1613,331
2013,36047024500,"Census Tract 245, Kings County, New York",2016,446,1570,1030,2471,30250,1939,2005,1123,40.4,278,109,763,103,53,1570,355
2014,36047024500,"Census Tract 245, Kings County, New York",1986,388,1598,1132,2666,37216,1939,2006,1141,37.9,372,177,828,50,62,1598,349
2015,36047024500,"Census Tract 245, Kings County, New York",1964,389,1575,1087,2527,41656,1939,2007,1172,35.4,422,193,764,39,58,1575,302
2016,36047024500,"Census Tract 245, Kings County, New York",1926,294,1632,1131,2732,49509,1939,2007,1190,29.7,483,221,761,64,75,1632,274
2017,36047024500,"Census Tract 245, Kings County, New York",1966,252,1714,1248,3080,53039,1939,2008,1279,28.1,574,317,773,71,102,1714,209
2018,36047024500,"Census Tract 245, Kings County, New York",1984,245,1739,1280,3027,65972,0,2011,1427,24.9,700,437,658,93,114,1739,195
2019,36047024500,"Census Tract 245, Kings County, New York",2064,253,1811,1301,2752,84327,0,2012,1645,23.8,787,466,634,91,125,1811,192
2020,36047024500,"Census Tract 245, Kings County, New York",2064,169,1895,1411,2995,88750,0,2014,1746,24.1,855,449,737,95,118,1895,195
2012,36047024600,"Census Tract 246, Kings County, New York",990,59,931,507,1801,46359,1939,2003,1200,35.1,95,276,8,151,72,931,169
2013,36047024600,"Census Tract 246, Kings County, New York",1022,71,951,556,1846,38289,1944,2004,1168,37.2,86,299,23,152,72,951,174
2014,36047024600,"Census Tract 246, Kings County, New York",1020,33,987,543,1794,29063,1946,2005,1212,42.1,104,292,20,149,72,987,222
2015,36047024600,"Census Tract 246, Kings County, New York",1003,34,969,512,1511,28667,1941,2007,1233,43.4,93,268,9,149,77,969,244
2016,36047024600,"Census Tract 246, Kings County, New York",1018,55,963,525,1440,34967,1949,2010,1293,39.1,144,305,10,117,85,963,226
2017,36047024600,"Census Tract 246, Kings County, New York",973,54,919,510,1351,35833,1939,2010,1230,43.8,133,307,8,106,81,919,184
2018,36047024600,"Census Tract 246, Kings County, New York",977,54,923,494,1372,40500,0,2011,1364,42.9,118,314,0,92,88,923,185
2019,36047024600,"Census Tract 246, Kings County, New York",974,62,912,488,1426,46429,0,2011,1430,39.6,104,279,9,59,141,912,153
2020,36047024600,"Census Tract 246, Kings County, New York",968,81,887,454,1221,49583,0,2011,1438,40.5,99,235,12,73,134,887,147
2012,36047024700,"Census Tract 247, Kings County, New York",1137,227,910,767,1627,40875,1939,2003,1103,29.6,292,114,537,8,39,910,161
2013,36047024700,"Census Tract 247, Kings County, New York",1115,253,862,728,1641,44018,1939,2004,1163,28.3,309,136,503,22,45,862,162
2014,36047024700,"Census Tract 247, Kings County, New York",1128,214,914,788,1761,42727,1939,2005,1196,29.3,311,135,529,43,68,914,193
2015,36047024700,"Census Tract 247, Kings County, New York",1120,174,946,827,1857,38482,1939,2007,1179,31.2,297,146,554,42,85,946,197
2016,36047024700,"Census Tract 247, Kings County, New York",1131,160,971,877,2065,43516,1942,2008,1279,32.4,339,209,493,49,108,971,227
2017,36047024700,"Census Tract 247, Kings County, New York",1110,132,978,878,2145,44107,1939,2009,1370,31.7,354,230,473,75,89,978,237
2018,36047024700,"Census Tract 247, Kings County, New York",1138,95,1043,927,2252,43125,1954,2009,1538,36.7,332,217,541,46,103,1043,269
2019,36047024700,"Census Tract 247, Kings County, New York",1151,87,1064,992,2427,45491,1959,2010,1712,34.3,361,261,561,70,106,1064,274
2020,36047024700,"Census Tract 247, Kings County, New York",1362,147,1215,1110,2321,47486,1949,2013,1926,33.2,619,339,406,70,210,1215,284
2012,36047024800,"Census Tract 248, Kings County, New York",915,24,891,518,1489,48258,1939,2004,1123,28.1,105,336,0,55,127,891,163
2013,36047024800,"Census Tract 248, Kings County, New York",930,22,908,537,1733,40074,1941,2005,1179,30.3,68,285,0,78,174,908,173
2014,36047024800,"Census Tract 248, Kings County, New York",913,29,884,562,1802,41452,1939,2007,1182,30,69,303,17,107,128,884,183
2015,36047024800,"Census Tract 248, Kings County, New York",905,19,886,538,1821,40083,1939,2008,1236,40.4,74,239,14,140,145,886,203
2016,36047024800,"Census Tract 248, Kings County, New York",919,25,894,554,1799,41778,1939,2008,1253,35.9,80,238,19,139,139,894,196
2017,36047024800,"Census Tract 248, Kings County, New York",908,43,865,538,1734,40250,1939,2008,1271,42.4,86,213,15,147,142,865,186
2018,36047024800,"Census Tract 248, Kings County, New York",865,62,803,491,1573,42578,0,2010,1292,40.6,126,167,14,164,119,803,115
2019,36047024800,"Census Tract 248, Kings County, New York",889,88,801,454,1389,38864,0,2007,1356,41.5,95,179,0,138,123,801,113
2020,36047024800,"Census Tract 248, Kings County, New York",875,105,770,446,1321,48611,0,2010,1475,36.9,132,205,0,102,119,770,84
2012,36047024900,"Census Tract 249, Kings County, New York",1967,404,1563,1190,2648,42328,1939,2006,1154,33.1,391,144,973,41,44,1563,321
2013,36047024900,"Census Tract 249, Kings County, New York",1945,379,1566,1206,2556,43355,1939,2007,1263,37.5,441,209,940,47,23,1566,333
2014,36047024900,"Census Tract 249, Kings County, New York",1988,357,1631,1321,2868,44177,1939,2009,1317,36.8,524,240,1007,56,61,1631,339
2015,36047024900,"Census Tract 249, Kings County, New York",2021,319,1702,1417,3075,41694,1939,2010,1246,33.9,530,270,1077,49,61,1702,346
2016,36047024900,"Census Tract 249, Kings County, New York",2030,220,1810,1491,3305,51114,1939,2011,1379,32.7,696,391,1004,54,56,1810,295
2017,36047024900,"Census Tract 249, Kings County, New York",2050,202,1848,1438,3389,56058,1939,2011,1467,31.9,652,379,888,34,136,1848,252
2018,36047024900,"Census Tract 249, Kings County, New York",2012,185,1827,1406,3138,58846,0,NA,1535,33.3,737,487,704,64,159,1827,288
2019,36047024900,"Census Tract 249, Kings County, New York",1996,161,1835,1422,2841,59792,0,2013,1541,30.7,830,545,656,47,135,1835,320
2020,36047024900,"Census Tract 249, Kings County, New York",2011,122,1889,1512,2996,66514,0,2015,1780,31.1,951,691,528,49,199,1889,346
2012,36047025000,"Census Tract 250, Kings County, New York",563,49,514,280,730,23750,1939,2005,1178,50,58,145,15,88,47,514,126
2013,36047025000,"Census Tract 250, Kings County, New York",546,39,507,233,697,25139,1939,2005,1226,50,57,106,13,100,27,507,130
2014,36047025000,"Census Tract 250, Kings County, New York",544,47,497,240,759,28194,1939,2006,1205,46.4,12,59,15,146,35,497,132
2015,36047025000,"Census Tract 250, Kings County, New York",548,46,502,212,643,52273,1939,2007,1255,34.5,35,60,12,114,38,502,112
2016,36047025000,"Census Tract 250, Kings County, New York",525,51,474,179,459,NA,1943,2009,1098,38.2,33,42,6,102,35,474,126
2017,36047025000,"Census Tract 250, Kings County, New York",543,40,503,186,580,47000,1953,2011,1116,37.9,47,21,7,120,45,503,98
2018,36047025000,"Census Tract 250, Kings County, New York",565,33,532,218,786,53438,0,2012,1273,33.5,33,24,0,106,88,532,78
2019,36047025000,"Census Tract 250, Kings County, New York",604,36,568,265,937,51563,0,2012,1407,35.8,44,28,0,154,83,568,102
2020,36047025000,"Census Tract 250, Kings County, New York",616,78,538,266,1019,53438,0,2015,1526,28.9,16,23,0,141,102,538,91
2012,36047025100,"Census Tract 251, Kings County, New York",1625,190,1435,1241,3219,23398,1939,2003,821,32.4,251,100,939,31,194,1435,468
2013,36047025100,"Census Tract 251, Kings County, New York",1567,193,1374,1198,3249,24808,1950,2002,817,32,208,115,919,40,142,1374,446
2014,36047025100,"Census Tract 251, Kings County, New York",1572,226,1346,1136,2875,22617,1958,2003,724,31.2,221,113,865,71,109,1346,476
2015,36047025100,"Census Tract 251, Kings County, New York",1568,170,1398,1176,3081,NA,1956,2004,748,29.1,286,99,854,71,157,1398,496
2016,36047025100,"Census Tract 251, Kings County, New York",1575,149,1426,1226,3056,32961,1952,2007,886,29.1,363,136,914,62,130,1426,421
2017,36047025100,"Census Tract 251, Kings County, New York",1567,142,1425,1233,3145,31771,1961,2009,958,29.4,350,142,860,80,172,1425,469
2018,36047025100,"Census Tract 251, Kings County, New York",1617,140,1477,1237,2957,32401,1961,2011,1104,28,447,181,725,65,201,1477,502
2019,36047025100,"Census Tract 251, Kings County, New York",1684,116,1568,1327,3160,39715,1951,2013,1336,28.5,542,277,754,64,151,1568,490
2020,36047025100,"Census Tract 251, Kings County, New York",1772,119,1653,1352,3053,43864,1960,2015,1572,31.7,583,361,745,61,111,1653,416
2012,36047025200,"Census Tract 252, Kings County, New York",2039,92,1947,1347,3489,37829,1939,2004,1160,36.2,340,691,10,222,416,1947,390
2013,36047025200,"Census Tract 252, Kings County, New York",2069,97,1972,1393,3378,40352,1939,2005,1148,34.3,367,717,36,251,375,1972,316
2014,36047025200,"Census Tract 252, Kings County, New York",1960,117,1843,1329,3239,40144,1939,2006,1179,34.8,371,658,58,213,385,1843,312
2015,36047025200,"Census Tract 252, Kings County, New York",1976,195,1781,1237,3302,35951,1939,2008,1214,33.8,334,658,53,237,274,1781,338
2016,36047025200,"Census Tract 252, Kings County, New York",1968,124,1844,1338,3552,39631,1939,2009,1255,33.5,386,752,63,244,264,1844,367
2017,36047025200,"Census Tract 252, Kings County, New York",2005,88,1917,1348,3453,45511,1939,2010,1298,34.1,342,685,79,250,326,1917,310
2018,36047025200,"Census Tract 252, Kings County, New York",1985,116,1869,1327,3263,48139,0,2011,1350,36.3,372,640,28,209,422,1869,279
2019,36047025200,"Census Tract 252, Kings County, New York",1987,122,1865,1353,3551,50199,0,2012,1422,38.2,390,627,20,285,412,1865,287
2020,36047025200,"Census Tract 252, Kings County, New York",1948,33,1915,1328,3424,50261,0,2011,1465,38.9,451,637,41,317,325,1915,363
2012,36047025300,"Census Tract 253, Kings County, New York",1300,325,975,739,1429,35347,1949,2005,1104,35.9,195,86,440,7,261,975,216
2013,36047025300,"Census Tract 253, Kings County, New York",1351,322,1029,871,1699,29063,1955,2006,1171,36.8,311,172,444,21,306,1029,262
2014,36047025300,"Census Tract 253, Kings County, New York",1407,294,1113,900,1778,29024,1975,2007,1226,35.6,342,217,378,34,341,1113,253
2015,36047025300,"Census Tract 253, Kings County, New York",1430,299,1131,942,1942,29521,1947,2009,1310,35.7,403,276,405,43,285,1131,280
2016,36047025300,"Census Tract 253, Kings County, New York",1462,270,1192,956,2040,34833,1939,2011,1488,36.8,412,336,366,83,217,1192,284
2017,36047025300,"Census Tract 253, Kings County, New York",1440,231,1209,938,2050,35385,1950,2011,1500,37.4,396,359,371,87,135,1209,258
2018,36047025300,"Census Tract 253, Kings County, New York",1483,207,1276,946,2102,36958,1946,2012,1572,36.6,404,379,315,100,172,1276,299
2019,36047025300,"Census Tract 253, Kings County, New York",1483,202,1281,985,2097,41477,1946,2013,1680,36,455,363,360,72,176,1281,290
2020,36047025300,"Census Tract 253, Kings County, New York",1431,107,1324,964,2008,69688,1962,2015,1847,33,486,390,324,77,134,1324,234
2012,36047025400,"Census Tract 254, Kings County, New York",1252,109,1143,677,1884,41855,1939,2003,1034,28.6,134,252,21,273,144,1143,132
2013,36047025400,"Census Tract 254, Kings County, New York",1261,110,1151,704,2090,52361,1939,2003,1040,25.7,154,229,27,282,185,1151,175
2014,36047025400,"Census Tract 254, Kings County, New York",1243,102,1141,703,2157,44831,1939,2003,1102,29.4,187,269,0,289,136,1141,172
2015,36047025400,"Census Tract 254, Kings County, New York",1266,82,1184,709,2233,44408,1939,2005,1093,25.1,224,271,0,295,130,1184,196
2016,36047025400,"Census Tract 254, Kings County, New York",1273,51,1222,716,2331,43654,1939,2005,1128,25.8,249,282,0,272,162,1222,260
2017,36047025400,"Census Tract 254, Kings County, New York",1259,50,1209,667,2088,38850,1939,2008,1178,28.2,224,276,0,304,70,1209,286
2018,36047025400,"Census Tract 254, Kings County, New York",1210,37,1173,604,1747,31750,0,2009,1247,31,201,260,0,252,72,1173,287
2019,36047025400,"Census Tract 254, Kings County, New York",1170,65,1105,596,1526,29038,0,2011,1253,31.2,182,235,0,264,78,1105,313
2020,36047025400,"Census Tract 254, Kings County, New York",1145,71,1074,584,1441,28636,0,2013,1330,36.2,218,206,0,306,57,1074,257
2012,36047025500,"Census Tract 255, Kings County, New York",1816,0,1816,1816,5630,27328,1949,1996,487,24.1,139,0,924,9,937,1816,705
2013,36047025500,"Census Tract 255, Kings County, New York",1822,21,1801,1801,5095,25838,1949,1997,515,25.9,137,0,941,19,934,1801,774
2014,36047025500,"Census Tract 255, Kings County, New York",1847,44,1803,1797,5290,22434,1950,1998,525,27.6,105,22,885,9,1057,1803,846
2015,36047025500,"Census Tract 255, Kings County, New York",1861,41,1820,1806,5242,22344,1950,1999,603,27,106,20,791,8,1114,1820,761
2016,36047025500,"Census Tract 255, Kings County, New York",1874,42,1832,1825,5599,21604,1950,2000,520,27.3,165,21,835,8,1146,1832,820
2017,36047025500,"Census Tract 255, Kings County, New York",1893,40,1853,1847,5556,20741,1948,1999,520,28.8,159,22,949,33,1102,1853,800
2018,36047025500,"Census Tract 255, Kings County, New York",1921,17,1904,1896,5850,21067,1948,2000,522,27.6,148,28,954,30,1183,1904,777
2019,36047025500,"Census Tract 255, Kings County, New York",1934,0,1934,1897,5450,21486,1947,2002,515,27.2,195,8,932,34,1187,1934,754
2020,36047025500,"Census Tract 255, Kings County, New York",2208,0,2208,2117,4850,19085,1947,1999,470,32.5,194,8,857,32,1244,2208,1013
2012,36047025600,"Census Tract 256, Kings County, New York",1118,73,1045,516,1441,28333,1939,2004,988,43.3,120,318,0,96,102,1045,234
2013,36047025600,"Census Tract 256, Kings County, New York",1102,67,1035,553,1696,36046,1939,2005,1047,40.4,123,326,0,143,74,1035,199
2014,36047025600,"Census Tract 256, Kings County, New York",1080,67,1013,509,1623,32434,1939,2005,1169,41.7,94,234,0,187,85,1013,192
2015,36047025600,"Census Tract 256, Kings County, New York",1080,85,995,505,1576,35288,1939,2005,1188,45,96,225,0,189,89,995,197
2016,36047025600,"Census Tract 256, Kings County, New York",1019,80,939,431,1488,35885,1939,2006,1329,50,70,202,0,183,34,939,155
2017,36047025600,"Census Tract 256, Kings County, New York",1037,108,929,495,1698,34406,1939,2010,1380,50,37,250,0,164,29,929,182
2018,36047025600,"Census Tract 256, Kings County, New York",1023,110,913,435,1396,33163,0,2011,1419,51,44,208,0,149,38,913,216
2019,36047025600,"Census Tract 256, Kings County, New York",1041,93,948,462,1676,34321,0,2012,1583,51,83,180,0,181,39,948,301
2020,36047025600,"Census Tract 256, Kings County, New York",980,55,925,496,1845,48909,0,2013,1585,51,111,173,0,219,34,925,297
2012,36047025700,"Census Tract 257, Kings County, New York",736,131,605,474,1337,35962,1951,2005,1113,34.9,66,70,111,0,301,605,201
2013,36047025700,"Census Tract 257, Kings County, New York",738,127,611,487,1442,44028,1939,2006,1182,34.4,100,108,106,11,276,611,200
2014,36047025700,"Census Tract 257, Kings County, New York",731,92,639,509,1528,52708,1939,2008,1302,30.7,120,153,108,13,249,639,207
2015,36047025700,"Census Tract 257, Kings County, New York",748,94,654,536,1704,49091,1939,2008,1323,32.6,118,110,166,11,264,654,239
2016,36047025700,"Census Tract 257, Kings County, New York",756,53,703,588,1918,52708,1946,2008,1374,32.6,138,146,173,14,273,703,228
2017,36047025700,"Census Tract 257, Kings County, New York",736,89,647,536,1595,61630,1954,2011,1428,31.6,150,146,179,14,210,647,197
2018,36047025700,"Census Tract 257, Kings County, New York",764,114,650,505,1486,64007,1958,2011,1402,30.4,122,149,145,0,210,650,136
2019,36047025700,"Census Tract 257, Kings County, New York",834,124,710,583,1913,64688,1973,2011,1659,32.5,222,183,162,0,215,710,144
2020,36047025700,"Census Tract 257, Kings County, New York",849,101,748,592,1923,100588,1977,2014,1584,19.8,226,242,73,0,244,748,67
2012,36047025800,"Census Tract 258, Kings County, New York",1661,95,1566,1108,3321,47188,1939,2004,1186,34,336,717,0,215,153,1566,218
2013,36047025800,"Census Tract 258, Kings County, New York",1658,122,1536,1094,3285,47262,1939,2004,1200,31.9,333,674,0,198,184,1536,291
2014,36047025800,"Census Tract 258, Kings County, New York",1623,145,1478,1070,3143,45240,1939,2005,1223,36.4,328,615,0,281,142,1478,364
2015,36047025800,"Census Tract 258, Kings County, New York",1557,117,1440,1025,2979,34219,1939,2006,1191,34.3,324,638,0,228,130,1440,376
2016,36047025800,"Census Tract 258, Kings County, New York",1560,81,1479,1100,3039,37857,1939,2008,1232,33.8,348,629,0,296,141,1479,407
2017,36047025800,"Census Tract 258, Kings County, New York",1601,67,1534,1158,3575,39063,1939,2010,1293,40.2,357,562,0,336,252,1534,387
2018,36047025800,"Census Tract 258, Kings County, New York",1562,54,1508,1152,3469,38125,0,2010,1374,44,411,607,0,314,231,1508,356
2019,36047025800,"Census Tract 258, Kings County, New York",1574,31,1543,1148,3306,48295,0,2011,1388,38.5,425,618,0,303,247,1543,239
2020,36047025800,"Census Tract 258, Kings County, New York",1585,56,1529,1196,3665,49286,0,2011,1450,38,479,545,0,362,311,1529,295
2012,36047025901,"Census Tract 259.01, Kings County, New York",769,132,637,589,1480,22298,1946,NA,1051,50,69,100,238,34,262,637,209
2013,36047025901,"Census Tract 259.01, Kings County, New York",806,127,679,558,1451,26898,1943,2006,1123,37.1,77,112,256,12,234,679,138
2014,36047025901,"Census Tract 259.01, Kings County, New York",767,161,606,520,1366,32014,1939,2007,1268,35.6,108,119,244,27,204,606,155
2015,36047025901,"Census Tract 259.01, Kings County, New York",761,130,631,522,1504,40469,1939,2010,1334,37.6,130,121,230,6,189,631,170
2016,36047025901,"Census Tract 259.01, Kings County, New York",793,102,691,575,1628,44107,1939,2011,1382,34.7,139,107,295,5,224,691,159
2017,36047025901,"Census Tract 259.01, Kings County, New York",793,79,714,610,1792,52692,1939,2012,1399,29.8,186,147,300,10,197,714,169
2018,36047025901,"Census Tract 259.01, Kings County, New York",772,77,695,586,1738,51250,0,2012,1478,31.4,187,166,244,9,209,695,170
2019,36047025901,"Census Tract 259.01, Kings County, New York",796,82,714,603,1802,51875,0,2013,1475,34.8,191,163,262,12,201,714,187
2020,36047025901,"Census Tract 259.01, Kings County, New York",783,67,716,660,1648,59200,0,2016,1723,32.7,294,197,296,24,155,716,164
2012,36047025902,"Census Tract 259.02, Kings County, New York",1136,0,1136,1120,3407,20278,1958,1998,404,29,35,0,700,0,420,1136,580
2013,36047025902,"Census Tract 259.02, Kings County, New York",1120,0,1120,1120,3554,17424,1961,1997,406,32.9,51,0,736,0,447,1120,680
2014,36047025902,"Census Tract 259.02, Kings County, New York",1131,0,1131,1131,3591,18715,1961,1999,373,30.4,69,0,669,10,498,1131,664
2015,36047025902,"Census Tract 259.02, Kings County, New York",1150,0,1150,1150,3737,16140,1961,2002,378,30.1,34,0,701,17,502,1150,763
2016,36047025902,"Census Tract 259.02, Kings County, New York",1151,0,1151,1151,3736,16406,1960,2002,350,31.3,52,0,729,21,503,1151,790
2017,36047025902,"Census Tract 259.02, Kings County, New York",1175,0,1175,1175,3826,16448,1958,2005,456,31.9,65,0,769,15,514,1175,770
2018,36047025902,"Census Tract 259.02, Kings County, New York",1173,0,1173,1173,3558,16802,1956,2006,350,29.9,74,0,704,37,568,1173,708
2019,36047025902,"Census Tract 259.02, Kings County, New York",1190,0,1190,1190,3533,18167,1956,2006,495,32.3,59,0,782,25,546,1190,718
2020,36047025902,"Census Tract 259.02, Kings County, New York",1357,0,1357,1313,3441,18413,1961,2006,432,31.7,166,0,775,14,620,1357,726
2012,36047026000,"Census Tract 260, Kings County, New York",1233,78,1155,712,2527,42447,1939,2005,1192,34,184,313,11,285,103,1155,188
2013,36047026000,"Census Tract 260, Kings County, New York",1215,72,1143,651,2134,50855,1939,2005,1287,33.9,183,313,0,247,82,1143,217
2014,36047026000,"Census Tract 260, Kings County, New York",1245,98,1147,603,1870,44243,1939,2007,1287,35.5,189,247,27,225,94,1147,238
2015,36047026000,"Census Tract 260, Kings County, New York",1240,97,1143,585,1736,46016,1939,2007,1318,33.9,165,241,28,217,89,1143,186
2016,36047026000,"Census Tract 260, Kings County, New York",1221,96,1125,578,1651,51167,1939,2009,1340,32.8,141,278,27,203,60,1125,204
2017,36047026000,"Census Tract 260, Kings County, New York",1212,98,1114,537,1534,43350,1939,2010,1235,40.8,97,238,28,171,84,1114,182
2018,36047026000,"Census Tract 260, Kings County, New York",1220,125,1095,532,1458,41806,0,2011,1361,37.5,99,249,19,164,75,1095,128
2019,36047026000,"Census Tract 260, Kings County, New York",1179,87,1092,504,1445,41429,0,2009,1416,42,88,249,0,187,45,1092,105
2020,36047026000,"Census Tract 260, Kings County, New York",1139,50,1089,557,1726,40561,0,2010,1425,41.5,144,282,0,159,92,1089,108
2012,36047026100,"Census Tract 261, Kings County, New York",2174,308,1866,1394,3228,28149,1946,2003,1111,37.5,329,152,1029,38,221,1866,553
2013,36047026100,"Census Tract 261, Kings County, New York",2263,357,1906,1463,3468,30747,1946,2004,1279,40.3,373,220,1037,39,218,1906,554
2014,36047026100,"Census Tract 261, Kings County, New York",2252,284,1968,1556,3756,31165,1939,2006,1340,40,419,349,1019,30,228,1968,536
2015,36047026100,"Census Tract 261, Kings County, New York",2368,297,2071,1646,3510,32389,1939,2008,1392,45.1,483,422,1002,15,267,2071,458
2016,36047026100,"Census Tract 261, Kings County, New York",2375,318,2057,1714,3534,38441,1962,2011,1444,40.1,557,479,904,0,389,2057,413
2017,36047026100,"Census Tract 261, Kings County, New York",2399,296,2103,1813,3962,40594,1975,2011,1377,34.8,599,440,841,0,623,2103,498
2018,36047026100,"Census Tract 261, Kings County, New York",2420,250,2170,1950,3949,50761,1967,2012,1454,34.7,683,436,979,23,610,2170,469
2019,36047026100,"Census Tract 261, Kings County, New York",2490,254,2236,2112,3895,51131,1967,2013,1503,33.1,782,525,898,19,688,2236,529
2020,36047026100,"Census Tract 261, Kings County, New York",2379,218,2161,2096,4282,63373,1969,2015,1491,27,843,557,931,27,574,2161,593
2012,36047026200,"Census Tract 262, Kings County, New York",917,143,774,266,616,43500,1939,2004,990,31,41,84,10,81,91,774,60
2013,36047026200,"Census Tract 262, Kings County, New York",864,119,745,299,835,45982,1939,2004,1142,32.5,58,114,0,126,59,745,97
2014,36047026200,"Census Tract 262, Kings County, New York",900,80,820,362,1005,40500,1939,2006,1142,33.8,79,135,0,134,93,820,156
2015,36047026200,"Census Tract 262, Kings County, New York",867,89,778,349,967,41042,1939,2005,1127,33.5,86,172,0,97,80,778,178
2016,36047026200,"Census Tract 262, Kings County, New York",831,63,768,359,1036,37434,1939,2007,1199,34,126,177,0,102,71,768,149
2017,36047026200,"Census Tract 262, Kings County, New York",847,51,796,416,1272,39500,1939,2009,1347,36.3,131,218,0,99,87,796,161
2018,36047026200,"Census Tract 262, Kings County, New York",878,66,812,461,1328,40813,0,2009,1398,37.9,147,212,0,120,117,812,174
2019,36047026200,"Census Tract 262, Kings County, New York",848,60,788,401,1069,42063,0,2010,1345,34.7,188,224,0,77,83,788,86
2020,36047026200,"Census Tract 262, Kings County, New York",839,56,783,434,1251,53362,0,2015,1405,31.3,250,191,0,151,71,783,43
2012,36047026300,"Census Tract 263, Kings County, New York",921,157,764,629,1670,35120,1939,2003,946,32.3,126,42,533,4,88,764,201
2013,36047026300,"Census Tract 263, Kings County, New York",929,167,762,650,1711,35864,1939,2003,959,32.2,122,60,533,4,79,762,190
2014,36047026300,"Census Tract 263, Kings County, New York",933,127,806,696,1758,34265,1939,2006,1066,34.2,172,60,533,6,122,806,245
2015,36047026300,"Census Tract 263, Kings County, New York",960,120,840,704,1591,32652,1939,2008,980,31.9,200,66,532,7,102,840,217
2016,36047026300,"Census Tract 263, Kings County, New York",961,134,827,732,1580,30435,1939,2011,1116,32.6,237,107,507,8,123,827,236
2017,36047026300,"Census Tract 263, Kings County, New York",973,144,829,698,1534,28571,1939,2011,1126,33.8,248,124,471,6,101,829,249
2018,36047026300,"Census Tract 263, Kings County, New York",979,137,842,706,1527,27885,0,2012,1219,36,256,146,453,13,101,842,279
2019,36047026300,"Census Tract 263, Kings County, New York",996,106,890,729,1633,31458,0,2012,1360,39.8,255,167,465,20,114,890,273
2020,36047026300,"Census Tract 263, Kings County, New York",1028,71,957,732,1512,45948,1946,2012,1489,33.5,302,126,505,29,90,957,265
2012,36047026400,"Census Tract 264, Kings County, New York",1708,140,1568,1090,2589,40875,1939,2004,1091,37.1,214,630,11,223,220,1568,370
2013,36047026400,"Census Tract 264, Kings County, New York",1710,62,1648,1149,2885,37113,1939,2004,1120,37.4,223,646,9,239,244,1648,362
2014,36047026400,"Census Tract 264, Kings County, New York",1731,106,1625,1076,2793,37000,1939,2005,1151,35.6,200,575,8,253,248,1625,359
2015,36047026400,"Census Tract 264, Kings County, New York",1754,110,1644,1095,2956,41830,1939,2006,1156,32.2,212,584,23,236,261,1644,356
2016,36047026400,"Census Tract 264, Kings County, New York",1747,141,1606,1180,3257,39886,1939,2008,1178,35.6,246,561,21,312,294,1606,285
2017,36047026400,"Census Tract 264, Kings County, New York",1741,140,1601,1171,3321,40757,1939,2010,1265,34.1,191,532,19,332,288,1601,228
2018,36047026400,"Census Tract 264, Kings County, New York",1717,176,1541,1233,3419,41622,0,2010,1299,31.3,194,431,14,408,390,1541,237
2019,36047026400,"Census Tract 264, Kings County, New York",1671,129,1542,1213,3253,41894,0,2012,1375,33.4,237,502,23,381,318,1542,285
2020,36047026400,"Census Tract 264, Kings County, New York",1584,107,1477,1173,3252,44583,0,2013,1425,30.2,214,521,0,347,317,1477,250
2012,36047026500,"Census Tract 265, Kings County, New York",1733,243,1490,1184,2965,25692,1939,2003,1012,33.4,153,31,1039,33,81,1490,464
2013,36047026500,"Census Tract 265, Kings County, New York",1739,263,1476,1159,2874,25513,1939,2004,1079,34.2,178,41,1002,42,74,1476,438
2014,36047026500,"Census Tract 265, Kings County, New York",1750,287,1463,1145,2797,23218,1939,2005,1080,40.7,260,82,906,16,113,1463,446
2015,36047026500,"Census Tract 265, Kings County, New York",1747,335,1412,1079,2501,27386,1939,2006,1047,33.7,326,115,796,0,141,1412,379
2016,36047026500,"Census Tract 265, Kings County, New York",1751,304,1447,1111,2477,NA,1939,2009,1145,29.7,360,200,730,0,154,1447,364
2017,36047026500,"Census Tract 265, Kings County, New York",1711,250,1461,1018,2412,51029,1939,2011,1313,24.5,360,212,622,0,148,1461,302
2018,36047026500,"Census Tract 265, Kings County, New York",1751,252,1499,1022,2416,52989,0,2011,1408,29,367,201,603,19,170,1499,276
2019,36047026500,"Census Tract 265, Kings County, New York",1784,237,1547,1042,2391,58645,0,2011,1400,23.2,395,220,546,44,224,1547,219
2020,36047026500,"Census Tract 265, Kings County, New York",1939,157,1782,1275,2261,53750,0,2012,1521,27,485,257,633,37,190,1782,242
2012,36047026600,"Census Tract 266, Kings County, New York",1284,107,1177,727,1992,41372,1939,2004,1153,35.8,199,411,0,270,46,1177,103
2013,36047026600,"Census Tract 266, Kings County, New York",1309,126,1183,765,2251,41303,1939,2005,1199,33.9,181,421,0,253,83,1183,103
2014,36047026600,"Census Tract 266, Kings County, New York",1292,128,1164,720,2207,42258,1939,2007,1229,34.2,166,371,0,213,125,1164,159
2015,36047026600,"Census Tract 266, Kings County, New York",1240,141,1099,759,2298,41920,1939,2007,1177,32.6,206,380,0,240,132,1099,168
2016,36047026600,"Census Tract 266, Kings County, New York",1225,118,1107,769,2573,37277,1939,2010,1323,32.1,185,389,0,250,126,1107,186
2017,36047026600,"Census Tract 266, Kings County, New York",1172,112,1060,748,2478,35821,1939,2012,1328,34.1,192,274,0,318,151,1060,204
2018,36047026600,"Census Tract 266, Kings County, New York",1165,85,1080,720,2284,36308,0,2011,1323,38.4,205,246,0,342,132,1080,205
2019,36047026600,"Census Tract 266, Kings County, New York",1171,95,1076,597,1960,38972,0,2012,1349,35.2,182,192,0,298,107,1076,160
2020,36047026600,"Census Tract 266, Kings County, New York",1183,65,1118,654,2205,37917,1947,2013,1438,43.4,222,207,0,273,174,1118,169
2012,36047026700,"Census Tract 267, Kings County, New York",2059,404,1655,1119,1855,43750,1939,2006,1239,31,481,243,822,10,70,1655,277
2013,36047026700,"Census Tract 267, Kings County, New York",1992,416,1576,1158,2020,39255,1939,2007,1253,33.4,470,254,827,10,90,1576,340
2014,36047026700,"Census Tract 267, Kings County, New York",2070,318,1752,1230,2120,37556,1939,2009,1196,35,469,229,912,2,83,1752,379
2015,36047026700,"Census Tract 267, Kings County, New York",2049,292,1757,1247,2158,33910,1939,2009,1147,33.5,437,241,923,0,56,1757,390
2016,36047026700,"Census Tract 267, Kings County, New York",2082,251,1831,1193,2102,34618,1939,2010,1211,33.6,512,275,776,11,111,1831,464
2017,36047026700,"Census Tract 267, Kings County, New York",2039,267,1772,1052,1974,30119,1939,2011,1309,37.9,435,261,621,11,154,1772,418
2018,36047026700,"Census Tract 267, Kings County, New York",2083,253,1830,1096,2075,39068,0,2011,1539,35.1,491,300,591,10,165,1830,338
2019,36047026700,"Census Tract 267, Kings County, New York",2071,278,1793,1124,2157,51346,0,2011,1773,29.8,551,374,565,20,160,1793,290
2020,36047026700,"Census Tract 267, Kings County, New York",2153,235,1918,1242,2307,74324,0,2013,1919,28.4,739,451,527,37,136,1918,229
2012,36047026800,"Census Tract 268, Kings County, New York",1511,133,1378,959,2635,36971,1939,2005,1142,34.9,222,634,25,107,183,1378,322
2013,36047026800,"Census Tract 268, Kings County, New York",1460,111,1349,919,2923,43958,1939,2006,1249,31.6,265,591,23,99,197,1349,253
2014,36047026800,"Census Tract 268, Kings County, New York",1400,98,1302,898,2689,27500,1939,2008,1241,38.9,202,533,0,118,238,1302,331
2015,36047026800,"Census Tract 268, Kings County, New York",1446,139,1307,914,2600,40104,1939,2009,1243,36.4,253,530,0,119,265,1307,302
2016,36047026800,"Census Tract 268, Kings County, New York",1424,133,1291,952,2751,46944,1939,2010,1334,32.5,278,540,0,145,267,1291,257
2017,36047026800,"Census Tract 268, Kings County, New York",1426,137,1289,961,2925,44294,1939,2010,1396,34.6,302,577,0,167,217,1289,293
2018,36047026800,"Census Tract 268, Kings County, New York",1447,99,1348,1019,2768,42564,0,2011,1410,38.5,288,557,0,183,279,1348,314
2019,36047026800,"Census Tract 268, Kings County, New York",1489,110,1379,1009,2809,43775,0,2011,1480,36.8,288,486,0,219,304,1379,251
2020,36047026800,"Census Tract 268, Kings County, New York",1615,92,1523,950,2622,49295,0,2012,1469,29.3,315,533,0,195,222,1523,231
2012,36047026900,"Census Tract 269, Kings County, New York",1370,261,1109,843,1879,27226,1939,2003,1104,29.5,176,67,713,0,41,1109,175
2013,36047026900,"Census Tract 269, Kings County, New York",1343,260,1083,759,1659,34058,1939,2004,1123,28.1,182,77,660,0,32,1083,62
2014,36047026900,"Census Tract 269, Kings County, New York",1385,238,1147,822,1906,39527,1939,2005,1303,28.9,229,112,624,0,86,1147,140
2015,36047026900,"Census Tract 269, Kings County, New York",1332,182,1150,857,1889,38393,1939,2007,1229,31.8,236,115,638,24,69,1150,160
2016,36047026900,"Census Tract 269, Kings County, New York",1346,171,1175,842,1991,38583,1939,2007,1270,34.1,296,122,578,74,63,1175,239
2017,36047026900,"Census Tract 269, Kings County, New York",1375,150,1225,853,2060,43424,1939,2009,1302,33,332,96,621,60,69,1225,214
2018,36047026900,"Census Tract 269, Kings County, New York",1437,183,1254,883,2001,47554,0,2011,1550,34.8,418,191,547,61,89,1254,264
2019,36047026900,"Census Tract 269, Kings County, New York",1463,202,1261,857,2014,56375,0,2012,1636,33.1,474,220,523,65,75,1261,252
2020,36047026900,"Census Tract 269, Kings County, New York",1458,197,1261,843,2195,75760,0,2015,1924,35.3,511,263,397,47,97,1261,220
2012,36047027000,"Census Tract 270, Kings County, New York",947,188,759,575,1253,27433,1939,2003,805,32.7,157,431,0,68,76,759,161
2013,36047027000,"Census Tract 270, Kings County, New York",974,151,823,603,1550,28661,1939,2003,1013,32.6,174,462,0,71,70,823,172
2014,36047027000,"Census Tract 270, Kings County, New York",984,108,876,636,1654,27632,1939,2004,1051,35,154,503,0,79,54,876,200
2015,36047027000,"Census Tract 270, Kings County, New York",946,44,902,632,1703,41250,1939,2004,1143,30.5,228,501,0,85,46,902,197
2016,36047027000,"Census Tract 270, Kings County, New York",928,60,868,584,1598,50444,1939,2005,1263,30.3,213,471,0,74,39,868,191
2017,36047027000,"Census Tract 270, Kings County, New York",951,55,896,561,1442,55697,1939,2009,1341,30.4,219,463,0,85,13,896,169
2018,36047027000,"Census Tract 270, Kings County, New York",892,40,852,545,1250,50375,0,2011,1444,30.2,269,405,0,95,45,852,195
2019,36047027000,"Census Tract 270, Kings County, New York",893,36,857,587,1357,50975,0,2011,1436,30.5,269,437,0,70,80,857,199
2020,36047027000,"Census Tract 270, Kings County, New York",868,36,832,591,1542,31563,0,2013,1534,47.7,255,468,0,56,67,832,253
2012,36047027100,"Census Tract 271, Kings County, New York",1094,177,917,731,1868,40145,1962,2003,1116,31.8,127,10,685,24,17,917,158
2013,36047027100,"Census Tract 271, Kings County, New York",1128,125,1003,832,2096,39868,1960,2004,1125,32.8,187,10,734,29,44,1003,163
2014,36047027100,"Census Tract 271, Kings County, New York",1155,125,1030,869,2172,35578,1961,2005,1201,36.5,271,29,735,41,50,1030,208
2015,36047027100,"Census Tract 271, Kings County, New York",1235,200,1035,828,1948,34722,1960,2008,1304,38.7,259,49,645,39,52,1035,179
2016,36047027100,"Census Tract 271, Kings County, New York",1302,195,1107,858,1972,36196,1961,2010,1350,37.6,325,77,643,32,97,1107,185
2017,36047027100,"Census Tract 271, Kings County, New York",1318,188,1130,916,2202,34245,1963,2009,1354,36.1,310,62,715,30,120,1130,206
2018,36047027100,"Census Tract 271, Kings County, New York",1324,221,1103,863,2065,34041,1964,2011,1364,34.9,259,69,707,33,91,1103,229
2019,36047027100,"Census Tract 271, Kings County, New York",1369,189,1180,918,2349,39593,1964,2011,1491,32.7,319,125,696,41,119,1180,199
2020,36047027100,"Census Tract 271, Kings County, New York",1413,145,1268,1067,2733,54648,1967,2012,1636,27.9,477,177,818,28,133,1268,216
2012,36047027200,"Census Tract 272, Kings County, New York",1173,71,1102,644,1469,34857,1939,2003,1127,32.8,100,466,0,71,107,1102,291
2013,36047027200,"Census Tract 272, Kings County, New York",1186,86,1100,706,1875,42500,1939,2005,1186,34.6,132,489,0,98,101,1100,152
2014,36047027200,"Census Tract 272, Kings County, New York",1205,63,1142,733,2166,39798,1940,2006,1248,35.2,177,542,0,106,71,1142,225
2015,36047027200,"Census Tract 272, Kings County, New York",1186,67,1119,752,2376,39813,1939,2007,1252,35.3,176,518,0,143,76,1119,219
2016,36047027200,"Census Tract 272, Kings County, New York",1189,77,1112,733,2484,38791,1939,2010,1255,34.5,205,469,0,136,112,1112,240
2017,36047027200,"Census Tract 272, Kings County, New York",1219,70,1149,804,2565,41105,1939,2010,1247,33.6,256,535,0,146,105,1149,209
2018,36047027200,"Census Tract 272, Kings County, New York",1222,77,1145,815,2722,40625,0,2009,1359,33,276,487,0,143,185,1145,279
2019,36047027200,"Census Tract 272, Kings County, New York",1212,55,1157,841,2743,55677,0,2009,1423,29.1,257,460,0,129,252,1157,207
2020,36047027200,"Census Tract 272, Kings County, New York",1391,72,1319,803,2486,56793,0,2008,1489,28.6,239,451,0,97,255,1319,234
2012,36047027300,"Census Tract 273, Kings County, New York",1373,118,1255,886,1615,20451,1939,2003,938,36.3,228,43,730,30,93,1255,388
2013,36047027300,"Census Tract 273, Kings County, New York",1371,108,1263,846,1472,17932,1939,2002,779,37.4,176,50,682,25,89,1263,404
2014,36047027300,"Census Tract 273, Kings County, New York",1354,170,1184,767,1366,18185,1939,2000,668,36,117,11,694,16,46,1184,380
2015,36047027300,"Census Tract 273, Kings County, New York",1399,153,1246,874,1627,23955,1939,2004,906,32.1,115,46,760,22,35,1246,407
2016,36047027300,"Census Tract 273, Kings County, New York",1409,145,1264,869,1719,26417,1939,2010,956,29.6,111,65,732,0,73,1264,363
2017,36047027300,"Census Tract 273, Kings County, New York",1429,153,1276,858,1854,32989,1939,2011,1053,34.6,154,86,687,10,79,1276,312
2018,36047027300,"Census Tract 273, Kings County, New York",1448,158,1290,843,1710,36473,0,2011,1107,35.7,220,117,663,8,85,1290,278
2019,36047027300,"Census Tract 273, Kings County, New York",1504,120,1384,952,1953,41250,0,2013,1190,28.8,267,180,667,11,73,1384,226
2020,36047027300,"Census Tract 273, Kings County, New York",1504,119,1385,868,2019,51731,0,2012,1365,29.1,394,176,558,34,87,1385,145
2012,36047027400,"Census Tract 274, Kings County, New York",963,56,907,490,1200,23889,1939,2004,1093,48.2,50,303,0,156,31,907,177
2013,36047027400,"Census Tract 274, Kings County, New York",973,65,908,492,1369,21645,1939,2006,1133,44.7,58,349,0,114,29,908,159
2014,36047027400,"Census Tract 274, Kings County, New York",1002,51,951,543,1422,26250,1939,2006,1141,39.4,92,366,0,122,55,951,158
2015,36047027400,"Census Tract 274, Kings County, New York",1029,25,1004,574,1532,33646,1943,2006,1237,40.2,89,396,0,95,83,1004,155
2016,36047027400,"Census Tract 274, Kings County, New York",1037,30,1007,583,1586,36648,1941,2006,1288,44.1,123,379,0,96,108,1007,153
2017,36047027400,"Census Tract 274, Kings County, New York",1030,32,998,554,1489,44265,1939,2007,1329,36.4,120,369,0,65,120,998,164
2018,36047027400,"Census Tract 274, Kings County, New York",1042,26,1016,613,1870,46932,0,2007,1345,37.8,137,346,15,130,122,1016,146
2019,36047027400,"Census Tract 274, Kings County, New York",1019,8,1011,567,1848,53244,0,2010,1585,36,159,306,11,115,113,1011,123
2020,36047027400,"Census Tract 274, Kings County, New York",1055,60,995,540,1701,41935,0,2010,1391,32.4,154,274,11,154,81,995,125
2012,36047027500,"Census Tract 275, Kings County, New York",1877,319,1558,1087,2682,49816,1939,2005,1204,28.6,443,164,857,41,40,1558,356
2013,36047027500,"Census Tract 275, Kings County, New York",1872,271,1601,1038,2623,41667,1939,2006,1180,35,400,112,814,55,64,1601,363
2014,36047027500,"Census Tract 275, Kings County, New York",1860,280,1580,1044,2582,44861,1939,2008,1264,32.4,395,181,736,62,91,1580,360
2015,36047027500,"Census Tract 275, Kings County, New York",1890,293,1597,1071,2692,46076,1939,2010,1397,31.7,398,164,784,69,89,1597,361
2016,36047027500,"Census Tract 275, Kings County, New York",1953,306,1647,1047,2675,52668,1939,2011,1538,29.3,405,200,715,68,55,1647,337
2017,36047027500,"Census Tract 275, Kings County, New York",1958,292,1666,1009,2585,59575,1939,2011,1681,28.4,400,217,631,77,59,1666,257
2018,36047027500,"Census Tract 275, Kings County, New York",1958,287,1671,1060,2440,66000,0,2012,1798,29.1,437,257,633,78,63,1671,286
2019,36047027500,"Census Tract 275, Kings County, New York",2036,252,1784,1250,2706,71989,0,2014,1828,28.4,575,330,738,92,62,1784,294
2020,36047027500,"Census Tract 275, Kings County, New York",1924,122,1802,1227,2853,80215,0,2015,1749,26.6,641,352,656,96,111,1802,283
2012,36047027600,"Census Tract 276, Kings County, New York",1290,69,1221,914,2709,33614,1939,2004,1019,34.4,128,385,12,262,257,1221,175
2013,36047027600,"Census Tract 276, Kings County, New York",1254,52,1202,932,2795,34015,1939,2005,1058,34.7,143,385,12,284,251,1202,208
2014,36047027600,"Census Tract 276, Kings County, New York",1293,40,1253,969,3522,42212,1939,2006,1234,33.9,224,381,10,303,268,1253,238
2015,36047027600,"Census Tract 276, Kings County, New York",1259,56,1203,958,3336,45444,1939,2008,1222,33,223,434,12,296,219,1203,322
2016,36047027600,"Census Tract 276, Kings County, New York",1245,36,1209,1058,3559,50086,1939,2009,1238,30.3,221,458,10,358,242,1209,275
2017,36047027600,"Census Tract 276, Kings County, New York",1274,78,1196,1033,3373,50781,1939,2009,1341,32.1,262,405,11,405,223,1196,296
2018,36047027600,"Census Tract 276, Kings County, New York",1280,87,1193,1056,3301,51804,0,2010,1337,30.1,298,454,9,330,248,1193,255
2019,36047027600,"Census Tract 276, Kings County, New York",1272,98,1174,1027,3114,52726,0,2010,1381,31.1,261,423,10,326,253,1174,222
2020,36047027600,"Census Tract 276, Kings County, New York",1295,87,1208,1034,3044,60523,0,2011,1415,27.9,249,381,29,255,352,1208,159
2012,36047027700,"Census Tract 277, Kings County, New York",1812,318,1494,1318,4051,27857,1939,2004,1050,33.3,200,22,1201,32,147,1494,541
2013,36047027700,"Census Tract 277, Kings County, New York",1761,275,1486,1303,3753,28187,1939,2005,1064,33.1,203,38,1167,21,126,1486,540
2014,36047027700,"Census Tract 277, Kings County, New York",1782,271,1511,1288,3782,28355,1939,2005,1063,35,195,31,1176,0,129,1511,572
2015,36047027700,"Census Tract 277, Kings County, New York",1799,192,1607,1393,4169,NA,1939,2004,1126,33.4,247,62,1195,0,165,1607,548
2016,36047027700,"Census Tract 277, Kings County, New York",1835,182,1653,1361,3907,35924,1939,2007,1207,36.9,254,91,1123,25,134,1653,510
2017,36047027700,"Census Tract 277, Kings County, New York",1844,159,1685,1315,3512,38472,1939,2006,1188,34.8,274,95,1096,22,118,1685,471
2018,36047027700,"Census Tract 277, Kings County, New York",1929,164,1765,1362,3341,38750,0,2007,1254,35.9,355,115,1114,23,128,1765,450
2019,36047027700,"Census Tract 277, Kings County, New York",1920,161,1759,1371,3428,43111,0,2009,1359,34,385,141,1104,20,126,1759,404
2020,36047027700,"Census Tract 277, Kings County, New York",1894,212,1682,1256,3278,46010,1963,2011,1489,32.2,418,120,1006,26,131,1682,297
2012,36047027800,"Census Tract 278, Kings County, New York",1217,26,1191,902,2115,29065,1945,2002,1086,36.9,260,679,0,132,90,1191,207
2013,36047027800,"Census Tract 278, Kings County, New York",1185,30,1155,896,2032,28434,1939,2003,1110,37.3,316,684,0,161,62,1155,227
2014,36047027800,"Census Tract 278, Kings County, New York",1199,29,1170,835,2113,32446,1939,2003,1177,38.6,310,559,0,202,84,1170,214
2015,36047027800,"Census Tract 278, Kings County, New York",1244,41,1203,826,2304,32321,1948,2004,1233,39.8,343,530,0,221,86,1203,263
2016,36047027800,"Census Tract 278, Kings County, New York",1210,10,1200,816,2400,40694,1948,2005,1350,36.6,315,545,14,169,88,1200,216
2017,36047027800,"Census Tract 278, Kings County, New York",1189,11,1178,814,1992,50724,1944,2006,1333,29.1,316,558,19,195,42,1178,203
2018,36047027800,"Census Tract 278, Kings County, New York",1206,10,1196,751,1851,45208,1950,2009,1407,32,236,466,18,199,68,1196,190
2019,36047027800,"Census Tract 278, Kings County, New York",1216,9,1207,861,1982,56325,1950,2012,1562,30,296,520,60,206,113,1207,211
2020,36047027800,"Census Tract 278, Kings County, New York",1162,0,1162,782,1933,55461,1952,2012,1551,31.4,260,478,53,180,103,1162,150
2012,36047027900,"Census Tract 279, Kings County, New York",1745,332,1413,1019,2402,36701,1939,2004,959,31.6,192,34,870,65,126,1413,284
2013,36047027900,"Census Tract 279, Kings County, New York",1741,337,1404,954,2427,39700,1939,2005,1019,31.2,188,52,760,70,119,1404,278
2014,36047027900,"Census Tract 279, Kings County, New York",1757,250,1507,970,2389,39405,1939,2004,1016,28.8,243,42,801,54,94,1507,263
2015,36047027900,"Census Tract 279, Kings County, New York",1784,305,1479,1051,2551,42734,1939,2008,1069,28.3,259,107,876,0,132,1479,259
2016,36047027900,"Census Tract 279, Kings County, New York",1796,280,1516,1109,2796,51250,1939,2009,1146,27.2,339,119,912,10,110,1516,247
2017,36047027900,"Census Tract 279, Kings County, New York",1824,334,1490,1045,2511,54056,1939,2010,1178,27.5,358,166,791,14,77,1490,255
2018,36047027900,"Census Tract 279, Kings County, New York",1842,287,1555,1114,2553,56250,0,2010,1299,27.8,422,186,795,18,62,1555,268
2019,36047027900,"Census Tract 279, Kings County, New York",1881,303,1578,1126,2539,57317,0,2011,1460,28.2,488,255,738,34,64,1578,294
2020,36047027900,"Census Tract 279, Kings County, New York",1861,232,1629,1170,2454,63061,0,2015,1574,32.1,611,318,694,37,79,1629,245
2012,36047028000,"Census Tract 280, Kings County, New York",664,32,632,261,792,36394,1941,2001,989,34.2,75,125,0,66,48,632,46
2013,36047028000,"Census Tract 280, Kings County, New York",663,61,602,211,586,32708,1945,2002,1000,36.4,65,107,0,43,35,602,34
2014,36047028000,"Census Tract 280, Kings County, New York",679,56,623,256,573,45000,1953,2007,1133,32.8,108,123,0,87,20,623,57
2015,36047028000,"Census Tract 280, Kings County, New York",670,50,620,287,674,50114,1949,2009,1176,31.5,109,139,5,105,30,620,85
2016,36047028000,"Census Tract 280, Kings County, New York",681,72,609,284,681,57609,1950,2011,1195,28.6,87,132,13,107,24,609,94
2017,36047028000,"Census Tract 280, Kings County, New York",690,70,620,325,864,55938,1947,2011,1276,27.8,79,149,13,118,38,620,115
2018,36047028000,"Census Tract 280, Kings County, New York",683,54,629,332,913,64688,1948,2012,1333,25.5,111,153,13,121,45,629,124
2019,36047028000,"Census Tract 280, Kings County, New York",679,50,629,317,959,63807,1945,2013,1352,24.6,68,151,36,103,47,629,97
2020,36047028000,"Census Tract 280, Kings County, New York",688,35,653,293,871,87375,0,2014,1480,21.6,72,116,27,93,76,653,82
2012,36047028100,"Census Tract 281, Kings County, New York",1745,105,1640,1499,4118,21120,1939,2004,790,28.3,261,80,908,0,527,1640,676
2013,36047028100,"Census Tract 281, Kings County, New York",1723,118,1605,1415,4171,24673,1939,2004,775,26.5,265,109,838,5,501,1605,674
2014,36047028100,"Census Tract 281, Kings County, New York",1766,76,1690,1497,4352,17583,1962,2005,745,30.2,273,126,879,4,535,1690,764
2015,36047028100,"Census Tract 281, Kings County, New York",1783,97,1686,1502,4212,17979,1962,2005,728,32.3,267,145,851,7,532,1686,776
2016,36047028100,"Census Tract 281, Kings County, New York",1836,121,1715,1513,4028,20804,1965,2006,753,31.7,318,136,803,27,520,1715,769
2017,36047028100,"Census Tract 281, Kings County, New York",1902,118,1784,1570,4300,24886,1968,2009,801,32.1,317,165,765,38,551,1784,751
2018,36047028100,"Census Tract 281, Kings County, New York",1962,136,1826,1591,3831,20104,1968,2010,834,32.9,340,214,749,24,540,1826,744
2019,36047028100,"Census Tract 281, Kings County, New York",2035,166,1869,1656,3988,28622,1968,2011,943,32.4,360,269,814,37,475,1869,619
2020,36047028100,"Census Tract 281, Kings County, New York",1949,142,1807,1664,4142,28803,1969,2012,1105,33.4,315,246,857,38,445,1807,566
2012,36047028200,"Census Tract 282, Kings County, New York",1299,54,1245,754,1735,33657,1953,2004,1157,41.7,171,494,0,212,48,1245,237
2013,36047028200,"Census Tract 282, Kings County, New York",1288,35,1253,746,1681,34472,1954,2005,1244,41.9,162,516,0,192,38,1253,200
2014,36047028200,"Census Tract 282, Kings County, New York",1319,104,1215,681,1529,39297,1955,2005,1291,44.1,195,500,0,145,36,1215,196
2015,36047028200,"Census Tract 282, Kings County, New York",1317,87,1230,757,1757,38875,1956,2005,1268,45.3,215,548,0,150,39,1230,192
2016,36047028200,"Census Tract 282, Kings County, New York",1296,49,1247,843,2121,57560,1955,2005,1413,29.5,331,607,0,164,52,1247,162
2017,36047028200,"Census Tract 282, Kings County, New York",1301,58,1243,756,2108,52250,1957,2006,1484,31.6,308,558,0,143,37,1243,187
2018,36047028200,"Census Tract 282, Kings County, New York",1269,57,1212,710,2078,52451,1960,2008,1596,32.4,366,412,0,216,57,1212,215
2019,36047028200,"Census Tract 282, Kings County, New York",1293,63,1230,721,2112,61932,1959,2010,1469,31.5,299,355,50,202,74,1230,225
2020,36047028200,"Census Tract 282, Kings County, New York",1389,31,1358,744,1979,62500,1957,2012,1597,32.2,377,374,136,141,79,1358,208
2012,36047028300,"Census Tract 283, Kings County, New York",1561,257,1304,1179,2963,18368,1964,2003,649,30.8,114,30,618,58,512,1304,595
2013,36047028300,"Census Tract 283, Kings County, New York",1571,180,1391,1279,3138,16793,1964,2004,713,30.8,98,41,720,45,538,1391,648
2014,36047028300,"Census Tract 283, Kings County, New York",1581,187,1394,1312,3157,19848,1960,2006,746,29.2,75,64,679,46,566,1394,586
2015,36047028300,"Census Tract 283, Kings County, New York",1588,172,1416,1325,3494,NA,1960,2006,802,29.8,101,80,739,49,528,1416,536
2016,36047028300,"Census Tract 283, Kings County, New York",1590,180,1410,1294,3439,28810,1963,2009,891,31.6,131,129,722,62,442,1410,555
2017,36047028300,"Census Tract 283, Kings County, New York",1558,178,1380,1300,3420,32321,1962,2010,888,31.2,228,197,658,14,484,1380,579
2018,36047028300,"Census Tract 283, Kings County, New York",1555,158,1397,1275,3218,26806,1960,2011,975,36.7,312,246,568,33,452,1397,597
2019,36047028300,"Census Tract 283, Kings County, New York",1537,130,1407,1303,3151,26976,1958,2011,991,38.4,368,268,551,29,480,1407,546
2020,36047028300,"Census Tract 283, Kings County, New York",1564,109,1455,1216,2894,25789,1954,2011,1279,38,456,272,466,46,412,1455,533
2012,36047028400,"Census Tract 284, Kings County, New York",1366,55,1311,1016,2666,35278,1939,2003,1051,35.7,102,639,6,101,254,1311,145
2013,36047028400,"Census Tract 284, Kings County, New York",1349,41,1308,949,2640,35536,1939,2004,1097,33.5,141,603,7,156,167,1308,235
2014,36047028400,"Census Tract 284, Kings County, New York",1342,15,1327,1035,2801,40646,1939,2005,1116,30,182,664,16,173,165,1327,241
2015,36047028400,"Census Tract 284, Kings County, New York",1343,72,1271,1018,2820,47895,1939,2005,1154,27.8,252,646,17,240,97,1271,258
2016,36047028400,"Census Tract 284, Kings County, New York",1370,98,1272,1030,2902,51935,1939,2007,1204,27.8,259,624,9,263,134,1272,247
2017,36047028400,"Census Tract 284, Kings County, New York",1413,117,1296,1077,3079,48125,1939,2007,1290,29.4,319,611,18,305,133,1296,264
2018,36047028400,"Census Tract 284, Kings County, New York",1409,140,1269,1102,3066,51300,0,2008,1326,29.4,375,624,17,272,170,1269,240
2019,36047028400,"Census Tract 284, Kings County, New York",1411,166,1245,1061,2989,57260,0,2009,1421,28.7,379,506,8,304,223,1245,187
2020,36047028400,"Census Tract 284, Kings County, New York",1522,125,1397,1215,2907,60157,0,2010,1535,33,510,541,14,288,353,1397,282
2012,36047028501,"Census Tract 285.01, Kings County, New York",84,0,84,80,331,100682,1939,2006,1786,27.7,45,21,0,0,59,84,9
2013,36047028501,"Census Tract 285.01, Kings County, New York",79,8,71,67,303,94250,1939,2007,2001,28.1,30,41,0,0,26,71,11
2014,36047028501,"Census Tract 285.01, Kings County, New York",102,8,94,81,358,102958,1939,2007,2001,27.4,41,51,0,0,30,94,10
2015,36047028501,"Census Tract 285.01, Kings County, New York",95,8,87,66,234,NA,1939,2006,1941,22.6,48,47,0,0,19,87,7
2016,36047028501,"Census Tract 285.01, Kings County, New York",129,23,106,88,376,95250,1939,2009,2111,21.6,52,51,0,4,33,106,20
2017,36047028501,"Census Tract 285.01, Kings County, New York",148,32,116,96,402,92368,1939,2009,1967,21.7,53,46,0,4,46,116,14
2018,36047028501,"Census Tract 285.01, Kings County, New York",160,32,128,108,405,93824,0,2009,2125,23.5,65,49,0,8,51,128,32
2019,36047028501,"Census Tract 285.01, Kings County, New York",164,32,132,122,410,87778,0,2011,1545,27.5,71,37,14,13,58,132,34
2020,36047028501,"Census Tract 285.01, Kings County, New York",183,31,152,152,362,56842,2011,2016,1484,32.6,82,45,13,18,67,152,57
2012,36047028502,"Census Tract 285.02, Kings County, New York",1173,34,1139,1132,2731,21170,1956,1990,449,26.1,84,0,688,0,528,1139,405
2013,36047028502,"Census Tract 285.02, Kings County, New York",1167,33,1134,1124,2723,20888,1956,1988,454,26.7,68,0,684,0,498,1134,430
2014,36047028502,"Census Tract 285.02, Kings County, New York",1172,38,1134,1124,2542,20086,1955,1986,470,27.6,77,0,766,0,413,1134,434
2015,36047028502,"Census Tract 285.02, Kings County, New York",1181,9,1172,1162,2616,14986,1956,1991,437,30,74,0,768,13,415,1172,552
2016,36047028502,"Census Tract 285.02, Kings County, New York",1194,11,1183,1171,2737,16781,1955,1993,435,30.3,103,0,715,12,468,1183,535
2017,36047028502,"Census Tract 285.02, Kings County, New York",1184,0,1184,1184,2938,18850,1955,1995,471,30.4,104,0,838,14,408,1184,536
2018,36047028502,"Census Tract 285.02, Kings County, New York",1194,0,1194,1194,3131,22115,1954,1999,530,28.1,93,0,810,18,458,1194,490
2019,36047028502,"Census Tract 285.02, Kings County, New York",1208,51,1157,1157,3205,23899,1954,2002,548,27.7,91,0,801,25,474,1157,455
2020,36047028502,"Census Tract 285.02, Kings County, New York",1171,39,1132,1132,2937,40375,1955,1998,584,23.4,78,0,724,6,531,1132,306
2012,36047028600,"Census Tract 286, Kings County, New York",2102,183,1919,1750,3765,38500,1946,2003,981,29.2,556,1319,76,122,198,1919,400
2013,36047028600,"Census Tract 286, Kings County, New York",2128,233,1895,1722,3937,43482,1947,2004,1046,28.2,599,1275,20,160,229,1895,290
2014,36047028600,"Census Tract 286, Kings County, New York",2141,128,2013,1812,4287,48142,1947,2004,1107,28.9,744,1218,14,267,279,2013,352
2015,36047028600,"Census Tract 286, Kings County, New York",2115,88,2027,1878,4326,41444,1948,2005,1120,29.7,826,1206,94,310,268,2027,433
2016,36047028600,"Census Tract 286, Kings County, New York",2099,123,1976,1818,4249,40625,1948,2007,1257,32.3,771,1157,70,345,246,1976,425
2017,36047028600,"Census Tract 286, Kings County, New York",2123,102,2021,1864,4674,39773,1947,2009,1317,35.1,891,1207,72,373,164,2021,452
2018,36047028600,"Census Tract 286, Kings County, New York",2070,84,1986,1853,4628,40799,1946,2009,1356,33.7,827,1127,71,333,219,1986,507
2019,36047028600,"Census Tract 286, Kings County, New York",2067,107,1960,1862,4842,38750,1945,2010,1473,40.4,734,1174,68,275,189,1960,464
2020,36047028600,"Census Tract 286, Kings County, New York",1959,111,1848,1676,4728,38545,1944,2012,1528,38.6,678,1086,11,254,204,1848,428
2012,36047028700,"Census Tract 287, Kings County, New York",1220,140,1080,956,2638,29524,1952,2002,922,30.8,212,147,507,29,322,1080,370
2013,36047028700,"Census Tract 287, Kings County, New York",1197,182,1015,887,2233,22568,1957,2002,836,33.9,157,113,524,42,236,1015,376
2014,36047028700,"Census Tract 287, Kings County, New York",1218,164,1054,876,2107,18886,1952,2004,639,33.2,137,104,463,49,255,1054,379
2015,36047028700,"Census Tract 287, Kings County, New York",1172,154,1018,811,1846,28165,1949,2004,752,35.3,145,119,479,71,219,1018,331
2016,36047028700,"Census Tract 287, Kings County, New York",1202,82,1120,852,1874,22196,1940,2008,670,37.4,155,120,440,100,256,1120,394
2017,36047028700,"Census Tract 287, Kings County, New York",1257,77,1180,931,1964,23403,1945,2006,669,34.4,185,122,460,73,365,1180,391
2018,36047028700,"Census Tract 287, Kings County, New York",1274,34,1240,990,2204,29136,1940,2010,1090,32.8,226,171,431,103,378,1240,362
2019,36047028700,"Census Tract 287, Kings County, New York",1303,18,1285,1026,2294,38093,1942,2010,1257,32.6,293,237,441,108,332,1285,341
2020,36047028700,"Census Tract 287, Kings County, New York",1351,19,1332,1065,2348,49375,1961,2013,1434,29.6,380,263,363,119,443,1332,352
2012,36047028800,"Census Tract 288, Kings County, New York",1099,81,1018,733,1886,26420,1939,2001,993,35.9,152,375,6,226,126,1018,251
2013,36047028800,"Census Tract 288, Kings County, New York",1109,67,1042,759,1882,32889,1939,2003,1023,29.4,192,414,6,238,81,1042,217
2014,36047028800,"Census Tract 288, Kings County, New York",1170,53,1117,827,2107,32679,1939,2005,1083,35.8,268,511,7,210,80,1117,266
2015,36047028800,"Census Tract 288, Kings County, New York",1247,61,1186,909,2605,37031,1939,2006,1137,31.9,274,526,8,210,143,1186,273
2016,36047028800,"Census Tract 288, Kings County, New York",1194,34,1160,844,2529,42109,1939,2008,1232,29.2,251,501,8,200,114,1160,205
2017,36047028800,"Census Tract 288, Kings County, New York",1213,36,1177,830,2634,42019,1939,2008,1254,32.5,238,470,0,232,108,1177,210
2018,36047028800,"Census Tract 288, Kings County, New York",1163,70,1093,760,2498,42586,0,2007,1386,36.8,194,430,9,189,132,1093,205
2019,36047028800,"Census Tract 288, Kings County, New York",1210,55,1155,835,2808,53977,0,2007,1456,27.1,224,440,9,175,211,1155,197
2020,36047028800,"Census Tract 288, Kings County, New York",1051,70,981,647,2021,50729,0,2006,1453,31.9,174,388,9,102,148,981,158
2012,36047028900,"Census Tract 289, Kings County, New York",1568,164,1404,1138,2482,20500,1942,2003,968,29.1,216,42,718,0,367,1404,456
2013,36047028900,"Census Tract 289, Kings County, New York",1548,199,1349,1163,2832,21643,1948,2003,930,30.7,165,80,690,0,425,1349,440
2014,36047028900,"Census Tract 289, Kings County, New York",1530,141,1389,1225,2640,21917,1949,2005,955,29.4,216,117,729,0,385,1389,398
2015,36047028900,"Census Tract 289, Kings County, New York",1498,157,1341,1175,2615,28750,1939,2005,1031,29.2,267,152,752,0,290,1341,357
2016,36047028900,"Census Tract 289, Kings County, New York",1514,148,1366,1113,2583,29939,1939,2007,1016,29.6,271,169,622,7,329,1366,337
2017,36047028900,"Census Tract 289, Kings County, New York",1518,181,1337,1058,2740,36316,1951,2008,1108,29.4,301,176,582,7,246,1337,384
2018,36047028900,"Census Tract 289, Kings County, New York",1543,192,1351,1035,2648,29375,1942,2010,1055,31,334,214,492,8,264,1351,410
2019,36047028900,"Census Tract 289, Kings County, New York",1550,231,1319,1030,2582,35000,1952,2011,1180,31.1,324,222,475,58,229,1319,363
2020,36047028900,"Census Tract 289, Kings County, New York",1675,188,1487,1121,2474,32539,0,2010,1179,31.8,449,220,611,40,231,1487,414
2012,36047029000,"Census Tract 290, Kings County, New York",1566,77,1489,1232,3203,35254,1940,2002,1132,30.3,308,895,50,121,157,1489,288
2013,36047029000,"Census Tract 290, Kings County, New York",1577,83,1494,1179,3092,38814,1939,2002,1149,29.8,284,890,35,111,136,1494,285
2014,36047029000,"Census Tract 290, Kings County, New York",1581,73,1508,1150,3380,44314,1939,2004,1256,31.8,284,852,15,125,151,1508,296
2015,36047029000,"Census Tract 290, Kings County, New York",1607,68,1539,1150,3049,41500,1939,2005,1244,33.1,371,879,16,126,129,1539,241
2016,36047029000,"Census Tract 290, Kings County, New York",1595,40,1555,1145,2995,46542,1939,2006,1228,32.3,420,862,17,178,88,1555,228
2017,36047029000,"Census Tract 290, Kings County, New York",1598,18,1580,1240,3385,46771,1939,2007,1320,32.3,458,946,0,203,71,1580,220
2018,36047029000,"Census Tract 290, Kings County, New York",1580,7,1573,1291,3388,42199,0,2009,1332,34.5,529,917,0,242,72,1573,243
2019,36047029000,"Census Tract 290, Kings County, New York",1550,92,1458,1213,2937,39542,0,2010,1380,41.1,573,863,0,226,57,1458,255
2020,36047029000,"Census Tract 290, Kings County, New York",1674,105,1569,1378,3071,37281,1943,2012,1362,41.6,752,910,0,210,188,1569,366
2012,36047029100,"Census Tract 291, Kings County, New York",1418,351,1067,788,2014,25540,1939,2005,1091,45.9,68,51,621,33,147,1067,236
2013,36047029100,"Census Tract 291, Kings County, New York",1396,298,1098,835,1976,27156,1939,2005,1110,43.7,92,40,686,26,153,1098,217
2014,36047029100,"Census Tract 291, Kings County, New York",1440,356,1084,775,2085,25602,1939,2006,1187,38.7,74,80,614,0,101,1084,233
2015,36047029100,"Census Tract 291, Kings County, New York",1442,389,1053,747,1660,24321,1939,2008,1117,35.5,102,93,551,0,85,1053,204
2016,36047029100,"Census Tract 291, Kings County, New York",1426,329,1097,844,1963,33750,1939,2010,1244,35.2,192,153,586,0,90,1097,139
2017,36047029100,"Census Tract 291, Kings County, New York",1381,270,1111,857,2046,40063,1939,2011,1356,34.4,240,159,602,0,93,1111,158
2018,36047029100,"Census Tract 291, Kings County, New York",1432,323,1109,829,2020,52058,0,2011,1413,30.2,261,180,541,0,98,1109,132
2019,36047029100,"Census Tract 291, Kings County, New York",1456,254,1202,935,2139,64363,0,2012,1472,27.4,326,175,611,0,138,1202,118
2020,36047029100,"Census Tract 291, Kings County, New York",1471,170,1301,1043,2422,66028,0,2014,1437,24.2,441,206,697,0,129,1301,95
2012,36047029200,"Census Tract 292, Kings County, New York",923,133,790,577,1348,27099,1939,2003,1012,32.4,82,417,22,65,72,790,169
2013,36047029200,"Census Tract 292, Kings County, New York",960,119,841,615,1549,28125,1939,2004,1071,33.8,128,395,19,64,135,841,206
2014,36047029200,"Census Tract 292, Kings County, New York",993,145,848,619,1553,33708,1939,2005,1122,37.6,96,375,23,88,130,848,191
2015,36047029200,"Census Tract 292, Kings County, New York",1012,105,907,656,1703,36343,1939,2007,1167,34.3,178,425,42,55,132,907,208
2016,36047029200,"Census Tract 292, Kings County, New York",1020,89,931,666,1836,37969,1939,2009,1216,33.9,225,417,31,89,129,931,220
2017,36047029200,"Census Tract 292, Kings County, New York",1029,79,950,681,2019,39199,1939,2010,1317,35.2,251,403,26,97,155,950,225
2018,36047029200,"Census Tract 292, Kings County, New York",1041,89,952,738,2025,47500,0,2012,1457,34.8,252,436,28,101,165,952,193
2019,36047029200,"Census Tract 292, Kings County, New York",1053,56,997,784,2312,48000,0,2013,1577,32.8,303,447,26,104,196,997,242
2020,36047029200,"Census Tract 292, Kings County, New York",1073,58,1015,809,2115,37835,0,2013,1572,40.2,363,466,4,109,213,1015,239
2012,36047029300,"Census Tract 293, Kings County, New York",1391,66,1325,1037,2416,21899,1966,2000,721,32.9,78,28,804,0,184,1325,309
2013,36047029300,"Census Tract 293, Kings County, New York",1422,91,1331,985,2315,21447,1970,1999,718,32,46,32,792,0,141,1331,367
2014,36047029300,"Census Tract 293, Kings County, New York",1471,97,1374,1006,2318,22857,1968,2002,753,31.7,143,50,777,0,167,1374,317
2015,36047029300,"Census Tract 293, Kings County, New York",1548,155,1393,1086,2660,NA,1963,2006,828,32.1,200,20,796,0,228,1393,377
2016,36047029300,"Census Tract 293, Kings County, New York",1495,154,1341,1046,2477,30074,1960,2006,942,32,237,53,748,0,246,1341,407
2017,36047029300,"Census Tract 293, Kings County, New York",1516,167,1349,1027,2125,31550,1953,2005,915,31,261,76,751,0,250,1349,349
2018,36047029300,"Census Tract 293, Kings County, New York",1544,170,1374,1094,2335,31212,1943,2008,988,32.8,304,100,752,8,272,1374,420
2019,36047029300,"Census Tract 293, Kings County, New York",1607,182,1425,1149,2501,35842,1952,2011,970,29.6,269,126,760,9,280,1425,399
2020,36047029300,"Census Tract 293, Kings County, New York",1484,133,1351,1067,2296,36310,0,2008,1018,28.3,235,121,802,19,173,1351,409
2012,36047029400,"Census Tract 294, Kings County, New York",584,33,551,475,1083,37450,1939,2000,1008,29.5,135,309,20,72,70,551,81
2013,36047029400,"Census Tract 294, Kings County, New York",624,25,599,496,1213,47500,1950,2000,1044,28.1,117,310,23,76,93,599,83
2014,36047029400,"Census Tract 294, Kings County, New York",618,31,587,478,1237,44545,1951,2004,1138,30.6,149,310,25,80,69,587,106
2015,36047029400,"Census Tract 294, Kings County, New York",625,14,611,497,1304,48393,1950,2004,1188,30.1,130,307,34,81,79,611,107
2016,36047029400,"Census Tract 294, Kings County, New York",622,0,622,517,1341,50417,1951,2005,1229,30.7,141,302,33,99,89,622,112
2017,36047029400,"Census Tract 294, Kings County, New York",637,17,620,507,1332,45809,1950,2007,1283,35.2,152,279,48,68,104,620,134
2018,36047029400,"Census Tract 294, Kings County, New York",627,16,611,488,1326,43636,1950,2010,1337,36.9,142,256,36,96,88,611,128
2019,36047029400,"Census Tract 294, Kings County, New York",629,33,596,485,1317,55739,1951,2011,1404,33.9,151,258,36,95,85,596,113
2020,36047029400,"Census Tract 294, Kings County, New York",643,30,613,527,1484,61932,1945,2013,1576,29.2,188,252,18,99,147,613,107
2012,36047029500,"Census Tract 295, Kings County, New York",1927,424,1503,882,1617,50814,1939,2004,1182,24.6,287,48,723,34,88,1503,280
2013,36047029500,"Census Tract 295, Kings County, New York",1895,330,1565,951,1841,52188,1939,2005,1169,23.6,328,112,732,25,69,1565,296
2014,36047029500,"Census Tract 295, Kings County, New York",1898,331,1567,979,2029,40371,1939,2006,1189,28.8,329,136,706,31,84,1567,350
2015,36047029500,"Census Tract 295, Kings County, New York",1921,348,1573,930,1982,38430,1939,2007,1264,33.8,343,182,672,3,57,1573,394
2016,36047029500,"Census Tract 295, Kings County, New York",1913,296,1617,1054,2128,41277,1939,2009,1367,32.7,494,248,713,7,63,1617,420
2017,36047029500,"Census Tract 295, Kings County, New York",1949,327,1622,1103,2268,41497,1939,2010,1460,39.9,628,248,704,6,95,1622,378
2018,36047029500,"Census Tract 295, Kings County, New York",1970,257,1713,1163,2442,44712,0,2011,1442,34.1,724,237,763,10,115,1713,388
2019,36047029500,"Census Tract 295, Kings County, New York",1980,236,1744,1157,2289,52212,0,2014,1433,29.5,693,329,685,0,122,1744,389
2020,36047029500,"Census Tract 295, Kings County, New York",1976,174,1802,1350,2753,53438,0,2016,1753,31.4,741,413,805,0,102,1802,393
2012,36047029600,"Census Tract 296, Kings County, New York",2024,68,1956,1346,2861,34643,1943,2001,1022,34.5,319,1165,18,106,71,1956,315
2013,36047029600,"Census Tract 296, Kings County, New York",1995,64,1931,1396,3055,30192,1939,2003,1042,34.3,306,1126,17,201,68,1931,346
2014,36047029600,"Census Tract 296, Kings County, New York",2080,20,2060,1539,3760,27574,1939,2004,1157,42,396,1191,0,261,66,2060,399
2015,36047029600,"Census Tract 296, Kings County, New York",2037,13,2024,1401,3666,30360,1940,2006,1213,37.1,415,1042,0,270,84,2024,410
2016,36047029600,"Census Tract 296, Kings County, New York",1982,10,1972,1317,3391,34135,1940,2008,1313,39,413,1013,0,218,72,1972,311
2017,36047029600,"Census Tract 296, Kings County, New York",2013,0,2013,1318,3681,36094,1941,2010,1395,42.7,542,966,0,256,78,2013,319
2018,36047029600,"Census Tract 296, Kings County, New York",2072,40,2032,1375,3785,32384,1944,2010,1467,51,562,990,0,194,158,2032,472
2019,36047029600,"Census Tract 296, Kings County, New York",2130,35,2095,1446,4073,40688,1940,2011,1597,41.2,592,974,0,216,234,2095,505
2020,36047029600,"Census Tract 296, Kings County, New York",2121,28,2093,1560,4085,41240,1941,2011,1626,46.3,591,1157,0,200,185,2093,491
2012,36047029700,"Census Tract 297, Kings County, New York",1718,260,1458,928,1953,34143,1939,2004,1333,48.8,277,40,773,29,61,1458,395
2013,36047029700,"Census Tract 297, Kings County, New York",1693,304,1389,859,2031,32372,1939,2005,1449,43.1,299,58,697,70,34,1389,437
2014,36047029700,"Census Tract 297, Kings County, New York",1685,287,1398,836,2100,38750,1939,2006,1455,39.1,328,54,670,90,68,1398,410
2015,36047029700,"Census Tract 297, Kings County, New York",1733,238,1495,934,2217,44519,1939,2007,1460,38.8,385,81,718,99,77,1495,377
2016,36047029700,"Census Tract 297, Kings County, New York",1793,198,1595,938,2159,46458,1939,2008,1509,37,402,138,719,61,82,1595,327
2017,36047029700,"Census Tract 297, Kings County, New York",1803,171,1632,965,2168,46845,1939,2009,1516,35,408,172,734,48,79,1632,322
2018,36047029700,"Census Tract 297, Kings County, New York",1843,155,1688,985,2121,50380,0,2010,1628,34,415,181,752,29,87,1688,317
2019,36047029700,"Census Tract 297, Kings County, New York",1885,117,1768,957,1826,48018,0,2011,1706,35.7,387,208,716,10,47,1768,265
2020,36047029700,"Census Tract 297, Kings County, New York",1931,131,1800,1012,1986,47237,0,2013,1952,51,332,190,794,0,33,1800,375
2012,36047029800,"Census Tract 298, Kings County, New York",1329,52,1277,851,2267,40875,1939,2004,1032,32.2,176,503,25,71,221,1277,139
2013,36047029800,"Census Tract 298, Kings County, New York",1361,66,1295,886,2604,38947,1939,2005,1122,33.3,243,475,30,105,257,1295,165
2014,36047029800,"Census Tract 298, Kings County, New York",1390,65,1325,905,2416,48450,1939,2005,1193,30.9,300,494,0,130,263,1325,130
2015,36047029800,"Census Tract 298, Kings County, New York",1358,69,1289,886,2403,50570,1939,2006,1264,30.3,344,522,0,161,185,1289,151
2016,36047029800,"Census Tract 298, Kings County, New York",1412,138,1274,846,2496,40714,1939,2007,1281,35.9,256,407,14,183,193,1274,250
2017,36047029800,"Census Tract 298, Kings County, New York",1421,95,1326,833,2399,48125,1939,2008,1362,32.2,331,427,8,117,239,1326,201
2018,36047029800,"Census Tract 298, Kings County, New York",1326,62,1264,733,1894,52524,0,2006,1500,32.3,253,415,30,95,178,1264,213
2019,36047029800,"Census Tract 298, Kings County, New York",1301,30,1271,696,1800,44211,0,2006,1497,34.5,257,445,42,56,157,1271,235
2020,36047029800,"Census Tract 298, Kings County, New York",1336,63,1273,627,1596,43911,0,2010,1597,34.1,221,338,42,94,141,1273,375
2012,36047029900,"Census Tract 299, Kings County, New York",844,123,721,619,1780,21659,1989,2004,955,36.5,35,15,532,0,107,721,277
2013,36047029900,"Census Tract 299, Kings County, New York",888,115,773,668,1913,21837,1989,2004,971,39.4,22,17,563,6,138,773,277
2014,36047029900,"Census Tract 299, Kings County, New York",946,115,831,739,2018,22535,1989,2006,1051,40.1,26,16,589,6,157,831,337
2015,36047029900,"Census Tract 299, Kings County, New York",953,143,810,708,2035,20000,1987,2006,1108,46.5,41,16,563,5,148,810,371
2016,36047029900,"Census Tract 299, Kings County, New York",979,112,867,744,2059,25071,1987,2007,1244,49.5,62,18,601,17,150,867,337
2017,36047029900,"Census Tract 299, Kings County, New York",1010,95,915,751,2195,29952,1984,2009,1219,39.9,63,18,585,18,172,915,354
2018,36047029900,"Census Tract 299, Kings County, New York",1019,68,951,764,2145,34302,1984,2009,1216,35.4,103,22,554,11,216,951,329
2019,36047029900,"Census Tract 299, Kings County, New York",1090,69,1021,774,2023,38906,1983,2011,1242,31.9,139,66,515,12,208,1021,263
2020,36047029900,"Census Tract 299, Kings County, New York",924,53,871,622,1424,43125,1957,2012,1368,28.4,213,55,415,13,133,871,253
2012,36047030000,"Census Tract 300, Kings County, New York",1323,189,1134,716,1773,38333,1939,2002,1102,33.2,84,483,0,152,81,1134,99
2013,36047030000,"Census Tract 300, Kings County, New York",1291,179,1112,715,1887,38996,1939,2004,1096,32.4,86,468,0,131,116,1112,117
2014,36047030000,"Census Tract 300, Kings County, New York",1328,192,1136,716,1927,38902,1949,2006,1122,29.3,116,412,0,206,98,1136,177
2015,36047030000,"Census Tract 300, Kings County, New York",1357,133,1224,799,2499,48616,1951,2008,1203,30.4,164,430,0,244,125,1224,240
2016,36047030000,"Census Tract 300, Kings County, New York",1379,100,1279,895,2587,33368,1951,2010,1234,42.5,180,402,53,286,178,1279,294
2017,36047030000,"Census Tract 300, Kings County, New York",1386,74,1312,880,2594,36346,1953,2011,1259,35.6,236,338,49,323,182,1312,277
2018,36047030000,"Census Tract 300, Kings County, New York",1462,56,1406,946,2584,35069,1955,2011,1352,40.1,294,352,54,378,160,1406,296
2019,36047030000,"Census Tract 300, Kings County, New York",1448,67,1381,938,2652,35664,1947,2011,1406,41.5,263,337,96,320,225,1381,269
2020,36047030000,"Census Tract 300, Kings County, New York",1428,90,1338,873,2537,36530,1947,2011,1454,41.5,216,287,97,305,205,1338,241
2012,36047030100,"Census Tract 301, Kings County, New York",1232,194,1038,782,1876,33298,1939,2003,1081,35.3,100,0,610,0,78,1038,312
2013,36047030100,"Census Tract 301, Kings County, New York",1197,133,1064,811,1958,34205,1939,2004,1124,31.7,95,18,632,12,68,1064,330
2014,36047030100,"Census Tract 301, Kings County, New York",1159,118,1041,718,1954,47750,1939,2004,1165,26.9,74,33,592,25,75,1041,221
2015,36047030100,"Census Tract 301, Kings County, New York",1182,196,986,659,1831,40536,1939,2006,1231,29.2,74,29,531,19,110,986,258
2016,36047030100,"Census Tract 301, Kings County, New York",1204,183,1021,648,1563,41250,1939,2006,1285,29.4,103,27,514,19,111,1021,243
2017,36047030100,"Census Tract 301, Kings County, New York",1206,171,1035,651,1614,37446,1939,2010,1273,29.9,113,35,529,20,151,1035,305
2018,36047030100,"Census Tract 301, Kings County, New York",1237,149,1088,632,1524,39239,0,2011,1301,36.1,129,0,586,8,126,1088,289
2019,36047030100,"Census Tract 301, Kings County, New York",1256,184,1072,656,1654,32222,0,2011,1313,39.3,176,18,588,9,116,1072,285
2020,36047030100,"Census Tract 301, Kings County, New York",1293,156,1137,776,1926,58947,0,2015,1350,28.2,276,36,596,58,137,1137,254
2012,36047030200,"Census Tract 302, Kings County, New York",1528,98,1430,785,1792,41063,1939,2003,1076,33.2,148,338,25,274,148,1430,228
2013,36047030200,"Census Tract 302, Kings County, New York",1524,49,1475,747,1677,41142,1944,2004,1118,32.8,175,304,25,328,90,1475,194
2014,36047030200,"Census Tract 302, Kings County, New York",1565,28,1537,787,1889,42232,1951,2006,1162,30,187,348,25,311,95,1537,232
2015,36047030200,"Census Tract 302, Kings County, New York",1556,64,1492,867,2307,56250,1948,2008,1212,27.1,231,345,25,376,112,1492,263
2016,36047030200,"Census Tract 302, Kings County, New York",1630,44,1586,989,2538,56225,1952,2009,1230,27.2,297,421,33,422,106,1586,270
2017,36047030200,"Census Tract 302, Kings County, New York",1589,36,1553,928,2620,41935,1954,2010,1340,30,265,391,8,441,64,1553,214
2018,36047030200,"Census Tract 302, Kings County, New York",1539,49,1490,960,2753,48438,1953,2011,1377,29.2,285,437,7,422,66,1490,289
2019,36047030200,"Census Tract 302, Kings County, New York",1489,41,1448,857,2485,53245,1954,2010,1361,28.6,262,448,10,367,22,1448,253
2020,36047030200,"Census Tract 302, Kings County, New York",1460,55,1405,757,2171,53090,1956,2010,1391,27.2,234,354,8,338,13,1405,236
2012,36047030300,"Census Tract 303, Kings County, New York",1807,243,1564,1178,3611,18750,1961,2003,1039,44.5,84,9,1110,0,142,1564,621
2013,36047030300,"Census Tract 303, Kings County, New York",1777,186,1591,1245,3727,15672,1957,2003,1063,50,123,18,1158,9,154,1591,741
2014,36047030300,"Census Tract 303, Kings County, New York",1790,192,1598,1309,3996,16832,1958,2004,988,39.5,153,42,1151,26,148,1598,705
2015,36047030300,"Census Tract 303, Kings County, New York",1791,171,1620,1347,3858,15260,1961,2007,1056,50,136,37,1123,23,228,1620,719
2016,36047030300,"Census Tract 303, Kings County, New York",1822,141,1681,1312,3806,16860,1959,2010,1092,48.2,175,73,1023,42,236,1681,660
2017,36047030300,"Census Tract 303, Kings County, New York",1893,125,1768,1450,3776,22424,1962,2011,1053,34.4,217,75,1093,40,333,1768,578
2018,36047030300,"Census Tract 303, Kings County, New York",1967,115,1852,1470,3564,27962,1962,2011,930,33.3,196,58,1107,41,339,1852,496
2019,36047030300,"Census Tract 303, Kings County, New York",2020,88,1932,1570,3607,29765,1953,2011,926,31.5,208,79,1190,28,367,1932,509
2020,36047030300,"Census Tract 303, Kings County, New York",2276,110,2166,1826,3669,34219,1955,2013,951,31.6,230,132,1437,21,371,2166,571
2012,36047030400,"Census Tract 304, Kings County, New York",1658,126,1532,1014,2222,31765,1964,2002,1096,32.8,266,657,17,223,117,1532,313
2013,36047030400,"Census Tract 304, Kings County, New York",1664,144,1520,953,2066,32991,1962,2004,1146,31.8,232,599,17,190,139,1520,320
2014,36047030400,"Census Tract 304, Kings County, New York",1654,157,1497,967,2207,35972,1961,2005,1176,33.6,259,613,17,196,126,1497,334
2015,36047030400,"Census Tract 304, Kings County, New York",1603,130,1473,976,2147,32627,1961,2006,1090,33.5,225,647,16,170,129,1473,367
2016,36047030400,"Census Tract 304, Kings County, New York",1626,86,1540,973,2118,33432,1957,2007,1080,33.3,206,620,8,198,119,1540,315
2017,36047030400,"Census Tract 304, Kings County, New York",1652,80,1572,1029,2469,36657,1959,2010,1111,33.1,222,596,29,247,118,1572,308
2018,36047030400,"Census Tract 304, Kings County, New York",1684,57,1627,1151,2713,35993,1962,2010,1135,34.5,309,665,28,302,89,1627,362
2019,36047030400,"Census Tract 304, Kings County, New York",1700,24,1676,1264,3072,36667,1963,2011,1160,34.2,332,662,66,306,174,1676,391
2020,36047030400,"Census Tract 304, Kings County, New York",1802,75,1727,1325,3166,39830,1963,2012,1238,33.9,391,616,96,395,165,1727,403
2012,36047030500,"Census Tract 305, Kings County, New York",2744,303,2441,2105,4434,49229,1939,2005,1411,33.7,1160,879,803,143,299,2441,380
2013,36047030500,"Census Tract 305, Kings County, New York",2805,227,2578,2207,4712,47997,1939,2006,1429,34.7,1157,835,909,156,283,2578,381
2014,36047030500,"Census Tract 305, Kings County, New York",2794,265,2529,2208,4641,51565,1939,2007,1493,32.5,1178,930,847,91,311,2529,455
2015,36047030500,"Census Tract 305, Kings County, New York",2835,264,2571,2302,4937,63333,1939,2009,1545,29.9,1294,969,883,74,374,2571,451
2016,36047030500,"Census Tract 305, Kings County, New York",2895,208,2687,2458,5249,72377,1939,2011,1651,28.8,1455,1027,990,82,348,2687,444
2017,36047030500,"Census Tract 305, Kings County, New York",2966,153,2813,2591,5553,72656,1939,NA,1708,28.9,1499,1083,1011,118,363,2813,487
2018,36047030500,"Census Tract 305, Kings County, New York",3025,189,2836,2575,5564,75568,0,2011,1838,28.4,1578,1156,1005,113,284,2836,516
2019,36047030500,"Census Tract 305, Kings County, New York",3134,212,2922,2746,5875,85909,0,2013,2038,27.3,1848,1328,909,79,364,2922,338
2020,36047030500,"Census Tract 305, Kings County, New York",3133,153,2980,2738,5854,85833,0,2013,2101,26.4,1703,1370,897,81,307,2980,381
2012,36047030600,"Census Tract 306, Kings County, New York",705,18,687,356,994,35921,1958,2002,991,33.5,50,275,0,50,31,687,120
2013,36047030600,"Census Tract 306, Kings County, New York",701,19,682,356,1081,37564,1958,2003,1057,34.4,55,250,0,65,41,682,124
2014,36047030600,"Census Tract 306, Kings County, New York",683,31,652,328,995,34615,1954,2004,1095,37.6,47,197,0,71,60,652,129
2015,36047030600,"Census Tract 306, Kings County, New York",689,53,636,334,1096,39559,1962,2006,1206,32.5,51,173,0,96,65,636,129
2016,36047030600,"Census Tract 306, Kings County, New York",728,67,661,343,1038,37569,1957,2007,1158,35.9,62,172,0,90,81,661,157
2017,36047030600,"Census Tract 306, Kings County, New York",723,97,626,299,902,32125,1949,2008,1214,45.2,33,143,0,86,70,626,141
2018,36047030600,"Census Tract 306, Kings County, New York",730,100,630,286,781,33750,1955,2011,1183,46.2,38,120,0,100,66,630,131
2019,36047030600,"Census Tract 306, Kings County, New York",741,97,644,294,752,40833,1961,2012,1201,37.1,50,105,0,135,54,644,125
2020,36047030600,"Census Tract 306, Kings County, New York",700,63,637,258,700,35000,1962,2015,1406,46.5,35,76,0,117,65,637,121
2012,36047030700,"Census Tract 307, Kings County, New York",2090,241,1849,1698,3557,20250,1947,2003,468,29.1,57,0,1463,6,336,1849,626
2013,36047030700,"Census Tract 307, Kings County, New York",2118,268,1850,1714,3735,19256,1954,2004,508,28.4,85,0,1509,0,293,1850,663
2014,36047030700,"Census Tract 307, Kings County, New York",2174,275,1899,1741,3872,22548,1953,2004,551,27.8,175,0,1405,21,396,1899,637
2015,36047030700,"Census Tract 307, Kings County, New York",2236,356,1880,1742,3903,21640,1952,2006,560,28.4,306,11,1393,19,370,1880,658
2016,36047030700,"Census Tract 307, Kings County, New York",2313,256,2057,1902,4057,20412,1951,2008,583,28.8,333,48,1566,16,271,2057,771
2017,36047030700,"Census Tract 307, Kings County, New York",2373,174,2199,1946,4400,20940,1947,2009,629,31.4,337,68,1499,14,375,2199,981
2018,36047030700,"Census Tract 307, Kings County, New York",2439,87,2352,2120,5038,23120,0,2010,605,32.3,350,67,1747,15,450,2352,973
2019,36047030700,"Census Tract 307, Kings County, New York",2520,40,2480,2254,5543,24396,1944,2011,743,32.4,389,122,1893,0,363,2480,957
2020,36047030700,"Census Tract 307, Kings County, New York",3041,0,3041,2537,6117,27549,1946,2012,796,34.5,396,321,1958,0,408,3041,1044
2012,36047030800,"Census Tract 308, Kings County, New York",781,38,743,462,1310,44375,1964,2003,928,33.7,55,337,0,52,73,743,91
2013,36047030800,"Census Tract 308, Kings County, New York",782,40,742,467,1185,34688,1964,2003,936,38.8,69,346,5,44,72,742,100
2014,36047030800,"Census Tract 308, Kings County, New York",803,51,752,469,1236,46205,1965,2004,1181,34.7,90,376,8,22,63,752,130
2015,36047030800,"Census Tract 308, Kings County, New York",841,122,719,459,1117,40650,1965,2005,981,32.4,98,368,22,15,54,719,140
2016,36047030800,"Census Tract 308, Kings County, New York",832,103,729,411,919,40197,1965,2006,933,24.8,82,337,29,25,20,729,133
2017,36047030800,"Census Tract 308, Kings County, New York",859,113,746,357,809,40446,1964,2007,996,24.9,65,280,30,29,18,746,120
2018,36047030800,"Census Tract 308, Kings County, New York",873,106,767,329,725,42950,1963,2008,1038,24.4,70,259,22,22,26,767,124
2019,36047030800,"Census Tract 308, Kings County, New York",868,106,762,265,612,37829,1963,2008,1014,34.6,73,190,25,26,24,762,93
2020,36047030800,"Census Tract 308, Kings County, New York",919,116,803,233,524,28750,1964,2006,988,36.6,67,167,0,54,12,803,79
2012,36047030900,"Census Tract 309, Kings County, New York",726,189,537,458,1438,34500,1971,2004,1107,34.6,9,0,402,0,92,537,245
2013,36047030900,"Census Tract 309, Kings County, New York",755,167,588,522,1669,25854,1972,2004,1099,34.2,17,4,409,0,123,588,292
2014,36047030900,"Census Tract 309, Kings County, New York",793,115,678,544,1632,28768,1973,2005,1018,33.1,57,4,478,2,91,678,253
2015,36047030900,"Census Tract 309, Kings County, New York",795,90,705,597,1740,NA,1971,2007,867,34.8,92,5,471,55,119,705,266
2016,36047030900,"Census Tract 309, Kings County, New York",792,62,730,608,1705,29387,1958,2008,1028,34,77,5,455,86,97,730,217
2017,36047030900,"Census Tract 309, Kings County, New York",782,30,752,616,1760,30313,1959,2008,1046,33,90,5,458,84,100,752,202
2018,36047030900,"Census Tract 309, Kings County, New York",796,54,742,559,1531,37455,1953,2011,1226,34,117,5,448,42,72,742,148
2019,36047030900,"Census Tract 309, Kings County, New York",827,46,781,559,1632,42628,1958,2011,1193,31.8,90,0,436,44,71,781,140
2020,36047030900,"Census Tract 309, Kings County, New York",858,46,812,604,1641,48250,1964,2013,1667,32.3,176,0,463,19,98,812,123
2012,36047031100,"Census Tract 311, Kings County, New York",1315,198,1117,913,2146,35925,1939,2004,1109,39,248,66,783,0,69,1117,248
2013,36047031100,"Census Tract 311, Kings County, New York",1330,212,1118,811,1835,40417,1939,2005,1151,35.9,235,33,750,0,47,1118,288
2014,36047031100,"Census Tract 311, Kings County, New York",1342,265,1077,733,1740,37434,1939,2006,1105,44.1,148,47,670,0,28,1077,297
2015,36047031100,"Census Tract 311, Kings County, New York",1359,244,1115,855,1976,36012,1939,2008,1071,42.9,219,44,695,0,104,1115,302
2016,36047031100,"Census Tract 311, Kings County, New York",1395,257,1138,892,2162,38818,1939,2008,1165,37.1,288,78,700,0,105,1138,257
2017,36047031100,"Census Tract 311, Kings County, New York",1417,260,1157,939,2461,37917,1939,2010,1127,33.6,285,79,739,0,95,1157,296
2018,36047031100,"Census Tract 311, Kings County, New York",1452,280,1172,973,2433,39427,0,2010,1263,32,359,85,763,0,94,1172,232
2019,36047031100,"Census Tract 311, Kings County, New York",1453,208,1245,1097,2521,36097,0,2011,1135,29.9,334,102,828,0,198,1245,245
2020,36047031100,"Census Tract 311, Kings County, New York",1491,224,1267,1100,2577,65192,0,2011,1244,28.3,453,195,840,0,137,1267,226
2012,36047031300,"Census Tract 313, Kings County, New York",2323,214,2109,1764,3189,34056,1939,2004,959,30.1,340,95,1523,35,107,2109,554
2013,36047031300,"Census Tract 313, Kings County, New York",2367,289,2078,1721,3112,35920,1939,2005,985,30.3,434,100,1415,30,121,2078,462
2014,36047031300,"Census Tract 313, Kings County, New York",2433,275,2158,1791,2944,32056,1939,2006,971,31.5,507,96,1516,28,89,2158,521
2015,36047031300,"Census Tract 313, Kings County, New York",2459,342,2117,1893,3239,32131,1939,2008,958,30.8,391,111,1579,25,158,2117,559
2016,36047031300,"Census Tract 313, Kings County, New York",2541,253,2288,2023,3577,35919,1939,2007,999,29.7,583,203,1661,29,195,2288,501
2017,36047031300,"Census Tract 313, Kings County, New York",2498,218,2280,1969,3611,36753,1939,2008,1086,32.5,560,188,1604,0,275,2280,431
2018,36047031300,"Census Tract 313, Kings County, New York",2438,141,2297,1960,3711,40719,0,2009,1143,31.3,560,260,1584,0,305,2297,444
2019,36047031300,"Census Tract 313, Kings County, New York",2435,177,2258,1904,4016,45313,0,2010,1227,27.9,587,274,1516,0,347,2258,452
2020,36047031300,"Census Tract 313, Kings County, New York",2475,235,2240,1819,3573,67784,0,2013,1242,23.6,649,246,1481,0,267,2240,348
2012,36047031400,"Census Tract 314, Kings County, New York",1865,33,1832,712,1133,23633,1964,2000,896,28.6,106,609,32,19,52,1832,272
2013,36047031400,"Census Tract 314, Kings County, New York",1945,31,1914,748,1144,24490,1964,1996,867,32.4,150,688,27,19,14,1914,305
2014,36047031400,"Census Tract 314, Kings County, New York",1954,53,1901,810,1346,24122,1964,2000,912,31.8,126,687,25,37,61,1901,334
2015,36047031400,"Census Tract 314, Kings County, New York",1974,75,1899,886,1599,19470,1964,2004,983,30.6,174,741,21,49,75,1899,388
2016,36047031400,"Census Tract 314, Kings County, New York",2011,88,1923,775,1572,35665,1963,2008,959,29.7,194,627,0,76,72,1923,276
2017,36047031400,"Census Tract 314, Kings County, New York",2121,89,2032,924,1958,39792,1963,2010,1043,28.4,218,744,0,95,85,2032,293
2018,36047031400,"Census Tract 314, Kings County, New York",2128,165,1963,870,2227,46875,1963,2011,1163,25.9,307,606,0,153,111,1963,215
2019,36047031400,"Census Tract 314, Kings County, New York",2091,198,1893,844,2092,49018,1962,2011,1232,27.2,318,543,0,246,55,1893,196
2020,36047031401,"Census Tract 314.01, Kings County, New York",1974,142,1832,827,2351,80688,1964,2011,1592,23.9,238,489,0,205,133,1832,160
2020,36047031402,"Census Tract 314.02, Kings County, New York",0,0,0,0,0,NA,NA,NA,NA,NA,0,0,0,0,0,0,0
2012,36047031500,"Census Tract 315, Kings County, New York",2634,264,2370,2059,4206,41428,1939,2004,1015,29.9,669,299,1481,0,257,2370,481
2013,36047031500,"Census Tract 315, Kings County, New York",2707,303,2404,2079,4133,45816,1939,2004,1034,28.7,827,359,1429,47,169,2404,606
2014,36047031500,"Census Tract 315, Kings County, New York",2658,398,2260,1968,3991,49824,1939,2005,1091,28.2,798,358,1340,42,189,2260,541
2015,36047031500,"Census Tract 315, Kings County, New York",2623,380,2243,1995,4017,53731,1939,2007,1139,26.4,895,408,1283,44,201,2243,483
2016,36047031500,"Census Tract 315, Kings County, New York",2642,297,2345,2095,4439,55270,1939,2009,1169,26.1,1044,621,1132,64,147,2345,568
2017,36047031500,"Census Tract 315, Kings County, New York",2714,367,2347,2129,4127,51784,1939,2010,1278,28.3,1049,636,1127,76,183,2347,520
2018,36047031500,"Census Tract 315, Kings County, New York",2687,309,2378,2046,3894,57500,0,2011,1406,24.9,1030,774,988,36,169,2378,413
2019,36047031500,"Census Tract 315, Kings County, New York",2746,265,2481,2180,4246,57000,0,2013,1469,29.4,1109,869,982,70,184,2481,474
2020,36047031500,"Census Tract 315, Kings County, New York",2754,251,2503,2210,4382,59167,0,2015,1651,28.6,1179,1019,910,75,155,2503,454
2012,36047031701,"Census Tract 317.01, Kings County, New York",1717,301,1416,1328,3050,33380,1939,2000,1005,35.4,347,79,1118,28,121,1416,271
2013,36047031701,"Census Tract 317.01, Kings County, New York",1657,251,1406,1255,2934,33851,1939,2003,1030,33.3,394,125,1021,16,105,1406,261
2014,36047031701,"Census Tract 317.01, Kings County, New York",1670,244,1426,1271,2816,37389,1939,2004,1143,33.8,493,151,981,44,101,1426,232
2015,36047031701,"Census Tract 317.01, Kings County, New York",1657,289,1368,1173,2657,45625,1939,2007,1216,32.7,495,178,809,64,110,1368,196
2016,36047031701,"Census Tract 317.01, Kings County, New York",1665,254,1411,1193,2620,45809,1939,2009,1253,33.8,501,241,815,30,98,1411,216
2017,36047031701,"Census Tract 317.01, Kings County, New York",1638,293,1345,1083,2362,46975,1939,2010,1244,32.9,395,233,688,42,87,1345,226
2018,36047031701,"Census Tract 317.01, Kings County, New York",1649,278,1371,1081,2354,58018,0,2012,1579,32.9,416,270,649,42,64,1371,167
2019,36047031701,"Census Tract 317.01, Kings County, New York",1679,208,1471,1112,2453,71389,0,2013,1477,27.5,479,383,564,39,75,1471,125
2020,36047031701,"Census Tract 317.01, Kings County, New York",1643,176,1467,1157,2538,70156,0,2013,1415,24.2,501,386,651,9,53,1467,110
2012,36047031702,"Census Tract 317.02, Kings County, New York",1530,240,1290,895,2122,36094,1939,2005,1221,37.6,274,110,641,16,156,1290,268
2013,36047031702,"Census Tract 317.02, Kings County, New York",1591,206,1385,947,2324,41689,1939,2007,1318,33.1,350,182,604,41,138,1385,275
2014,36047031702,"Census Tract 317.02, Kings County, New York",1643,156,1487,1076,2812,43582,1939,2010,1381,35.2,411,241,658,38,162,1487,279
2015,36047031702,"Census Tract 317.02, Kings County, New York",1708,206,1502,1083,2725,43980,1939,2011,1379,33.9,508,266,608,47,162,1502,216
2016,36047031702,"Census Tract 317.02, Kings County, New York",1620,214,1406,979,2648,58393,1939,2011,1457,28.8,515,361,418,33,121,1406,208
2017,36047031702,"Census Tract 317.02, Kings County, New York",1662,232,1430,1068,2781,61218,1939,2012,1540,28.8,609,375,480,45,113,1430,185
2018,36047031702,"Census Tract 317.02, Kings County, New York",1706,257,1449,1126,2637,65692,0,2012,1629,27.5,678,349,535,42,157,1449,134
2019,36047031702,"Census Tract 317.02, Kings County, New York",1758,281,1477,1126,2252,73667,0,2015,1699,27.9,713,360,492,77,119,1477,155
2020,36047031702,"Census Tract 317.02, Kings County, New York",1768,183,1585,1177,2311,79213,0,2015,1774,26.1,793,371,534,64,73,1585,145
2012,36047031900,"Census Tract 319, Kings County, New York",1465,117,1348,1051,2497,37250,1939,1999,1103,34.1,195,96,899,0,63,1348,284
2013,36047031900,"Census Tract 319, Kings County, New York",1475,126,1349,1077,2754,42031,1941,2001,1131,30.9,266,135,880,0,70,1349,254
2014,36047031900,"Census Tract 319, Kings County, New York",1464,126,1338,1076,2623,41396,1941,2000,1109,29.4,351,118,917,9,59,1338,268
2015,36047031900,"Census Tract 319, Kings County, New York",1459,124,1335,1034,2648,40234,1946,2002,1113,30.1,324,176,793,9,82,1335,284
2016,36047031900,"Census Tract 319, Kings County, New York",1479,125,1354,1073,2601,49438,1954,2004,1132,28,389,222,744,12,119,1354,246
2017,36047031900,"Census Tract 319, Kings County, New York",1456,83,1373,1103,2612,45951,1953,2002,1140,32.1,454,220,786,34,95,1373,204
2018,36047031900,"Census Tract 319, Kings County, New York",1438,98,1340,1105,2434,47306,1949,2007,1282,32.5,455,330,693,38,83,1340,218
2019,36047031900,"Census Tract 319, Kings County, New York",1440,118,1322,1067,2535,52219,1941,2007,1324,30.2,374,387,603,25,99,1322,115
2020,36047031900,"Census Tract 319, Kings County, New York",1330,89,1241,965,2026,54021,1943,2008,1233,28.7,310,351,552,25,78,1241,87
2012,36047032100,"Census Tract 321, Kings County, New York",2188,120,2068,1922,5547,30025,1939,2000,1049,40.9,521,163,1529,61,228,2068,486
2013,36047032100,"Census Tract 321, Kings County, New York",2178,127,2051,1876,5196,37623,1939,2002,1151,35,608,234,1453,81,173,2051,433
2014,36047032100,"Census Tract 321, Kings County, New York",2183,101,2082,1946,5384,35534,1939,2004,1221,36.4,595,344,1375,59,219,2082,513
2015,36047032100,"Census Tract 321, Kings County, New York",2224,192,2032,1902,5446,39769,1939,2005,1264,36.6,636,307,1285,73,213,2032,480
2016,36047032100,"Census Tract 321, Kings County, New York",2250,168,2082,1943,5505,40863,1939,2007,1315,38,673,306,1266,101,216,2082,467
2017,36047032100,"Census Tract 321, Kings County, New York",2271,163,2108,1951,5261,47070,1939,2010,1467,34.4,786,447,1205,94,177,2108,370
2018,36047032100,"Census Tract 321, Kings County, New York",2300,171,2129,1917,4897,55903,0,2011,1648,31.9,900,437,1184,73,124,2129,346
2019,36047032100,"Census Tract 321, Kings County, New York",2337,158,2179,1970,4920,56667,0,2012,1631,31,925,459,1261,53,119,2179,339
2020,36047032100,"Census Tract 321, Kings County, New York",2380,94,2286,2100,4840,66346,0,2012,1606,31.4,883,481,1264,36,409,2286,279
2012,36047032300,"Census Tract 323, Kings County, New York",1557,75,1482,1342,3430,45814,1939,2002,1145,33.1,391,187,1010,8,148,1482,274
2013,36047032300,"Census Tract 323, Kings County, New York",1500,105,1395,1229,3212,50223,1939,2003,1216,30.7,404,170,928,10,155,1395,289
2014,36047032300,"Census Tract 323, Kings County, New York",1520,118,1402,1217,3093,44125,1939,2003,1258,33.4,461,188,875,40,172,1402,268
2015,36047032300,"Census Tract 323, Kings County, New York",1518,106,1412,1233,3183,50852,1939,2003,1266,30.8,457,156,873,34,229,1412,198
2016,36047032300,"Census Tract 323, Kings County, New York",1467,65,1402,1225,3194,62668,1939,2003,1281,29.3,490,134,937,28,211,1402,218
2017,36047032300,"Census Tract 323, Kings County, New York",1491,45,1446,1254,3096,65338,1939,2004,1350,28,575,219,890,30,159,1446,218
2018,36047032300,"Census Tract 323, Kings County, New York",1556,44,1512,1307,2996,53224,0,2007,1482,30.6,619,324,875,30,117,1512,300
2019,36047032300,"Census Tract 323, Kings County, New York",1535,33,1502,1292,2952,70625,0,2008,1511,27.9,653,348,831,12,144,1502,291
2020,36047032300,"Census Tract 323, Kings County, New York",1513,31,1482,1214,2632,65625,0,2010,1510,27.5,576,340,783,12,112,1482,311
2012,36047032500,"Census Tract 325, Kings County, New York",2576,136,2440,2266,5536,29276,1960,2000,1021,33.7,362,94,2014,0,133,2440,730
2013,36047032500,"Census Tract 325, Kings County, New York",2585,138,2447,2380,6068,30968,1960,2001,1082,36.6,359,139,2059,16,179,2447,691
2014,36047032500,"Census Tract 325, Kings County, New York",2556,97,2459,2326,6212,38093,1954,2001,1180,36.9,412,206,1980,33,126,2459,497
2015,36047032500,"Census Tract 325, Kings County, New York",2652,171,2481,2303,5973,41190,1954,2004,1232,38.3,498,252,1839,37,204,2481,334
2016,36047032500,"Census Tract 325, Kings County, New York",2713,142,2571,2386,6151,47104,1957,2003,1276,34.3,511,249,1988,66,102,2571,315
2017,36047032500,"Census Tract 325, Kings County, New York",2724,154,2570,2361,6497,50048,1958,2004,1351,34.1,635,255,1933,63,151,2570,279
2018,36047032500,"Census Tract 325, Kings County, New York",2686,111,2575,2357,6316,52167,1961,2004,1376,32.6,567,229,1890,61,135,2575,296
2019,36047032500,"Census Tract 325, Kings County, New York",2708,149,2559,2435,5912,52010,1958,2006,1404,32.8,688,230,1913,47,189,2559,379
2020,36047032500,"Census Tract 325, Kings County, New York",2762,167,2595,2507,5757,54160,1958,2008,1498,33,806,293,1866,59,211,2595,429
2012,36047032600,"Census Tract 326, Kings County, New York",2550,174,2376,2071,5891,21715,1970,1999,632,30.8,225,576,848,115,532,2376,962
2013,36047032600,"Census Tract 326, Kings County, New York",2546,280,2266,1926,5513,19658,1971,1998,632,33.1,203,503,985,108,330,2266,1003
2014,36047032600,"Census Tract 326, Kings County, New York",2590,277,2313,2025,5869,21134,1969,1999,842,36.1,233,487,773,113,618,2313,1036
2015,36047032600,"Census Tract 326, Kings County, New York",2592,262,2330,2147,6176,19746,1971,1999,635,33.4,239,492,851,83,670,2330,1070
2016,36047032600,"Census Tract 326, Kings County, New York",2573,262,2311,2127,6308,22464,1970,2001,716,31.7,279,378,966,78,629,2311,994
2017,36047032600,"Census Tract 326, Kings County, New York",2533,210,2323,2102,6121,21765,1971,2002,691,33.6,195,361,904,28,777,2323,1026
2018,36047032600,"Census Tract 326, Kings County, New York",2531,236,2295,2127,6725,22457,1971,2003,667,30.9,213,266,905,28,856,2295,1047
2019,36047032600,"Census Tract 326, Kings County, New York",2469,272,2197,2002,5781,21472,1971,2004,592,30.1,350,283,918,65,710,2197,999
2020,36047032600,"Census Tract 326, Kings County, New York",2560,194,2366,1929,5093,23988,1970,2010,649,31.6,289,279,705,39,859,2366,968
2012,36047032700,"Census Tract 327, Kings County, New York",1330,36,1294,1117,2301,37038,1939,1998,983,32,291,155,772,45,166,1294,262
2013,36047032700,"Census Tract 327, Kings County, New York",1333,74,1259,1051,2118,39891,1939,1998,993,32.6,311,129,787,12,153,1259,320
2014,36047032700,"Census Tract 327, Kings County, New York",1326,88,1238,972,1903,45515,1939,2001,1139,32.2,394,175,666,10,136,1238,228
2015,36047032700,"Census Tract 327, Kings County, New York",1347,91,1256,999,1889,42292,1939,2001,1095,34.2,389,188,625,41,177,1256,265
2016,36047032700,"Census Tract 327, Kings County, New York",1359,78,1281,1069,1882,40301,1939,2005,1147,34.8,463,243,641,42,173,1281,233
2017,36047032700,"Census Tract 327, Kings County, New York",1382,106,1276,1046,1818,39167,1939,2005,1118,35.1,469,241,624,28,171,1276,238
2018,36047032700,"Census Tract 327, Kings County, New York",1389,101,1288,1070,1862,36439,0,2005,1187,36.9,464,301,576,15,184,1288,254
2019,36047032700,"Census Tract 327, Kings County, New York",1443,117,1326,1129,2013,43385,0,2008,1277,33.8,518,262,578,76,228,1326,209
2020,36047032700,"Census Tract 327, Kings County, New York",1408,119,1289,993,1920,43594,0,2014,1372,34.5,413,281,470,49,193,1289,145
2012,36047032800,"Census Tract 328, Kings County, New York",1142,44,1098,579,1591,31472,1966,2002,875,36.1,33,77,284,36,208,1098,262
2013,36047032800,"Census Tract 328, Kings County, New York",1119,81,1038,547,1430,28255,1965,2002,901,37.2,44,62,264,25,215,1038,324
2014,36047032800,"Census Tract 328, Kings County, New York",1124,211,913,460,936,24766,1966,2002,842,39.7,41,74,202,27,157,913,283
2015,36047032800,"Census Tract 328, Kings County, New York",1109,151,958,488,1211,37813,1967,2002,937,34.4,90,87,217,25,142,958,263
2016,36047032800,"Census Tract 328, Kings County, New York",1093,113,980,519,1078,45156,1966,2003,854,31,103,122,203,25,144,980,189
2017,36047032800,"Census Tract 328, Kings County, New York",1086,175,911,486,1100,41944,1971,2004,889,30.6,117,99,177,64,128,911,121
2018,36047032800,"Census Tract 328, Kings County, New York",1094,118,976,559,1405,24564,1966,2008,1001,32.5,103,123,265,94,60,976,151
2019,36047032800,"Census Tract 328, Kings County, New York",1107,46,1061,651,1558,23988,1963,2009,1035,34.8,140,150,267,85,122,1061,206
2020,36047032800,"Census Tract 328, Kings County, New York",1231,94,1137,681,1506,24653,1963,2011,947,45.4,102,125,275,140,141,1137,232
2012,36047032900,"Census Tract 329, Kings County, New York",2397,233,2164,1888,4788,33238,1939,2001,1075,38.2,430,238,1255,13,393,2164,445
2013,36047032900,"Census Tract 329, Kings County, New York",2330,232,2098,1898,4951,39632,1939,2003,1169,35.3,506,353,1197,0,310,2098,388
2014,36047032900,"Census Tract 329, Kings County, New York",2389,216,2173,1958,4795,48676,1939,2005,1215,36,678,394,1300,0,225,2173,452
2015,36047032900,"Census Tract 329, Kings County, New York",2529,200,2329,2147,5252,35938,1939,2006,1180,38.3,679,401,1400,0,390,2329,466
2016,36047032900,"Census Tract 329, Kings County, New York",2473,203,2270,2070,5464,43971,1939,2007,1265,37,818,470,1298,0,346,2270,507
2017,36047032900,"Census Tract 329, Kings County, New York",2461,139,2322,2152,5621,37215,1939,2010,1319,38.3,783,633,1316,19,211,2322,652
2018,36047032900,"Census Tract 329, Kings County, New York",2516,110,2406,2186,5470,36263,0,2009,1360,41.7,730,577,1333,31,305,2406,651
2019,36047032900,"Census Tract 329, Kings County, New York",2526,161,2365,2125,5260,38823,0,2006,1336,40.5,575,538,1312,42,249,2365,655
2020,36047032900,"Census Tract 329, Kings County, New York",2348,144,2204,1834,4388,39205,0,2006,1319,39.3,483,471,1147,49,171,2204,606
2012,36047033000,"Census Tract 330, Kings County, New York",1773,92,1681,1569,3691,24094,1968,1995,530,27.8,242,452,905,21,244,1681,534
2013,36047033000,"Census Tract 330, Kings County, New York",1773,148,1625,1537,3699,22614,1967,1998,530,30.8,307,535,721,51,271,1625,633
2014,36047033000,"Census Tract 330, Kings County, New York",1804,108,1696,1606,4122,19315,1968,2001,522,33.2,278,477,755,28,390,1696,713
2015,36047033000,"Census Tract 330, Kings County, New York",1807,71,1736,1630,4360,21300,1967,2002,523,30.5,334,430,775,48,427,1736,749
2016,36047033000,"Census Tract 330, Kings County, New York",1829,76,1753,1613,4249,20867,1967,2005,538,30.5,337,407,765,49,419,1753,675
2017,36047033000,"Census Tract 330, Kings County, New York",1860,65,1795,1663,4558,24102,1966,2006,604,30.7,422,432,837,56,342,1795,671
2018,36047033000,"Census Tract 330, Kings County, New York",1864,37,1827,1632,4682,21516,1967,2007,640,30.1,412,439,762,54,384,1827,690
2019,36047033000,"Census Tract 330, Kings County, New York",1891,54,1837,1630,4383,19275,1964,2007,788,32.2,424,406,754,97,363,1837,745
2020,36047033000,"Census Tract 330, Kings County, New York",1920,44,1876,1653,4165,19128,1966,2006,771,32.1,506,443,736,84,325,1876,829
2012,36047033100,"Census Tract 331, Kings County, New York",1534,113,1421,1199,3064,28064,1939,2000,1038,41.8,273,472,636,0,121,1421,343
2013,36047033100,"Census Tract 331, Kings County, New York",1589,166,1423,1169,2995,35281,1939,1998,1046,33.4,321,406,621,0,181,1423,347
2014,36047033100,"Census Tract 331, Kings County, New York",1578,138,1440,1210,3215,35539,1939,2003,1148,39.3,385,399,683,0,185,1440,352
2015,36047033100,"Census Tract 331, Kings County, New York",1621,116,1505,1311,3595,36603,1939,2007,1225,40,385,448,706,0,173,1505,345
2016,36047033100,"Census Tract 331, Kings County, New York",1603,97,1506,1280,3240,35571,1939,2008,1221,44.9,370,447,731,0,116,1506,312
2017,36047033100,"Census Tract 331, Kings County, New York",1587,77,1510,1203,2945,35830,1939,2010,1257,45,291,411,731,0,116,1510,295
2018,36047033100,"Census Tract 331, Kings County, New York",1610,82,1528,1201,2946,36030,0,2011,1354,43.4,313,441,717,0,88,1528,304
2019,36047033100,"Census Tract 331, Kings County, New York",1628,103,1525,1205,3073,36439,0,2011,1391,38,351,485,675,0,80,1525,302
2020,36047033100,"Census Tract 331, Kings County, New York",1660,101,1559,1160,2940,38864,0,2008,1405,31.5,376,418,697,0,68,1559,323
2012,36047033300,"Census Tract 333, Kings County, New York",1421,44,1377,837,2328,28125,1939,2004,1068,39.9,279,262,489,0,93,1377,365
2013,36047033300,"Census Tract 333, Kings County, New York",1397,59,1338,868,2552,35455,1939,2004,1133,39.8,323,283,500,0,98,1338,313
2014,36047033300,"Census Tract 333, Kings County, New York",1373,78,1295,877,2557,40059,1939,2004,1234,43.3,300,355,465,0,76,1295,279
2015,36047033300,"Census Tract 333, Kings County, New York",1397,91,1306,864,2440,35625,1939,2005,1222,43.2,319,351,491,0,44,1306,260
2016,36047033300,"Census Tract 333, Kings County, New York",1412,95,1317,880,2735,34630,1939,2005,1274,41,302,387,439,0,61,1317,324
2017,36047033300,"Census Tract 333, Kings County, New York",1412,102,1310,857,2591,40377,1939,2006,1322,39.2,278,394,419,0,45,1310,296
2018,36047033300,"Census Tract 333, Kings County, New York",1458,137,1321,927,2792,42524,0,2004,1395,41.8,277,432,441,0,48,1321,266
2019,36047033300,"Census Tract 333, Kings County, New York",1472,154,1318,885,2767,41020,0,2004,1330,31,250,422,388,0,47,1318,312
2020,36047033300,"Census Tract 333, Kings County, New York",1455,112,1343,992,3453,51524,0,2011,1521,31.4,296,587,293,0,72,1343,249
2012,36047033500,"Census Tract 335, Kings County, New York",868,98,770,346,978,32361,1939,2003,1149,39.9,68,82,211,17,36,770,201
2013,36047033500,"Census Tract 335, Kings County, New York",840,72,768,315,928,34550,1939,2004,1327,40.7,89,85,169,25,36,768,157
2014,36047033500,"Census Tract 335, Kings County, New York",819,66,753,396,1078,40139,1939,2004,1279,41.5,139,128,197,30,41,753,100
2015,36047033500,"Census Tract 335, Kings County, New York",827,70,757,396,1141,40000,1939,2006,1322,48.9,140,125,193,37,41,757,140
2016,36047033500,"Census Tract 335, Kings County, New York",873,89,784,414,1146,36042,1939,2006,1313,50,140,150,192,25,42,784,113
2017,36047033500,"Census Tract 335, Kings County, New York",899,86,813,453,1237,35313,1939,2007,1323,50,151,171,235,26,15,813,131
2018,36047033500,"Census Tract 335, Kings County, New York",886,84,802,469,1375,39886,0,2009,1449,51,163,197,227,25,15,802,111
2019,36047033500,"Census Tract 335, Kings County, New York",888,100,788,399,1107,36840,0,2011,1434,51,129,158,199,17,19,788,162
2020,36047033500,"Census Tract 335, Kings County, New York",959,88,871,535,1520,48779,0,2012,1662,38.8,206,181,270,0,58,871,114
2012,36047033600,"Census Tract 336, Kings County, New York",1856,276,1580,820,2057,44100,1948,2004,1262,29.7,288,611,65,76,68,1580,266
2013,36047033600,"Census Tract 336, Kings County, New York",1835,319,1516,832,2004,43676,1951,2004,1306,28.7,352,631,73,63,65,1516,281
2014,36047033600,"Census Tract 336, Kings County, New York",1798,336,1462,762,2013,50449,1951,2005,1121,27.2,312,582,66,55,41,1462,278
2015,36047033600,"Census Tract 336, Kings County, New York",1779,426,1353,593,1588,61595,1943,2008,1409,28.2,268,442,46,45,42,1353,221
2016,36047033600,"Census Tract 336, Kings County, New York",1932,535,1397,684,1811,64091,1939,2010,1427,24.4,310,529,48,30,62,1397,167
2017,36047033600,"Census Tract 336, Kings County, New York",1912,460,1452,688,1666,70429,1939,2011,1551,28.2,335,583,32,9,48,1452,213
2018,36047033600,"Census Tract 336, Kings County, New York",1928,372,1556,700,1652,76875,0,2012,1540,29.4,351,617,0,0,67,1556,189
2019,36047033600,"Census Tract 336, Kings County, New York",1947,375,1572,792,1982,74444,0,2012,1616,30.7,444,639,35,0,118,1572,196
2020,36047033600,"Census Tract 336, Kings County, New York",1942,344,1598,832,2100,70833,0,2012,1610,30.7,438,636,35,9,136,1598,196
2012,36047033700,"Census Tract 337, Kings County, New York",1575,259,1316,1081,2576,41910,1939,2002,1100,32.9,416,459,614,0,70,1316,216
2013,36047033700,"Census Tract 337, Kings County, New York",1558,269,1289,1023,2606,39788,1939,2003,1174,36.3,290,459,555,0,75,1289,220
2014,36047033700,"Census Tract 337, Kings County, New York",1540,226,1314,1038,2771,39310,1939,2003,1224,36.1,238,392,599,0,118,1314,242
2015,36047033700,"Census Tract 337, Kings County, New York",1531,228,1303,1036,2813,38302,1939,2003,1198,34.6,277,335,576,37,117,1303,279
2016,36047033700,"Census Tract 337, Kings County, New York",1513,204,1309,999,2741,44219,1939,2005,1300,31.5,337,353,505,39,133,1309,195
2017,36047033700,"Census Tract 337, Kings County, New York",1515,204,1311,933,2698,50096,1939,2007,1363,31.1,279,273,503,41,132,1311,183
2018,36047033700,"Census Tract 337, Kings County, New York",1551,182,1369,1004,2562,47806,0,2009,1359,33.5,377,242,572,36,184,1369,245
2019,36047033700,"Census Tract 337, Kings County, New York",1526,201,1325,996,2597,51320,0,2011,1474,34.3,385,293,461,45,214,1325,188
2020,36047033701,"Census Tract 337.01, Kings County, New York",910,86,824,612,1475,43889,0,2004,1169,34,72,164,382,0,82,824,123
2020,36047033702,"Census Tract 337.02, Kings County, New York",635,93,542,400,938,70755,0,2016,2078,35,277,190,133,8,69,542,43
2012,36047033900,"Census Tract 339, Kings County, New York",2055,249,1806,1403,2973,36054,1939,2001,969,28.8,253,131,1137,26,132,1806,538
2013,36047033900,"Census Tract 339, Kings County, New York",2063,165,1898,1474,2901,22035,1939,2003,930,30.3,213,166,1148,44,116,1898,593
2014,36047033900,"Census Tract 339, Kings County, New York",2084,210,1874,1490,3077,35000,1939,2005,944,29.1,256,167,1204,44,79,1874,569
2015,36047033900,"Census Tract 339, Kings County, New York",2089,221,1868,1642,3706,30227,1939,2008,937,30.9,258,194,1300,73,60,1868,607
2016,36047033900,"Census Tract 339, Kings County, New York",2098,212,1886,1580,3753,32083,1939,2009,1021,30.1,322,179,1265,89,50,1886,614
2017,36047033900,"Census Tract 339, Kings County, New York",2096,163,1933,1592,3598,27112,1939,2010,1091,32.1,377,233,1228,95,60,1933,627
2018,36047033900,"Census Tract 339, Kings County, New York",2158,213,1945,1632,3768,29671,0,2010,1237,33.4,416,219,1275,100,82,1945,634
2019,36047033900,"Census Tract 339, Kings County, New York",2158,175,1983,1537,3255,24073,0,2011,1204,35.1,394,204,1136,135,89,1983,613
2020,36047033900,"Census Tract 339, Kings County, New York",2125,130,1995,1443,3089,23299,0,2011,1364,37,450,183,1017,110,104,1995,560
2012,36047034000,"Census Tract 340, Kings County, New York",690,26,664,664,1727,21944,1956,1996,431,27.5,131,173,261,4,231,664,257
2013,36047034000,"Census Tract 340, Kings County, New York",671,23,648,648,1503,18750,1956,1996,429,29.3,156,203,257,4,189,648,269
2014,36047034000,"Census Tract 340, Kings County, New York",663,9,654,654,1524,19022,1957,1998,493,29.4,147,217,239,15,182,654,271
2015,36047034000,"Census Tract 340, Kings County, New York",669,13,656,656,1413,17574,1956,1997,445,28.8,183,223,280,29,125,656,279
2016,36047034000,"Census Tract 340, Kings County, New York",672,10,662,662,1415,20833,1957,1998,466,27.1,217,227,287,32,142,662,260
2017,36047034000,"Census Tract 340, Kings County, New York",687,35,652,645,1460,20558,1959,1999,514,28.4,235,214,294,31,132,652,296
2018,36047034000,"Census Tract 340, Kings County, New York",693,47,646,640,1456,20213,1959,2000,536,28.6,194,200,290,44,140,646,288
2019,36047034000,"Census Tract 340, Kings County, New York",707,76,631,624,1335,21042,1959,2001,516,28.1,221,201,299,33,128,631,267
2020,36047034000,"Census Tract 340, Kings County, New York",699,71,628,622,1303,22672,1958,2001,571,29.9,214,185,293,20,148,628,266
2012,36047034100,"Census Tract 341, Kings County, New York",1113,65,1048,926,2001,42571,1939,2004,1018,27.1,328,47,744,0,127,1048,117
2013,36047034100,"Census Tract 341, Kings County, New York",1123,66,1057,944,1858,40217,1939,2004,1045,29.5,293,80,744,0,117,1057,132
2014,36047034100,"Census Tract 341, Kings County, New York",1137,86,1051,902,1930,42250,1939,2005,1157,30.3,317,83,659,0,120,1051,146
2015,36047034100,"Census Tract 341, Kings County, New York",1135,87,1048,924,2142,48250,1939,2006,1263,33.8,314,115,696,0,113,1048,174
2016,36047034100,"Census Tract 341, Kings County, New York",1163,123,1040,941,2147,48185,1939,2005,1302,34.1,316,112,716,0,108,1040,165
2017,36047034100,"Census Tract 341, Kings County, New York",1187,116,1071,947,2045,44313,1939,2004,1310,35.6,302,124,721,0,74,1071,206
2018,36047034100,"Census Tract 341, Kings County, New York",1204,103,1101,946,2049,41992,0,2003,1328,35,310,113,757,0,51,1101,251
2019,36047034100,"Census Tract 341, Kings County, New York",1253,58,1195,1078,2231,44231,0,2002,1313,33.4,334,142,822,0,71,1195,255
2020,36047034100,"Census Tract 341, Kings County, New York",1353,59,1294,1098,2154,42500,0,2002,1330,33.9,393,119,820,0,61,1294,277
2012,36047034200,"Census Tract 342, Kings County, New York",2862,175,2687,2661,5162,17936,1972,1998,472,31.1,438,1048,1059,35,523,2687,1145
2013,36047034200,"Census Tract 342, Kings County, New York",2833,263,2570,2527,5030,13641,1972,2000,363,32.2,543,964,987,45,488,2570,1293
2014,36047034200,"Census Tract 342, Kings County, New York",2853,223,2630,2573,5449,14732,1973,2001,388,30.8,625,1042,960,44,528,2630,1379
2015,36047034200,"Census Tract 342, Kings County, New York",2891,227,2664,2607,5537,NA,1972,2002,407,31.2,627,1001,1032,63,540,2664,1301
2016,36047034200,"Census Tract 342, Kings County, New York",2957,237,2720,2674,5672,17513,1972,2004,439,31.8,680,1065,1015,60,551,2720,1221
2017,36047034200,"Census Tract 342, Kings County, New York",3028,201,2827,2736,6045,18939,1972,2005,478,31.3,714,1122,1009,71,610,2827,1138
2018,36047034200,"Census Tract 342, Kings County, New York",3095,189,2906,2841,6052,18861,1972,2005,453,31.7,794,1190,1025,35,697,2906,1294
2019,36047034200,"Census Tract 342, Kings County, New York",3144,211,2933,2879,5838,17325,1972,2008,469,31.5,768,1306,943,65,609,2933,1343
2020,36047034200,"Census Tract 342, Kings County, New York",2975,189,2786,2619,5181,17482,1973,2007,498,32,788,1136,906,43,577,2786,1233
2012,36047034300,"Census Tract 343, Kings County, New York",2200,125,2075,1854,4341,18571,1954,2000,578,29.9,245,68,1564,0,237,2075,786
2013,36047034300,"Census Tract 343, Kings County, New York",2191,98,2093,1889,4635,22636,1955,2001,630,27.9,285,85,1491,41,287,2093,745
2014,36047034300,"Census Tract 343, Kings County, New York",2235,172,2063,1913,4678,24396,1954,2002,643,26.9,299,55,1493,72,342,2063,711
2015,36047034300,"Census Tract 343, Kings County, New York",2210,152,2058,1890,4662,NA,1954,2003,629,26.9,325,47,1472,68,336,2058,684
2016,36047034300,"Census Tract 343, Kings County, New York",2233,190,2043,1900,4422,23981,1953,2004,684,28.7,394,138,1352,77,362,2043,731
2017,36047034300,"Census Tract 343, Kings County, New York",2225,202,2023,1835,4733,24767,1953,2006,693,29.5,388,181,1257,64,356,2023,698
2018,36047034300,"Census Tract 343, Kings County, New York",2256,209,2047,1888,4691,23048,1954,2005,720,31.1,430,193,1360,28,336,2047,784
2019,36047034300,"Census Tract 343, Kings County, New York",2243,140,2103,1865,4560,30302,1953,2006,779,29.2,471,277,1283,14,345,2103,724
2020,36047034300,"Census Tract 343, Kings County, New York",2132,121,2011,1759,4347,27159,1952,2005,779,29.8,496,246,1087,12,417,2011,818
2012,36047034500,"Census Tract 345, Kings County, New York",1111,214,897,634,1413,40102,1939,2003,1122,29.8,134,18,582,0,43,897,205
2013,36047034500,"Census Tract 345, Kings County, New York",1173,258,915,653,1523,40128,1939,2005,1101,30.8,145,0,591,31,39,915,207
2014,36047034500,"Census Tract 345, Kings County, New York",1234,244,990,701,1655,26688,1939,2006,1144,43.3,150,13,625,30,40,990,328
2015,36047034500,"Census Tract 345, Kings County, New York",1234,143,1091,781,1987,27243,1939,2008,1179,44.2,201,47,679,29,44,1091,335
2016,36047034500,"Census Tract 345, Kings County, New York",1259,122,1137,861,2238,26578,1939,2011,1236,49.9,219,46,686,28,90,1137,383
2017,36047034500,"Census Tract 345, Kings County, New York",1260,148,1112,766,1848,29973,1939,2011,1329,46.3,226,71,558,27,86,1112,261
2018,36047034500,"Census Tract 345, Kings County, New York",1242,100,1142,780,1885,29510,0,2012,1384,46,278,103,535,15,88,1142,270
2019,36047034500,"Census Tract 345, Kings County, New York",1278,118,1160,824,1981,34010,0,2012,1375,39.5,256,136,508,16,86,1160,228
2020,36047034500,"Census Tract 345, Kings County, New York",1314,127,1187,848,1788,38109,0,2014,1561,42.6,260,156,388,29,172,1187,261
2012,36047034700,"Census Tract 347, Kings County, New York",1498,110,1388,1172,2852,23250,1945,2004,843,36.9,94,11,1003,0,243,1388,463
2013,36047034700,"Census Tract 347, Kings County, New York",1586,74,1512,1281,2639,18708,1941,2004,782,37.4,133,15,1060,0,231,1512,529
2014,36047034700,"Census Tract 347, Kings County, New York",1589,105,1484,1305,2839,20767,1939,2004,832,31.4,114,28,1074,0,249,1484,509
2015,36047034700,"Census Tract 347, Kings County, New York",1638,135,1503,1345,2966,22478,1939,2006,859,33,175,21,1144,0,260,1503,564
2016,36047034700,"Census Tract 347, Kings County, New York",1697,108,1589,1415,2931,28142,1939,2006,964,32.8,259,33,1181,25,241,1589,488
2017,36047034700,"Census Tract 347, Kings County, New York",1732,146,1586,1329,2686,23977,1939,2007,998,33.9,276,32,1136,35,177,1586,504
2018,36047034700,"Census Tract 347, Kings County, New York",1752,147,1605,1365,2994,26989,0,2009,1103,35.7,296,46,1177,42,159,1605,492
2019,36047034700,"Census Tract 347, Kings County, New York",1777,122,1655,1368,2442,27308,0,2011,1184,41.1,396,62,1157,53,192,1655,453
2020,36047034700,"Census Tract 347, Kings County, New York",1924,114,1810,1460,2650,25696,0,2010,1174,46.2,329,120,1160,43,139,1810,447
2012,36047034800,"Census Tract 348, Kings County, New York",815,116,699,565,1777,34155,1966,2005,1262,39.4,99,239,65,10,283,699,210
2013,36047034800,"Census Tract 348, Kings County, New York",827,102,725,570,1720,26667,1969,2005,1303,50,103,269,61,12,265,725,276
2014,36047034800,"Census Tract 348, Kings County, New York",840,111,729,579,1642,33050,1963,2006,1283,45.5,113,298,15,9,257,729,258
2015,36047034800,"Census Tract 348, Kings County, New York",816,106,710,579,1757,41023,1970,2007,1427,38.9,136,297,13,37,232,710,258
2016,36047034800,"Census Tract 348, Kings County, New York",799,100,699,556,2013,56000,1974,2007,1532,31,132,303,0,51,202,699,237
2017,36047034800,"Census Tract 348, Kings County, New York",873,90,783,606,2341,48750,1960,2008,1567,40.7,142,276,24,51,255,783,260
2018,36047034800,"Census Tract 348, Kings County, New York",878,127,751,611,2420,61750,0,2009,1614,34.5,191,226,30,87,268,751,181
2019,36047034800,"Census Tract 348, Kings County, New York",886,82,804,693,2520,48920,0,2011,1684,39.3,254,228,41,125,299,804,208
2020,36047034800,"Census Tract 348, Kings County, New York",936,39,897,783,2668,55489,1961,2013,1772,34.9,302,196,134,89,364,897,213
2012,36047034900,"Census Tract 349, Kings County, New York",2174,141,2033,1882,5492,34010,1939,2002,974,30.7,110,64,1678,39,106,2033,546
2013,36047034900,"Census Tract 349, Kings County, New York",2158,143,2015,1912,5307,30597,1939,2002,999,33.9,108,77,1652,62,140,2015,595
2014,36047034900,"Census Tract 349, Kings County, New York",2186,125,2061,1974,5548,31167,1939,2004,1112,37.6,143,79,1650,66,215,2061,591
2015,36047034900,"Census Tract 349, Kings County, New York",2195,95,2100,1991,5086,29693,1939,2005,1144,40.6,179,81,1654,27,257,2100,623
2016,36047034900,"Census Tract 349, Kings County, New York",2224,62,2162,2050,5649,29590,1939,2007,1226,41.5,242,140,1660,33,247,2162,623
2017,36047034900,"Census Tract 349, Kings County, New York",2243,59,2184,2059,5694,33597,1939,2010,1275,41.8,292,131,1682,31,255,2184,606
2018,36047034900,"Census Tract 349, Kings County, New York",2282,17,2265,2095,5602,37031,0,2010,1307,39.3,390,131,1713,52,233,2265,582
2019,36047034900,"Census Tract 349, Kings County, New York",2369,125,2244,2078,5602,39781,0,2009,1288,35.6,428,122,1708,52,192,2244,568
2020,36047034901,"Census Tract 349.01, Kings County, New York",811,68,743,723,1879,39716,0,2011,1261,36.9,147,28,604,48,43,743,108
2020,36047034902,"Census Tract 349.02, Kings County, New York",1674,60,1614,1436,3703,40076,0,2011,1294,36.6,370,239,1087,41,95,1614,302
2012,36047035000,"Census Tract 350, Kings County, New York",1493,82,1411,1138,2316,31667,1964,1994,933,31.8,355,1105,0,19,0,1411,246
2013,36047035000,"Census Tract 350, Kings County, New York",1503,46,1457,1176,2256,30698,1964,1995,961,32.1,384,1151,0,25,0,1457,330
2014,36047035000,"Census Tract 350, Kings County, New York",1530,69,1461,1135,2105,28672,1964,1994,984,34.3,408,1126,0,9,0,1461,343
2015,36047035000,"Census Tract 350, Kings County, New York",1524,67,1457,1160,2135,26250,1963,1995,1017,37,448,1149,0,11,0,1457,372
2016,36047035000,"Census Tract 350, Kings County, New York",1514,63,1451,1112,1971,26250,1963,1997,1043,35.6,423,1101,0,11,0,1451,442
2017,36047035000,"Census Tract 350, Kings County, New York",1528,23,1505,1105,1861,27064,1963,1997,1036,37.2,382,1084,11,0,10,1505,472
2018,36047035000,"Census Tract 350, Kings County, New York",1536,22,1514,1159,2100,34920,1964,1997,1105,36.5,524,1130,10,0,19,1514,383
2019,36047035000,"Census Tract 350, Kings County, New York",1526,0,1526,1062,1981,40227,1964,1998,1142,36,473,1034,9,0,19,1526,338
2020,36047035000,"Census Tract 350, Kings County, New York",1640,80,1560,1022,1827,37500,1964,1998,1161,35.4,421,997,7,0,18,1560,451
2012,36047035100,"Census Tract 351, Kings County, New York",1800,164,1636,1440,3666,26336,1939,2001,1073,35.3,134,264,984,27,160,1636,469
2013,36047035100,"Census Tract 351, Kings County, New York",1800,121,1679,1562,4121,24535,1939,2000,1076,35.8,190,212,1079,34,213,1679,547
2014,36047035100,"Census Tract 351, Kings County, New York",1787,129,1658,1546,4057,24625,1939,2001,1040,37.8,167,249,1072,27,178,1658,582
2015,36047035100,"Census Tract 351, Kings County, New York",1791,155,1636,1487,3893,22276,1939,2002,1047,39,144,250,995,29,211,1636,603
2016,36047035100,"Census Tract 351, Kings County, New York",1840,218,1622,1407,3456,30046,1939,2004,1065,34.7,152,176,1041,15,246,1622,533
2017,36047035100,"Census Tract 351, Kings County, New York",1886,234,1652,1440,3626,30776,1939,2007,1137,35.3,196,233,876,52,262,1652,545
2018,36047035100,"Census Tract 351, Kings County, New York",1960,303,1657,1464,3551,31494,0,2007,1192,38.2,175,253,915,30,251,1657,500
2019,36047035100,"Census Tract 351, Kings County, New York",2010,242,1768,1601,3951,42675,0,2010,1216,33.4,315,277,1013,57,292,1768,413
2020,36047035101,"Census Tract 351.01, Kings County, New York",1059,158,901,783,1908,42463,0,2010,1202,37.6,156,54,552,74,112,901,257
2020,36047035102,"Census Tract 351.02, Kings County, New York",876,12,864,696,1676,53433,0,2009,1416,28.5,269,183,431,0,46,864,165
2012,36047035200,"Census Tract 352, Kings County, New York",489,59,430,430,518,9675,1963,2001,273,33.2,110,260,80,4,86,430,273
2013,36047035200,"Census Tract 352, Kings County, New York",497,22,475,475,548,9959,1963,2001,271,32,141,259,95,6,115,475,290
2014,36047035200,"Census Tract 352, Kings County, New York",505,38,467,467,547,11641,1963,2001,285,32.5,93,254,106,2,105,467,266
2015,36047035200,"Census Tract 352, Kings County, New York",504,33,471,471,597,11011,1963,2002,276,31.8,95,302,67,3,99,471,303
2016,36047035200,"Census Tract 352, Kings County, New York",506,47,459,459,558,11444,1966,2004,286,31.3,135,267,81,0,111,459,287
2017,36047035200,"Census Tract 352, Kings County, New York",511,18,493,493,652,12302,1967,2004,297,31.6,180,315,76,0,102,493,311
2018,36047035200,"Census Tract 352, Kings County, New York",513,16,497,497,664,12545,1967,2006,328,32.7,156,326,47,22,102,497,334
2019,36047035200,"Census Tract 352, Kings County, New York",518,0,518,518,792,14167,1966,2007,300,31.7,168,336,45,45,92,518,329
2020,36047035200,"Census Tract 352, Kings County, New York",504,0,504,504,676,12114,1965,2009,311,32.3,228,339,49,52,64,504,354
2012,36047035300,"Census Tract 353, Kings County, New York",2136,225,1911,1704,4076,33113,1939,2001,1041,33.8,350,136,1371,0,213,1911,533
2013,36047035300,"Census Tract 353, Kings County, New York",2116,213,1903,1701,4055,34975,1939,2001,1043,32.6,349,170,1293,0,260,1903,502
2014,36047035300,"Census Tract 353, Kings County, New York",2075,216,1859,1673,3804,33996,1939,2003,1136,35.3,385,173,1323,15,179,1859,524
2015,36047035300,"Census Tract 353, Kings County, New York",2088,160,1928,1731,4129,36166,1939,2008,1138,32.3,460,234,1198,13,257,1928,573
2016,36047035300,"Census Tract 353, Kings County, New York",2103,136,1967,1793,3989,36310,1939,2007,1157,32.5,492,257,1368,11,219,1967,559
2017,36047035300,"Census Tract 353, Kings County, New York",2150,132,2018,1809,4115,45897,1939,2007,1204,32.2,562,222,1374,31,186,2018,463
2018,36047035300,"Census Tract 353, Kings County, New York",2171,143,2028,1780,4081,41360,0,2006,1243,32.8,539,237,1294,26,213,2028,466
2019,36047035300,"Census Tract 353, Kings County, New York",2182,96,2086,1859,4400,43325,0,2010,1340,30,564,266,1291,20,296,2086,461
2020,36047035301,"Census Tract 353.01, Kings County, New York",1115,22,1093,1075,2486,36307,0,2012,1468,38,287,135,778,14,130,1093,328
2020,36047035302,"Census Tract 353.02, Kings County, New York",1021,102,919,785,2103,64031,0,2006,1523,26.5,304,88,658,0,103,919,106
2012,36047035400,"Census Tract 354, Kings County, New York",2748,95,2653,1209,2252,35346,1965,1994,847,33.7,397,1194,15,0,0,2653,375
2013,36047035400,"Census Tract 354, Kings County, New York",2765,92,2673,1056,1944,24583,1965,1994,850,35.3,370,1032,24,0,0,2673,385
2014,36047035400,"Census Tract 354, Kings County, New York",2800,134,2666,897,1530,26696,1965,1996,790,35.2,295,885,12,0,0,2666,390
2015,36047035400,"Census Tract 354, Kings County, New York",2851,165,2686,1008,1972,34231,1964,1998,779,29.9,298,895,19,0,94,2686,388
2016,36047035400,"Census Tract 354, Kings County, New York",2825,173,2652,1058,2030,35349,1964,2001,786,28.2,412,948,17,0,93,2652,331
2017,36047035400,"Census Tract 354, Kings County, New York",2884,182,2702,1110,2173,36535,1964,2001,856,31.7,428,983,16,0,111,2702,342
2018,36047035400,"Census Tract 354, Kings County, New York",2878,203,2675,1157,2411,38341,1964,2004,946,32.9,477,1041,19,0,97,2675,344
2019,36047035400,"Census Tract 354, Kings County, New York",2902,153,2749,1495,3134,45725,1964,2004,973,33.8,638,1367,17,0,111,2749,567
2020,36047035400,"Census Tract 354, Kings County, New York",2866,110,2756,1298,2722,47442,1964,2003,1077,31.1,573,1259,39,0,0,2756,514
2012,36047035500,"Census Tract 355, Kings County, New York",2050,116,1934,1750,4115,24976,1939,2001,1073,39.3,240,166,1458,0,160,1934,559
2013,36047035500,"Census Tract 355, Kings County, New York",2057,99,1958,1790,4395,30877,1939,2003,1126,32.7,292,204,1390,0,215,1958,525
2014,36047035500,"Census Tract 355, Kings County, New York",2127,120,2007,1827,4501,31030,1939,2003,1117,31.5,342,193,1467,0,165,2007,543
2015,36047035500,"Census Tract 355, Kings County, New York",2163,78,2085,1946,5152,38733,1939,2005,1150,32,454,182,1528,0,249,2085,534
2016,36047035500,"Census Tract 355, Kings County, New York",2175,175,2000,1840,5184,46522,1939,2006,1257,33,424,196,1496,0,210,2000,450
2017,36047035500,"Census Tract 355, Kings County, New York",2211,180,2031,1908,4955,45417,1939,2007,1241,34,523,183,1513,0,271,2031,424
2018,36047035500,"Census Tract 355, Kings County, New York",2206,168,2038,1918,4950,46786,0,2005,1247,34.9,480,193,1483,0,227,2038,468
2019,36047035500,"Census Tract 355, Kings County, New York",2219,140,2079,1973,5237,50387,0,2005,1308,32.3,427,227,1449,0,281,2079,416
2020,36047035500,"Census Tract 355, Kings County, New York",2218,141,2077,1993,5200,49556,0,2006,1420,33.9,398,191,1529,0,268,2077,367
2012,36047035601,"Census Tract 356.01, Kings County, New York",1454,87,1367,998,1897,26500,1964,1993,887,33.2,493,987,0,0,11,1367,245
2013,36047035601,"Census Tract 356.01, Kings County, New York",1480,99,1381,962,1748,21111,1964,1993,913,38.6,460,962,0,0,0,1381,291
2014,36047035601,"Census Tract 356.01, Kings County, New York",1499,95,1404,872,1490,18417,1965,1995,888,48.8,402,872,0,0,0,1404,330
2015,36047035601,"Census Tract 356.01, Kings County, New York",1514,123,1391,854,1534,16207,1965,1997,883,49,445,849,0,0,5,1391,338
2016,36047035601,"Census Tract 356.01, Kings County, New York",1500,73,1427,957,1832,NA,1964,2001,898,33,476,915,33,0,9,1427,399
2017,36047035601,"Census Tract 356.01, Kings County, New York",1524,64,1460,1065,2017,26250,1964,2001,846,32.7,533,992,64,0,9,1460,431
2018,36047035601,"Census Tract 356.01, Kings County, New York",1523,66,1457,1061,2107,31823,1964,2003,927,33.8,559,955,78,0,9,1457,347
2019,36047035601,"Census Tract 356.01, Kings County, New York",1526,44,1482,1086,2051,23472,1965,2003,887,38.8,672,986,64,0,9,1482,390
2020,36047035601,"Census Tract 356.01, Kings County, New York",1487,47,1440,1050,1818,20192,1965,2004,849,42.5,589,965,61,0,0,1440,437
2012,36047035602,"Census Tract 356.02, Kings County, New York",2869,274,2595,1637,2912,32772,1964,2001,1058,32.5,845,1584,53,0,0,2595,501
2013,36047035602,"Census Tract 356.02, Kings County, New York",2893,310,2583,1561,2611,21875,1964,2001,858,32.7,815,1503,58,0,0,2583,533
2014,36047035602,"Census Tract 356.02, Kings County, New York",2918,333,2585,1473,2365,20838,1964,2001,1055,46.1,868,1427,12,0,34,2585,604
2015,36047035602,"Census Tract 356.02, Kings County, New York",2919,305,2614,1670,3022,24075,1964,2001,1139,43.3,964,1594,0,24,52,2614,621
2016,36047035602,"Census Tract 356.02, Kings County, New York",2869,267,2602,1601,2975,27121,1965,2002,1183,39.3,863,1504,0,38,59,2602,597
2017,36047035602,"Census Tract 356.02, Kings County, New York",2910,176,2734,1642,2921,25309,1965,2001,899,42.5,813,1558,0,35,49,2734,618
2018,36047035602,"Census Tract 356.02, Kings County, New York",2920,176,2744,1639,3033,32118,1964,2003,1265,43.9,768,1526,0,35,78,2744,491
2019,36047035602,"Census Tract 356.02, Kings County, New York",2914,124,2790,1780,3420,33750,1964,2005,1296,43.6,937,1677,0,34,52,2790,457
2020,36047035602,"Census Tract 356.02, Kings County, New York",2943,180,2763,1492,3068,39559,1964,2007,1492,43.9,857,1391,0,13,22,2763,343
2012,36047035700,"Census Tract 357, Kings County, New York",933,0,933,911,1990,15865,1963,2001,1034,48.4,94,0,845,4,79,933,461
2013,36047035700,"Census Tract 357, Kings County, New York",965,16,949,929,2280,14406,1939,2003,1036,50,78,0,783,4,161,949,513
2014,36047035700,"Census Tract 357, Kings County, New York",979,21,958,935,2455,21004,1939,2004,1106,50,79,5,773,5,157,958,478
2015,36047035700,"Census Tract 357, Kings County, New York",983,21,962,938,2409,20909,1939,2005,1078,48.1,83,15,795,4,151,962,475
2016,36047035700,"Census Tract 357, Kings County, New York",995,22,973,950,2400,22372,1939,2006,1082,46.1,79,12,809,0,176,973,455
2017,36047035700,"Census Tract 357, Kings County, New York",1017,45,972,958,2374,26500,1939,2006,1082,44.3,89,17,784,6,165,972,408
2018,36047035700,"Census Tract 357, Kings County, New York",1011,29,982,970,2390,28750,0,2006,1154,44.9,124,36,786,6,141,982,371
2019,36047035700,"Census Tract 357, Kings County, New York",1028,41,987,954,2207,28654,0,2008,1069,39.4,116,30,781,6,165,987,332
2020,36047035701,"Census Tract 357.01, Kings County, New York",1087,72,1015,980,2187,38981,0,2009,1108,37.3,151,37,776,6,174,1015,241
2020,36047035702,"Census Tract 357.02, Kings County, New York",0,0,0,0,0,NA,NA,NA,NA,NA,0,0,0,0,0,0,0
2012,36047035900,"Census Tract 359, Kings County, New York",2296,174,2122,2012,4757,27679,1952,2004,1065,40.7,307,0,1857,20,247,2122,954
2013,36047035900,"Census Tract 359, Kings County, New York",2256,178,2078,1983,4658,24005,1944,2003,1053,44.3,266,0,1898,18,159,2078,929
2014,36047035900,"Census Tract 359, Kings County, New York",2263,118,2145,1994,4389,30240,1942,2004,1113,44.6,294,0,1865,13,250,2145,869
2015,36047035900,"Census Tract 359, Kings County, New York",2339,136,2203,2054,4532,NA,1939,2004,1113,40.3,194,0,1952,0,201,2203,887
2016,36047035900,"Census Tract 359, Kings County, New York",2364,137,2227,2105,4569,30221,1939,2004,1138,38.7,222,0,1981,0,221,2227,814
2017,36047035900,"Census Tract 359, Kings County, New York",2357,173,2184,2079,4645,28194,1939,2003,1110,39.9,205,0,1952,0,193,2184,806
2018,36047035900,"Census Tract 359, Kings County, New York",2360,157,2203,2070,4672,31100,0,2004,1122,35.9,225,108,1798,0,147,2203,805
2019,36047035900,"Census Tract 359, Kings County, New York",2449,188,2261,2154,4884,31230,0,2009,1146,34.4,240,111,1772,0,241,2261,810
2020,36047035900,"Census Tract 359, Kings County, New York",2608,174,2434,2155,4685,35336,0,2011,1264,32.6,395,105,1670,121,238,2434,722
2012,36047036001,"Census Tract 360.01, Kings County, New York",1742,85,1657,1239,2295,19028,1946,2001,884,33.4,495,1204,0,7,28,1657,602
2013,36047036001,"Census Tract 360.01, Kings County, New York",1716,127,1589,1141,2089,14683,1945,2001,931,34.5,495,1121,0,4,16,1589,609
2014,36047036001,"Census Tract 360.01, Kings County, New York",1754,170,1584,1187,2263,16838,1944,2002,1000,34.8,499,1168,0,5,14,1584,620
2015,36047036001,"Census Tract 360.01, Kings County, New York",1771,149,1622,1236,2241,17591,1942,2002,966,41.4,514,1185,10,6,24,1622,635
2016,36047036001,"Census Tract 360.01, Kings County, New York",1740,140,1600,1210,2191,14369,1940,2003,975,44.4,439,1164,9,0,9,1600,670
2017,36047036001,"Census Tract 360.01, Kings County, New York",1829,168,1661,1268,2311,15132,1939,2005,1027,41,484,1189,10,0,30,1661,660
2018,36047036001,"Census Tract 360.01, Kings County, New York",1852,139,1713,1383,2487,17446,0,2006,1046,39.9,490,1305,11,0,30,1713,675
2019,36047036001,"Census Tract 360.01, Kings County, New York",1828,96,1732,1347,2408,18221,0,2006,968,37.3,539,1236,9,23,33,1732,591
2020,36047036001,"Census Tract 360.01, Kings County, New York",1835,166,1669,1269,2376,18052,0,2009,1048,38,559,1140,0,19,21,1669,551
2012,36047036002,"Census Tract 360.02, Kings County, New York",2092,106,1986,1871,3276,14272,1948,2001,874,48.3,724,1768,0,0,28,1986,897
2013,36047036002,"Census Tract 360.02, Kings County, New York",2079,97,1982,1894,3109,14225,1947,2000,960,45.8,774,1820,0,0,39,1982,959
2014,36047036002,"Census Tract 360.02, Kings County, New York",2107,70,2037,1928,3564,14570,1948,2000,1038,37.2,850,1754,13,53,70,2037,1001
2015,36047036002,"Census Tract 360.02, Kings County, New York",2147,74,2073,1969,3724,NA,1945,2003,1061,38.3,831,1793,14,35,84,2073,1097
2016,36047036002,"Census Tract 360.02, Kings County, New York",2167,77,2090,1927,3806,15655,1939,2004,1065,37.3,717,1741,15,7,110,2090,1122
2017,36047036002,"Census Tract 360.02, Kings County, New York",2198,79,2119,1958,3971,17227,1939,2003,975,34.9,746,1775,28,24,118,2119,1088
2018,36047036002,"Census Tract 360.02, Kings County, New York",2175,84,2091,1943,4092,17712,0,2004,829,34.2,846,1748,29,28,82,2091,1040
2019,36047036002,"Census Tract 360.02, Kings County, New York",2172,125,2047,1927,3885,15764,0,2005,635,34.3,976,1815,14,14,15,2047,1083
2020,36047036002,"Census Tract 360.02, Kings County, New York",2158,112,2046,1910,3675,20262,0,2008,1056,35.2,1009,1751,27,15,16,2046,905
2012,36047036100,"Census Tract 361, Kings County, New York",1103,151,952,891,1957,13559,1963,2004,859,41.4,54,0,726,37,141,952,461
2013,36047036100,"Census Tract 361, Kings County, New York",1107,118,989,902,1928,17214,1967,2004,885,37.2,55,7,691,36,169,989,367
2014,36047036100,"Census Tract 361, Kings County, New York",1098,70,1028,980,2134,22039,1968,2005,934,40.7,56,7,789,40,156,1028,317
2015,36047036100,"Census Tract 361, Kings County, New York",1127,58,1069,1033,2106,26054,1950,2006,968,38.9,94,7,852,38,164,1069,312
2016,36047036100,"Census Tract 361, Kings County, New York",1140,47,1093,1024,2082,25733,1949,2008,1009,39.8,124,23,803,33,181,1093,358
2017,36047036100,"Census Tract 361, Kings County, New York",1172,46,1126,1020,2174,27649,1955,2010,971,38.2,118,38,776,9,211,1126,376
2018,36047036100,"Census Tract 361, Kings County, New York",1190,75,1115,1006,2058,27533,0,2011,970,35.8,124,37,760,10,220,1115,347
2019,36047036100,"Census Tract 361, Kings County, New York",1236,84,1152,1029,1959,21532,1943,2012,987,37.5,152,50,786,11,225,1152,364
2020,36047036100,"Census Tract 361, Kings County, New York",1251,90,1161,989,1764,18954,1958,2011,958,38,96,54,748,10,173,1161,395
2012,36047036200,"Census Tract 362, Kings County, New York",1430,230,1200,936,2457,24561,1939,2005,963,37.7,112,389,23,93,436,1200,447
2013,36047036200,"Census Tract 362, Kings County, New York",1521,216,1305,1044,2823,23663,1939,2007,1011,45,149,526,22,77,425,1305,482
2014,36047036200,"Census Tract 362, Kings County, New York",1473,266,1207,970,2469,24722,1939,2007,1011,46.8,156,489,26,101,346,1207,433
2015,36047036200,"Census Tract 362, Kings County, New York",1444,251,1193,866,2250,25045,1939,2009,1083,50,195,465,16,143,261,1193,419
2016,36047036200,"Census Tract 362, Kings County, New York",1461,229,1232,883,2237,25023,1939,2011,1149,50,244,459,17,116,277,1232,426
2017,36047036200,"Census Tract 362, Kings County, New York",1471,237,1234,854,2263,23333,1939,2011,1282,50,294,486,25,124,205,1234,452
2018,36047036200,"Census Tract 362, Kings County, New York",1432,212,1220,884,2287,27037,0,2011,1346,51,334,473,29,76,263,1220,460
2019,36047036200,"Census Tract 362, Kings County, New York",1471,136,1335,931,2559,31060,1946,2012,1441,51,355,543,9,110,227,1335,464
2020,36047036200,"Census Tract 362, Kings County, New York",1468,148,1320,945,2521,31719,1944,2013,1369,39.8,326,506,57,86,224,1320,462
2012,36047036300,"Census Tract 363, Kings County, New York",1823,401,1422,1192,3017,26224,1976,2005,1136,40.5,170,0,988,0,291,1422,355
2013,36047036300,"Census Tract 363, Kings County, New York",1837,356,1481,1257,2969,28281,1965,2006,1211,40.2,237,0,1102,0,233,1481,369
2014,36047036300,"Census Tract 363, Kings County, New York",1834,303,1531,1329,3177,23328,1990,2007,1184,42.9,358,0,1182,0,202,1531,320
2015,36047036300,"Census Tract 363, Kings County, New York",1857,285,1572,1273,2904,23008,1978,2007,1107,43.1,296,0,1130,0,200,1572,358
2016,36047036300,"Census Tract 363, Kings County, New York",1818,217,1601,1333,2988,22960,1978,2007,1088,38.6,297,48,1113,0,296,1601,455
2017,36047036300,"Census Tract 363, Kings County, New York",1860,165,1695,1374,3088,23239,1986,2007,1105,40.9,276,60,1192,8,187,1695,499
2018,36047036300,"Census Tract 363, Kings County, New York",1983,143,1840,1467,3399,24938,1980,2008,1073,40,191,88,1204,9,230,1840,516
2019,36047036300,"Census Tract 363, Kings County, New York",2042,143,1899,1521,3651,26588,1955,2009,1203,39.3,172,85,1280,17,220,1899,603
2020,36047036300,"Census Tract 363, Kings County, New York",2045,105,1940,1675,4054,30186,1976,2012,1271,40.5,223,95,1301,25,289,1940,681
2012,36047036400,"Census Tract 364, Kings County, New York",1004,160,844,661,1766,35027,1941,2004,1140,36.7,131,395,9,96,161,844,269
2013,36047036400,"Census Tract 364, Kings County, New York",983,122,861,625,1533,23365,1939,2004,1121,42.2,136,369,32,96,140,861,294
2014,36047036400,"Census Tract 364, Kings County, New York",978,161,817,584,1450,26711,1939,2005,1197,39.4,170,361,31,104,111,817,190
2015,36047036400,"Census Tract 364, Kings County, New York",957,175,782,550,1293,26528,1939,2007,1251,34.2,214,410,36,49,75,782,205
2016,36047036400,"Census Tract 364, Kings County, New York",939,128,811,556,1377,25139,1939,2009,1291,37.5,204,383,27,96,59,811,249
2017,36047036400,"Census Tract 364, Kings County, New York",993,110,883,586,1523,31071,1939,2010,1353,34.4,275,425,34,77,61,883,278
2018,36047036400,"Census Tract 364, Kings County, New York",962,97,865,595,1610,53750,0,2011,1390,33.4,317,437,12,72,52,865,272
2019,36047036400,"Census Tract 364, Kings County, New York",923,24,899,646,1722,52903,0,2011,1423,34,336,491,15,56,54,899,240
2020,36047036400,"Census Tract 364, Kings County, New York",982,49,933,630,1537,41688,0,2012,1471,42.3,363,418,5,52,130,933,236
2012,36047036501,"Census Tract 365.01, Kings County, New York",1207,127,1080,1006,2215,30461,1965,2000,882,34,156,35,887,14,83,1080,323
2013,36047036501,"Census Tract 365.01, Kings County, New York",1220,104,1116,1061,2325,38678,1965,2002,914,28.4,253,53,917,20,78,1116,240
2014,36047036501,"Census Tract 365.01, Kings County, New York",1277,104,1173,1113,2375,40169,1965,2002,972,32.5,277,49,971,28,71,1173,152
2015,36047036501,"Census Tract 365.01, Kings County, New York",1303,142,1161,1074,2394,38194,1965,2004,938,33,254,48,967,0,74,1161,213
2016,36047036501,"Census Tract 365.01, Kings County, New York",1335,124,1211,1087,2322,40243,1964,2004,938,32.3,369,20,1007,0,75,1211,193
2017,36047036501,"Census Tract 365.01, Kings County, New York",1348,118,1230,1171,2792,40151,1964,2006,1002,33,415,21,1094,6,66,1230,256
2018,36047036501,"Census Tract 365.01, Kings County, New York",1374,120,1254,1155,3029,38632,1964,2005,1107,35,285,0,1030,11,167,1254,239
2019,36047036501,"Census Tract 365.01, Kings County, New York",1401,105,1296,1221,3217,43750,1964,2005,1141,32.1,294,8,1113,9,163,1296,328
2020,36047036501,"Census Tract 365.01, Kings County, New York",1354,75,1279,1166,3114,45417,1963,2005,1208,33.8,268,8,1013,9,205,1279,243
2012,36047036502,"Census Tract 365.02, Kings County, New York",471,92,379,279,572,46726,1997,2005,1098,24.9,109,0,269,0,33,379,63
2013,36047036502,"Census Tract 365.02, Kings County, New York",481,75,406,285,688,45481,1995,2006,1130,33.7,79,0,249,0,55,406,57
2014,36047036502,"Census Tract 365.02, Kings County, New York",476,117,359,259,643,21932,1994,2007,1028,46,41,7,198,0,65,359,93
2015,36047036502,"Census Tract 365.02, Kings County, New York",532,123,409,292,641,23750,1990,2009,986,38,25,13,204,0,82,409,92
2016,36047036502,"Census Tract 365.02, Kings County, New York",521,118,403,278,749,25300,1991,2011,1022,39.1,12,15,196,0,77,403,84
2017,36047036502,"Census Tract 365.02, Kings County, New York",571,126,445,320,763,27879,1990,2012,1032,37.2,31,12,205,0,104,445,94
2018,36047036502,"Census Tract 365.02, Kings County, New York",577,139,438,346,886,29138,1977,2013,1048,35.1,41,11,220,0,130,438,101
2019,36047036502,"Census Tract 365.02, Kings County, New York",632,123,509,378,855,35816,2001,2014,1058,30.4,48,6,223,0,155,509,103
2020,36047036502,"Census Tract 365.02, Kings County, New York",585,82,503,394,1067,43611,2002,2015,1166,28.3,49,4,245,0,215,503,114
2012,36047036600,"Census Tract 366, Kings County, New York",1400,145,1255,893,2671,35114,1939,2003,1058,32,231,431,21,208,214,1255,297
2013,36047036600,"Census Tract 366, Kings County, New York",1410,167,1243,868,2638,26952,1941,2004,1087,37.5,174,449,47,167,189,1243,305
2014,36047036600,"Census Tract 366, Kings County, New York",1500,181,1319,970,3093,26025,1939,2004,1116,42.9,204,470,48,226,204,1319,447
2015,36047036600,"Census Tract 366, Kings County, New York",1533,144,1389,1050,3264,30648,1943,2006,1156,39.1,251,575,40,186,212,1389,433
2016,36047036600,"Census Tract 366, Kings County, New York",1506,90,1416,1046,3394,33929,1947,2007,1256,39.5,305,586,39,169,189,1416,422
2017,36047036600,"Census Tract 366, Kings County, New York",1544,81,1463,1069,3407,30911,1951,2007,1310,40.6,379,617,20,154,229,1463,475
2018,36047036600,"Census Tract 366, Kings County, New York",1479,87,1392,1050,3169,33553,1953,2008,1338,37.4,443,638,20,175,172,1392,454
2019,36047036600,"Census Tract 366, Kings County, New York",1401,58,1343,1005,2862,38563,1960,2010,1354,37.3,401,645,10,130,181,1343,415
2020,36047036600,"Census Tract 366, Kings County, New York",1374,91,1283,983,3024,31743,1963,2011,1426,39.8,396,537,62,89,227,1283,448
2012,36047036700,"Census Tract 367, Kings County, New York",528,41,487,306,876,46515,1939,2005,1105,31.1,58,6,144,0,133,487,89
2013,36047036700,"Census Tract 367, Kings County, New York",544,51,493,314,678,42222,1939,2007,1011,33.6,32,5,187,0,122,493,87
2014,36047036700,"Census Tract 367, Kings County, New York",543,40,503,322,763,32273,1939,2007,1132,39.1,13,2,207,0,113,503,89
2015,36047036700,"Census Tract 367, Kings County, New York",542,27,515,342,928,46354,1939,2009,1250,34,39,4,231,0,95,515,120
2016,36047036700,"Census Tract 367, Kings County, New York",561,44,517,376,879,32250,1939,2010,1206,35,72,0,212,31,123,517,99
2017,36047036700,"Census Tract 367, Kings County, New York",546,43,503,381,960,28924,1939,2010,1270,50,72,0,269,13,88,503,96
2018,36047036700,"Census Tract 367, Kings County, New York",554,54,500,374,901,NA,0,2011,1274,37.7,92,8,258,17,110,500,90
2019,36047036700,"Census Tract 367, Kings County, New York",578,63,515,360,840,45625,0,2013,1412,37.4,100,19,227,23,103,515,70
2020,36047036700,"Census Tract 367, Kings County, New York",593,89,504,356,832,30268,0,2014,1500,48,98,13,213,24,130,504,87
2012,36047036900,"Census Tract 369, Kings County, New York",2001,323,1678,1315,3452,17151,1957,2005,941,44.4,136,58,1007,11,287,1678,672
2013,36047036900,"Census Tract 369, Kings County, New York",2027,310,1717,1347,3488,21314,1959,2005,971,42,144,48,1022,5,319,1717,664
2014,36047036900,"Census Tract 369, Kings County, New York",2067,321,1746,1430,3644,17321,1963,2006,1013,39.4,164,31,1050,8,362,1746,685
2015,36047036900,"Census Tract 369, Kings County, New York",2145,328,1817,1526,3947,27557,1963,2008,1088,37.3,166,47,1082,6,435,1817,680
2016,36047036900,"Census Tract 369, Kings County, New York",2201,263,1938,1675,4642,36875,1961,2008,1138,32.4,211,62,1186,6,461,1938,587
2017,36047036900,"Census Tract 369, Kings County, New York",2235,244,1991,1787,4851,34757,1939,2008,1202,33,321,87,1253,0,493,1991,676
2018,36047036900,"Census Tract 369, Kings County, New York",2288,193,2095,1928,5154,34828,0,2011,1154,32.4,382,131,1374,18,457,2095,706
2019,36047036900,"Census Tract 369, Kings County, New York",2343,176,2167,1944,4943,33309,0,2013,1167,33.5,427,128,1380,25,477,2167,738
2020,36047036900,"Census Tract 369, Kings County, New York",2618,141,2477,2169,5255,35250,0,2013,1105,32.6,475,120,1419,22,641,2477,875
2012,36047037000,"Census Tract 370, Kings County, New York",1676,174,1502,524,1316,28646,1943,2003,1153,35.8,135,316,0,139,62,1502,219
2013,36047037000,"Census Tract 370, Kings County, New York",1718,149,1569,544,1481,30690,1939,2004,1244,38.6,146,293,0,161,83,1569,180
2014,36047037000,"Census Tract 370, Kings County, New York",1746,183,1563,520,1395,31855,1941,2005,1299,39.2,113,303,0,135,73,1563,173
2015,36047037000,"Census Tract 370, Kings County, New York",1743,214,1529,442,1255,31250,1942,2006,1342,38.8,132,228,0,111,66,1529,164
2016,36047037000,"Census Tract 370, Kings County, New York",1700,164,1536,474,1364,32462,1942,2006,1263,38.8,101,217,0,137,93,1536,136
2017,36047037000,"Census Tract 370, Kings County, New York",1760,173,1587,484,1421,42738,1948,2007,1290,36.9,145,235,0,157,73,1587,141
2018,36047037000,"Census Tract 370, Kings County, New York",1688,188,1500,438,1361,43750,1951,2008,1308,35.4,156,217,0,151,44,1500,208
2019,36047037000,"Census Tract 370, Kings County, New York",1668,187,1481,430,1353,34000,1951,2009,1440,43.9,163,216,0,143,45,1481,236
2020,36047037000,"Census Tract 370, Kings County, New York",1582,136,1446,499,1536,52067,1950,2008,1454,36.8,187,240,0,210,35,1446,229
2012,36047037100,"Census Tract 371, Kings County, New York",1795,159,1636,981,2556,28149,1939,2004,1167,45.2,131,0,830,8,212,1636,335
2013,36047037100,"Census Tract 371, Kings County, New York",1729,145,1584,900,2217,27750,1939,2005,1128,46.4,158,0,858,8,140,1584,327
2014,36047037100,"Census Tract 371, Kings County, New York",1790,165,1625,1008,2514,22119,1939,2006,1162,48.7,179,0,950,9,147,1625,381
2015,36047037100,"Census Tract 371, Kings County, New York",1781,152,1629,1071,2782,29194,1939,2008,1206,42.1,166,34,946,26,225,1629,408
2016,36047037100,"Census Tract 371, Kings County, New York",1750,151,1599,1073,2816,42821,1939,2010,1308,35.1,210,51,918,28,215,1599,338
2017,36047037100,"Census Tract 371, Kings County, New York",1774,188,1586,1137,2945,45404,1939,2011,1432,33.4,246,97,963,17,221,1586,365
2018,36047037100,"Census Tract 371, Kings County, New York",1818,178,1640,1205,3206,46778,0,2011,1431,33.9,259,84,973,17,264,1640,311
2019,36047037100,"Census Tract 371, Kings County, New York",1810,90,1720,1263,3361,59732,0,2011,1461,29.3,300,103,1029,22,243,1720,274
2020,36047037100,"Census Tract 371, Kings County, New York",1703,67,1636,1144,3263,68500,0,2012,1641,30.5,350,81,941,0,152,1636,236
2012,36047037300,"Census Tract 373, Kings County, New York",1728,278,1450,1168,2764,29706,1958,2004,871,31.8,136,19,895,0,274,1450,425
2013,36047037300,"Census Tract 373, Kings County, New York",1730,253,1477,1187,2839,28713,1939,2006,913,32.6,159,0,906,0,318,1477,480
2014,36047037300,"Census Tract 373, Kings County, New York",1704,207,1497,1198,3009,28370,1939,2006,1018,34.6,172,43,896,14,285,1497,473
2015,36047037300,"Census Tract 373, Kings County, New York",1691,207,1484,1136,2867,24259,1939,2009,1120,37.4,206,74,791,26,283,1484,529
2016,36047037300,"Census Tract 373, Kings County, New York",1728,167,1561,1314,3260,27073,1939,2010,1193,37.9,271,86,924,30,334,1561,560
2017,36047037300,"Census Tract 373, Kings County, New York",1750,125,1625,1301,3148,26152,1939,2011,1139,37,310,97,947,36,240,1625,578
2018,36047037300,"Census Tract 373, Kings County, New York",1783,137,1646,1319,3223,34688,0,2012,1207,34.5,340,113,960,39,219,1646,563
2019,36047037300,"Census Tract 373, Kings County, New York",1857,151,1706,1378,3360,39597,0,2012,1554,34,443,158,1008,45,188,1706,547
2020,36047037300,"Census Tract 373, Kings County, New York",2003,160,1843,1509,3204,50202,0,2013,1270,34.3,517,150,1066,80,193,1843,515
2012,36047037401,"Census Tract 374.01, Kings County, New York",1803,0,1803,1095,2006,34934,1957,2001,1091,33,491,925,53,42,128,1803,318
2013,36047037401,"Census Tract 374.01, Kings County, New York",1843,0,1843,1114,2022,34300,1955,2002,1124,31.9,457,909,54,67,114,1843,288
2014,36047037401,"Census Tract 374.01, Kings County, New York",1846,30,1816,1054,2019,31903,1953,2005,1210,34.5,496,813,45,107,122,1816,295
2015,36047037401,"Census Tract 374.01, Kings County, New York",1862,53,1809,1130,2234,33800,1957,2007,1237,34.3,497,903,42,100,93,1809,243
2016,36047037401,"Census Tract 374.01, Kings County, New York",1947,106,1841,1264,2476,31900,1956,2008,1260,37.7,604,1021,52,65,85,1841,326
2017,36047037401,"Census Tract 374.01, Kings County, New York",1992,132,1860,1261,2667,36622,1955,2007,1335,38.5,637,941,115,64,96,1860,309
2018,36047037401,"Census Tract 374.01, Kings County, New York",2019,170,1849,1256,2701,40946,1956,2008,1443,37.6,699,969,89,81,94,1849,374
2019,36047037401,"Census Tract 374.01, Kings County, New York",2049,168,1881,1307,2842,44538,1955,2009,1523,35.6,718,997,143,71,64,1881,385
2020,36047037401,"Census Tract 374.01, Kings County, New York",2040,182,1858,1179,2512,42734,1954,2011,1557,36.9,613,834,176,56,67,1858,446
2012,36047037402,"Census Tract 374.02, Kings County, New York",2004,0,2004,1612,3185,28129,1954,2000,928,36.5,581,1533,9,48,22,2004,269
2013,36047037402,"Census Tract 374.02, Kings County, New York",1993,43,1950,1716,3290,22455,1953,2001,896,37.1,702,1617,24,47,28,1950,474
2014,36047037402,"Census Tract 374.02, Kings County, New York",2084,86,1998,1787,3798,23268,1952,2003,921,36.6,827,1531,41,90,142,1998,588
2015,36047037402,"Census Tract 374.02, Kings County, New York",2105,91,2014,1829,4201,28384,1951,2006,1033,36.1,1011,1476,81,107,181,2014,543
2016,36047037402,"Census Tract 374.02, Kings County, New York",2160,101,2059,1773,4004,27898,1951,2008,1128,35.5,946,1360,73,110,245,2059,559
2017,36047037402,"Census Tract 374.02, Kings County, New York",2192,121,2071,1737,3657,24867,1952,2008,1195,37.8,891,1308,82,101,260,2071,632
2018,36047037402,"Census Tract 374.02, Kings County, New York",2271,145,2126,1719,3817,29511,1952,2011,1224,41.8,736,1092,157,104,321,2126,514
2019,36047037402,"Census Tract 374.02, Kings County, New York",2279,158,2121,1818,3972,25833,1954,2011,1398,48.4,830,1174,136,187,263,2121,462
2020,36047037402,"Census Tract 374.02, Kings County, New York",2179,152,2027,1629,3533,30009,1954,2010,1478,48.6,733,1074,82,172,243,2027,519
2012,36047037500,"Census Tract 375, Kings County, New York",1170,194,976,738,2195,31908,1939,2004,1183,36,62,30,581,0,148,976,163
2013,36047037500,"Census Tract 375, Kings County, New York",1215,202,1013,804,2300,34609,1939,2005,1170,34.1,65,27,679,0,115,1013,140
2014,36047037500,"Census Tract 375, Kings County, New York",1253,170,1083,925,2744,42974,1939,2004,1213,35,53,24,700,13,200,1083,223
2015,36047037500,"Census Tract 375, Kings County, New York",1334,197,1137,984,2695,44000,1939,2006,1304,33.8,170,109,658,73,239,1137,245
2016,36047037500,"Census Tract 375, Kings County, New York",1339,195,1144,995,2678,42781,1952,2010,1406,37.5,204,119,634,105,209,1144,220
2017,36047037500,"Census Tract 375, Kings County, New York",1336,194,1142,1012,2591,32331,1952,2010,1564,39.9,232,109,608,109,235,1142,254
2018,36047037500,"Census Tract 375, Kings County, New York",1438,125,1313,1089,2574,46287,0,2011,1566,37.5,315,136,584,82,304,1313,265
2019,36047037500,"Census Tract 375, Kings County, New York",1499,148,1351,1139,2627,47168,1948,2013,1499,34.9,366,166,630,79,269,1351,213
2020,36047037500,"Census Tract 375, Kings County, New York",1517,124,1393,1121,2457,54770,0,2013,1491,32.1,389,142,604,49,309,1393,143
2012,36047037700,"Census Tract 377, Kings County, New York",1778,212,1566,1050,2306,39353,1939,2003,1189,35.4,269,97,792,36,128,1566,282
2013,36047037700,"Census Tract 377, Kings County, New York",1716,219,1497,1015,2348,38877,1939,2005,1293,37.6,259,109,773,32,103,1497,292
2014,36047037700,"Census Tract 377, Kings County, New York",1729,219,1510,1014,2421,38125,1939,2006,1324,45,316,137,744,32,119,1510,282
2015,36047037700,"Census Tract 377, Kings County, New York",1743,215,1528,993,2509,31250,1939,2008,1402,50,256,143,677,0,210,1528,355
2016,36047037700,"Census Tract 377, Kings County, New York",1789,226,1563,1017,2371,30916,1939,2010,1332,50,299,95,766,9,195,1563,401
2017,36047037700,"Census Tract 377, Kings County, New York",1800,197,1603,978,2314,31204,1939,2011,1399,48,310,89,729,10,136,1603,459
2018,36047037700,"Census Tract 377, Kings County, New York",1888,176,1712,1082,2435,31346,0,2011,1342,48.7,361,102,803,3,173,1712,426
2019,36047037700,"Census Tract 377, Kings County, New York",1888,179,1709,1055,2337,35054,0,2013,1457,47.6,382,119,762,18,143,1709,458
2020,36047037700,"Census Tract 377, Kings County, New York",1978,120,1858,1204,2503,49900,0,2016,1493,41.2,464,180,892,23,105,1858,347
2012,36047037900,"Census Tract 379, Kings County, New York",1656,210,1446,968,2446,31695,1965,2005,1237,38,210,49,830,0,150,1446,366
2013,36047037900,"Census Tract 379, Kings County, New York",1629,255,1374,912,2273,32700,1960,2005,1228,35.5,177,68,807,0,93,1374,360
2014,36047037900,"Census Tract 379, Kings County, New York",1653,305,1348,947,2187,31440,1961,2006,1217,37.7,159,42,840,0,73,1348,360
2015,36047037900,"Census Tract 379, Kings County, New York",1664,273,1391,983,2338,30876,1948,2009,1145,35.2,126,81,780,0,138,1391,416
2016,36047037900,"Census Tract 379, Kings County, New York",1645,221,1424,982,2324,31422,1939,2009,1180,40.8,169,80,795,0,106,1424,429
2017,36047037900,"Census Tract 379, Kings County, New York",1659,182,1477,1014,2245,32105,1939,2011,1154,32.6,222,87,776,22,116,1477,396
2018,36047037900,"Census Tract 379, Kings County, New York",1653,107,1546,1008,2291,32197,0,2011,1234,39.9,262,96,774,20,94,1546,410
2019,36047037900,"Census Tract 379, Kings County, New York",1737,51,1686,1083,2682,39157,0,2012,1296,29.4,265,114,824,17,81,1686,316
2020,36047037900,"Census Tract 379, Kings County, New York",1656,42,1614,1058,2809,38094,0,2010,1348,28.2,280,102,822,16,48,1614,355
2012,36047038100,"Census Tract 381, Kings County, New York",2115,265,1850,1550,3660,23008,1950,2002,615,28.2,252,31,1330,0,213,1850,642
2013,36047038100,"Census Tract 381, Kings County, New York",2116,282,1834,1535,3991,21868,1952,2003,581,28.7,236,38,1290,0,194,1834,732
2014,36047038100,"Census Tract 381, Kings County, New York",2148,301,1847,1510,4100,22143,1951,2005,615,28.9,223,62,1237,0,203,1847,685
2015,36047038100,"Census Tract 381, Kings County, New York",2195,213,1982,1586,4112,23990,1952,2006,671,28.6,225,66,1311,0,195,1982,667
2016,36047038100,"Census Tract 381, Kings County, New York",2191,248,1943,1536,3961,23045,1951,2006,663,31.2,206,86,1289,0,180,1943,633
2017,36047038100,"Census Tract 381, Kings County, New York",2258,196,2062,1594,4020,26884,1951,2006,689,28.4,270,99,1269,0,241,2062,592
2018,36047038100,"Census Tract 381, Kings County, New York",2269,133,2136,1708,3921,28636,1945,2007,841,28.8,411,123,1363,8,209,2136,546
2019,36047038100,"Census Tract 381, Kings County, New York",2331,77,2254,1823,4024,37697,1952,2005,940,28.9,438,129,1476,9,259,2254,574
2020,36047038100,"Census Tract 381, Kings County, New York",2440,61,2379,1941,4022,39347,1953,2007,1063,26,542,172,1531,8,348,2379,551
2012,36047038200,"Census Tract 382, Kings County, New York",2205,107,2098,1923,5039,16687,1952,2001,459,28.2,193,234,801,242,642,2098,1071
2013,36047038200,"Census Tract 382, Kings County, New York",2168,78,2090,1975,5154,18232,1953,2001,552,29.3,199,304,734,329,634,2090,1006
2014,36047038200,"Census Tract 382, Kings County, New York",2202,111,2091,2010,5550,16094,1953,2000,604,30.2,258,282,823,354,536,2091,1099
2015,36047038200,"Census Tract 382, Kings County, New York",2234,140,2094,2053,5675,NA,1954,2000,567,30.4,288,254,868,352,601,2094,1081
2016,36047038200,"Census Tract 382, Kings County, New York",2241,140,2101,2038,5527,18079,1956,1999,505,29.3,302,275,800,368,624,2101,954
2017,36047038200,"Census Tract 382, Kings County, New York",2252,118,2134,2057,5821,18868,1956,1999,502,30.1,228,189,856,409,710,2134,890
2018,36047038200,"Census Tract 382, Kings County, New York",2257,96,2161,2106,5970,18029,1956,2002,400,29.6,241,97,948,272,956,2161,997
2019,36047038200,"Census Tract 382, Kings County, New York",2259,63,2196,2145,5494,18099,1955,2003,432,31.2,294,97,890,422,849,2196,1002
2020,36047038200,"Census Tract 382, Kings County, New York",2173,39,2134,2077,5427,18202,1955,2004,423,30.9,324,46,881,332,886,2134,935
2012,36047038300,"Census Tract 383, Kings County, New York",1819,303,1516,967,2151,28933,1939,2005,1209,39.4,247,22,780,0,140,1516,239
2013,36047038300,"Census Tract 383, Kings County, New York",1829,287,1542,917,2109,28573,1939,2007,1184,39,232,28,822,0,81,1542,215
2014,36047038300,"Census Tract 383, Kings County, New York",1886,257,1629,1018,2479,30474,1939,2009,1293,43.2,328,36,867,0,152,1629,280
2015,36047038300,"Census Tract 383, Kings County, New York",1907,273,1634,1011,2488,29226,1939,2010,1321,43.9,291,33,876,0,139,1634,293
2016,36047038300,"Census Tract 383, Kings County, New York",1946,260,1686,1026,2279,32375,1939,2010,1394,37.5,324,105,822,10,103,1686,251
2017,36047038300,"Census Tract 383, Kings County, New York",1917,263,1654,1017,2508,38750,1939,2011,1403,36.2,362,144,754,46,103,1654,267
2018,36047038300,"Census Tract 383, Kings County, New York",1948,225,1723,1084,2581,42111,0,2011,1493,35.1,437,152,789,51,122,1723,262
2019,36047038300,"Census Tract 383, Kings County, New York",1954,227,1727,1079,2653,69051,0,2013,1677,31.8,437,194,731,90,64,1727,352
2020,36047038300,"Census Tract 383, Kings County, New York",2071,134,1937,1094,2416,69797,0,2016,1823,32.3,539,284,648,64,77,1937,367
2012,36047038500,"Census Tract 385, Kings County, New York",1692,381,1311,996,1920,27649,1939,2004,950,34.4,115,40,804,17,115,1311,352
2013,36047038500,"Census Tract 385, Kings County, New York",1682,371,1311,1016,2189,27308,1939,2005,1058,33.3,99,42,791,17,158,1311,380
2014,36047038500,"Census Tract 385, Kings County, New York",1677,289,1388,1035,2131,23472,1939,2007,1049,34.7,113,29,754,18,206,1388,396
2015,36047038500,"Census Tract 385, Kings County, New York",1676,321,1355,1009,2028,28674,1940,2008,1033,33.4,150,50,706,20,230,1355,355
2016,36047038500,"Census Tract 385, Kings County, New York",1615,296,1319,968,2314,31522,1949,2010,1195,34.1,243,96,659,20,185,1319,322
2017,36047038500,"Census Tract 385, Kings County, New York",1620,347,1273,948,2321,43750,1944,2010,1264,33.2,279,92,661,0,200,1273,288
2018,36047038500,"Census Tract 385, Kings County, New York",1670,353,1317,921,2270,58625,1944,2009,1515,31.7,328,111,583,16,204,1317,203
2019,36047038500,"Census Tract 385, Kings County, New York",1700,322,1378,963,2336,71978,1941,2009,1568,30.3,378,122,653,30,165,1378,156
2020,36047038500,"Census Tract 385, Kings County, New York",1721,196,1525,1102,2439,81079,0,2009,1468,24.2,586,126,665,23,268,1525,188
2012,36047038600,"Census Tract 386, Kings County, New York",1229,136,1093,498,1458,36591,1953,2005,1223,48.8,97,294,0,142,62,1093,217
2013,36047038600,"Census Tract 386, Kings County, New York",1283,87,1196,598,1727,31500,1942,2006,1212,44,139,313,0,151,134,1196,223
2014,36047038600,"Census Tract 386, Kings County, New York",1289,101,1188,520,1451,33879,1939,2007,1196,46.9,113,295,0,121,104,1188,181
2015,36047038600,"Census Tract 386, Kings County, New York",1289,89,1200,516,1569,27100,1947,2008,1167,50,117,281,0,91,144,1200,167
2016,36047038600,"Census Tract 386, Kings County, New York",1299,135,1164,523,1674,34395,1939,2009,1234,38,139,317,0,89,117,1164,175
2017,36047038600,"Census Tract 386, Kings County, New York",1297,179,1118,487,1620,42540,1939,2009,1385,36.6,121,323,0,51,104,1118,128
2018,36047038600,"Census Tract 386, Kings County, New York",1311,241,1070,417,1381,68657,0,2011,1474,31,148,318,0,47,24,1070,119
2019,36047038600,"Census Tract 386, Kings County, New York",1258,176,1082,451,1520,69476,0,2011,1449,29.8,211,301,0,73,55,1082,181
2020,36047038600,"Census Tract 386, Kings County, New York",1252,196,1056,534,1680,79708,0,2006,1615,24.6,216,283,0,99,132,1056,133
2012,36047038700,"Census Tract 387, Kings County, New York",1559,196,1363,1112,2710,26170,1939,2005,1129,44.2,154,41,822,41,274,1363,438
2013,36047038700,"Census Tract 387, Kings County, New York",1581,223,1358,1069,2552,25813,1939,2005,1162,47.8,88,84,729,52,298,1358,416
2014,36047038700,"Census Tract 387, Kings County, New York",1595,196,1399,1109,2803,27665,1939,2005,1012,39.9,144,79,770,49,249,1399,413
2015,36047038700,"Census Tract 387, Kings County, New York",1647,268,1379,999,2682,35139,1939,2005,1052,36.8,178,83,741,13,245,1379,316
2016,36047038700,"Census Tract 387, Kings County, New York",1699,278,1421,887,2403,38008,1939,2008,1213,36.2,195,112,693,9,173,1421,377
2017,36047038700,"Census Tract 387, Kings County, New York",1706,259,1447,995,2507,42036,1939,2008,1300,28.3,303,171,689,9,204,1447,310
2018,36047038700,"Census Tract 387, Kings County, New York",1754,284,1470,1068,2484,48404,1942,2010,1333,26.8,390,156,763,9,211,1470,286
2019,36047038700,"Census Tract 387, Kings County, New York",1771,304,1467,938,1938,49241,0,2012,1339,29.4,359,181,551,46,191,1467,302
2020,36047038700,"Census Tract 387, Kings County, New York",1674,221,1453,952,1941,54565,1941,2014,1639,28.9,390,232,489,42,178,1453,369
2012,36047038800,"Census Tract 388, Kings County, New York",1422,76,1346,658,1405,39583,1954,2001,1094,34.7,131,611,0,0,47,1346,218
2013,36047038800,"Census Tract 388, Kings County, New York",1495,83,1412,663,1377,42601,1954,2003,1213,34,199,569,12,0,82,1412,249
2014,36047038800,"Census Tract 388, Kings County, New York",1528,92,1436,737,1587,44391,1954,2003,1290,36.3,261,642,9,0,86,1436,257
2015,36047038800,"Census Tract 388, Kings County, New York",1520,76,1444,751,1731,47552,1953,2003,1321,31.5,308,594,39,12,106,1444,237
2016,36047038800,"Census Tract 388, Kings County, New York",1503,91,1412,809,1826,60512,1956,2004,1285,28,370,681,43,4,81,1412,224
2017,36047038800,"Census Tract 388, Kings County, New York",1527,85,1442,919,2289,55536,1955,2008,1478,30.5,416,665,86,70,98,1442,172
2018,36047038800,"Census Tract 388, Kings County, New York",1599,53,1546,1056,2703,57744,1953,2010,1481,32.1,456,731,93,99,133,1546,206
2019,36047038800,"Census Tract 388, Kings County, New York",1633,29,1604,1169,2917,59679,1954,2012,1400,28.4,457,773,181,111,104,1604,229
2020,36047038800,"Census Tract 388, Kings County, New York",1793,88,1705,1228,3110,65246,1955,2013,1431,27.8,465,776,154,97,165,1705,215
2012,36047038900,"Census Tract 389, Kings County, New York",1149,107,1042,755,1800,22019,1939,2005,1089,50,195,181,69,72,419,1042,408
2013,36047038900,"Census Tract 389, Kings County, New York",1171,99,1072,767,1867,23661,1939,2005,1034,47,186,199,45,56,450,1072,462
2014,36047038900,"Census Tract 389, Kings County, New York",1229,98,1131,740,1969,26231,1954,2007,1163,44.2,199,179,22,65,450,1131,414
2015,36047038900,"Census Tract 389, Kings County, New York",1223,71,1152,786,2040,41000,1939,2008,1286,36.8,233,201,46,73,466,1152,382
2016,36047038900,"Census Tract 389, Kings County, New York",1231,80,1151,763,1920,42228,1939,2009,1399,35.9,242,197,80,118,353,1151,368
2017,36047038900,"Census Tract 389, Kings County, New York",1190,81,1109,787,2115,49965,1951,2010,1567,29.8,306,262,62,130,322,1109,261
2018,36047038900,"Census Tract 389, Kings County, New York",1241,110,1131,821,2195,52583,1968,2011,1597,31.1,312,254,82,124,381,1131,211
2019,36047038900,"Census Tract 389, Kings County, New York",1288,150,1138,863,2044,67614,1962,2013,1758,31.1,362,324,89,95,344,1138,175
2020,36047038900,"Census Tract 389, Kings County, New York",1315,123,1192,852,2066,81745,1965,2016,2134,31.4,477,432,59,90,244,1192,105
2012,36047039000,"Census Tract 390, Kings County, New York",932,137,795,266,776,36875,1945,2003,1481,34.9,61,224,0,42,0,795,60
2013,36047039000,"Census Tract 390, Kings County, New York",937,138,799,257,698,33990,1947,2005,1154,34.2,73,214,0,43,0,799,75
2014,36047039000,"Census Tract 390, Kings County, New York",931,140,791,278,743,27065,1949,2006,1162,34.7,99,232,0,46,0,791,106
2015,36047039000,"Census Tract 390, Kings County, New York",895,107,788,276,789,25568,1951,2010,1350,50,88,246,0,12,18,788,148
2016,36047039000,"Census Tract 390, Kings County, New York",867,89,778,308,879,26667,1951,2011,1336,50,98,265,0,12,16,778,142
2017,36047039000,"Census Tract 390, Kings County, New York",866,120,746,268,834,47750,1948,2012,1354,29.8,72,236,0,0,17,746,117
2018,36047039000,"Census Tract 390, Kings County, New York",862,139,723,258,781,56500,1950,2012,1431,30.8,71,229,0,0,17,723,104
2019,36047039000,"Census Tract 390, Kings County, New York",891,128,763,293,877,55250,1948,2015,1416,29.8,81,228,0,0,51,763,119
2020,36047039000,"Census Tract 390, Kings County, New York",899,122,777,276,860,61579,1949,2014,1386,25,72,223,0,0,39,777,73
2012,36047039100,"Census Tract 391, Kings County, New York",944,37,907,707,2002,36964,2001,2005,1030,31.9,158,193,54,49,421,907,257
2013,36047039100,"Census Tract 391, Kings County, New York",1047,45,1002,822,2202,38143,2000,2005,1115,33.9,210,233,45,44,501,1002,261
2014,36047039100,"Census Tract 391, Kings County, New York",1072,41,1031,868,2613,32381,2001,2006,1115,40.4,224,180,157,27,537,1031,364
2015,36047039100,"Census Tract 391, Kings County, New York",1099,48,1051,964,2809,30682,1996,2007,1158,44.4,291,236,161,28,561,1051,408
2016,36047039100,"Census Tract 391, Kings County, New York",1157,31,1126,991,2774,35525,2000,2009,1202,41.1,341,253,192,46,556,1126,368
2017,36047039100,"Census Tract 391, Kings County, New York",1169,32,1137,988,2632,36848,1995,2011,1311,37,365,309,161,48,515,1137,304
2018,36047039100,"Census Tract 391, Kings County, New York",1181,57,1124,981,2377,37178,1998,2012,1308,33.5,395,331,184,62,447,1124,284
2019,36047039100,"Census Tract 391, Kings County, New York",1429,58,1371,1256,2910,70000,2002,2013,1249,30.5,581,438,101,127,571,1371,293
2020,36047039100,"Census Tract 391, Kings County, New York",1548,92,1456,1329,3219,85024,2006,2014,1542,28.3,684,440,105,157,592,1456,277
2012,36047039200,"Census Tract 392, Kings County, New York",1060,120,940,541,1045,32461,1939,2001,1059,44.4,207,392,38,56,55,940,92
2013,36047039200,"Census Tract 392, Kings County, New York",1025,133,892,530,1143,30814,1943,2002,1123,46.9,179,430,12,55,33,892,156
2014,36047039200,"Census Tract 392, Kings County, New York",1103,91,1012,633,1532,30871,1945,2004,1191,46.3,248,515,13,72,33,1012,209
2015,36047039200,"Census Tract 392, Kings County, New York",1104,82,1022,631,1568,35697,1950,2009,1240,45.8,262,509,16,73,33,1022,210
2016,36047039200,"Census Tract 392, Kings County, New York",1097,78,1019,718,2090,48750,1939,2011,1446,37.9,330,578,13,118,9,1019,262
2017,36047039200,"Census Tract 392, Kings County, New York",1100,101,999,644,1699,48409,1951,2011,1440,41.4,262,554,0,54,36,999,301
2018,36047039200,"Census Tract 392, Kings County, New York",1170,86,1084,669,1843,51577,0,2012,1480,38.5,261,576,0,50,43,1084,252
2019,36047039200,"Census Tract 392, Kings County, New York",1165,99,1066,641,1657,51006,0,2011,1438,34.8,240,562,0,41,38,1066,172
2020,36047039200,"Census Tract 392, Kings County, New York",1244,89,1155,815,2041,42114,1951,2011,1427,37,331,668,66,49,32,1155,207
2012,36047039300,"Census Tract 393, Kings County, New York",1376,230,1146,930,2416,45256,1939,2004,1334,31.6,227,185,318,0,463,1146,243
2013,36047039300,"Census Tract 393, Kings County, New York",1364,178,1186,898,2570,45000,1939,2005,1239,31.7,245,208,290,8,500,1186,255
2014,36047039300,"Census Tract 393, Kings County, New York",1393,155,1238,935,2538,50495,1939,2006,1180,29.7,303,220,341,7,549,1238,261
2015,36047039300,"Census Tract 393, Kings County, New York",1412,173,1239,988,2384,47222,1939,2009,1142,33.5,261,260,362,7,535,1239,298
2016,36047039300,"Census Tract 393, Kings County, New York",1452,144,1308,1019,2458,44269,1939,2011,1278,37.3,226,253,403,20,527,1308,353
2017,36047039300,"Census Tract 393, Kings County, New York",1483,142,1341,1013,2393,50313,1943,2011,1364,34.7,274,273,367,55,462,1341,308
2018,36047039300,"Census Tract 393, Kings County, New York",1575,109,1466,1180,2638,54150,1943,2012,1615,34.5,411,317,367,78,511,1466,350
2019,36047039300,"Census Tract 393, Kings County, New York",1636,149,1487,1121,2659,56734,1963,2013,1865,33.7,437,353,256,93,427,1487,376
2020,36047039300,"Census Tract 393, Kings County, New York",1600,113,1487,1082,2640,57955,1948,2014,2022,33.5,496,367,213,116,396,1487,383
2012,36047039400,"Census Tract 394, Kings County, New York",881,102,779,404,1084,40709,1939,2002,1101,32.5,52,339,0,6,28,779,57
2013,36047039400,"Census Tract 394, Kings County, New York",833,52,781,444,1219,40439,1939,2005,1264,34.8,94,373,0,4,35,781,66
2014,36047039400,"Census Tract 394, Kings County, New York",790,86,704,403,1126,40772,1939,2006,1309,35.8,91,341,0,8,19,704,76
2015,36047039400,"Census Tract 394, Kings County, New York",809,72,737,412,1286,42500,1939,2006,1412,37.5,118,324,0,8,44,737,78
2016,36047039400,"Census Tract 394, Kings County, New York",786,79,707,383,1173,44250,1939,2007,1405,34.7,132,309,0,14,57,707,89
2017,36047039400,"Census Tract 394, Kings County, New York",800,97,703,347,1110,44620,1939,2010,1431,35.5,119,246,14,12,52,703,130
2018,36047039400,"Census Tract 394, Kings County, New York",802,109,693,354,1180,44500,0,2008,1503,38.9,107,261,11,22,38,693,161
2019,36047039400,"Census Tract 394, Kings County, New York",829,132,697,321,1013,36908,0,2010,1439,51,93,225,12,14,45,697,186
2020,36047039400,"Census Tract 394, Kings County, New York",808,102,706,317,868,NA,0,2011,1325,51,91,227,14,19,28,706,226
2012,36047039500,"Census Tract 395, Kings County, New York",1407,231,1176,1053,3067,18906,1939,2004,1249,50,191,128,276,75,611,1176,562
2013,36047039500,"Census Tract 395, Kings County, New York",1392,203,1189,1064,3093,25526,1939,2004,1152,44.1,185,92,350,99,613,1189,495
2014,36047039500,"Census Tract 395, Kings County, New York",1386,161,1225,1070,3184,24479,1939,2006,1204,40.4,182,74,331,144,605,1225,498
2015,36047039500,"Census Tract 395, Kings County, New York",1366,204,1162,902,2727,27039,1939,2008,1185,39.9,130,126,258,76,505,1162,513
2016,36047039500,"Census Tract 395, Kings County, New York",1395,154,1241,1018,3346,41077,1939,2010,1238,34,180,173,310,123,482,1241,480
2017,36047039500,"Census Tract 395, Kings County, New York",1440,178,1262,1032,3375,43068,1939,2012,1296,31.5,256,205,335,136,414,1262,488
2018,36047039500,"Census Tract 395, Kings County, New York",1427,177,1250,995,2975,42245,0,2012,1423,31.5,273,281,268,94,341,1250,456
2019,36047039500,"Census Tract 395, Kings County, New York",1413,123,1290,1013,2834,51635,0,2014,1903,30.6,316,339,268,82,321,1290,391
2020,36047039500,"Census Tract 395, Kings County, New York",1776,82,1694,1434,3328,NA,0,2016,2012,35,491,668,341,81,342,1694,473
2012,36047039600,"Census Tract 396, Kings County, New York",786,82,704,328,832,29231,1939,2003,948,33.5,49,239,35,30,8,704,91
2013,36047039600,"Census Tract 396, Kings County, New York",801,106,695,339,768,30875,1939,2005,1151,38.4,80,301,0,4,28,695,83
2014,36047039600,"Census Tract 396, Kings County, New York",824,110,714,389,958,31250,1939,2008,1222,46.4,116,329,0,7,47,714,130
2015,36047039600,"Census Tract 396, Kings County, New York",806,97,709,408,1105,40955,1951,2010,1229,40.3,112,297,0,6,68,709,100
2016,36047039600,"Census Tract 396, Kings County, New York",853,124,729,439,1110,39728,1954,2012,1291,44.8,95,302,0,6,64,729,104
2017,36047039600,"Census Tract 396, Kings County, New York",838,138,700,450,1085,40342,1955,2012,1300,48.1,121,314,0,6,69,700,112
2018,36047039600,"Census Tract 396, Kings County, New York",849,120,729,456,1194,43617,1956,2013,1345,38.4,154,330,0,5,57,729,117
2019,36047039600,"Census Tract 396, Kings County, New York",819,153,666,389,1161,NA,1949,2013,1376,32.6,142,311,0,5,14,666,82
2020,36047039600,"Census Tract 396, Kings County, New York",811,164,647,383,1067,48750,1944,2013,1440,38.6,161,339,0,5,7,647,117
2012,36047039700,"Census Tract 397, Kings County, New York",1435,320,1115,887,2104,25048,1939,2004,1194,34.5,129,108,537,0,255,1115,306
2013,36047039700,"Census Tract 397, Kings County, New York",1471,247,1224,1026,2713,28529,1939,2005,1200,36.7,144,110,638,0,290,1224,358
2014,36047039700,"Census Tract 397, Kings County, New York",1432,232,1200,999,2483,29201,1939,2006,1220,40.8,208,158,575,0,271,1200,370
2015,36047039700,"Census Tract 397, Kings County, New York",1450,253,1197,941,2472,37621,1939,2007,1263,34.2,214,169,524,0,277,1197,347
2016,36047039700,"Census Tract 397, Kings County, New York",1480,211,1269,902,2289,36172,1939,2008,1323,36,263,192,528,0,267,1269,362
2017,36047039700,"Census Tract 397, Kings County, New York",1484,193,1291,946,2598,36371,1939,2011,1250,33.1,269,193,542,0,259,1291,411
2018,36047039700,"Census Tract 397, Kings County, New York",1506,210,1296,918,2205,31964,0,2012,1296,33.9,269,242,530,0,210,1296,406
2019,36047039700,"Census Tract 397, Kings County, New York",1586,212,1374,955,2327,41780,0,2013,1374,31.3,324,224,516,19,224,1374,355
2020,36047039700,"Census Tract 397, Kings County, New York",1569,216,1353,1021,2495,55121,0,2014,1666,30,367,296,505,18,256,1353,300
2012,36047039800,"Census Tract 398, Kings County, New York",898,90,808,405,1138,33403,1942,2003,1110,35.4,93,266,0,105,34,808,61
2013,36047039800,"Census Tract 398, Kings County, New York",917,102,815,396,1111,29188,1944,2003,1123,36.8,98,250,0,101,45,815,80
2014,36047039800,"Census Tract 398, Kings County, New York",960,94,866,448,1411,27667,1939,2006,1173,43.6,86,280,0,102,66,866,140
2015,36047039800,"Census Tract 398, Kings County, New York",938,65,873,411,1423,29612,1939,2010,1226,41.3,93,220,0,123,68,873,146
2016,36047039800,"Census Tract 398, Kings County, New York",943,46,897,436,1394,38452,1939,2010,1284,40.2,92,237,0,127,72,897,171
2017,36047039800,"Census Tract 398, Kings County, New York",895,37,858,392,1251,38636,1939,2011,1327,40.9,84,221,0,105,66,858,187
2018,36047039800,"Census Tract 398, Kings County, New York",908,41,867,396,1309,42159,0,2012,1363,32.8,104,193,0,108,83,867,204
2019,36047039800,"Census Tract 398, Kings County, New York",887,45,842,397,1436,70982,0,2014,1394,22.3,112,144,0,142,93,842,116
2020,36047039800,"Census Tract 398, Kings County, New York",844,53,791,378,1427,71976,0,2015,1461,25.2,86,122,0,125,82,791,100
2012,36047039900,"Census Tract 399, Kings County, New York",1493,176,1317,1089,3194,36107,1939,2004,897,23.4,146,36,526,0,558,1317,313
2013,36047039900,"Census Tract 399, Kings County, New York",1508,205,1303,1105,3217,31648,1939,2005,979,26.4,177,66,653,15,480,1303,392
2014,36047039900,"Census Tract 399, Kings County, New York",1516,231,1285,1137,3094,36298,1939,2006,1118,30.7,239,77,739,9,453,1285,373
2015,36047039900,"Census Tract 399, Kings County, New York",1540,268,1272,1115,2777,24821,1939,2005,1141,38.1,222,56,733,9,529,1272,411
2016,36047039900,"Census Tract 399, Kings County, New York",1516,150,1366,1240,3035,33456,1939,2006,1196,39.6,242,89,776,12,584,1366,441
2017,36047039900,"Census Tract 399, Kings County, New York",1517,100,1417,1275,3404,36979,1939,2009,1175,36.5,308,154,667,8,630,1417,452
2018,36047039900,"Census Tract 399, Kings County, New York",1524,131,1393,1221,3257,41853,0,2010,1217,35.2,315,173,564,0,629,1393,370
2019,36047039900,"Census Tract 399, Kings County, New York",1561,112,1449,1210,3116,43261,0,2012,1362,32.5,281,202,452,0,597,1449,391
2020,36047039900,"Census Tract 399, Kings County, New York",1764,94,1670,1411,3349,49653,0,2016,1319,29.6,333,249,508,0,780,1670,545
2012,36047040000,"Census Tract 400, Kings County, New York",1218,98,1120,683,1707,40657,1939,2003,1137,31.9,107,391,10,166,100,1120,191
2013,36047040000,"Census Tract 400, Kings County, New York",1213,110,1103,633,1522,40531,1939,2004,1159,35.1,126,370,11,135,102,1103,198
2014,36047040000,"Census Tract 400, Kings County, New York",1208,94,1114,616,1690,40726,1939,2006,1263,37,118,352,0,140,113,1114,240
2015,36047040000,"Census Tract 400, Kings County, New York",1191,73,1118,680,1905,40944,1939,2006,1262,35.6,144,387,0,183,110,1118,231
2016,36047040000,"Census Tract 400, Kings County, New York",1144,83,1061,616,1657,41604,1939,2006,1286,35.9,151,399,0,120,97,1061,188
2017,36047040000,"Census Tract 400, Kings County, New York",1158,73,1085,613,1554,40655,1939,2008,1354,38.2,132,313,20,173,107,1085,148
2018,36047040000,"Census Tract 400, Kings County, New York",1175,47,1128,662,1717,42667,0,2009,1441,38.7,124,309,25,178,150,1128,141
2019,36047040000,"Census Tract 400, Kings County, New York",1147,89,1058,583,1443,44145,0,2010,1428,36,121,290,24,130,139,1058,105
2020,36047040000,"Census Tract 400, Kings County, New York",1075,89,986,569,1424,46213,0,2013,1429,39.6,104,302,17,113,137,986,133
2012,36047040100,"Census Tract 401, Kings County, New York",1289,235,1054,753,2186,40677,1939,2003,1138,35.9,121,45,502,0,236,1054,331
2013,36047040100,"Census Tract 401, Kings County, New York",1288,210,1078,816,2270,31979,1939,2004,1131,32.7,121,72,499,0,289,1078,326
2014,36047040100,"Census Tract 401, Kings County, New York",1325,174,1151,934,2482,40617,1939,2005,1161,37.3,186,134,554,0,316,1151,328
2015,36047040100,"Census Tract 401, Kings County, New York",1358,198,1160,931,2374,40507,1939,2008,1188,38.1,232,131,482,23,346,1160,313
2016,36047040100,"Census Tract 401, Kings County, New York",1342,180,1162,935,2311,41263,1941,2009,1297,38.4,260,102,498,39,323,1162,273
2017,36047040100,"Census Tract 401, Kings County, New York",1322,158,1164,930,2422,40985,1963,2010,1342,43.7,301,138,454,49,309,1164,301
2018,36047040100,"Census Tract 401, Kings County, New York",1347,171,1176,926,2285,38750,1966,2010,1361,44.2,237,158,368,39,361,1176,316
2019,36047040100,"Census Tract 401, Kings County, New York",1334,214,1120,786,1861,41354,1971,2013,1368,38,261,155,352,51,232,1120,256
2020,36047040100,"Census Tract 401, Kings County, New York",1335,191,1144,643,1564,42569,1960,2012,1396,36.7,192,140,317,27,176,1144,286
2012,36047040200,"Census Tract 402, Kings County, New York",986,104,882,419,949,34306,1939,2004,942,35.3,119,180,0,127,112,882,135
2013,36047040200,"Census Tract 402, Kings County, New York",983,85,898,435,1031,31653,1939,2004,1023,34.9,120,182,0,126,127,898,145
2014,36047040200,"Census Tract 402, Kings County, New York",953,71,882,410,1025,35250,1939,2005,1077,34.8,134,185,0,131,87,882,167
2015,36047040200,"Census Tract 402, Kings County, New York",986,80,906,421,1137,31382,1939,2006,1121,35.5,118,189,0,151,75,906,195
2016,36047040200,"Census Tract 402, Kings County, New York",991,74,917,485,1351,30688,1939,2007,1206,38.6,133,194,0,157,128,917,238
2017,36047040200,"Census Tract 402, Kings County, New York",1001,53,948,491,1460,38188,1939,2007,1226,37.2,141,223,0,124,138,948,195
2018,36047040200,"Census Tract 402, Kings County, New York",997,57,940,446,1218,29643,0,2007,1294,39.9,132,203,0,106,131,940,241
2019,36047040200,"Census Tract 402, Kings County, New York",1010,55,955,488,1381,41733,0,2007,1380,36.2,118,238,0,123,111,955,196
2020,36047040200,"Census Tract 402, Kings County, New York",970,61,909,464,1231,42500,0,2008,1426,37.2,121,227,0,101,123,909,174
2012,36047040300,"Census Tract 403, Kings County, New York",1293,155,1138,747,2107,17328,1947,2004,1298,50,89,30,516,0,215,1138,480
2013,36047040300,"Census Tract 403, Kings County, New York",1331,133,1198,903,2787,20967,1957,2006,1366,50,174,44,630,9,245,1198,517
2014,36047040300,"Census Tract 403, Kings County, New York",1403,149,1254,986,3052,21529,1961,2008,1349,50,173,50,675,8,297,1254,596
2015,36047040300,"Census Tract 403, Kings County, New York",1473,172,1301,1003,2830,22372,1952,2010,1344,50,198,110,671,6,265,1301,599
2016,36047040300,"Census Tract 403, Kings County, New York",1464,206,1258,912,2572,24015,1950,2011,1421,50,244,154,545,15,210,1258,498
2017,36047040300,"Census Tract 403, Kings County, New York",1525,210,1315,991,2751,27596,1951,2012,1574,47.3,251,155,545,24,289,1315,429
2018,36047040300,"Census Tract 403, Kings County, New York",1537,238,1299,914,2303,34048,0,2012,1739,43.4,232,190,442,49,255,1299,415
2019,36047040300,"Census Tract 403, Kings County, New York",1575,280,1295,864,2065,40417,1949,2013,1801,39,290,194,429,46,242,1295,393
2020,36047040300,"Census Tract 403, Kings County, New York",1566,258,1308,906,2210,53611,1954,2013,1916,35,343,150,469,50,276,1308,331
2012,36047040400,"Census Tract 404, Kings County, New York",821,78,743,419,1256,35163,1939,2004,958,25.3,54,202,2,197,18,743,105
2013,36047040400,"Census Tract 404, Kings County, New York",871,105,766,446,1157,35093,1939,2005,1045,31.8,93,232,15,162,37,766,126
2014,36047040400,"Census Tract 404, Kings County, New York",899,100,799,448,1186,36250,1939,2006,1104,34.1,83,230,0,145,83,799,115
2015,36047040400,"Census Tract 404, Kings County, New York",909,81,828,472,1260,32451,1939,2006,1142,36.8,98,243,10,138,91,828,137
2016,36047040400,"Census Tract 404, Kings County, New York",911,101,810,440,1180,39038,1939,2007,1187,34.6,94,219,13,124,94,810,136
2017,36047040400,"Census Tract 404, Kings County, New York",945,114,831,407,1020,41031,1939,2008,1216,34.8,66,193,12,108,107,831,171
2018,36047040400,"Census Tract 404, Kings County, New York",926,81,845,397,1032,42390,0,2011,1339,33.6,85,169,15,122,103,845,139
2019,36047040400,"Census Tract 404, Kings County, New York",923,85,838,405,1083,42813,0,2012,1372,35.8,96,171,16,123,73,838,151
2020,36047040400,"Census Tract 404, Kings County, New York",899,105,794,379,1056,51985,0,2014,1425,29.1,128,143,0,131,83,794,114
2012,36047040500,"Census Tract 405, Kings County, New York",600,138,462,321,982,36172,1939,2004,1057,31.1,5,0,244,17,90,462,57
2013,36047040500,"Census Tract 405, Kings County, New York",587,105,482,325,897,35605,1939,2004,1065,35.5,20,15,248,23,71,482,85
2014,36047040500,"Census Tract 405, Kings County, New York",612,117,495,359,936,35893,1939,2006,1160,38.4,36,19,235,23,109,495,119
2015,36047040500,"Census Tract 405, Kings County, New York",634,97,537,434,1164,36279,1950,2010,1317,41.3,53,33,249,31,153,537,153
2016,36047040500,"Census Tract 405, Kings County, New York",651,89,562,446,1115,39946,1945,2011,1366,31.1,97,53,233,17,160,562,129
2017,36047040500,"Census Tract 405, Kings County, New York",666,66,600,513,1192,58229,1960,2011,1452,29.4,191,100,285,20,112,600,138
2018,36047040500,"Census Tract 405, Kings County, New York",699,79,620,521,1276,46938,1947,2012,1563,31.3,187,107,225,22,173,620,158
2019,36047040500,"Census Tract 405, Kings County, New York",696,83,613,497,1075,61563,0,2014,1797,34.1,225,120,240,14,103,613,102
2020,36047040500,"Census Tract 405, Kings County, New York",732,63,669,539,1078,59670,1961,2015,2001,42.3,232,156,255,16,94,669,85
2012,36047040600,"Census Tract 406, Kings County, New York",1198,94,1104,700,1944,36716,1939,2003,1077,33.4,55,340,0,241,85,1104,86
2013,36047040600,"Census Tract 406, Kings County, New York",1182,107,1075,699,1874,36613,1939,2005,1206,37.2,93,304,19,259,105,1075,109
2014,36047040600,"Census Tract 406, Kings County, New York",1216,113,1103,684,1790,36064,1939,2006,1203,36.7,120,277,26,232,144,1103,94
2015,36047040600,"Census Tract 406, Kings County, New York",1232,80,1152,695,1906,34203,1939,2007,1262,43.6,123,282,26,223,174,1152,130
2016,36047040600,"Census Tract 406, Kings County, New York",1192,96,1096,624,1619,28989,1939,2009,1249,50,161,247,25,188,155,1096,246
2017,36047040600,"Census Tract 406, Kings County, New York",1242,85,1157,687,1831,25723,1939,2011,1297,50,153,291,37,186,175,1157,305
2018,36047040600,"Census Tract 406, Kings County, New York",1272,72,1200,666,1833,26081,0,2011,1310,51,170,295,8,158,190,1200,300
2019,36047040600,"Census Tract 406, Kings County, New York",1225,74,1151,660,1819,28841,0,2012,1384,51,171,290,5,198,159,1151,287
2020,36047040600,"Census Tract 406, Kings County, New York",1204,50,1154,695,2016,53693,0,2016,1428,33.3,169,342,8,238,107,1154,215
2012,36047040700,"Census Tract 407, Kings County, New York",0,0,0,0,0,NA,NA,NA,NA,NA,0,0,0,0,0,0,0
2013,36047040700,"Census Tract 407, Kings County, New York",0,0,0,0,0,NA,NA,NA,NA,NA,0,0,0,0,0,0,0
2014,36047040700,"Census Tract 407, Kings County, New York",0,0,0,0,0,NA,NA,NA,NA,NA,0,0,0,0,0,0,0
2015,36047040700,"Census Tract 407, Kings County, New York",0,0,0,0,0,NA,NA,NA,NA,NA,0,0,0,0,0,0,0
2016,36047040700,"Census Tract 407, Kings County, New York",0,0,0,0,0,NA,NA,NA,NA,NA,0,0,0,0,0,0,0
2017,36047040700,"Census Tract 407, Kings County, New York",0,0,0,0,0,NA,NA,NA,NA,NA,0,0,0,0,0,0,0
2018,36047040700,"Census Tract 407, Kings County, New York",0,0,0,0,0,NA,NA,NA,NA,NA,0,0,0,0,0,0,0
2019,36047040700,"Census Tract 407, Kings County, New York",0,0,0,0,0,NA,NA,NA,NA,NA,0,0,0,0,0,0,0
2020,36047040700,"Census Tract 407, Kings County, New York",0,0,0,0,0,NA,NA,NA,NA,NA,0,0,0,0,0,0,0
2012,36047040800,"Census Tract 408, Kings County, New York",1117,49,1068,581,1546,38717,1939,2003,1194,32.6,151,352,0,166,54,1068,165
2013,36047040800,"Census Tract 408, Kings County, New York",1118,60,1058,622,1787,40774,1939,2004,1140,32.4,167,326,29,220,25,1058,184
2014,36047040800,"Census Tract 408, Kings County, New York",1092,75,1017,625,1868,29964,1939,2005,1199,36.5,171,295,20,222,66,1017,239
2015,36047040800,"Census Tract 408, Kings County, New York",1105,61,1044,666,2001,46667,1939,2010,1253,30.6,228,281,21,264,80,1044,267
2016,36047040800,"Census Tract 408, Kings County, New York",1097,62,1035,608,2019,48676,1939,2010,1287,30.5,181,260,22,187,105,1035,251
2017,36047040800,"Census Tract 408, Kings County, New York",1114,83,1031,573,1903,65066,1939,2011,1354,32.8,146,195,23,187,147,1031,177
2018,36047040800,"Census Tract 408, Kings County, New York",1121,72,1049,594,1953,60750,0,2012,1397,33.1,163,173,0,228,177,1049,119
2019,36047040800,"Census Tract 408, Kings County, New York",1180,62,1118,588,1862,78486,0,2013,1384,25.2,131,210,0,236,128,1118,84
2020,36047040800,"Census Tract 408, Kings County, New York",1261,68,1193,481,1534,78340,0,2014,1442,30.4,112,212,0,148,104,1193,77
2012,36047040900,"Census Tract 409, Kings County, New York",1381,198,1183,940,2955,24932,1939,2004,1315,50,111,82,198,20,654,1183,346
2013,36047040900,"Census Tract 409, Kings County, New York",1387,140,1247,1005,3139,28168,1939,2005,1241,43.1,116,108,231,30,699,1247,408
2014,36047040900,"Census Tract 409, Kings County, New York",1375,100,1275,1016,3259,30455,1939,2007,1214,41,99,92,241,28,763,1275,424
2015,36047040900,"Census Tract 409, Kings County, New York",1398,144,1254,1028,3057,33208,1939,2010,1290,43.1,142,103,259,24,771,1254,403
2016,36047040900,"Census Tract 409, Kings County, New York",1420,160,1260,1037,2980,36806,1939,2011,1404,39.3,150,98,310,23,757,1260,323
2017,36047040900,"Census Tract 409, Kings County, New York",1432,141,1291,1053,2794,43777,1939,2011,1391,38.5,163,98,292,9,794,1291,309
2018,36047040900,"Census Tract 409, Kings County, New York",1440,126,1314,1145,3086,48146,0,2011,1427,36.2,205,114,283,0,843,1314,359
2019,36047040900,"Census Tract 409, Kings County, New York",1449,119,1330,1163,3252,52511,0,2011,1463,37.5,186,115,360,0,755,1330,292
2020,36047040900,"Census Tract 409, Kings County, New York",1412,63,1349,1161,3253,52585,0,2013,1694,44,170,187,252,0,648,1349,376
2012,36047041000,"Census Tract 410, Kings County, New York",713,32,681,270,618,31615,1950,2005,854,30.5,32,178,0,27,65,681,64
2013,36047041000,"Census Tract 410, Kings County, New York",732,35,697,292,622,31336,1948,2005,896,32.7,35,209,0,33,50,697,55
2014,36047041000,"Census Tract 410, Kings County, New York",757,55,702,290,684,34226,1943,2004,973,31.7,47,188,0,41,61,702,90
2015,36047041000,"Census Tract 410, Kings County, New York",743,41,702,296,743,26522,1939,2007,1093,36.5,55,203,0,37,56,702,148
2016,36047041000,"Census Tract 410, Kings County, New York",761,73,688,328,924,NA,1939,2009,1172,34.5,90,199,0,74,50,688,152
2017,36047041000,"Census Tract 410, Kings County, New York",793,76,717,346,946,41167,1939,2008,1259,33.5,92,243,0,79,18,717,136
2018,36047041000,"Census Tract 410, Kings County, New York",811,84,727,340,877,36000,0,2011,1393,39.1,91,239,0,72,22,727,165
2019,36047041000,"Census Tract 410, Kings County, New York",766,72,694,348,899,33594,0,2013,1520,41.9,94,262,0,67,13,694,156
2020,36047041000,"Census Tract 410, Kings County, New York",701,70,631,318,829,42656,0,2013,1698,39.2,80,230,0,65,7,631,100
2012,36047041100,"Census Tract 411, Kings County, New York",1278,114,1164,955,2564,25154,1955,NA,1104,35.8,102,64,479,0,393,1164,481
2013,36047041100,"Census Tract 411, Kings County, New York",1255,147,1108,886,2494,26298,1956,2007,1173,34.5,70,51,440,0,386,1108,417
2014,36047041100,"Census Tract 411, Kings County, New York",1292,157,1135,918,2801,26905,1958,2007,1082,34.9,43,61,360,0,489,1135,431
2015,36047041100,"Census Tract 411, Kings County, New York",1313,179,1134,960,2861,27048,1955,2008,1162,37.2,71,40,355,45,494,1134,380
2016,36047041100,"Census Tract 411, Kings County, New York",1304,215,1089,860,2361,26111,1958,2010,1066,37.3,144,71,320,53,398,1089,314
2017,36047041100,"Census Tract 411, Kings County, New York",1323,214,1109,931,2427,26813,1950,2011,1169,40.3,182,132,379,62,346,1109,350
2018,36047041100,"Census Tract 411, Kings County, New York",1360,202,1158,1015,2416,26653,1951,2011,1161,39.9,175,185,373,56,395,1158,378
2019,36047041100,"Census Tract 411, Kings County, New York",1377,199,1178,986,2172,27500,0,2012,1238,44.4,221,232,375,56,287,1178,388
2020,36047041100,"Census Tract 411, Kings County, New York",1336,158,1178,975,2061,NA,0,2013,1594,51,342,252,388,24,235,1178,411
2012,36047041200,"Census Tract 412, Kings County, New York",1098,53,1045,605,1519,39068,1939,2003,1151,35.8,132,398,0,96,100,1045,106
2013,36047041200,"Census Tract 412, Kings County, New York",1136,100,1036,650,1508,37212,1939,2004,1151,36.9,177,497,0,12,128,1036,135
2014,36047041200,"Census Tract 412, Kings County, New York",1177,160,1017,587,1533,36328,1939,2005,1163,38.6,141,402,0,12,157,1017,142
2015,36047041200,"Census Tract 412, Kings County, New York",1137,129,1008,576,1498,38333,1939,2006,1176,38.9,145,364,0,22,190,1008,162
2016,36047041200,"Census Tract 412, Kings County, New York",1152,123,1029,572,1513,40357,1939,2007,1196,36.5,154,407,0,22,143,1029,176
2017,36047041200,"Census Tract 412, Kings County, New York",1118,121,997,555,1552,30733,1939,2006,1206,34.5,150,406,0,29,108,997,216
2018,36047041200,"Census Tract 412, Kings County, New York",1117,92,1025,503,1266,35688,0,2005,1190,35.2,132,369,0,60,54,1025,216
2019,36047041200,"Census Tract 412, Kings County, New York",1088,19,1069,561,1317,26461,0,2006,1325,38.9,184,402,0,69,75,1069,285
2020,36047041200,"Census Tract 412, Kings County, New York",1131,12,1119,628,1645,26821,0,2007,1358,39.1,160,388,0,175,53,1119,337
2012,36047041300,"Census Tract 413, Kings County, New York",1298,244,1054,732,2426,38500,1945,2004,1348,35.9,132,55,289,17,394,1054,185
2013,36047041300,"Census Tract 413, Kings County, New York",1343,195,1148,891,2859,34779,1939,2005,1274,36.2,169,86,302,17,551,1148,267
2014,36047041300,"Census Tract 413, Kings County, New York",1376,128,1248,944,2828,32167,1939,2007,1234,37.6,161,131,373,18,529,1248,294
2015,36047041300,"Census Tract 413, Kings County, New York",1442,64,1378,1084,3322,36346,1939,2008,1278,37.1,229,132,471,18,614,1378,301
2016,36047041300,"Census Tract 413, Kings County, New York",1440,89,1351,1105,3298,34653,1939,2009,1285,38,163,101,571,0,618,1351,328
2017,36047041300,"Census Tract 413, Kings County, New York",1421,71,1350,1123,3276,33750,1939,2010,1248,38.5,155,118,551,9,574,1350,406
2018,36047041300,"Census Tract 413, Kings County, New York",1410,51,1359,1121,3139,40705,1944,2011,1321,35.3,167,114,558,12,519,1359,321
2019,36047041300,"Census Tract 413, Kings County, New York",1448,105,1343,1096,3128,51098,0,2011,1535,32.2,205,80,469,32,579,1343,243
2020,36047041300,"Census Tract 413, Kings County, New York",1504,102,1402,1070,2521,51359,1947,2013,1415,31.6,233,112,362,89,548,1402,196
2012,36047041401,"Census Tract 414.01, Kings County, New York",546,59,487,118,373,50854,1939,1991,1362,33.1,14,93,0,0,25,487,60
2013,36047041401,"Census Tract 414.01, Kings County, New York",558,54,504,129,273,36813,1939,2002,1361,31.7,38,114,0,4,11,504,68
2014,36047041401,"Census Tract 414.01, Kings County, New York",559,53,506,155,366,39491,1951,2004,1241,33.4,45,112,0,32,11,506,95
2015,36047041401,"Census Tract 414.01, Kings County, New York",554,27,527,204,465,38500,1952,2005,1280,35.3,51,154,0,35,15,527,115
2016,36047041401,"Census Tract 414.01, Kings County, New York",561,43,518,269,704,45625,1951,2008,1390,34,72,200,0,31,38,518,122
2017,36047041401,"Census Tract 414.01, Kings County, New York",551,32,519,274,869,42917,1945,2010,1489,38.2,73,216,0,29,29,519,127
2018,36047041401,"Census Tract 414.01, Kings County, New York",510,29,481,282,1011,46250,1947,2012,1634,37.9,60,205,0,38,39,481,135
2019,36047041401,"Census Tract 414.01, Kings County, New York",511,33,478,255,877,NA,1951,2012,1667,51,67,204,0,23,28,478,142
2020,36047041401,"Census Tract 414.01, Kings County, New York",463,18,445,256,1030,51875,1952,2013,1818,47.6,87,196,0,24,36,445,118
2012,36047041402,"Census Tract 414.02, Kings County, New York",717,54,663,438,850,28750,1939,2004,1119,38,157,424,0,14,0,663,60
2013,36047041402,"Census Tract 414.02, Kings County, New York",708,49,659,357,682,21597,1939,2004,1081,39,127,344,0,13,0,659,102
2014,36047041402,"Census Tract 414.02, Kings County, New York",712,63,649,440,945,20556,1939,2004,1108,40.4,191,435,0,0,5,649,135
2015,36047041402,"Census Tract 414.02, Kings County, New York",696,49,647,462,1043,19405,1939,2006,1095,42.5,176,456,0,0,6,647,146
2016,36047041402,"Census Tract 414.02, Kings County, New York",681,15,666,478,1182,35372,1939,2007,1183,37,179,470,0,0,8,666,137
2017,36047041402,"Census Tract 414.02, Kings County, New York",695,15,680,508,1281,36824,1939,2007,1334,36.5,200,478,0,0,30,680,123
2018,36047041402,"Census Tract 414.02, Kings County, New York",728,49,679,522,1346,44286,0,2008,1383,36.2,226,466,0,0,56,679,99
2019,36047041402,"Census Tract 414.02, Kings County, New York",734,51,683,517,1394,44375,0,2008,1454,38.4,215,449,0,0,62,683,119
2020,36047041402,"Census Tract 414.02, Kings County, New York",828,77,751,562,1286,39211,0,2008,1374,42.8,204,364,0,0,150,751,121
2012,36047041500,"Census Tract 415, Kings County, New York",1436,138,1298,893,2504,36982,1939,2004,1387,43.3,70,29,449,0,474,1298,188
2013,36047041500,"Census Tract 415, Kings County, New York",1456,138,1318,886,3035,39058,1939,2005,1361,35.7,93,45,294,28,570,1318,201
2014,36047041500,"Census Tract 415, Kings County, New York",1482,207,1275,943,3061,41776,1939,2007,1433,33.6,135,36,332,50,620,1275,212
2015,36047041500,"Census Tract 415, Kings County, New York",1450,219,1231,937,3381,49196,1939,2009,1416,31.2,145,38,362,47,651,1231,245
2016,36047041500,"Census Tract 415, Kings County, New York",1427,162,1265,939,3281,46442,1939,2009,1426,32.1,116,55,333,47,679,1265,299
2017,36047041500,"Census Tract 415, Kings County, New York",1436,151,1285,967,3304,46036,1939,2010,1404,31.2,98,107,267,49,670,1285,272
2018,36047041500,"Census Tract 415, Kings County, New York",1405,144,1261,930,2756,48321,0,2011,1481,32.9,101,128,325,44,553,1261,258
2019,36047041500,"Census Tract 415, Kings County, New York",1447,116,1331,980,2899,49650,0,2010,1441,32.3,88,179,360,18,504,1331,276
2020,36047041500,"Census Tract 415, Kings County, New York",1604,143,1461,1204,2994,60625,0,2014,1725,30.2,278,331,452,19,409,1461,277
2012,36047041600,"Census Tract 416, Kings County, New York",816,67,749,291,852,27792,1939,2002,1084,38.4,81,235,0,7,49,749,118
2013,36047041600,"Census Tract 416, Kings County, New York",819,66,753,354,1029,27333,1939,2003,1051,38.2,75,272,14,18,50,753,166
2014,36047041600,"Census Tract 416, Kings County, New York",845,97,748,394,1174,22273,1939,2003,1211,49.1,101,291,14,28,61,748,176
2015,36047041600,"Census Tract 416, Kings County, New York",826,99,727,395,1305,21908,1939,2004,1316,48.7,133,293,17,29,56,727,193
2016,36047041600,"Census Tract 416, Kings County, New York",809,88,721,436,1407,24100,1939,2005,1302,45.9,152,328,15,32,61,721,225
2017,36047041600,"Census Tract 416, Kings County, New York",781,88,693,425,1359,NA,1939,2010,1308,44.7,125,311,28,29,57,693,224
2018,36047041600,"Census Tract 416, Kings County, New York",800,102,698,384,1212,50875,0,2011,1506,41.5,135,277,30,26,51,698,156
2019,36047041600,"Census Tract 416, Kings County, New York",809,82,727,393,1216,51181,0,2012,1526,43.9,168,320,23,25,25,727,149
2020,36047041600,"Census Tract 416, Kings County, New York",789,67,722,436,1306,43906,0,2013,1472,37.9,182,289,21,35,46,722,128
2012,36047041700,"Census Tract 417, Kings County, New York",1408,163,1245,1125,3092,17058,1953,2004,844,38.4,54,0,348,65,838,1245,529
2013,36047041700,"Census Tract 417, Kings County, New York",1421,211,1210,1087,3012,19076,1944,2005,865,37.2,83,20,333,63,761,1210,458
2014,36047041700,"Census Tract 417, Kings County, New York",1473,246,1227,1089,2812,20202,1955,2004,863,37.1,75,21,333,76,790,1227,443
2015,36047041700,"Census Tract 417, Kings County, New York",1493,218,1275,1175,2817,18618,1964,2005,867,37.9,92,18,415,80,857,1275,495
2016,36047041700,"Census Tract 417, Kings County, New York",1504,224,1280,1157,2884,22650,1975,2005,852,35.5,120,61,396,48,824,1280,493
2017,36047041700,"Census Tract 417, Kings County, New York",1483,195,1288,1114,2734,30688,1962,2006,847,35.5,168,80,444,36,764,1288,382
2018,36047041700,"Census Tract 417, Kings County, New York",1502,133,1369,1218,2728,23206,1966,2006,777,35,122,76,403,43,886,1369,501
2019,36047041700,"Census Tract 417, Kings County, New York",1475,99,1376,1184,2611,21667,1946,2009,1012,34.8,141,95,325,59,857,1376,522
2020,36047041700,"Census Tract 417, Kings County, New York",1381,85,1296,1092,2614,23795,1952,2008,641,31.3,122,108,158,44,836,1296,432
2012,36047041800,"Census Tract 418, Kings County, New York",881,199,682,413,754,23403,1939,2003,997,34.4,95,373,0,8,32,682,135
2013,36047041800,"Census Tract 418, Kings County, New York",866,175,691,452,828,24643,1939,2003,1053,34,89,409,0,16,27,691,134
2014,36047041800,"Census Tract 418, Kings County, New York",886,169,717,478,1025,23021,1939,2002,1074,39.6,119,382,13,19,77,717,186
2015,36047041800,"Census Tract 418, Kings County, New York",868,120,748,498,1275,27083,1939,2005,1175,43.1,107,364,14,32,102,748,212
2016,36047041800,"Census Tract 418, Kings County, New York",872,102,770,496,1450,30417,1939,2009,1247,41.3,91,363,15,26,107,770,223
2017,36047041800,"Census Tract 418, Kings County, New York",888,87,801,517,1425,30066,1939,2006,1235,41.9,114,386,14,36,95,801,241
2018,36047041800,"Census Tract 418, Kings County, New York",931,116,815,555,1655,30592,0,2009,1353,38.4,139,393,14,31,116,815,287
2019,36047041800,"Census Tract 418, Kings County, New York",919,64,855,575,1802,32330,0,2010,1552,35.4,170,441,0,34,84,855,239
2020,36047041800,"Census Tract 418, Kings County, New York",915,59,856,534,1511,30625,0,2011,1488,33.4,209,415,0,46,38,856,236
2012,36047041900,"Census Tract 419, Kings County, New York",1352,116,1236,1027,2930,30898,1975,2003,995,34.1,139,112,265,14,674,1236,357
2013,36047041900,"Census Tract 419, Kings County, New York",1361,150,1211,964,2737,32833,1971,2004,1019,34.3,116,95,316,8,631,1211,357
2014,36047041900,"Census Tract 419, Kings County, New York",1424,118,1306,997,2828,36161,1966,2004,1044,32.3,151,127,329,11,632,1306,350
2015,36047041900,"Census Tract 419, Kings County, New York",1435,123,1312,1050,2976,32336,1963,2007,1093,37.1,198,151,281,10,684,1312,406
2016,36047041900,"Census Tract 419, Kings County, New York",1412,151,1261,954,2607,37237,1972,2009,1250,34.8,248,176,266,11,580,1261,331
2017,36047041900,"Census Tract 419, Kings County, New York",1426,187,1239,999,2814,36090,1976,2005,1131,34,171,156,271,10,670,1239,317
2018,36047041900,"Census Tract 419, Kings County, New York",1428,155,1273,1099,2981,38969,1976,2009,1270,33.8,218,205,247,10,690,1273,271
2019,36047041900,"Census Tract 419, Kings County, New York",1435,138,1297,1133,3113,50673,1969,2008,1374,32,204,177,267,35,721,1297,254
2020,36047041900,"Census Tract 419, Kings County, New York",1335,85,1250,1100,3435,49097,1967,2006,1250,31.1,223,190,298,55,617,1250,358
2012,36047042000,"Census Tract 420, Kings County, New York",574,51,523,283,833,28938,1941,2004,1126,50,94,180,10,0,73,523,119
2013,36047042000,"Census Tract 420, Kings County, New York",557,54,503,243,759,27574,1944,2005,1233,50,70,161,11,0,54,503,120
2014,36047042000,"Census Tract 420, Kings County, New York",564,58,506,265,717,26850,1941,2004,1344,50,69,208,9,5,29,506,117
2015,36047042000,"Census Tract 420, Kings County, New York",559,40,519,280,764,30417,1941,2006,1341,50,88,220,10,6,32,519,114
2016,36047042000,"Census Tract 420, Kings County, New York",567,51,516,273,733,33472,1940,2006,1440,50,100,224,14,6,29,516,128
2017,36047042000,"Census Tract 420, Kings County, New York",558,42,516,208,632,41667,1947,2007,1679,29.5,83,175,10,6,20,516,102
2018,36047042000,"Census Tract 420, Kings County, New York",585,60,525,249,726,40521,0,2005,1775,30.5,113,214,11,6,22,525,109
2019,36047042000,"Census Tract 420, Kings County, New York",590,58,532,232,820,49000,1941,2007,2068,35.2,102,199,17,0,25,532,98
2020,36047042000,"Census Tract 420, Kings County, New York",563,50,513,230,930,49861,0,2007,2015,39,89,185,21,0,38,513,100
2012,36047042100,"Census Tract 421, Kings County, New York",1421,245,1176,982,2738,27722,1943,2004,1107,39.2,138,99,108,69,694,1176,311
2013,36047042100,"Census Tract 421, Kings County, New York",1453,198,1255,1089,3134,40363,1945,2006,1259,34,206,146,193,81,740,1255,289
2014,36047042100,"Census Tract 421, Kings County, New York",1470,157,1313,1177,3339,29158,1941,2007,1203,37.7,219,147,259,93,801,1313,375
2015,36047042100,"Census Tract 421, Kings County, New York",1435,133,1302,1166,3465,32344,1939,2008,1158,32.8,240,192,340,88,697,1302,346
2016,36047042100,"Census Tract 421, Kings County, New York",1436,86,1350,1162,3463,38578,1939,2010,1297,33.1,248,202,320,91,700,1350,354
2017,36047042100,"Census Tract 421, Kings County, New York",1451,79,1372,1159,3588,39539,1943,2011,1372,33.3,275,228,241,92,748,1372,403
2018,36047042100,"Census Tract 421, Kings County, New York",1463,81,1382,1184,3509,40645,0,2011,1383,37.8,356,335,185,72,646,1382,415
2019,36047042100,"Census Tract 421, Kings County, New York",1504,68,1436,1189,3424,49727,1952,2012,1657,40.4,373,345,130,25,701,1436,364
2020,36047042100,"Census Tract 421, Kings County, New York",1656,57,1599,1349,3375,62373,1952,2013,1849,35,507,426,70,69,780,1599,313
2012,36047042200,"Census Tract 422, Kings County, New York",1250,124,1126,788,1945,43500,1939,2004,1214,30.2,215,502,27,99,160,1126,85
2013,36047042200,"Census Tract 422, Kings County, New York",1229,154,1075,753,1891,56771,1939,2005,1348,30.2,252,524,39,91,99,1075,119
2014,36047042200,"Census Tract 422, Kings County, New York",1180,146,1034,697,1774,44792,1939,2005,1395,31.3,263,542,4,64,87,1034,155
2015,36047042200,"Census Tract 422, Kings County, New York",1178,100,1078,782,2428,65667,1939,2008,1435,30.4,279,535,16,80,151,1078,161
2016,36047042200,"Census Tract 422, Kings County, New York",1177,131,1046,685,2124,63583,1939,2008,1444,33.5,230,456,12,13,161,1046,124
2017,36047042200,"Census Tract 422, Kings County, New York",1212,171,1041,751,2434,59735,1939,2009,1495,34,220,432,33,42,175,1041,160
2018,36047042200,"Census Tract 422, Kings County, New York",1206,145,1061,737,2417,61792,0,2011,1467,33.4,264,401,43,42,146,1061,135
2019,36047042200,"Census Tract 422, Kings County, New York",1189,122,1067,727,2314,63173,0,2011,1552,32.5,279,381,50,46,158,1067,134
2020,36047042200,"Census Tract 422, Kings County, New York",1185,131,1054,627,2067,59028,0,2011,1619,31.5,249,344,35,39,91,1054,165
2012,36047042300,"Census Tract 423, Kings County, New York",1317,169,1148,971,3243,35481,1939,2005,1298,45.8,151,183,82,12,729,1148,385
2013,36047042300,"Census Tract 423, Kings County, New York",1347,141,1206,1025,3578,38442,1939,2007,1351,42.3,184,235,126,1,759,1206,302
2014,36047042300,"Census Tract 423, Kings County, New York",1399,85,1314,1127,3873,43917,1939,2009,1357,35.2,259,324,141,34,736,1314,312
2015,36047042300,"Census Tract 423, Kings County, New York",1414,99,1315,1205,4128,50583,1939,2010,1375,32.3,279,327,155,40,786,1315,324
2016,36047042300,"Census Tract 423, Kings County, New York",1434,60,1374,1241,3859,52872,1939,2010,1412,33.8,257,364,141,40,774,1374,325
2017,36047042300,"Census Tract 423, Kings County, New York",1433,83,1350,1220,3669,67763,1939,2011,1614,29.4,296,436,120,44,690,1350,278
2018,36047042300,"Census Tract 423, Kings County, New York",1469,103,1366,1264,3657,68929,1941,2012,1690,30.2,361,473,71,72,633,1366,268
2019,36047042300,"Census Tract 423, Kings County, New York",1494,144,1350,1232,3377,67278,1952,2013,2042,30.5,422,533,61,63,540,1350,216
2020,36047042300,"Census Tract 423, Kings County, New York",1544,178,1366,1252,3279,85165,1956,2015,2341,31.9,349,494,116,160,445,1366,129
2012,36047042400,"Census Tract 424, Kings County, New York",1358,102,1256,948,2418,34429,1939,2002,1056,32.5,248,550,31,199,155,1256,197
2013,36047042400,"Census Tract 424, Kings County, New York",1387,136,1251,945,2373,37196,1939,2003,1129,32.7,363,587,41,204,102,1251,178
2014,36047042400,"Census Tract 424, Kings County, New York",1418,174,1244,969,2447,37480,1939,2005,1142,34.5,324,639,19,180,119,1244,201
2015,36047042400,"Census Tract 424, Kings County, New York",1435,171,1264,942,2535,42036,1939,2005,1193,32.4,298,609,19,178,127,1264,203
2016,36047042400,"Census Tract 424, Kings County, New York",1435,162,1273,977,2780,40795,1939,2007,1195,32.2,313,652,0,182,133,1273,257
2017,36047042400,"Census Tract 424, Kings County, New York",1478,181,1297,996,2660,40661,1939,2008,1313,35.6,382,702,0,148,119,1297,249
2018,36047042400,"Census Tract 424, Kings County, New York",1433,202,1231,914,2515,40854,0,2007,1358,34.3,242,580,0,140,170,1231,302
2019,36047042400,"Census Tract 424, Kings County, New York",1353,166,1187,790,2257,47813,0,2006,1374,32.8,262,489,5,115,159,1187,212
2020,36047042400,"Census Tract 424, Kings County, New York",1277,141,1136,783,2153,46042,0,2010,1411,35.6,281,450,9,184,116,1136,265
2012,36047042500,"Census Tract 425, Kings County, New York",1122,130,992,955,2200,36250,1972,2005,1174,35.7,244,224,78,34,663,992,238
2013,36047042500,"Census Tract 425, Kings County, New York",1153,154,999,973,2461,37719,1965,2006,1208,38.3,285,253,114,39,648,999,218
2014,36047042500,"Census Tract 425, Kings County, New York",1157,148,1009,971,2487,41843,1963,2007,1244,33,318,299,101,36,608,1009,179
2015,36047042500,"Census Tract 425, Kings County, New York",1157,124,1033,997,2759,NA,1964,2010,1363,34.5,369,366,71,38,586,1033,222
2016,36047042500,"Census Tract 425, Kings County, New York",1128,75,1053,1020,2806,49542,1967,2011,1439,35.1,437,345,76,38,595,1053,165
2017,36047042500,"Census Tract 425, Kings County, New York",1150,72,1078,1027,2901,59398,1973,2011,1491,31.5,497,394,68,37,550,1078,131
2018,36047042500,"Census Tract 425, Kings County, New York",1175,63,1112,1047,2870,75391,1979,2011,1692,27.4,475,406,80,19,549,1112,106
2019,36047042500,"Census Tract 425, Kings County, New York",1183,72,1111,1069,3207,77566,1990,2012,1793,31.2,471,332,103,30,610,1111,184
2020,36047042500,"Census Tract 425, Kings County, New York",1137,49,1088,1035,3235,76994,1979,2013,1780,31.1,451,369,97,21,550,1088,141
2012,36047042600,"Census Tract 426, Kings County, New York",1481,77,1404,857,2378,29554,1939,2003,1025,32.3,156,456,10,260,117,1404,323
2013,36047042600,"Census Tract 426, Kings County, New York",1495,45,1450,887,2503,26116,1939,2002,1090,35.6,177,498,19,243,112,1450,318
2014,36047042600,"Census Tract 426, Kings County, New York",1518,35,1483,910,2471,28214,1939,2005,1113,33.8,217,476,17,255,103,1483,259
2015,36047042600,"Census Tract 426, Kings County, New York",1521,48,1473,1017,2898,NA,1939,2007,1164,31,293,472,16,331,164,1473,301
2016,36047042600,"Census Tract 426, Kings County, New York",1550,60,1490,1116,3092,33106,1939,2009,1169,32,395,563,21,280,225,1490,370
2017,36047042600,"Census Tract 426, Kings County, New York",1531,60,1471,1043,2902,33109,1939,2010,1190,31.9,464,565,28,231,191,1471,401
2018,36047042600,"Census Tract 426, Kings County, New York",1578,65,1513,1128,3067,34063,0,2011,1212,32.9,515,536,18,328,202,1513,470
2019,36047042600,"Census Tract 426, Kings County, New York",1610,57,1553,1096,2834,38667,0,2011,1249,32.5,511,576,19,261,195,1553,449
2020,36047042600,"Census Tract 426, Kings County, New York",1654,70,1584,946,2249,36827,0,2010,1283,33.4,410,616,23,160,106,1584,339
2012,36047042700,"Census Tract 427, Kings County, New York",1825,165,1660,1624,5739,37805,1939,2003,1163,34.8,289,276,56,39,1237,1660,577
2013,36047042700,"Census Tract 427, Kings County, New York",1831,145,1686,1641,5786,41438,1939,2004,1220,35.1,355,313,135,37,1203,1686,584
2014,36047042700,"Census Tract 427, Kings County, New York",1830,119,1711,1658,5646,43750,1939,2005,1314,37.4,398,320,153,86,1157,1711,573
2015,36047042700,"Census Tract 427, Kings County, New York",1847,131,1716,1632,5338,45925,1939,2007,1342,36.3,438,392,123,95,1059,1716,524
2016,36047042700,"Census Tract 427, Kings County, New York",1879,140,1739,1642,5103,46000,1939,2008,1384,36.8,522,470,174,99,984,1739,548
2017,36047042700,"Census Tract 427, Kings County, New York",1914,120,1794,1678,4890,49428,1939,2011,1485,39.3,611,498,192,88,968,1794,572
2018,36047042700,"Census Tract 427, Kings County, New York",1919,135,1784,1625,4588,51597,0,2011,1494,38.7,671,486,120,125,932,1784,539
2019,36047042700,"Census Tract 427, Kings County, New York",1897,136,1761,1627,4483,57951,0,2012,1535,35.4,710,596,119,76,869,1761,481
2020,36047042700,"Census Tract 427, Kings County, New York",1956,134,1822,1691,4291,59498,0,2013,1803,35.4,849,697,171,142,727,1822,435
2012,36047042800,"Census Tract 428, Kings County, New York",1475,47,1428,865,2200,32944,1939,2003,1132,38.2,245,680,0,126,69,1428,278
2013,36047042800,"Census Tract 428, Kings County, New York",1518,72,1446,857,2043,35647,1939,2003,1120,36.1,270,651,0,144,69,1446,246
2014,36047042800,"Census Tract 428, Kings County, New York",1565,70,1495,923,2266,36250,1939,2004,1190,35.8,323,683,9,153,95,1495,325
2015,36047042800,"Census Tract 428, Kings County, New York",1540,86,1454,911,2185,36340,1939,2005,1214,32.4,433,722,11,114,67,1454,302
2016,36047042800,"Census Tract 428, Kings County, New York",1564,88,1476,953,2304,37664,1939,2005,1280,31.5,507,748,11,140,58,1476,296
2017,36047042800,"Census Tract 428, Kings County, New York",1576,92,1484,955,2156,36948,1939,2005,1297,33.2,549,722,32,121,77,1484,265
2018,36047042800,"Census Tract 428, Kings County, New York",1558,55,1503,974,2259,39839,0,2006,1360,34.7,553,712,39,131,88,1503,276
2019,36047042800,"Census Tract 428, Kings County, New York",1541,37,1504,885,2012,41438,0,2007,1426,35.3,526,605,34,112,63,1504,219
2020,36047042800,"Census Tract 428, Kings County, New York",1468,22,1446,849,2013,45137,0,2008,1392,35,423,536,46,156,69,1446,169
2012,36047042900,"Census Tract 429, Kings County, New York",2070,141,1929,1919,6323,39016,1939,2003,1135,38.3,184,183,169,67,1550,1929,693
2013,36047042900,"Census Tract 429, Kings County, New York",2008,165,1843,1807,6103,42894,1939,2003,1192,35.6,247,256,206,47,1399,1843,574
2014,36047042900,"Census Tract 429, Kings County, New York",2037,245,1792,1757,5760,43963,1939,2004,1201,34.8,303,307,232,61,1284,1792,529
2015,36047042900,"Census Tract 429, Kings County, New York",1989,224,1765,1717,5657,NA,1939,2006,1280,35.1,351,383,208,60,1210,1765,435
2016,36047042900,"Census Tract 429, Kings County, New York",1999,235,1764,1695,5681,43569,1939,2008,1340,35.3,344,395,231,63,1157,1764,483
2017,36047042900,"Census Tract 429, Kings County, New York",2004,273,1731,1635,5156,46675,1939,2010,1410,34,473,490,193,72,1002,1731,455
2018,36047042900,"Census Tract 429, Kings County, New York",2035,258,1777,1686,5152,47067,0,2012,1524,37.2,502,518,121,107,978,1777,535
2019,36047042900,"Census Tract 429, Kings County, New York",2041,174,1867,1788,5293,47614,0,2012,1613,36.9,592,548,156,101,1061,1867,536
2020,36047042900,"Census Tract 429, Kings County, New York",2016,161,1855,1775,5020,51250,0,2014,1656,34.9,765,568,130,109,941,1855,495
2012,36047043000,"Census Tract 430, Kings County, New York",1374,175,1199,967,2320,43843,1939,2003,1078,26.6,421,695,0,175,97,1199,161
2013,36047043000,"Census Tract 430, Kings County, New York",1374,173,1201,1015,2459,43021,1939,2004,1099,26.7,380,681,0,241,93,1201,206
2014,36047043000,"Census Tract 430, Kings County, New York",1379,164,1215,988,2364,37656,1939,2004,1153,29.6,303,610,0,254,124,1215,187
2015,36047043000,"Census Tract 430, Kings County, New York",1383,98,1285,1102,2811,33544,1939,2005,1185,33.9,348,672,0,326,104,1285,276
2016,36047043000,"Census Tract 430, Kings County, New York",1408,133,1275,1077,2767,34196,1939,2006,1244,38.2,325,643,0,331,103,1275,329
2017,36047043000,"Census Tract 430, Kings County, New York",1406,134,1272,1048,2872,34138,1939,2007,1288,41.8,287,591,0,306,124,1272,355
2018,36047043000,"Census Tract 430, Kings County, New York",1349,120,1229,991,2762,34271,0,2009,1355,41.2,305,526,0,307,125,1229,342
2019,36047043000,"Census Tract 430, Kings County, New York",1322,131,1191,998,2776,35128,1941,2010,1376,38.3,352,573,0,275,100,1191,366
2020,36047043000,"Census Tract 430, Kings County, New York",1301,128,1173,973,2747,41902,0,2011,1432,38.1,382,538,0,226,127,1173,270
2012,36047043100,"Census Tract 431, Kings County, New York",1955,150,1805,1735,5219,24477,1939,2004,1071,44,223,225,138,150,1309,1805,753
2013,36047043100,"Census Tract 431, Kings County, New York",1911,145,1766,1676,5056,26500,1939,2004,1131,43.4,260,255,180,165,1197,1766,701
2014,36047043100,"Census Tract 431, Kings County, New York",1868,119,1749,1632,5191,33796,1939,2007,1243,36.7,284,275,168,186,1107,1749,607
2015,36047043100,"Census Tract 431, Kings County, New York",1862,126,1736,1599,5079,41549,1939,2009,1295,35.9,389,367,135,195,1015,1736,576
2016,36047043100,"Census Tract 431, Kings County, New York",1825,123,1702,1597,4959,48854,1939,2011,1381,33.9,452,477,161,206,869,1702,459
2017,36047043100,"Census Tract 431, Kings County, New York",1815,121,1694,1571,4898,63219,1939,2011,1576,33.2,557,536,97,195,798,1694,442
2018,36047043100,"Census Tract 431, Kings County, New York",1835,136,1699,1597,4685,56984,0,2012,1662,35.7,618,546,85,145,858,1699,416
2019,36047043100,"Census Tract 431, Kings County, New York",1911,146,1765,1698,4557,58846,0,2012,1787,35.9,728,635,36,89,886,1765,399
2020,36047043100,"Census Tract 431, Kings County, New York",1950,127,1823,1772,4542,74030,0,2015,1941,37.1,901,604,111,94,920,1823,426
2012,36047043200,"Census Tract 432, Kings County, New York",1625,86,1539,1044,2950,36136,1939,2004,1108,29.9,264,616,17,136,276,1539,247
2013,36047043200,"Census Tract 432, Kings County, New York",1606,104,1502,1015,2902,35318,1939,2006,1146,30.3,269,572,19,146,279,1502,276
2014,36047043200,"Census Tract 432, Kings County, New York",1649,102,1547,1070,3115,36786,1939,2007,1178,31.6,281,637,0,186,228,1547,268
2015,36047043200,"Census Tract 432, Kings County, New York",1644,53,1591,1118,3146,44274,1939,2007,1201,29.8,323,705,0,157,238,1591,344
2016,36047043200,"Census Tract 432, Kings County, New York",1605,40,1565,1074,2979,37083,1939,2008,1195,32.3,321,633,0,203,222,1565,384
2017,36047043200,"Census Tract 432, Kings County, New York",1594,53,1541,1032,2737,39550,1939,2011,1272,33.2,351,644,6,180,202,1541,357
2018,36047043200,"Census Tract 432, Kings County, New York",1534,54,1480,1031,2645,44219,0,2011,1299,32.1,436,579,13,196,209,1480,289
2019,36047043200,"Census Tract 432, Kings County, New York",1507,71,1436,990,2793,53819,0,2011,1314,28.4,417,498,23,219,236,1436,257
2020,36047043200,"Census Tract 432, Kings County, New York",1440,71,1369,944,2768,51618,0,2012,1250,28.8,367,446,30,248,206,1369,188
2012,36047043300,"Census Tract 433, Kings County, New York",1461,105,1356,1233,3944,23697,1970,2002,868,32.8,154,89,219,51,1011,1356,534
2013,36047043300,"Census Tract 433, Kings County, New York",1454,40,1414,1288,4053,29310,1966,2003,1004,32.2,227,120,240,33,1055,1414,524
2014,36047043300,"Census Tract 433, Kings County, New York",1435,48,1387,1250,3831,30479,1961,2004,1089,33.5,216,87,311,63,1008,1387,455
2015,36047043300,"Census Tract 433, Kings County, New York",1443,38,1405,1300,4106,33824,1962,2005,1119,31.3,281,120,321,88,989,1405,400
2016,36047043300,"Census Tract 433, Kings County, New York",1482,48,1434,1329,3869,32699,1939,2004,1118,34.6,206,104,369,68,1058,1434,435
2017,36047043300,"Census Tract 433, Kings County, New York",1499,85,1414,1331,3898,30552,1950,2005,1190,34.8,162,114,288,84,1067,1414,449
2018,36047043300,"Census Tract 433, Kings County, New York",1495,107,1388,1340,3785,26950,1967,2005,1142,34.2,182,133,282,66,1046,1388,440
2019,36047043300,"Census Tract 433, Kings County, New York",1411,137,1274,1218,3369,24609,1974,2004,1099,34.4,191,123,247,46,922,1274,477
2020,36047043300,"Census Tract 433, Kings County, New York",1356,126,1230,1195,3360,25054,1973,2005,1172,33.6,180,123,262,52,886,1230,459
2012,36047043400,"Census Tract 434, Kings County, New York",1331,64,1267,897,2511,35308,1939,2002,1132,33.1,310,492,58,203,115,1267,308
2013,36047043400,"Census Tract 434, Kings County, New York",1339,67,1272,833,2076,39191,1939,2003,1149,34.4,328,539,55,130,74,1272,268
2014,36047043400,"Census Tract 434, Kings County, New York",1319,66,1253,797,2076,41595,1939,2005,1179,35.3,377,527,34,127,66,1253,266
2015,36047043400,"Census Tract 434, Kings County, New York",1261,73,1188,763,2113,40795,1939,2007,1157,34.4,387,518,36,91,75,1188,259
2016,36047043400,"Census Tract 434, Kings County, New York",1307,127,1180,798,2133,41522,1939,2007,1189,34.9,425,476,53,109,125,1180,224
2017,36047043400,"Census Tract 434, Kings County, New York",1307,91,1216,810,2232,44405,1939,2007,1260,34.9,392,519,14,138,141,1216,174
2018,36047043400,"Census Tract 434, Kings County, New York",1311,68,1243,859,2331,36434,0,2010,1304,42.4,421,502,80,164,112,1243,271
2019,36047043400,"Census Tract 434, Kings County, New York",1351,86,1265,859,2303,32361,0,2008,1351,47.2,385,468,95,161,143,1265,342
2020,36047043400,"Census Tract 434, Kings County, New York",1418,179,1239,813,2256,37337,0,2010,1477,47.1,346,430,87,154,133,1239,351
2012,36047043500,"Census Tract 435, Kings County, New York",1597,120,1477,1254,4158,28800,1939,2003,1338,46.1,100,50,269,12,1030,1477,447
2013,36047043500,"Census Tract 435, Kings County, New York",1592,114,1478,1261,4588,33809,1939,2004,1359,43.1,112,25,394,0,1046,1478,423
2014,36047043500,"Census Tract 435, Kings County, New York",1593,129,1464,1205,3879,35077,1939,2006,1360,41.8,206,71,410,0,951,1464,348
2015,36047043500,"Census Tract 435, Kings County, New York",1558,121,1437,1165,3833,36199,1939,2007,1386,40.5,183,81,460,0,855,1437,338
2016,36047043500,"Census Tract 435, Kings County, New York",1566,141,1425,1164,3891,37179,1939,2009,1428,40.9,178,109,473,0,808,1425,400
2017,36047043500,"Census Tract 435, Kings County, New York",1585,106,1479,1118,3907,46765,1939,2010,1526,35.9,274,140,370,15,715,1479,323
2018,36047043500,"Census Tract 435, Kings County, New York",1551,74,1477,1091,3545,51827,0,2011,1708,33.9,385,179,289,26,659,1477,302
2019,36047043500,"Census Tract 435, Kings County, New York",1592,90,1502,1130,3807,56824,0,2011,1724,31.1,270,138,237,76,706,1502,312
2020,36047043500,"Census Tract 435, Kings County, New York",1740,78,1662,1301,3754,69701,0,2013,1815,33.9,316,178,161,71,909,1662,313
2012,36047043600,"Census Tract 436, Kings County, New York",1637,9,1628,1241,3279,31583,1939,2002,1097,40.8,405,874,0,202,142,1628,494
2013,36047043600,"Census Tract 436, Kings County, New York",1645,8,1637,1273,3065,28080,1939,2002,1109,36.5,481,1030,0,117,99,1637,476
2014,36047043600,"Census Tract 436, Kings County, New York",1674,66,1608,1176,2787,30000,1939,2003,1135,35,413,971,0,130,51,1608,426
2015,36047043600,"Census Tract 436, Kings County, New York",1683,69,1614,1071,2817,39911,1939,2004,1172,30.5,355,837,0,191,26,1614,354
2016,36047043600,"Census Tract 436, Kings County, New York",1687,74,1613,1167,2994,38274,1939,2006,1193,31.6,387,895,16,216,35,1613,401
2017,36047043600,"Census Tract 436, Kings County, New York",1677,114,1563,1043,2760,33221,1939,2007,1239,36,344,817,19,169,38,1563,371
2018,36047043600,"Census Tract 436, Kings County, New York",1704,147,1557,1137,3329,42875,0,2010,1309,33.6,416,777,20,157,151,1557,332
2019,36047043600,"Census Tract 436, Kings County, New York",1669,58,1611,1167,3603,50150,0,2010,1355,34.7,445,761,24,134,170,1611,340
2020,36047043600,"Census Tract 436, Kings County, New York",1664,83,1581,1126,3599,46591,0,2011,1380,35.3,439,730,54,137,149,1581,343
2012,36047043700,"Census Tract 437, Kings County, New York",1792,152,1640,1373,4478,38222,1939,2003,1166,35.1,309,217,337,12,851,1640,381
2013,36047043700,"Census Tract 437, Kings County, New York",1843,179,1664,1432,5214,42303,1939,2004,1219,35.9,291,232,392,12,904,1664,411
2014,36047043700,"Census Tract 437, Kings County, New York",1880,181,1699,1455,5337,42292,1939,2006,1371,36.4,278,269,458,14,828,1699,478
2015,36047043700,"Census Tract 437, Kings County, New York",1848,138,1710,1439,5304,41641,1939,2007,1400,37.4,348,311,453,11,841,1710,441
2016,36047043700,"Census Tract 437, Kings County, New York",1858,170,1688,1419,5065,43250,1939,2009,1395,36.6,395,320,450,0,813,1688,389
2017,36047043700,"Census Tract 437, Kings County, New York",1951,173,1778,1527,5477,45863,1939,2010,1514,38,452,324,507,11,844,1778,452
2018,36047043700,"Census Tract 437, Kings County, New York",1992,172,1820,1588,4908,54898,0,2012,1688,34.8,624,392,502,18,784,1820,354
2019,36047043700,"Census Tract 437, Kings County, New York",2039,165,1874,1649,4731,54415,0,2013,1767,35.6,747,403,424,47,814,1874,273
2020,36047043700,"Census Tract 437, Kings County, New York",2121,196,1925,1689,4844,56131,0,2013,1769,36.7,661,293,321,50,974,1925,375
2012,36047043800,"Census Tract 438, Kings County, New York",967,66,901,679,1911,31758,1941,2003,1256,39.9,165,544,11,39,85,901,192
2013,36047043800,"Census Tract 438, Kings County, New York",974,73,901,680,1975,32417,1939,2004,1256,40,184,544,0,22,108,901,199
2014,36047043800,"Census Tract 438, Kings County, New York",968,88,880,639,1803,33459,1939,2004,1287,47.2,181,514,5,11,103,880,247
2015,36047043800,"Census Tract 438, Kings County, New York",1006,72,934,710,1900,33556,1939,2005,1337,44.6,208,497,26,29,140,934,241
2016,36047043800,"Census Tract 438, Kings County, New York",1022,70,952,740,1951,35930,1939,2007,1349,42.1,251,546,26,39,114,952,252
2017,36047043800,"Census Tract 438, Kings County, New York",1025,97,928,735,1944,35028,1939,2009,1408,45.1,274,542,26,49,102,928,278
2018,36047043800,"Census Tract 438, Kings County, New York",1053,92,961,734,1972,33900,0,2010,1474,45.5,278,572,29,51,68,961,263
2019,36047043800,"Census Tract 438, Kings County, New York",1079,119,960,743,2025,39071,1942,2012,1513,41.4,298,587,26,50,47,960,231
2020,36047043800,"Census Tract 438, Kings County, New York",1066,122,944,779,2058,54125,1942,2013,1640,35.2,298,667,8,38,34,944,193
2012,36047043900,"Census Tract 439, Kings County, New York",1297,86,1211,1041,3407,35435,1939,2001,1094,37.7,146,54,175,95,718,1211,331
2013,36047043900,"Census Tract 439, Kings County, New York",1349,63,1286,1044,3542,31227,1939,2001,1184,38.1,133,24,297,82,721,1286,357
2014,36047043900,"Census Tract 439, Kings County, New York",1358,62,1296,1057,3470,38706,1939,2003,1219,31,169,78,295,42,735,1296,279
2015,36047043900,"Census Tract 439, Kings County, New York",1386,92,1294,1027,3208,NA,1939,2004,1245,27.2,138,82,355,42,695,1294,356
2016,36047043900,"Census Tract 439, Kings County, New York",1370,78,1292,1016,3091,37500,1939,2004,1312,36.8,190,61,329,34,740,1292,395
2017,36047043900,"Census Tract 439, Kings County, New York",1370,78,1292,969,2957,46406,1939,2008,1403,33.6,179,82,345,31,664,1292,365
2018,36047043900,"Census Tract 439, Kings County, New York",1362,72,1290,912,2378,34891,0,2008,1511,43.8,202,110,262,27,576,1290,411
2019,36047043900,"Census Tract 439, Kings County, New York",1382,114,1268,911,2457,39023,0,2010,1646,44.4,227,103,246,41,566,1268,362
2020,36047043900,"Census Tract 439, Kings County, New York",1321,110,1211,867,2288,49960,0,2010,1754,31.2,240,125,178,57,531,1211,243
2012,36047044000,"Census Tract 440, Kings County, New York",932,88,844,505,1315,37411,1942,2003,1290,35.4,147,418,0,0,72,844,146
2013,36047044000,"Census Tract 440, Kings County, New York",942,79,863,551,1477,35855,1943,2003,1284,37.3,210,455,0,14,54,863,148
2014,36047044000,"Census Tract 440, Kings County, New York",965,87,878,536,1357,31288,1941,2004,1338,41.6,185,449,0,10,70,878,183
2015,36047044000,"Census Tract 440, Kings County, New York",986,70,916,546,1385,30484,1942,2005,1366,49.4,207,445,9,17,68,916,240
2016,36047044000,"Census Tract 440, Kings County, New York",987,81,906,566,1450,32222,1943,2006,1449,43.8,238,464,12,23,61,906,207
2017,36047044000,"Census Tract 440, Kings County, New York",985,50,935,563,1425,30365,1943,2007,1427,45.8,206,432,9,34,75,935,200
2018,36047044000,"Census Tract 440, Kings County, New York",963,76,887,522,1370,34375,1945,2009,1462,46.8,174,383,16,31,84,887,181
2019,36047044000,"Census Tract 440, Kings County, New York",971,92,879,487,1325,36016,1945,2010,1606,47.6,152,338,24,33,85,879,204
2020,36047044000,"Census Tract 440, Kings County, New York",937,76,861,539,1604,46036,1944,2012,1592,34.9,218,363,25,41,109,861,212
2012,36047044100,"Census Tract 441, Kings County, New York",2082,170,1912,1736,6052,33774,1939,2005,1171,36.7,265,226,78,109,1392,1912,718
2013,36047044100,"Census Tract 441, Kings County, New York",2077,168,1909,1721,6020,44271,1939,2006,1246,32.9,274,301,191,136,1268,1909,655
2014,36047044100,"Census Tract 441, Kings County, New York",2057,151,1906,1752,6080,37500,1939,2007,1294,33.8,294,272,184,127,1321,1906,586
2015,36047044100,"Census Tract 441, Kings County, New York",1991,137,1854,1700,5599,45991,1939,2008,1269,31.5,288,315,212,166,1158,1854,516
2016,36047044100,"Census Tract 441, Kings County, New York",2001,96,1905,1726,5312,50083,1939,2010,1289,31.2,365,318,269,191,1113,1905,504
2017,36047044100,"Census Tract 441, Kings County, New York",1995,125,1870,1658,4528,51477,1939,2010,1385,31.4,459,368,272,222,945,1870,428
2018,36047044100,"Census Tract 441, Kings County, New York",2017,126,1891,1663,4278,41801,0,2010,1410,33.3,456,317,230,208,988,1891,493
2019,36047044100,"Census Tract 441, Kings County, New York",2062,114,1948,1716,4290,48043,0,2011,1455,34.4,575,303,264,217,1061,1948,538
2020,36047044100,"Census Tract 441, Kings County, New York",2111,122,1989,1777,4399,55455,0,2010,1498,31.5,697,323,239,159,1153,1989,465
2012,36047044200,"Census Tract 442, Kings County, New York",900,89,811,403,1029,31380,1948,2003,1360,50,98,357,0,27,19,811,111
2013,36047044200,"Census Tract 442, Kings County, New York",890,58,832,467,1325,32473,1957,2004,1301,47.2,147,428,0,24,15,832,148
2014,36047044200,"Census Tract 442, Kings County, New York",873,20,853,486,1428,30903,1962,2005,1374,49.9,145,450,0,21,15,853,160
2015,36047044200,"Census Tract 442, Kings County, New York",919,56,863,450,1254,31607,1964,2006,1349,46.6,157,419,0,15,16,863,133
2016,36047044200,"Census Tract 442, Kings County, New York",940,56,884,436,1296,35000,1961,2010,1421,43.7,202,405,0,14,0,884,121
2017,36047044200,"Census Tract 442, Kings County, New York",934,36,898,464,1361,53938,1960,2011,1536,29.5,208,442,0,5,0,898,133
2018,36047044200,"Census Tract 442, Kings County, New York",920,35,885,412,1126,37917,1945,2011,1593,37.2,160,383,0,4,8,885,111
2019,36047044200,"Census Tract 442, Kings County, New York",942,75,867,419,1155,43264,1942,2012,1486,30.8,156,374,0,6,20,867,85
2020,36047044200,"Census Tract 442, Kings County, New York",1007,57,950,458,1177,NA,1944,2012,1397,33.1,213,422,0,4,17,950,196
2012,36047044300,"Census Tract 443, Kings County, New York",1992,229,1763,1528,5210,43081,1939,2004,1253,30.2,264,233,101,116,1113,1763,504
2013,36047044300,"Census Tract 443, Kings County, New York",2007,195,1812,1617,5534,48984,1939,2005,1333,29.6,294,274,103,116,1149,1812,504
2014,36047044300,"Census Tract 443, Kings County, New York",2017,159,1858,1748,5813,49565,1939,2005,1380,30.9,381,337,153,141,1178,1858,504
2015,36047044300,"Census Tract 443, Kings County, New York",1973,136,1837,1742,5124,NA,1939,2006,1387,30.6,418,315,173,222,1103,1837,440
2016,36047044300,"Census Tract 443, Kings County, New York",2017,98,1919,1820,5131,53750,1939,2007,1408,32,495,387,229,205,1098,1919,493
2017,36047044300,"Census Tract 443, Kings County, New York",2003,90,1913,1791,4555,44911,1939,2007,1408,35,500,452,236,264,930,1913,438
2018,36047044300,"Census Tract 443, Kings County, New York",2015,62,1953,1807,4581,41827,0,2009,1484,37.4,565,485,186,248,958,1953,447
2019,36047044300,"Census Tract 443, Kings County, New York",2041,127,1914,1726,4032,41447,0,2010,1572,35.5,649,470,138,249,924,1914,418
2020,36047044300,"Census Tract 443, Kings County, New York",2138,138,2000,1853,4114,62837,0,2012,1773,34.2,944,644,175,153,909,2000,334
2012,36047044400,"Census Tract 444, Kings County, New York",1255,118,1137,703,1658,26274,1939,2000,1181,50,229,604,15,12,72,1137,214
2013,36047044400,"Census Tract 444, Kings County, New York",1197,107,1090,613,1332,22566,1939,2003,1230,50,190,546,9,0,47,1090,236
2014,36047044400,"Census Tract 444, Kings County, New York",1208,108,1100,645,1355,25759,1943,2004,1289,45.4,240,537,12,7,80,1100,254
2015,36047044400,"Census Tract 444, Kings County, New York",1232,65,1167,687,1523,26528,1950,2006,1198,44,210,553,45,10,71,1167,242
2016,36047044400,"Census Tract 444, Kings County, New York",1259,58,1201,742,1719,38918,1956,2010,1225,39.3,215,539,76,10,109,1201,190
2017,36047044400,"Census Tract 444, Kings County, New York",1290,62,1228,791,1899,39668,1957,2011,1200,38.8,239,549,87,18,130,1228,225
2018,36047044400,"Census Tract 444, Kings County, New York",1335,141,1194,794,1959,40700,1956,2010,1297,38.2,242,565,85,32,112,1194,278
2019,36047044400,"Census Tract 444, Kings County, New York",1343,134,1209,803,2376,48867,1958,2012,1304,32.7,228,578,144,22,86,1209,206
2020,36047044400,"Census Tract 444, Kings County, New York",1338,160,1178,737,2192,44611,1941,2012,1429,37,288,508,82,20,174,1178,310
2012,36047044500,"Census Tract 445, Kings County, New York",1687,158,1529,1243,3893,34194,1939,2004,1239,38.1,240,275,85,75,772,1529,381
2013,36047044500,"Census Tract 445, Kings County, New York",1690,134,1556,1225,3737,33594,1939,2005,1226,38.3,251,301,59,90,738,1556,392
2014,36047044500,"Census Tract 445, Kings County, New York",1710,108,1602,1303,3941,39139,1939,2006,1281,36.2,314,334,64,107,775,1602,407
2015,36047044500,"Census Tract 445, Kings County, New York",1726,115,1611,1335,4090,40379,1939,2006,1290,35.5,344,343,90,139,751,1611,411
2016,36047044500,"Census Tract 445, Kings County, New York",1711,77,1634,1369,4219,44033,1939,2007,1350,36.1,440,332,76,134,805,1634,397
2017,36047044500,"Census Tract 445, Kings County, New York",1731,72,1659,1359,4250,54316,1939,2008,1419,32.1,537,386,105,134,765,1659,308
2018,36047044500,"Census Tract 445, Kings County, New York",1729,67,1662,1408,4073,60701,0,2008,1447,29.9,609,469,109,122,742,1662,234
2019,36047044500,"Census Tract 445, Kings County, New York",1768,101,1667,1454,4131,62500,0,2007,1449,31.1,599,410,124,135,845,1667,280
2020,36047044500,"Census Tract 445, Kings County, New York",1837,133,1704,1406,3651,69375,0,2011,1581,30.1,707,465,73,155,698,1704,239
2012,36047044600,"Census Tract 446, Kings County, New York",688,4,684,434,983,43500,1948,2004,1239,30.3,148,256,39,56,122,684,107
2013,36047044600,"Census Tract 446, Kings County, New York",698,16,682,411,975,53125,1956,2004,1230,31.4,135,277,0,61,73,682,137
2014,36047044600,"Census Tract 446, Kings County, New York",737,16,721,416,1002,63182,1943,2004,1191,27.5,135,282,0,68,66,721,95
2015,36047044600,"Census Tract 446, Kings County, New York",719,28,691,376,990,31823,1941,2005,1125,33.6,72,235,0,88,53,691,127
2016,36047044600,"Census Tract 446, Kings County, New York",734,59,675,363,1066,43854,1946,2010,1273,33,86,195,11,80,83,675,156
2017,36047044600,"Census Tract 446, Kings County, New York",719,62,657,345,1029,50673,1944,2010,1272,29.7,82,172,13,95,73,657,119
2018,36047044600,"Census Tract 446, Kings County, New York",699,65,634,358,1069,46923,0,2011,1380,35.7,70,155,16,104,95,634,113
2019,36047044600,"Census Tract 446, Kings County, New York",678,95,583,325,1010,48365,1943,2013,1575,39.6,73,106,16,101,112,583,137
2020,36047044600,"Census Tract 446, Kings County, New York",741,124,617,362,1107,53456,1942,2015,1577,33.9,87,152,15,102,104,617,108
2012,36047044700,"Census Tract 447, Kings County, New York",880,93,787,708,1836,51053,1939,2004,1079,24.9,114,200,45,15,413,787,92
2013,36047044700,"Census Tract 447, Kings County, New York",881,41,840,728,1839,44565,1939,2006,1236,32.7,166,215,72,21,395,840,91
2014,36047044700,"Census Tract 447, Kings County, New York",821,29,792,730,1969,50083,1941,2007,1477,32.7,256,313,87,49,302,792,111
2015,36047044700,"Census Tract 447, Kings County, New York",820,27,793,715,1672,NA,1939,2007,1410,34.3,314,345,103,41,249,793,158
2016,36047044700,"Census Tract 447, Kings County, New York",838,43,795,724,1704,47283,1939,2010,1424,34.1,343,362,91,65,238,795,88
2017,36047044700,"Census Tract 447, Kings County, New York",835,47,788,735,1795,47578,1939,2011,1484,35.7,367,346,84,62,283,788,121
2018,36047044700,"Census Tract 447, Kings County, New York",874,92,782,739,1773,42865,0,2010,1384,36,336,304,50,46,343,782,200
2019,36047044700,"Census Tract 447, Kings County, New York",884,53,831,758,1808,44643,0,2012,1518,36.1,352,327,45,50,340,831,174
2020,36047044700,"Census Tract 447, Kings County, New York",978,53,925,885,1898,46186,0,2014,1662,34.3,445,432,53,38,365,925,201
2012,36047044800,"Census Tract 448, Kings County, New York",797,70,727,304,533,50543,1960,2001,1088,26.3,180,244,12,16,32,727,87
2013,36047044800,"Census Tract 448, Kings County, New York",800,23,777,346,645,36500,1957,2004,1223,32.4,193,279,9,18,40,777,96
2014,36047044800,"Census Tract 448, Kings County, New York",822,40,782,384,880,39583,1958,2006,1310,40.6,217,297,4,26,57,782,120
2015,36047044800,"Census Tract 448, Kings County, New York",800,58,742,400,943,27885,1956,2008,1293,46.6,220,296,5,40,47,742,135
2016,36047044800,"Census Tract 448, Kings County, New York",766,82,684,359,840,38125,1958,2008,1276,45.3,183,286,0,32,25,684,132
2017,36047044800,"Census Tract 448, Kings County, New York",777,96,681,331,795,25536,1957,2010,1283,49.2,148,264,0,26,24,681,149
2018,36047044800,"Census Tract 448, Kings County, New York",801,97,704,322,761,26333,1959,2010,1293,43.9,148,255,0,23,21,704,141
2019,36047044800,"Census Tract 448, Kings County, New York",759,105,654,257,550,26042,1960,2008,1201,45.2,95,217,0,24,0,654,116
2020,36047044800,"Census Tract 448, Kings County, New York",791,83,708,252,578,37292,1959,2007,1338,42.2,122,233,0,15,0,708,102
2012,36047044900,"Census Tract 449, Kings County, New York",1161,59,1102,977,2462,29055,1952,1996,649,26.6,223,221,305,36,460,1102,266
2013,36047044900,"Census Tract 449, Kings County, New York",1179,89,1090,937,2408,40331,1953,1996,825,25.4,244,225,337,6,425,1090,233
2014,36047044900,"Census Tract 449, Kings County, New York",1210,84,1126,969,2606,30592,1953,1999,829,27,219,156,356,5,506,1126,244
2015,36047044900,"Census Tract 449, Kings County, New York",1174,51,1123,998,2922,26615,1955,2000,750,26.8,197,138,429,26,476,1123,315
2016,36047044900,"Census Tract 449, Kings County, New York",1157,35,1122,1030,3079,25682,1955,2003,758,29.1,173,149,426,28,493,1122,373
2017,36047044900,"Census Tract 449, Kings County, New York",1160,34,1126,1021,2660,23304,1955,2004,873,32,177,148,429,19,507,1126,402
2018,36047044900,"Census Tract 449, Kings County, New York",1182,12,1170,1099,2893,21050,1956,2007,613,28.9,206,168,387,13,665,1170,496
2019,36047044900,"Census Tract 449, Kings County, New York",1173,17,1156,1128,2976,21879,1957,2009,719,29.2,248,227,469,27,546,1156,483
2020,36047044901,"Census Tract 449.01, Kings County, New York",1162,26,1136,1117,2764,43250,1955,2009,806,28.9,201,253,477,9,424,1136,362
2020,36047044902,"Census Tract 449.02, Kings County, New York",0,0,0,0,0,NA,NA,NA,NA,NA,0,0,0,0,0,0,0
2012,36047045000,"Census Tract 450, Kings County, New York",200,11,189,49,126,40699,1947,2006,1715,47.2,9,9,0,0,40,189,30
2013,36047045000,"Census Tract 450, Kings County, New York",222,11,211,63,150,40341,1948,2005,1703,48.6,12,24,0,0,39,211,37
2014,36047045000,"Census Tract 450, Kings County, New York",145,12,133,41,127,15481,1955,2004,1635,50,13,35,0,0,6,133,46
2015,36047045000,"Census Tract 450, Kings County, New York",154,23,131,49,131,NA,1952,2004,1705,50,16,43,0,0,6,131,63
2016,36047045000,"Census Tract 450, Kings County, New York",165,24,141,48,137,10000,1951,2004,1773,50,17,48,0,0,0,141,58
2017,36047045000,"Census Tract 450, Kings County, New York",170,16,154,50,143,NA,1950,2003,1925,50,17,50,0,0,0,154,60
2018,36047045000,"Census Tract 450, Kings County, New York",154,16,138,46,156,NA,0,2005,2192,51,26,46,0,0,0,138,53
2019,36047045000,"Census Tract 450, Kings County, New York",187,17,170,59,119,NA,1944,2007,2173,51,39,53,6,0,0,170,54
2020,36047045000,"Census Tract 450, Kings County, New York",200,4,196,88,268,80972,1948,2019,2318,45.2,58,82,6,0,0,196,43
2012,36047045200,"Census Tract 452, Kings County, New York",934,67,867,404,998,60750,1951,2001,1324,40.4,176,337,0,0,54,867,71
2013,36047045200,"Census Tract 452, Kings County, New York",921,67,854,391,1083,61484,1951,2003,1438,40.7,156,345,0,3,28,854,65
2014,36047045200,"Census Tract 452, Kings County, New York",949,33,916,419,1141,37446,1949,2005,1607,45.9,153,357,0,8,30,916,140
2015,36047045200,"Census Tract 452, Kings County, New York",939,66,873,364,1087,50568,1946,2005,1537,40,160,306,0,9,32,873,116
2016,36047045200,"Census Tract 452, Kings County, New York",908,38,870,362,1121,36917,1947,2007,1543,46.7,130,318,0,9,35,870,114
2017,36047045200,"Census Tract 452, Kings County, New York",922,57,865,334,1061,50600,1947,2008,1677,45.5,139,297,7,7,23,865,122
2018,36047045200,"Census Tract 452, Kings County, New York",953,114,839,315,947,37708,1945,2008,1773,51,144,285,7,0,23,839,126
2019,36047045200,"Census Tract 452, Kings County, New York",954,187,767,290,1011,60000,1946,2012,1927,44.1,109,269,6,6,9,767,84
2020,36047045200,"Census Tract 452, Kings County, New York",989,162,827,327,1193,60096,1951,2013,1991,47.3,151,298,9,6,8,827,101
2012,36047045300,"Census Tract 453, Kings County, New York",699,66,633,610,1651,53663,1939,2006,1630,31.3,286,376,18,17,213,633,76
2013,36047045300,"Census Tract 453, Kings County, New York",710,76,634,608,1398,52550,1939,2005,1466,33.3,304,307,16,25,270,634,127
2014,36047045300,"Census Tract 453, Kings County, New York",718,58,660,631,1606,52050,1939,2008,1597,33.7,311,277,22,42,293,660,163
2015,36047045300,"Census Tract 453, Kings County, New York",691,58,633,625,1562,55536,1939,2008,1633,32.2,297,252,24,51,317,633,130
2016,36047045300,"Census Tract 453, Kings County, New York",679,29,650,646,1553,62083,1939,2010,1716,32,302,279,29,56,301,650,144
2017,36047045300,"Census Tract 453, Kings County, New York",691,27,664,660,1637,52969,1939,2011,1724,32.6,276,286,25,50,313,664,163
2018,36047045300,"Census Tract 453, Kings County, New York",712,17,695,691,1591,56976,0,2012,1864,31.8,327,336,25,34,296,695,127
2019,36047045300,"Census Tract 453, Kings County, New York",702,19,683,683,1651,51953,0,2014,1902,39.9,327,302,22,24,307,683,123
2020,36047045300,"Census Tract 453, Kings County, New York",698,25,673,673,1566,54063,0,2016,1960,44.9,373,296,17,32,251,673,161
2012,36047045400,"Census Tract 454, Kings County, New York",585,57,528,316,960,41700,1939,2003,1167,29,144,241,0,35,26,528,103
2013,36047045400,"Census Tract 454, Kings County, New York",582,37,545,342,1142,43646,1939,2004,1196,29.1,145,253,0,34,42,545,112
2014,36047045400,"Census Tract 454, Kings County, New York",625,31,594,362,1030,41250,1939,2005,1204,34.7,144,259,0,41,54,594,149
2015,36047045400,"Census Tract 454, Kings County, New York",642,34,608,372,1116,40268,1939,2005,1208,39.3,121,235,14,50,52,608,136
2016,36047045400,"Census Tract 454, Kings County, New York",636,47,589,392,1068,25417,1939,2004,1208,45.1,144,234,13,65,57,589,154
2017,36047045400,"Census Tract 454, Kings County, New York",629,47,582,327,894,29313,1940,2005,1350,42.9,161,212,13,16,65,582,105
2018,36047045400,"Census Tract 454, Kings County, New York",603,57,546,267,736,28839,1950,2006,1372,43,126,167,20,21,37,546,101
2019,36047045400,"Census Tract 454, Kings County, New York",596,62,534,284,901,42794,0,2006,1450,41.8,137,197,20,20,24,534,81
2020,36047045400,"Census Tract 454, Kings County, New York",572,71,501,262,1035,56500,0,2012,1667,34.5,110,172,6,11,73,501,48
2012,36047045600,"Census Tract 456, Kings County, New York",868,17,851,646,1571,22143,1939,2002,1142,46,321,563,11,19,28,851,226
2013,36047045600,"Census Tract 456, Kings County, New York",893,13,880,689,1700,19931,1939,2004,1199,48.5,308,610,9,45,12,880,244
2014,36047045600,"Census Tract 456, Kings County, New York",891,15,876,701,1855,29531,1939,2005,1242,44.9,330,638,11,32,9,876,223
2015,36047045600,"Census Tract 456, Kings County, New York",863,51,812,670,1927,29375,1939,2006,1231,43.6,251,546,16,81,12,812,208
2016,36047045600,"Census Tract 456, Kings County, New York",877,57,820,709,2115,31688,1939,2007,1290,43.9,257,561,21,89,11,820,231
2017,36047045600,"Census Tract 456, Kings County, New York",869,64,805,678,1941,29500,1939,2006,1289,43.5,217,531,11,101,22,805,247
2018,36047045600,"Census Tract 456, Kings County, New York",872,111,761,662,2090,37400,0,2006,1349,38.7,278,493,11,94,27,761,234
2019,36047045600,"Census Tract 456, Kings County, New York",849,132,717,595,1830,35871,0,2006,1388,35,203,359,12,107,33,717,223
2020,36047045600,"Census Tract 456, Kings County, New York",932,109,823,683,1798,53325,0,2006,1524,29.2,315,414,31,93,80,823,174
2012,36047045800,"Census Tract 458, Kings County, New York",576,109,467,157,393,29760,1952,2005,995,44.9,37,142,0,0,15,467,66
2013,36047045800,"Census Tract 458, Kings County, New York",569,61,508,161,432,29760,1951,2004,995,41.9,22,147,0,0,14,508,50
2014,36047045800,"Census Tract 458, Kings County, New York",577,56,521,185,556,45260,1951,2006,1125,46,31,171,0,0,14,521,63
2015,36047045800,"Census Tract 458, Kings County, New York",581,32,549,210,671,32287,1952,2005,1083,42.2,38,193,0,0,17,549,55
2016,36047045800,"Census Tract 458, Kings County, New York",579,16,563,214,702,47155,1939,2008,1170,42.2,24,197,0,0,17,563,35
2017,36047045800,"Census Tract 458, Kings County, New York",558,27,531,163,445,30547,1955,2002,1105,50,41,163,0,0,0,531,62
2018,36047045800,"Census Tract 458, Kings County, New York",548,29,519,187,483,31691,1953,2006,1138,51,55,187,0,0,0,519,69
2019,36047045800,"Census Tract 458, Kings County, New York",553,63,490,141,267,29632,1954,2000,1067,33.9,47,141,0,0,0,490,43
2020,36047045800,"Census Tract 458, Kings County, New York",535,54,481,145,282,29250,1953,2002,1104,45,53,145,0,0,0,481,67
2012,36047046000,"Census Tract 460, Kings County, New York",1272,108,1164,735,1573,30229,1939,2001,1015,33.9,284,485,29,124,83,1164,267
2013,36047046000,"Census Tract 460, Kings County, New York",1261,70,1191,694,1636,30690,1942,2000,1068,34.3,309,495,34,120,31,1191,286
2014,36047046000,"Census Tract 460, Kings County, New York",1277,46,1231,751,2168,33537,1944,2001,1090,33.8,332,505,37,134,37,1231,315
2015,36047046000,"Census Tract 460, Kings County, New York",1264,19,1245,776,2517,31552,1943,2003,1231,39.7,308,464,13,248,17,1245,365
2016,36047046000,"Census Tract 460, Kings County, New York",1244,21,1223,791,2499,28542,1943,2004,1252,41.7,277,513,0,242,19,1223,348
2017,36047046000,"Census Tract 460, Kings County, New York",1271,41,1230,783,2527,31823,1939,2004,1303,37.1,255,511,7,216,28,1230,353
2018,36047046000,"Census Tract 460, Kings County, New York",1262,79,1183,748,2313,44400,0,2006,1262,35.3,196,468,10,217,34,1183,268
2019,36047046000,"Census Tract 460, Kings County, New York",1256,87,1169,704,1777,47283,0,2007,1348,35.4,183,426,11,205,33,1169,262
2020,36047046000,"Census Tract 460, Kings County, New York",1151,92,1059,582,1587,49444,0,2007,1389,33.6,198,324,23,147,64,1059,221
2012,36047046201,"Census Tract 462.01, Kings County, New York",1085,155,930,670,1689,23526,1948,2003,1044,35.8,274,517,0,75,72,930,297
2013,36047046201,"Census Tract 462.01, Kings County, New York",1088,106,982,719,1863,27321,1960,2003,1141,34.4,314,540,0,94,78,982,306
2014,36047046201,"Census Tract 462.01, Kings County, New York",1118,51,1067,742,1835,22443,1962,2004,1057,32.8,369,545,0,94,93,1067,357
2015,36047046201,"Census Tract 462.01, Kings County, New York",1118,58,1060,656,1618,20714,1964,2003,1056,36.1,316,499,0,117,40,1060,333
2016,36047046201,"Census Tract 462.01, Kings County, New York",1125,38,1087,658,1496,16359,1963,2004,1033,35.8,342,513,0,89,56,1087,353
2017,36047046201,"Census Tract 462.01, Kings County, New York",1120,70,1050,587,1101,14297,1964,2004,937,33.8,313,512,0,56,19,1050,350
2018,36047046201,"Census Tract 462.01, Kings County, New York",1122,67,1055,606,1185,18186,1961,2005,1029,35.7,340,507,0,68,31,1055,297
2019,36047046201,"Census Tract 462.01, Kings County, New York",1087,104,983,582,1276,18810,1957,2005,883,33,257,430,0,124,28,983,293
2020,36047046201,"Census Tract 462.01, Kings County, New York",1050,69,981,606,1273,21875,1956,2007,1139,30.9,234,452,0,127,27,981,215
2012,36047046202,"Census Tract 462.02, Kings County, New York",629,26,603,347,890,42463,1941,2003,1349,44.3,165,264,6,12,71,603,136
2013,36047046202,"Census Tract 462.02, Kings County, New York",620,25,595,344,1204,43093,1943,2003,1475,47.4,118,247,5,11,86,595,148
2014,36047046202,"Census Tract 462.02, Kings County, New York",621,37,584,290,955,41111,1947,2003,1524,49.4,110,208,5,6,76,584,102
2015,36047046202,"Census Tract 462.02, Kings County, New York",627,25,602,298,1107,40156,1944,2004,1474,46.4,118,216,5,14,68,602,110
2016,36047046202,"Census Tract 462.02, Kings County, New York",638,33,605,314,1234,33966,1941,2004,1527,50,105,232,0,16,66,605,102
2017,36047046202,"Census Tract 462.02, Kings County, New York",627,43,584,293,1248,34781,1943,2005,1634,50,103,208,0,11,62,584,82
2018,36047046202,"Census Tract 462.02, Kings County, New York",645,47,598,290,1010,40893,1940,2006,1732,49.8,125,224,0,12,38,598,92
2019,36047046202,"Census Tract 462.02, Kings County, New York",637,41,596,275,944,37266,0,2009,1685,45.2,94,208,0,13,36,596,99
2020,36047046202,"Census Tract 462.02, Kings County, New York",595,23,572,253,631,37426,1942,2011,1469,33.8,94,191,0,31,17,572,83
2012,36047046400,"Census Tract 464, Kings County, New York",704,20,684,364,1489,40152,1939,2004,1329,50,126,298,0,26,40,684,142
2013,36047046400,"Census Tract 464, Kings County, New York",700,20,680,337,1344,30417,1939,2004,1355,50,96,264,0,42,31,680,146
2014,36047046400,"Census Tract 464, Kings County, New York",714,31,683,358,1462,31818,1939,2004,1363,50,94,282,0,44,32,683,149
2015,36047046400,"Census Tract 464, Kings County, New York",686,30,656,334,1203,30667,1939,2005,1351,50,106,239,11,46,30,656,166
2016,36047046400,"Census Tract 464, Kings County, New York",689,60,629,313,1299,31625,1943,2006,1489,50,112,244,13,32,14,629,152
2017,36047046400,"Census Tract 464, Kings County, New York",722,59,663,310,1303,32105,1947,2007,1498,47.5,104,232,18,33,15,663,146
2018,36047046400,"Census Tract 464, Kings County, New York",730,105,625,302,1339,34457,1945,2010,1689,51,84,222,28,13,20,625,144
2019,36047046400,"Census Tract 464, Kings County, New York",705,97,608,305,1287,50795,1953,2012,1838,43.1,98,192,37,18,37,608,119
2020,36047046400,"Census Tract 464, Kings County, New York",706,104,602,292,1377,41406,1948,2011,1736,41.5,63,206,26,19,36,602,126
2012,36047046800,"Census Tract 468, Kings County, New York",478,0,478,201,717,23625,1962,2005,1503,46.6,35,188,0,13,0,478,115
2013,36047046800,"Census Tract 468, Kings County, New York",508,0,508,215,1028,24896,1965,2004,1358,50,56,201,0,14,0,508,174
2014,36047046800,"Census Tract 468, Kings County, New York",520,0,520,258,1063,22500,1964,2006,1705,50,47,246,0,12,0,520,186
2015,36047046800,"Census Tract 468, Kings County, New York",539,14,525,260,1062,27727,1963,2007,1756,50,49,248,0,12,0,525,182
2016,36047046800,"Census Tract 468, Kings County, New York",542,16,526,252,857,29318,1961,2007,1710,50,53,245,0,7,0,526,153
2017,36047046800,"Census Tract 468, Kings County, New York",550,39,511,269,1085,29020,1956,2009,1835,50,26,269,0,0,0,511,157
2018,36047046800,"Census Tract 468, Kings County, New York",551,61,490,242,988,33750,1965,2012,1946,51,19,242,0,0,0,490,112
2019,36047046800,"Census Tract 468, Kings County, New York",527,70,457,219,1076,37250,1970,2014,2025,51,15,219,0,0,0,457,69
2020,36047046800,"Census Tract 468, Kings County, New York",610,84,526,249,1071,30063,1963,2011,1836,51,82,249,0,0,0,526,119
2012,36047047000,"Census Tract 470, Kings County, New York",795,30,765,264,1117,28250,1955,2004,1132,50,47,256,0,0,8,765,168
2013,36047047000,"Census Tract 470, Kings County, New York",782,28,754,296,1298,26894,1956,2004,1246,50,44,282,5,5,9,754,198
2014,36047047000,"Census Tract 470, Kings County, New York",769,61,708,330,1487,25515,1945,2005,1214,50,50,311,10,5,14,708,226
2015,36047047000,"Census Tract 470, Kings County, New York",737,26,711,345,1465,30250,1940,2005,1194,49.4,57,310,7,18,17,711,212
2016,36047047000,"Census Tract 470, Kings County, New York",731,61,670,351,1427,40511,1954,2005,1355,44.6,60,303,7,18,24,670,186
2017,36047047000,"Census Tract 470, Kings County, New York",755,74,681,362,1501,36439,1954,2005,1422,46.5,76,296,10,27,29,681,183
2018,36047047000,"Census Tract 470, Kings County, New York",756,79,677,354,1397,38571,1955,2006,1700,51,65,301,0,22,24,677,142
2019,36047047000,"Census Tract 470, Kings County, New York",742,103,639,310,1265,46786,1955,2009,1813,39.7,61,259,0,17,27,639,78
2020,36047047000,"Census Tract 470, Kings County, New York",807,193,614,283,992,48828,1956,2011,1911,51,51,246,0,0,31,614,48
2012,36047047200,"Census Tract 472, Kings County, New York",852,91,761,290,1366,43214,1941,1995,1523,46,49,278,0,0,12,761,128
2013,36047047200,"Census Tract 472, Kings County, New York",846,84,762,317,1639,49511,1939,1999,1490,41,33,317,0,0,0,762,139
2014,36047047200,"Census Tract 472, Kings County, New York",851,118,733,294,1267,48088,1939,2003,1690,46.2,36,294,0,0,0,733,109
2015,36047047200,"Census Tract 472, Kings County, New York",827,95,732,337,1456,43984,1939,2006,1428,47.8,26,337,0,0,0,732,122
2016,36047047200,"Census Tract 472, Kings County, New York",811,110,701,319,1418,37614,1940,2009,1564,50,35,319,0,0,0,701,146
2017,36047047200,"Census Tract 472, Kings County, New York",776,109,667,332,1403,30952,1941,2010,1465,50,57,332,0,0,0,667,128
2018,36047047200,"Census Tract 472, Kings County, New York",766,153,613,328,1361,31944,1945,2010,1621,51,68,323,0,5,0,613,118
2019,36047047200,"Census Tract 472, Kings County, New York",739,134,605,379,1717,32396,1947,2008,1646,47.6,68,365,0,6,8,605,143
2020,36047047200,"Census Tract 472, Kings County, New York",797,158,639,373,1721,40083,1950,2008,1757,51,73,359,0,1,13,639,139
2012,36047047400,"Census Tract 474, Kings County, New York",871,33,838,530,1954,25893,1939,2001,1318,47.7,150,471,0,29,30,838,173
2013,36047047400,"Census Tract 474, Kings County, New York",841,44,797,490,1683,31364,1939,2001,1374,41.1,121,411,0,30,38,797,108
2014,36047047400,"Census Tract 474, Kings County, New York",840,46,794,485,2069,43583,1940,2002,1554,47.6,119,448,0,27,0,794,104
2015,36047047400,"Census Tract 474, Kings County, New York",787,68,719,462,1915,43750,1944,2005,1409,39.1,81,444,0,5,0,719,134
2016,36047047400,"Census Tract 474, Kings County, New York",765,54,711,444,1781,32065,1942,2005,1384,49.6,64,413,0,5,6,711,152
2017,36047047400,"Census Tract 474, Kings County, New York",786,66,720,445,1871,33359,1939,2006,1448,50,63,422,0,0,7,720,155
2018,36047047400,"Census Tract 474, Kings County, New York",759,77,682,387,1703,32431,0,2007,1604,51,55,376,0,0,6,682,153
2019,36047047400,"Census Tract 474, Kings County, New York",764,93,671,391,1603,26083,0,2009,1706,51,86,379,0,0,7,671,178
2020,36047047400,"Census Tract 474, Kings County, New York",757,103,654,324,1308,24833,0,2006,1468,51,68,311,0,0,8,654,158
2012,36047047600,"Census Tract 476, Kings County, New York",1020,22,998,625,2363,33153,1950,2000,1243,50,117,586,0,0,39,998,205
2013,36047047600,"Census Tract 476, Kings County, New York",1033,66,967,649,2415,33292,1947,2001,1280,50,159,562,0,0,41,967,225
2014,36047047600,"Census Tract 476, Kings County, New York",1007,70,937,567,2534,39676,1939,2003,1415,41.5,175,494,0,0,49,937,183
2015,36047047600,"Census Tract 476, Kings County, New York",988,96,892,528,2465,42750,1939,2004,1187,36.1,118,446,0,0,60,892,202
2016,36047047600,"Census Tract 476, Kings County, New York",1018,114,904,482,2086,31667,1939,2001,1185,39.9,95,426,0,0,32,904,233
2017,36047047600,"Census Tract 476, Kings County, New York",1079,140,939,471,1704,22383,1939,2002,1125,50,76,409,12,0,32,939,193
2018,36047047600,"Census Tract 476, Kings County, New York",1073,112,961,469,1920,23326,0,1999,1285,49.9,89,421,15,0,33,961,227
2019,36047047600,"Census Tract 476, Kings County, New York",1088,157,931,452,1735,23542,0,2003,1211,51,77,442,7,3,0,931,206
2020,36047047600,"Census Tract 476, Kings County, New York",1000,136,864,403,1561,33798,1962,2005,1602,51,59,327,17,6,0,864,144
2012,36047047700,"Census Tract 477, Kings County, New York",1636,50,1586,1221,2409,73778,1945,2005,1774,31,799,886,53,64,218,1586,141
2013,36047047700,"Census Tract 477, Kings County, New York",1723,63,1660,1240,2391,77805,1945,2005,1877,30.6,886,912,58,69,201,1660,169
2014,36047047700,"Census Tract 477, Kings County, New York",1793,70,1723,1319,2766,82694,1951,2007,2001,29.4,968,1023,72,81,136,1723,157
2015,36047047700,"Census Tract 477, Kings County, New York",1802,60,1742,1300,2766,86389,1952,2009,2240,29,957,1006,78,71,125,1742,149
2016,36047047700,"Census Tract 477, Kings County, New York",1798,98,1700,1211,2436,92083,1963,2011,2342,29.5,854,970,51,62,100,1700,163
2017,36047047700,"Census Tract 477, Kings County, New York",1831,113,1718,1239,2554,102188,1964,2012,2450,27.9,868,980,80,69,77,1718,140
2018,36047047700,"Census Tract 477, Kings County, New York",1872,158,1714,1281,2604,103977,1963,2013,2661,26.5,925,998,76,73,93,1714,119
2019,36047047700,"Census Tract 477, Kings County, New York",1947,172,1775,1257,2509,140650,1978,2015,2694,22.6,983,1015,14,61,118,1775,93
2020,36047047700,"Census Tract 477, Kings County, New York",1834,129,1705,1289,2780,143897,1977,2016,2699,22.8,981,1062,32,57,82,1705,130
2012,36047047800,"Census Tract 478, Kings County, New York",1332,152,1180,880,3331,19766,1939,2003,1259,50,117,559,7,32,247,1180,469
2013,36047047800,"Census Tract 478, Kings County, New York",1323,176,1147,835,2952,19039,1939,2003,1308,50,106,531,7,25,242,1147,412
2014,36047047800,"Census Tract 478, Kings County, New York",1313,174,1139,803,3184,19057,1939,2003,1337,50,118,472,6,13,256,1139,415
2015,36047047800,"Census Tract 478, Kings County, New York",1265,139,1126,752,2695,24074,1939,2003,1287,50,97,502,8,31,197,1126,323
2016,36047047800,"Census Tract 478, Kings County, New York",1249,90,1159,781,2829,26375,1939,2003,1306,50,95,520,0,40,205,1159,371
2017,36047047800,"Census Tract 478, Kings County, New York",1204,99,1105,661,2528,36103,1939,2002,1215,33.9,122,405,0,39,185,1105,277
2018,36047047800,"Census Tract 478, Kings County, New York",1142,72,1070,634,2272,43833,1941,2003,1290,29.8,132,356,0,34,217,1070,255
2019,36047047800,"Census Tract 478, Kings County, New York",1112,75,1037,660,1945,43669,0,2006,1330,31.3,174,406,0,78,160,1037,234
2020,36047047800,"Census Tract 478, Kings County, New York",1091,85,1006,562,1725,49250,1953,2009,1513,32.1,184,391,0,47,109,1006,215
2012,36047048000,"Census Tract 480, Kings County, New York",1114,116,998,750,2761,38182,1939,2004,1197,37.4,101,481,29,84,141,998,371
2013,36047048000,"Census Tract 480, Kings County, New York",1118,138,980,702,2356,24750,1944,2005,1160,34,83,423,35,103,124,980,380
2014,36047048000,"Census Tract 480, Kings County, New York",1102,126,976,773,2468,31307,1958,2006,1221,40.1,122,457,27,108,158,976,390
2015,36047048000,"Census Tract 480, Kings County, New York",1120,92,1028,819,2448,23911,1965,2006,1207,44.7,179,515,27,73,188,1028,376
2016,36047048000,"Census Tract 480, Kings County, New York",1131,59,1072,858,2813,24855,1961,2007,1336,46.1,213,490,51,105,212,1072,390
2017,36047048000,"Census Tract 480, Kings County, New York",1127,42,1085,919,2965,26778,1958,2007,1343,42.7,215,518,62,103,236,1085,423
2018,36047048000,"Census Tract 480, Kings County, New York",1132,72,1060,907,3036,31218,1962,2009,1486,43.2,242,522,27,83,275,1060,358
2019,36047048000,"Census Tract 480, Kings County, New York",1129,104,1025,845,2574,30659,1952,2008,1419,31.2,217,515,44,63,234,1025,299
2020,36047048000,"Census Tract 480, Kings County, New York",1131,141,990,843,2497,27482,1950,2008,1316,31.9,173,463,57,110,241,990,363
2012,36047048100,"Census Tract 481, Kings County, New York",1451,65,1386,1226,2374,64500,1939,2005,1370,27.3,619,657,19,65,476,1386,246
2013,36047048100,"Census Tract 481, Kings County, New York",1443,117,1326,1140,2303,63028,1939,2006,1500,29.5,582,685,42,31,379,1326,280
2014,36047048100,"Census Tract 481, Kings County, New York",1482,119,1363,1229,2472,72411,1939,2008,1487,28.2,690,723,88,45,368,1363,235
2015,36047048100,"Census Tract 481, Kings County, New York",1451,91,1360,1197,2688,66948,1952,2010,1558,28.1,661,647,102,77,364,1360,204
2016,36047048100,"Census Tract 481, Kings County, New York",1412,65,1347,1196,2596,69919,1955,2010,1758,28.9,670,685,89,73,349,1347,271
2017,36047048100,"Census Tract 481, Kings County, New York",1401,93,1308,1200,2780,76955,1950,2011,1967,27.4,667,717,77,136,270,1308,239
2018,36047048100,"Census Tract 481, Kings County, New York",1444,56,1388,1280,2743,79677,0,2011,1919,27.2,748,776,73,97,325,1388,242
2019,36047048100,"Census Tract 481, Kings County, New York",1441,50,1391,1231,2528,88098,0,2012,1981,25.4,711,736,44,124,317,1391,269
2020,36047048100,"Census Tract 481, Kings County, New York",1377,120,1257,1100,2555,79423,0,2014,1910,30.5,585,635,57,73,328,1257,266
2012,36047048200,"Census Tract 482, Kings County, New York",2016,76,1940,1581,4715,27360,1948,2003,1107,40.4,412,1026,131,270,124,1940,671
2013,36047048200,"Census Tract 482, Kings County, New York",2044,87,1957,1613,4594,28290,1953,2004,1126,38.5,554,1142,80,264,97,1957,621
2014,36047048200,"Census Tract 482, Kings County, New York",2039,83,1956,1587,4656,29237,1953,2004,1181,41.1,522,1014,100,262,188,1956,568
2015,36047048200,"Census Tract 482, Kings County, New York",1967,95,1872,1549,4720,30569,1956,2005,1202,41.7,589,981,96,304,144,1872,520
2016,36047048200,"Census Tract 482, Kings County, New York",1948,98,1850,1491,4178,32464,1955,2005,1212,39.4,587,876,97,346,154,1850,447
2017,36047048200,"Census Tract 482, Kings County, New York",1902,79,1823,1430,4079,35093,1953,2007,1228,38.3,588,833,78,377,126,1823,382
2018,36047048200,"Census Tract 482, Kings County, New York",1854,74,1780,1310,3808,40632,1951,2009,1367,39.2,483,694,84,384,140,1780,313
2019,36047048200,"Census Tract 482, Kings County, New York",1843,73,1770,1276,3590,43852,1950,2010,1418,38.6,518,674,93,327,188,1770,313
2020,36047048200,"Census Tract 482, Kings County, New York",2143,33,2110,1473,3431,43990,0,2009,1317,32.6,542,801,233,214,251,2110,256
2012,36047048400,"Census Tract 484, Kings County, New York",1643,44,1599,1329,4108,34301,1939,2002,1182,39.1,409,729,153,165,282,1599,255
2013,36047048400,"Census Tract 484, Kings County, New York",1583,34,1549,1238,4078,33929,1939,2003,1288,41.1,428,791,143,167,137,1549,247
2014,36047048400,"Census Tract 484, Kings County, New York",1601,36,1565,1244,4160,31887,1939,2004,1397,47.9,433,823,133,142,146,1565,290
2015,36047048400,"Census Tract 484, Kings County, New York",1643,10,1633,1219,4463,31014,1941,2005,1427,48.6,450,900,89,80,113,1633,405
2016,36047048400,"Census Tract 484, Kings County, New York",1634,27,1607,1242,4765,28733,1943,2006,1581,50,468,884,120,72,89,1607,469
2017,36047048400,"Census Tract 484, Kings County, New York",1668,29,1639,1256,4558,36536,1943,2008,1640,47.3,526,893,126,76,100,1639,432
2018,36047048400,"Census Tract 484, Kings County, New York",1677,31,1646,1256,4083,41125,1942,2011,1674,45.4,515,891,77,126,98,1646,400
2019,36047048400,"Census Tract 484, Kings County, New York",1666,50,1616,1153,3663,40380,1942,2011,1722,46.9,467,764,56,137,128,1616,385
2020,36047048400,"Census Tract 484, Kings County, New York",1542,51,1491,1137,4105,53281,1944,2013,1722,40,519,792,52,143,121,1491,321
2012,36047048500,"Census Tract 485, Kings County, New York",1017,122,895,806,2348,61667,1948,2006,1816,36.9,477,468,52,39,241,895,176
2013,36047048500,"Census Tract 485, Kings County, New York",1009,112,897,791,2441,73021,1950,2007,1936,29.4,511,506,12,32,235,897,158
2014,36047048500,"Census Tract 485, Kings County, New York",1024,52,972,788,2620,83333,1959,2008,2001,29,524,442,19,18,300,972,120
2015,36047048500,"Census Tract 485, Kings County, New York",995,32,963,789,2505,87446,1950,2011,1967,27.8,514,444,30,14,301,963,160
2016,36047048500,"Census Tract 485, Kings County, New York",981,29,952,804,2387,96974,1949,2011,2169,27.5,527,513,29,14,236,952,191
2017,36047048500,"Census Tract 485, Kings County, New York",981,48,933,760,2287,100625,1939,2012,2309,28.5,491,487,24,20,223,933,185
2018,36047048500,"Census Tract 485, Kings County, New York",1027,66,961,824,2248,100729,0,2012,2419,31,548,515,30,21,239,961,205
2019,36047048500,"Census Tract 485, Kings County, New York",981,76,905,799,2016,103750,0,2013,2425,28.5,493,526,21,13,219,905,185
2020,36047048500,"Census Tract 485, Kings County, New York",1018,82,936,815,1936,94813,0,2014,2388,28.5,539,472,8,17,276,936,207
2012,36047048600,"Census Tract 486, Kings County, New York",997,39,958,691,2554,25054,1939,2004,1266,50,225,235,13,294,149,958,346
2013,36047048600,"Census Tract 486, Kings County, New York",958,45,913,650,2414,25938,1939,2005,1267,46.9,197,161,10,283,196,913,311
2014,36047048600,"Census Tract 486, Kings County, New York",997,41,956,699,2510,25905,1939,2004,1275,47.2,188,158,10,313,218,956,307
2015,36047048600,"Census Tract 486, Kings County, New York",985,70,915,710,2432,37353,1939,2004,1288,38.9,169,144,11,323,232,915,249
2016,36047048600,"Census Tract 486, Kings County, New York",969,50,919,711,2346,39181,1939,2004,1302,39,183,133,16,350,212,919,265
2017,36047048600,"Census Tract 486, Kings County, New York",952,40,912,684,2285,39741,1939,2006,1330,39.2,214,142,26,331,185,912,245
2018,36047048600,"Census Tract 486, Kings County, New York",944,42,902,665,2270,39938,0,2006,1425,43.2,210,160,21,293,191,902,211
2019,36047048600,"Census Tract 486, Kings County, New York",934,68,866,640,2235,39808,0,2010,1483,42.5,178,170,18,302,150,866,222
2020,36047048600,"Census Tract 486, Kings County, New York",810,56,754,559,2450,50250,0,2010,1486,48.2,188,137,58,239,125,754,159
2012,36047048800,"Census Tract 488, Kings County, New York",1535,133,1402,909,2643,26308,1942,2004,1281,50,320,531,51,151,137,1402,396
2013,36047048800,"Census Tract 488, Kings County, New York",1538,112,1426,901,2860,26955,1943,2004,1294,50,366,527,50,166,123,1426,379
2014,36047048800,"Census Tract 488, Kings County, New York",1509,122,1387,926,2939,37870,1946,2004,1246,33.6,386,490,55,174,150,1387,370
2015,36047048800,"Census Tract 488, Kings County, New York",1480,104,1376,905,2856,43275,1939,2003,1209,28.6,409,398,73,173,235,1376,243
2016,36047048800,"Census Tract 488, Kings County, New York",1439,42,1397,804,2667,44949,1939,2005,1196,29.2,369,364,79,198,144,1397,225
2017,36047048800,"Census Tract 488, Kings County, New York",1429,43,1386,703,2260,38108,1939,2008,1182,35.1,292,312,56,219,103,1386,250
2018,36047048800,"Census Tract 488, Kings County, New York",1405,34,1371,747,2396,43839,1942,2005,1183,29.4,257,355,55,176,126,1371,145
2019,36047048800,"Census Tract 488, Kings County, New York",1449,14,1435,701,1926,41627,0,2009,1276,34.9,246,299,48,200,136,1435,169
2020,36047048800,"Census Tract 488, Kings County, New York",1487,15,1472,651,2064,51891,1948,2008,1508,32.6,272,261,30,236,108,1472,161
2012,36047048900,"Census Tract 489, Kings County, New York",1516,75,1441,1430,4176,19132,1958,1999,437,26.3,92,16,642,0,843,1441,674
2013,36047048900,"Census Tract 489, Kings County, New York",1515,52,1463,1444,4112,19135,1958,2002,426,27.5,60,22,588,0,893,1463,618
2014,36047048900,"Census Tract 489, Kings County, New York",1541,80,1461,1436,3849,21491,1959,2000,437,27.1,68,25,648,0,871,1461,568
2015,36047048900,"Census Tract 489, Kings County, New York",1558,47,1511,1499,3790,19674,1958,2000,419,28.6,81,27,618,0,932,1511,591
2016,36047048900,"Census Tract 489, Kings County, New York",1569,67,1502,1488,3711,18676,1958,2002,420,28.6,152,25,702,13,879,1502,647
2017,36047048900,"Census Tract 489, Kings County, New York",1598,55,1543,1533,3563,17694,1959,2000,420,29,153,10,721,9,922,1543,699
2018,36047048900,"Census Tract 489, Kings County, New York",1603,58,1545,1545,3506,18640,1958,2001,415,27.1,172,39,744,9,902,1545,726
2019,36047048900,"Census Tract 489, Kings County, New York",1615,35,1580,1580,3617,24808,1959,2003,436,27.4,257,66,761,13,872,1580,629
2020,36047048900,"Census Tract 489, Kings County, New York",1516,18,1498,1498,3591,19269,1959,2001,437,23.5,235,86,667,17,866,1498,692
2012,36047049000,"Census Tract 490, Kings County, New York",2187,129,2058,1490,3855,33198,1959,2002,1152,42.3,744,1025,237,147,53,2058,482
2013,36047049000,"Census Tract 490, Kings County, New York",2154,74,2080,1621,4421,31264,1960,2003,1254,47.5,923,1035,258,144,131,2080,523
2014,36047049000,"Census Tract 490, Kings County, New York",2122,136,1986,1586,4437,34236,1961,2005,1261,47.7,858,1028,176,162,161,1986,519
2015,36047049000,"Census Tract 490, Kings County, New York",2162,165,1997,1547,4661,34878,1958,2007,1353,48,851,955,193,214,106,1997,517
2016,36047049000,"Census Tract 490, Kings County, New York",2229,124,2105,1549,4618,55829,1957,2008,1448,34.5,938,945,191,170,188,2105,497
2017,36047049000,"Census Tract 490, Kings County, New York",2217,115,2102,1506,4794,50952,1956,2008,1470,38.3,1025,915,84,231,233,2102,484
2018,36047049000,"Census Tract 490, Kings County, New York",2214,103,2111,1431,3840,53125,1955,2010,1507,34.4,874,771,118,232,271,2111,370
2019,36047049000,"Census Tract 490, Kings County, New York",2301,30,2271,1593,4134,57743,1953,2009,1558,33.6,991,853,145,246,312,2271,340
2020,36047049000,"Census Tract 490, Kings County, New York",2319,74,2245,1602,3596,51667,1952,2012,1580,34.3,816,827,132,207,398,2245,446
2012,36047049100,"Census Tract 491, Kings County, New York",2607,256,2351,2142,5450,33595,1964,2000,781,27.8,408,320,499,538,820,2351,488
2013,36047049100,"Census Tract 491, Kings County, New York",2661,269,2392,2215,5472,33417,1964,2000,818,29.3,421,313,501,552,939,2392,481
2014,36047049100,"Census Tract 491, Kings County, New York",2711,296,2415,2161,5384,33284,1965,2002,842,29.7,423,310,472,602,915,2415,465
2015,36047049100,"Census Tract 491, Kings County, New York",2781,238,2543,2259,5415,32089,1965,2004,861,30.5,410,372,524,713,851,2543,512
2016,36047049100,"Census Tract 491, Kings County, New York",2796,107,2689,2432,5887,31042,1966,2005,904,32,394,401,624,817,784,2689,608
2017,36047049100,"Census Tract 491, Kings County, New York",2808,85,2723,2438,6027,35743,1966,2005,1038,32.5,448,458,555,785,869,2723,757
2018,36047049100,"Census Tract 491, Kings County, New York",2856,132,2724,2365,5674,36308,1966,2005,1076,32.5,435,410,517,746,854,2724,758
2019,36047049100,"Census Tract 491, Kings County, New York",2882,95,2787,2421,5957,49890,1967,2006,1260,30.1,519,489,306,777,924,2787,646
2020,36047049100,"Census Tract 491, Kings County, New York",2717,81,2636,2256,5996,37381,1967,2007,1306,33.3,508,550,268,571,908,2636,771
2012,36047049200,"Census Tract 492, Kings County, New York",1127,85,1042,650,2296,32885,1943,2004,1256,35,264,284,83,80,211,1042,334
2013,36047049200,"Census Tract 492, Kings County, New York",1166,45,1121,718,2342,32852,1943,2004,1252,36.7,261,339,114,118,155,1121,365
2014,36047049200,"Census Tract 492, Kings County, New York",1165,0,1165,753,2263,32873,1944,2003,1195,36.1,241,365,164,77,152,1165,336
2015,36047049200,"Census Tract 492, Kings County, New York",1140,16,1124,680,2219,33958,1946,2002,1100,35.7,193,337,123,96,117,1124,288
2016,36047049200,"Census Tract 492, Kings County, New York",1126,26,1100,630,1900,35045,1947,2006,1216,40.4,169,309,106,100,98,1100,273
2017,36047049200,"Census Tract 492, Kings County, New York",1134,22,1112,648,1625,36188,1952,2007,1277,41.1,213,329,100,67,133,1112,270
2018,36047049200,"Census Tract 492, Kings County, New York",1152,65,1087,600,1475,38017,1953,2007,1323,43,216,303,59,65,140,1087,211
2019,36047049200,"Census Tract 492, Kings County, New York",1120,125,995,537,1230,37694,1952,2011,1527,51,207,306,0,90,115,995,205
2020,36047049200,"Census Tract 492, Kings County, New York",1273,68,1205,733,1519,37586,1958,2013,1621,51,391,510,70,58,95,1205,321
2012,36047049300,"Census Tract 493, Kings County, New York",3342,268,3074,2876,7100,28021,1952,2000,755,28.6,625,422,581,82,1940,3074,856
2013,36047049300,"Census Tract 493, Kings County, New York",3367,239,3128,2985,7546,30296,1945,2000,787,30.6,633,480,500,83,2014,3128,919
2014,36047049300,"Census Tract 493, Kings County, New York",3387,176,3211,3079,7395,33058,1943,2002,690,30.1,810,579,528,64,2044,3211,920
2015,36047049300,"Census Tract 493, Kings County, New York",3380,162,3218,3109,7188,NA,1946,2004,688,31.1,898,609,600,99,1928,3218,1190
2016,36047049300,"Census Tract 493, Kings County, New York",3401,171,3230,3127,7484,31647,1948,2005,671,29.3,917,582,673,145,1869,3230,1174
2017,36047049300,"Census Tract 493, Kings County, New York",3429,112,3317,3264,7725,32539,1950,2004,634,29,873,611,855,162,1885,3317,1366
2018,36047049300,"Census Tract 493, Kings County, New York",3425,173,3252,3202,7405,29748,1948,2006,778,29.9,901,753,760,188,1669,3252,1269
2019,36047049300,"Census Tract 493, Kings County, New York",3472,217,3255,3165,7160,27440,1940,2003,940,31.9,824,599,781,155,1763,3255,1235
2020,36047049301,"Census Tract 493.01, Kings County, New York",1009,0,1009,982,2261,21500,0,1997,562,36.4,93,30,301,0,708,1009,416
2020,36047049302,"Census Tract 493.02, Kings County, New York",2342,182,2160,2105,4903,43976,1970,2005,1103,28.9,719,558,166,139,1254,2160,609
2012,36047049400,"Census Tract 494, Kings County, New York",2051,0,2051,1438,3684,41364,1939,2003,1129,33.4,546,943,88,201,190,2051,452
2013,36047049400,"Census Tract 494, Kings County, New York",2083,0,2083,1472,3821,40433,1939,2003,1136,34.3,637,927,89,245,192,2083,492
2014,36047049400,"Census Tract 494, Kings County, New York",2081,0,2081,1482,3834,45571,1943,2004,1227,31.7,643,956,95,210,191,2081,429
2015,36047049400,"Census Tract 494, Kings County, New York",2039,0,2039,1445,3778,42268,1939,2004,1284,32.8,609,900,138,181,176,2039,420
2016,36047049400,"Census Tract 494, Kings County, New York",2060,22,2038,1448,3895,45602,1941,2006,1374,32.7,668,938,126,147,190,2038,370
2017,36047049400,"Census Tract 494, Kings County, New York",2054,24,2030,1488,4077,42826,1939,2005,1390,33.1,732,968,104,198,181,2030,446
2018,36047049400,"Census Tract 494, Kings County, New York",2077,25,2052,1461,3763,47554,0,2007,1582,33.4,747,963,94,168,192,2052,377
2019,36047049400,"Census Tract 494, Kings County, New York",2033,24,2009,1334,3554,56750,0,2009,1711,29.5,766,871,44,240,147,2009,265
2020,36047049400,"Census Tract 494, Kings County, New York",2371,48,2323,1358,3286,72703,0,2012,1762,28.1,769,888,108,197,165,2323,250
2012,36047049500,"Census Tract 495, Kings County, New York",1267,97,1170,940,1879,53041,1939,2004,1516,24.4,588,729,18,29,175,1170,190
2013,36047049500,"Census Tract 495, Kings County, New York",1356,94,1262,995,2053,50391,1939,2005,1446,28.3,570,696,29,60,218,1262,224
2014,36047049500,"Census Tract 495, Kings County, New York",1340,102,1238,971,1975,52472,1939,2007,1587,28.8,552,690,0,81,187,1238,204
2015,36047049500,"Census Tract 495, Kings County, New York",1341,75,1266,992,2057,73152,1939,2009,1576,25,622,704,13,94,177,1266,176
2016,36047049500,"Census Tract 495, Kings County, New York",1337,66,1271,996,2223,91111,1939,2011,1652,24,634,632,11,122,234,1271,109
2017,36047049500,"Census Tract 495, Kings County, New York",1315,82,1233,915,2137,89909,1939,2011,1615,24.8,542,535,34,102,246,1233,142
2018,36047049500,"Census Tract 495, Kings County, New York",1255,44,1211,956,2077,97241,0,2012,2022,24.6,657,660,38,85,182,1211,185
2019,36047049500,"Census Tract 495, Kings County, New York",1271,42,1229,994,2100,96190,0,2014,2138,24.8,747,638,44,114,210,1229,203
2020,36047049500,"Census Tract 495, Kings County, New York",1299,48,1251,1053,2185,105880,0,2014,2287,30.6,799,688,60,108,188,1251,186
2012,36047049600,"Census Tract 496, Kings County, New York",1360,28,1332,976,2812,50139,1939,2002,1224,28.7,273,514,42,232,169,1332,255
2013,36047049600,"Census Tract 496, Kings County, New York",1406,39,1367,1003,2889,57356,1939,2004,1389,26.6,336,488,52,234,220,1367,207
2014,36047049600,"Census Tract 496, Kings County, New York",1412,21,1391,931,2758,57245,1939,2005,1431,25.8,372,421,42,223,217,1391,203
2015,36047049600,"Census Tract 496, Kings County, New York",1429,56,1373,938,2481,53793,1939,2006,1465,29.5,422,397,26,233,236,1373,230
2016,36047049600,"Census Tract 496, Kings County, New York",1466,75,1391,948,2747,58622,1939,2007,1612,30.2,393,417,11,236,272,1391,257
2017,36047049600,"Census Tract 496, Kings County, New York",1516,82,1434,956,2899,62167,1939,2009,1621,30.3,371,368,11,198,366,1434,222
2018,36047049600,"Census Tract 496, Kings County, New York",1481,96,1385,912,2864,60455,0,2007,1667,33.5,351,382,11,183,308,1385,258
2019,36047049600,"Census Tract 496, Kings County, New York",1475,95,1380,936,2806,62769,0,2007,1660,34.6,395,411,10,194,321,1380,255
2020,36047049600,"Census Tract 496, Kings County, New York",1536,157,1379,1007,2824,53556,0,2007,1661,35.6,388,401,11,342,253,1379,317
2012,36047049700,"Census Tract 497, Kings County, New York",1468,75,1393,1103,2006,67684,1939,2006,1721,28.9,727,861,0,76,118,1393,171
2013,36047049700,"Census Tract 497, Kings County, New York",1498,54,1444,1159,2179,64213,1939,2007,1732,29.1,747,927,0,67,118,1444,183
2014,36047049700,"Census Tract 497, Kings County, New York",1513,25,1488,1194,2301,67318,1939,2009,1788,28.1,828,890,27,96,148,1488,150
2015,36047049700,"Census Tract 497, Kings County, New York",1494,25,1469,1221,2276,70547,1939,2011,1808,27.5,895,880,30,155,122,1469,139
2016,36047049700,"Census Tract 497, Kings County, New York",1509,56,1453,1165,2160,66250,1939,2011,1856,28.7,814,820,26,149,139,1453,130
2017,36047049700,"Census Tract 497, Kings County, New York",1524,76,1448,1171,2188,72147,1939,2011,1942,26.6,802,819,34,182,128,1448,112
2018,36047049700,"Census Tract 497, Kings County, New York",1576,109,1467,1178,2169,88800,0,2012,2142,28,842,857,27,184,100,1467,119
2019,36047049700,"Census Tract 497, Kings County, New York",1588,144,1444,1146,2031,90222,0,2013,2173,28.6,771,805,24,151,145,1444,100
2020,36047049700,"Census Tract 497, Kings County, New York",1566,166,1400,1095,2027,88875,0,2014,2153,29.5,751,765,29,128,144,1400,80
2012,36047049800,"Census Tract 498, Kings County, New York",1660,65,1595,1113,2667,43774,1948,2004,1247,33.6,471,657,41,262,118,1595,223
2013,36047049800,"Census Tract 498, Kings County, New York",1693,101,1592,1155,2744,41354,1945,2004,1294,35.9,456,634,80,274,134,1592,267
2014,36047049800,"Census Tract 498, Kings County, New York",1710,54,1656,1127,2785,43083,1944,2005,1379,35.6,483,666,73,250,161,1656,305
2015,36047049800,"Census Tract 498, Kings County, New York",1726,52,1674,1114,2560,52056,1947,2007,1405,34.2,539,649,67,200,183,1674,295
2016,36047049800,"Census Tract 498, Kings County, New York",1684,70,1614,1066,2565,58088,1947,2010,1443,32.7,536,545,73,215,223,1614,254
2017,36047049800,"Census Tract 498, Kings County, New York",1700,87,1613,1084,2812,56250,1946,2010,1526,32.2,534,477,69,277,251,1613,205
2018,36047049800,"Census Tract 498, Kings County, New York",1603,71,1532,1020,2549,59000,1951,2011,1599,33.6,549,471,20,306,214,1532,122
2019,36047049800,"Census Tract 498, Kings County, New York",1572,65,1507,971,2396,61581,1952,2011,1634,33.9,511,422,23,310,209,1507,66
2020,36047049800,"Census Tract 498, Kings County, New York",1496,59,1437,989,2688,55060,1947,2011,1654,33.6,437,418,0,377,207,1437,120
2012,36047049900,"Census Tract 499, Kings County, New York",928,102,826,571,956,48924,1939,2000,1029,27.8,188,494,24,3,50,826,23
2013,36047049900,"Census Tract 499, Kings County, New York",940,107,833,550,924,57917,1939,2002,1239,29,268,486,0,27,37,833,36
2014,36047049900,"Census Tract 499, Kings County, New York",963,96,867,547,995,74531,1939,2005,1296,27.3,312,464,0,28,55,867,52
2015,36047049900,"Census Tract 499, Kings County, New York",949,116,833,550,1029,71214,1939,2008,1502,28.2,341,477,0,23,50,833,59
2016,36047049900,"Census Tract 499, Kings County, New York",935,82,853,577,1091,73413,1939,2011,1700,27.8,341,462,0,30,81,853,70
2017,36047049900,"Census Tract 499, Kings County, New York",941,63,878,633,1241,74740,1939,2012,1844,28.7,404,513,0,39,76,878,57
2018,36047049900,"Census Tract 499, Kings County, New York",939,59,880,721,1418,75350,1941,2013,1952,31.2,446,593,0,29,83,880,47
2019,36047049900,"Census Tract 499, Kings County, New York",938,45,893,686,1242,73780,1942,2014,2061,33.5,394,555,0,31,83,893,25
2020,36047049900,"Census Tract 499, Kings County, New York",1040,44,996,713,1309,86938,0,2016,2236,29.9,410,508,19,50,69,996,66
2012,36047050000,"Census Tract 500, Kings County, New York",1637,87,1550,838,1789,49841,1940,2004,1312,27.7,461,669,83,21,35,1550,205
2013,36047050000,"Census Tract 500, Kings County, New York",1615,94,1521,835,1807,63343,1939,2004,1388,28,506,615,94,68,20,1521,222
2014,36047050000,"Census Tract 500, Kings County, New York",1613,140,1473,827,1800,71172,1939,2004,1609,26.9,505,574,85,75,34,1473,222
2015,36047050000,"Census Tract 500, Kings County, New York",1600,153,1447,793,1994,77445,1939,2004,1519,24.5,472,556,83,99,0,1447,204
2016,36047050000,"Census Tract 500, Kings County, New York",1617,149,1468,733,1827,64901,1939,2004,1640,28,493,465,105,144,0,1468,125
2017,36047050000,"Census Tract 500, Kings County, New York",1588,127,1461,641,1640,78442,1939,2004,1655,25.8,434,404,53,160,11,1461,60
2018,36047050000,"Census Tract 500, Kings County, New York",1577,140,1437,651,1723,79864,1944,2010,1745,25.7,475,389,102,144,16,1437,40
2019,36047050000,"Census Tract 500, Kings County, New York",1576,116,1460,665,1631,83007,1947,2011,1770,26.4,479,378,126,122,27,1460,50
2020,36047050001,"Census Tract 500.01, Kings County, New York",914,46,868,397,905,87113,1949,2013,1954,29.8,276,197,104,66,16,868,9
2020,36047050002,"Census Tract 500.02, Kings County, New York",708,77,631,368,913,92750,1945,2011,1847,24.3,291,245,55,58,10,631,18
2012,36047050100,"Census Tract 501, Kings County, New York",1465,129,1336,1020,2072,64333,1939,2004,1565,26.8,627,806,0,61,153,1336,123
2013,36047050100,"Census Tract 501, Kings County, New York",1492,154,1338,1066,2237,65047,1939,2004,1477,26,592,823,9,35,190,1338,109
2014,36047050100,"Census Tract 501, Kings County, New York",1479,142,1337,1113,2220,73036,1939,2006,1706,26.2,774,877,30,44,155,1337,129
2015,36047050100,"Census Tract 501, Kings County, New York",1470,76,1394,1096,2223,73514,1939,2007,1663,27.8,682,860,47,63,108,1394,137
2016,36047050100,"Census Tract 501, Kings County, New York",1451,52,1399,1057,2055,76250,1939,2010,1708,26.3,705,802,46,71,86,1399,141
2017,36047050100,"Census Tract 501, Kings County, New York",1473,53,1420,1004,1975,76786,1939,NA,1882,26.9,745,732,53,63,94,1420,181
2018,36047050100,"Census Tract 501, Kings County, New York",1490,46,1444,1036,2031,83696,0,2011,2025,28.5,700,724,25,97,138,1444,155
2019,36047050100,"Census Tract 501, Kings County, New York",1520,54,1466,1036,1997,107727,0,2013,2203,27.6,684,710,15,96,141,1466,158
2020,36047050100,"Census Tract 501, Kings County, New York",1559,81,1478,1057,2012,109375,1941,2013,2256,26.1,657,598,36,95,260,1478,187
2012,36047050202,"Census Tract 502.02, Kings County, New York",1116,10,1106,401,729,70677,1943,2004,1572,27.4,271,323,26,0,64,1106,128
2013,36047050202,"Census Tract 502.02, Kings County, New York",1100,0,1100,468,886,86964,1963,2005,1660,26.7,327,377,29,0,74,1100,157
2014,36047050202,"Census Tract 502.02, Kings County, New York",1115,0,1115,512,981,73472,1963,2007,1684,28.1,420,442,29,0,45,1115,144
2015,36047050202,"Census Tract 502.02, Kings County, New York",1106,0,1106,465,934,47798,1967,2010,1715,32.8,414,421,0,0,39,1106,92
2016,36047050202,"Census Tract 502.02, Kings County, New York",1115,35,1080,393,692,94028,1965,2010,1681,26.9,298,299,0,0,68,1080,76
2017,36047050202,"Census Tract 502.02, Kings County, New York",1117,42,1075,394,665,94545,1965,2008,1762,27.8,327,327,9,7,29,1075,97
2018,36047050202,"Census Tract 502.02, Kings County, New York",1122,39,1083,399,771,78750,1968,2011,1849,29.9,288,308,10,31,31,1083,83
2019,36047050202,"Census Tract 502.02, Kings County, New York",1125,42,1083,326,683,85227,1967,2013,2105,28,210,208,11,46,33,1083,110
2020,36047050202,"Census Tract 502.02, Kings County, New York",1105,35,1070,351,632,81101,1981,2011,1856,30.3,169,175,11,55,97,1070,110
2012,36047050300,"Census Tract 503, Kings County, New York",1202,30,1172,854,1856,74194,1939,2004,1654,25.4,513,645,0,48,159,1172,185
2013,36047050300,"Census Tract 503, Kings County, New York",1246,52,1194,859,1723,66475,1939,2004,1661,27.7,527,652,0,57,131,1194,190
2014,36047050300,"Census Tract 503, Kings County, New York",1223,42,1181,858,1663,71250,1939,2005,1745,27.1,510,612,0,36,158,1181,193
2015,36047050300,"Census Tract 503, Kings County, New York",1271,62,1209,836,1672,76750,1939,2008,1784,26.5,464,588,0,49,155,1209,148
2016,36047050300,"Census Tract 503, Kings County, New York",1283,54,1229,896,1666,82188,1939,2010,1882,30.1,563,644,11,62,149,1229,131
2017,36047050300,"Census Tract 503, Kings County, New York",1313,63,1250,918,1694,83864,1939,2011,1929,31.7,601,612,23,67,166,1250,128
2018,36047050300,"Census Tract 503, Kings County, New York",1328,65,1263,931,1811,91125,0,2012,1968,29.6,619,585,53,59,199,1263,73
2019,36047050300,"Census Tract 503, Kings County, New York",1396,68,1328,976,1812,91932,0,2014,2111,24.8,680,621,59,60,207,1328,84
2020,36047050300,"Census Tract 503, Kings County, New York",1434,72,1362,1077,2025,116985,0,2016,2480,26.4,783,752,51,38,223,1362,124
2012,36047050400,"Census Tract 504, Kings County, New York",2155,71,2084,1317,3225,70665,1939,2002,1312,23.8,645,842,206,41,233,2084,216
2013,36047050400,"Census Tract 504, Kings County, New York",2103,110,1993,1245,2813,66917,1943,2002,1361,25.7,662,764,207,24,234,1993,97
2014,36047050400,"Census Tract 504, Kings County, New York",2096,135,1961,1269,3192,71827,1939,2002,1388,24.4,693,769,179,68,238,1961,133
2015,36047050400,"Census Tract 504, Kings County, New York",2091,90,2001,1268,3234,72606,1945,2002,1364,25.6,718,686,198,71,281,2001,200
2016,36047050400,"Census Tract 504, Kings County, New York",2047,133,1914,1273,3054,66417,1942,2003,1456,26.7,751,732,198,66,256,1914,218
2017,36047050400,"Census Tract 504, Kings County, New York",2071,117,1954,1308,3246,68571,1939,2003,1468,27.2,712,712,210,94,287,1954,277
2018,36047050400,"Census Tract 504, Kings County, New York",2105,94,2011,1335,3186,78535,1942,2004,1542,26.3,759,722,242,100,284,2011,263
2019,36047050400,"Census Tract 504, Kings County, New York",2158,81,2077,1374,3333,86883,1944,2007,1586,25.6,751,720,271,103,278,2077,278
2020,36047050401,"Census Tract 504.01, Kings County, New York",1251,74,1177,829,2182,86839,1945,2016,2201,27.5,555,435,198,124,60,1177,198
2020,36047050402,"Census Tract 504.02, Kings County, New York",951,9,942,368,748,81471,1954,2002,1429,25,112,216,63,31,44,942,71
2012,36047050500,"Census Tract 505, Kings County, New York",1838,93,1745,1573,3676,19823,1945,2002,771,31.2,331,338,269,118,918,1745,627
2013,36047050500,"Census Tract 505, Kings County, New York",1907,62,1845,1657,3802,19740,1952,2002,773,30.8,420,441,241,130,940,1845,623
2014,36047050500,"Census Tract 505, Kings County, New York",1915,34,1881,1639,3661,24368,1942,2002,850,29.2,437,497,254,136,855,1881,568
2015,36047050500,"Census Tract 505, Kings County, New York",2000,38,1962,1735,3785,28424,1954,2005,907,30,510,533,356,165,833,1962,513
2016,36047050500,"Census Tract 505, Kings County, New York",2013,30,1983,1781,3943,29154,1954,2006,958,31.3,501,487,373,170,882,1983,556
2017,36047050500,"Census Tract 505, Kings County, New York",2023,94,1929,1691,3540,30536,1951,2007,958,32,510,465,428,133,752,1929,516
2018,36047050500,"Census Tract 505, Kings County, New York",2021,120,1901,1695,3351,33858,1949,2008,1041,31.3,547,489,367,141,743,1901,504
2019,36047050500,"Census Tract 505, Kings County, New York",2053,120,1933,1707,3569,37776,1953,2010,1090,31.2,650,435,350,179,798,1933,506
2020,36047050500,"Census Tract 505, Kings County, New York",1956,116,1840,1639,3586,36921,1952,2012,1033,31.7,626,402,366,260,664,1840,474
2012,36047050600,"Census Tract 506, Kings County, New York",2058,193,1865,1636,4499,32548,1939,2002,1114,39.1,352,165,1051,26,403,1865,448
2013,36047050600,"Census Tract 506, Kings County, New York",2034,200,1834,1595,4585,33623,1939,2003,1158,35.6,410,156,933,41,448,1834,439
2014,36047050600,"Census Tract 506, Kings County, New York",2031,144,1887,1654,4643,36728,1939,2003,1298,34.4,468,168,998,51,458,1887,373
2015,36047050600,"Census Tract 506, Kings County, New York",2026,120,1906,1616,4674,42857,1939,2004,1371,34.4,453,166,877,40,555,1906,350
2016,36047050600,"Census Tract 506, Kings County, New York",2052,140,1912,1673,4799,43218,1939,2007,1476,35.7,536,228,804,79,538,1912,410
2017,36047050600,"Census Tract 506, Kings County, New York",2065,91,1974,1779,5266,47114,1939,2008,1536,36,539,297,794,95,565,1974,437
2018,36047050600,"Census Tract 506, Kings County, New York",2069,46,2023,1806,4914,51172,0,2009,1537,32.6,554,337,791,102,564,2023,371
2019,36047050600,"Census Tract 506, Kings County, New York",2050,39,2011,1748,4332,56328,0,2010,1582,33.2,575,387,651,117,522,2011,353
2020,36047050600,"Census Tract 506, Kings County, New York",1992,21,1971,1679,4071,54417,0,2011,1728,38,548,423,605,124,430,1971,331
2012,36047050700,"Census Tract 507, Kings County, New York",541,75,466,442,2119,28500,1991,2005,1148,37.5,9,210,18,3,199,466,201
2013,36047050700,"Census Tract 507, Kings County, New York",559,88,471,439,2234,24219,1996,2005,1341,42.4,23,208,20,4,179,471,231
2014,36047050700,"Census Tract 507, Kings County, New York",570,83,487,429,2178,29464,1999,2005,1613,47.3,44,222,33,14,131,487,222
2015,36047050700,"Census Tract 507, Kings County, New York",565,69,496,403,1963,26793,1999,2006,1540,45.5,73,217,52,15,121,496,194
2016,36047050700,"Census Tract 507, Kings County, New York",569,58,511,412,2020,29833,1999,2007,1265,41.6,80,220,43,14,137,511,199
2017,36047050700,"Census Tract 507, Kings County, New York",586,41,545,416,1922,30167,1996,2006,1199,38.6,85,193,51,18,156,545,195
2018,36047050700,"Census Tract 507, Kings County, New York",607,27,580,456,2156,29271,2000,2007,1139,38.2,52,232,48,22,166,580,257
2019,36047050700,"Census Tract 507, Kings County, New York",652,55,597,474,2266,30913,1999,2007,1241,38.9,60,256,31,15,172,597,238
2020,36047050700,"Census Tract 507, Kings County, New York",689,72,617,490,2159,26862,2002,2008,1379,51,114,313,25,15,137,617,317
2012,36047050801,"Census Tract 508.01, Kings County, New York",1513,116,1397,1397,3772,34063,1939,2001,1188,39.8,126,33,1062,71,340,1397,330
2013,36047050801,"Census Tract 508.01, Kings County, New York",1506,173,1333,1333,4109,39176,1939,2003,1238,33.6,164,62,942,69,316,1333,326
2014,36047050801,"Census Tract 508.01, Kings County, New York",1484,178,1306,1297,3762,42550,1939,2003,1180,31.7,220,103,924,79,258,1306,330
2015,36047050801,"Census Tract 508.01, Kings County, New York",1486,177,1309,1291,3874,40994,1939,2002,1205,33.1,301,139,863,88,301,1309,347
2016,36047050801,"Census Tract 508.01, Kings County, New York",1502,100,1402,1370,4096,45909,1939,2004,1266,31.9,348,165,948,13,293,1402,294
2017,36047050801,"Census Tract 508.01, Kings County, New York",1483,163,1320,1279,3975,49188,1939,2005,1358,33.1,367,210,817,5,273,1320,281
2018,36047050801,"Census Tract 508.01, Kings County, New York",1490,111,1379,1335,3915,44450,0,2002,1366,34.6,369,199,886,14,275,1379,321
2019,36047050801,"Census Tract 508.01, Kings County, New York",1516,88,1428,1400,3939,50375,0,2003,1434,32.7,376,188,970,19,280,1428,344
2020,36047050801,"Census Tract 508.01, Kings County, New York",1409,106,1303,1270,3522,56389,0,2005,1453,30.2,370,193,810,36,228,1303,265
2012,36047050803,"Census Tract 508.03, Kings County, New York",1005,126,879,846,2063,46250,1939,2002,1072,26.6,183,155,615,28,92,879,202
2013,36047050803,"Census Tract 508.03, Kings County, New York",969,86,883,843,2095,42131,1939,2004,1077,28.2,230,156,597,25,89,883,222
2014,36047050803,"Census Tract 508.03, Kings County, New York",961,101,860,837,1973,41677,1939,2004,1141,33.6,258,200,556,12,54,860,152
2015,36047050803,"Census Tract 508.03, Kings County, New York",969,93,876,851,1934,38722,1939,2004,1215,36.2,311,212,499,18,102,876,122
2016,36047050803,"Census Tract 508.03, Kings County, New York",986,35,951,911,2074,40931,1939,2005,1215,33,354,229,519,17,120,951,142
2017,36047050803,"Census Tract 508.03, Kings County, New York",964,44,920,873,1978,42458,1939,2007,1338,33.9,384,210,502,15,115,920,136
2018,36047050803,"Census Tract 508.03, Kings County, New York",1000,52,948,919,2136,46164,0,2008,1453,36.1,397,230,498,31,139,948,140
2019,36047050803,"Census Tract 508.03, Kings County, New York",1003,47,956,926,2274,49914,0,2011,1491,35.9,413,224,552,39,112,956,188
2020,36047050803,"Census Tract 508.03, Kings County, New York",1141,56,1085,1053,2413,62159,0,2008,1561,32.7,485,241,615,31,154,1085,145
2012,36047050804,"Census Tract 508.04, Kings County, New York",2471,125,2346,2213,5613,42785,1939,1999,1095,32.1,675,286,1371,146,463,2346,518
2013,36047050804,"Census Tract 508.04, Kings County, New York",2478,131,2347,2183,5729,48694,1939,2000,1136,30.5,711,317,1355,115,463,2347,483
2014,36047050804,"Census Tract 508.04, Kings County, New York",2533,66,2467,2297,5533,49381,1939,2002,1157,31.1,751,339,1353,104,531,2467,440
2015,36047050804,"Census Tract 508.04, Kings County, New York",2569,45,2524,2380,5503,50150,1939,2005,1163,31.5,801,447,1375,55,555,2524,452
2016,36047050804,"Census Tract 508.04, Kings County, New York",2599,162,2437,2387,6080,50159,1939,2006,1179,31.7,874,552,1242,35,578,2437,322
2017,36047050804,"Census Tract 508.04, Kings County, New York",2685,209,2476,2388,6196,50550,1939,2006,1292,32.9,906,543,1211,42,588,2476,387
2018,36047050804,"Census Tract 508.04, Kings County, New York",2773,265,2508,2381,5788,52156,0,2007,1277,32.7,875,508,1180,44,615,2508,503
2019,36047050804,"Census Tract 508.04, Kings County, New York",2782,296,2486,2302,5690,58819,0,2007,1401,30.4,909,573,1109,61,542,2486,366
2020,36047050804,"Census Tract 508.04, Kings County, New York",2782,225,2557,2362,5689,70846,0,2009,1569,28.4,1046,770,1109,62,368,2557,332
2012,36047050900,"Census Tract 509, Kings County, New York",737,88,649,482,2602,22143,1993,2004,1102,49.8,5,350,24,0,118,649,296
2013,36047050900,"Census Tract 509, Kings County, New York",739,91,648,440,2420,22326,1995,2004,1281,50,5,345,22,0,82,648,310
2014,36047050900,"Census Tract 509, Kings County, New York",722,107,615,428,2585,24375,1997,2004,1140,49,10,329,29,0,80,615,311
2015,36047050900,"Census Tract 509, Kings County, New York",719,64,655,473,2848,27350,1999,2005,1205,48,20,383,28,0,74,655,331
2016,36047050900,"Census Tract 509, Kings County, New York",721,54,667,508,3300,26528,2002,2006,1250,50,21,424,23,0,61,667,364
2017,36047050900,"Census Tract 509, Kings County, New York",770,45,725,539,3472,30274,2002,2006,1244,47.3,43,441,18,0,80,725,368
2018,36047050900,"Census Tract 509, Kings County, New York",806,38,768,584,3835,32083,2004,2008,1491,39.9,60,484,27,0,73,768,390
2019,36047050900,"Census Tract 509, Kings County, New York",839,17,822,623,4010,31138,2004,2010,1682,51,67,551,0,0,72,822,396
2020,36047050900,"Census Tract 509, Kings County, New York",898,18,880,597,3872,34018,2006,2012,1660,51,92,556,0,0,41,880,419
2012,36047051001,"Census Tract 510.01, Kings County, New York",1510,133,1377,1377,3778,38328,1939,2001,1076,33.6,390,91,1121,0,215,1377,280
2013,36047051001,"Census Tract 510.01, Kings County, New York",1504,133,1371,1371,3539,42088,1939,2001,1070,30.2,419,91,1104,0,158,1371,207
2014,36047051001,"Census Tract 510.01, Kings County, New York",1512,46,1466,1466,4054,44538,1939,2001,1155,30.7,478,106,1150,0,197,1466,133
2015,36047051001,"Census Tract 510.01, Kings County, New York",1520,44,1476,1476,4274,44332,1939,2004,1230,30.6,579,165,1052,0,229,1476,128
2016,36047051001,"Census Tract 510.01, Kings County, New York",1546,67,1479,1479,4498,49896,1939,2004,1251,30.7,462,119,1065,21,220,1479,180
2017,36047051001,"Census Tract 510.01, Kings County, New York",1554,78,1476,1476,4361,50954,1939,2005,1335,32.6,404,158,1077,15,205,1476,233
2018,36047051001,"Census Tract 510.01, Kings County, New York",1539,94,1445,1445,4168,53373,0,2006,1411,35,426,186,1051,15,202,1445,229
2019,36047051001,"Census Tract 510.01, Kings County, New York",1563,93,1470,1470,4092,55435,0,2005,1402,34.7,374,175,1116,29,146,1470,271
2020,36047051001,"Census Tract 510.01, Kings County, New York",1809,85,1724,1724,4677,47632,0,2006,1406,39.2,293,152,1296,57,148,1724,329
2012,36047051002,"Census Tract 510.02, Kings County, New York",1918,122,1796,1723,4454,42868,1939,2003,1114,32.3,397,133,1269,16,293,1796,300
2013,36047051002,"Census Tract 510.02, Kings County, New York",1879,88,1791,1713,4513,43695,1939,2003,1123,32.7,462,134,1264,32,286,1791,375
2014,36047051002,"Census Tract 510.02, Kings County, New York",1880,91,1789,1704,4516,42995,1939,2003,1149,33.2,403,117,1223,42,362,1789,353
2015,36047051002,"Census Tract 510.02, Kings County, New York",1907,54,1853,1787,4823,45149,1939,2003,1193,33,426,160,1205,42,430,1853,333
2016,36047051002,"Census Tract 510.02, Kings County, New York",1901,78,1823,1734,4555,48000,1939,2004,1239,32.2,488,182,1166,55,392,1823,317
2017,36047051002,"Census Tract 510.02, Kings County, New York",1903,110,1793,1726,4367,47426,1939,2004,1241,33.7,530,175,1147,40,384,1793,352
2018,36047051002,"Census Tract 510.02, Kings County, New York",1929,116,1813,1753,4400,46677,0,2006,1357,34.8,498,214,1106,16,427,1813,234
2019,36047051002,"Census Tract 510.02, Kings County, New York",1964,88,1876,1827,4681,49044,0,2007,1361,35.1,565,271,1172,18,355,1876,208
2020,36047051002,"Census Tract 510.02, Kings County, New York",1829,135,1694,1669,4051,47490,0,2007,1430,35.6,474,236,1094,65,253,1694,167
2012,36047051100,"Census Tract 511, Kings County, New York",1719,72,1647,1436,3129,21262,1967,2002,857,38.4,272,413,159,247,653,1647,486
2013,36047051100,"Census Tract 511, Kings County, New York",1725,89,1636,1435,3057,23954,1966,2002,963,36.4,326,520,127,220,592,1636,479
2014,36047051100,"Census Tract 511, Kings County, New York",1761,103,1658,1409,2931,23652,1966,2003,936,35.2,376,559,151,181,553,1658,449
2015,36047051100,"Census Tract 511, Kings County, New York",1794,77,1717,1505,3152,27554,1966,2004,982,34.4,481,600,195,212,530,1717,450
2016,36047051100,"Census Tract 511, Kings County, New York",1841,70,1771,1644,3531,29926,1965,2006,981,34.1,665,593,205,277,628,1771,386
2017,36047051100,"Census Tract 511, Kings County, New York",1955,35,1920,1790,4088,34524,1966,2008,1101,32.8,746,634,219,291,677,1920,477
2018,36047051100,"Census Tract 511, Kings County, New York",1980,35,1945,1758,3827,37059,1968,2009,1118,31.5,765,616,202,261,672,1945,463
2019,36047051100,"Census Tract 511, Kings County, New York",2026,38,1988,1823,3985,46875,1968,2010,1207,30.8,834,648,133,337,670,1988,451
2020,36047051100,"Census Tract 511, Kings County, New York",2024,58,1966,1808,4008,53333,1968,2012,1360,29.7,833,712,97,362,583,1966,463
2012,36047051200,"Census Tract 512, Kings County, New York",2548,77,2471,2335,6354,43216,1939,2000,1084,32.1,606,88,1662,13,597,2471,408
2013,36047051200,"Census Tract 512, Kings County, New York",2498,122,2376,2243,5639,35659,1939,2001,1105,33.4,644,158,1610,44,448,2376,459
2014,36047051200,"Census Tract 512, Kings County, New York",2539,98,2441,2295,5734,37088,1939,2002,1152,34.6,744,162,1518,24,565,2441,480
2015,36047051200,"Census Tract 512, Kings County, New York",2540,103,2437,2314,5854,36125,1939,2003,1200,34,876,200,1580,38,437,2437,528
2016,36047051200,"Census Tract 512, Kings County, New York",2537,193,2344,2193,5434,39232,1939,2006,1290,38.1,727,237,1383,50,473,2344,456
2017,36047051200,"Census Tract 512, Kings County, New York",2496,171,2325,2207,5564,40220,1939,2007,1399,40,793,328,1383,53,462,2325,442
2018,36047051200,"Census Tract 512, Kings County, New York",2527,163,2364,2245,5789,51586,0,2008,1515,32.9,781,382,1423,27,431,2364,379
2019,36047051200,"Census Tract 512, Kings County, New York",2532,139,2393,2202,5398,55147,0,2007,1600,32.7,796,383,1397,53,375,2393,379
2020,36047051200,"Census Tract 512, Kings County, New York",2431,123,2308,2142,5389,58553,0,2011,1626,32.3,745,368,1402,44,343,2308,256
2012,36047051300,"Census Tract 513, Kings County, New York",2013,160,1853,1604,3454,62807,1939,2003,1338,27.7,731,812,58,72,616,1853,316
2013,36047051300,"Census Tract 513, Kings County, New York",2032,94,1938,1697,3551,65683,1939,2004,1384,26.1,784,836,49,142,622,1938,329
2014,36047051300,"Census Tract 513, Kings County, New York",2094,130,1964,1678,3632,66925,1939,2006,1610,26.2,824,873,76,122,594,1964,303
2015,36047051300,"Census Tract 513, Kings County, New York",2134,145,1989,1736,3850,NA,1944,2007,1733,26.8,936,936,70,163,588,1989,292
2016,36047051300,"Census Tract 513, Kings County, New York",2249,122,2127,1886,4210,69297,1957,2010,1928,29.3,958,954,102,161,719,2127,329
2017,36047051300,"Census Tract 513, Kings County, New York",2272,125,2147,1932,4541,82961,1962,2011,2203,28.3,1037,1022,96,175,671,2147,246
2018,36047051300,"Census Tract 513, Kings County, New York",2373,141,2232,1945,4604,94938,1967,2012,2412,28.6,1063,997,108,97,716,2232,283
2019,36047051300,"Census Tract 513, Kings County, New York",2429,123,2306,2023,4625,111782,1971,2012,2506,25.6,1139,1074,69,90,670,2306,274
2020,36047051300,"Census Tract 513, Kings County, New York",2432,103,2329,2085,4653,116039,1966,2014,2747,26.4,1206,986,90,63,672,2329,267
2012,36047051400,"Census Tract 514, Kings County, New York",2871,130,2741,2479,7210,41118,1939,2000,1194,34.3,494,315,1340,66,973,2741,520
2013,36047051400,"Census Tract 514, Kings County, New York",2835,179,2656,2430,6659,41652,1939,1999,1208,36,443,264,1490,111,669,2656,538
2014,36047051400,"Census Tract 514, Kings County, New York",2870,196,2674,2420,6508,44551,1939,2001,1298,34.7,614,250,1389,73,798,2674,446
2015,36047051400,"Census Tract 514, Kings County, New York",2872,121,2751,2516,6857,45199,1939,2002,1335,33.6,748,456,1417,63,587,2751,409
2016,36047051400,"Census Tract 514, Kings County, New York",2855,137,2718,2485,7146,45072,1939,2002,1357,35.3,747,436,1352,151,549,2718,540
2017,36047051400,"Census Tract 514, Kings County, New York",2866,110,2756,2545,7364,47228,1939,2004,1419,34,816,488,1271,194,583,2756,581
2018,36047051400,"Census Tract 514, Kings County, New York",2889,105,2784,2505,7134,49954,0,2005,1456,31,873,539,1232,132,607,2784,551
2019,36047051400,"Census Tract 514, Kings County, New York",2843,73,2770,2546,7328,62824,0,2006,1472,30.2,818,525,1172,244,526,2770,495
2020,36047051400,"Census Tract 514, Kings County, New York",2818,55,2763,2548,7006,55702,0,2005,1455,29.8,652,393,1264,272,474,2763,599
2012,36047051500,"Census Tract 515, Kings County, New York",664,58,606,357,762,54469,1939,2004,1460,28.9,197,210,0,23,84,606,74
2013,36047051500,"Census Tract 515, Kings County, New York",750,70,680,384,728,86000,1951,2008,2001,29.2,277,268,0,29,37,680,50
2014,36047051500,"Census Tract 515, Kings County, New York",799,73,726,401,795,72404,1950,2009,1725,26.3,277,270,8,31,65,726,61
2015,36047051500,"Census Tract 515, Kings County, New York",842,97,745,489,896,84375,1955,2010,2042,26.2,369,345,11,39,94,745,74
2016,36047051500,"Census Tract 515, Kings County, New York",938,81,857,661,1254,112656,1974,2011,2465,24.3,503,438,47,66,110,857,46
2017,36047051500,"Census Tract 515, Kings County, New York",1046,44,1002,790,1546,140250,2001,2012,2880,23.3,619,567,50,73,100,1002,30
2018,36047051500,"Census Tract 515, Kings County, New York",1139,33,1106,902,1776,142833,2003,2014,3097,23.4,699,586,86,84,146,1106,55
2019,36047051500,"Census Tract 515, Kings County, New York",1212,34,1178,976,1902,153500,2006,2016,3232,23,779,653,75,109,139,1178,54
2020,36047051500,"Census Tract 515, Kings County, New York",1229,38,1191,969,1894,172837,2009,NA,3352,23.1,798,599,91,134,145,1191,56
2012,36047051601,"Census Tract 516.01, Kings County, New York",2042,57,1985,1942,5630,31344,1939,2002,1125,42.9,244,151,1405,0,331,1985,589
2013,36047051601,"Census Tract 516.01, Kings County, New York",1950,70,1880,1845,5556,28265,1939,2002,1193,47.5,269,138,1388,0,312,1880,626
2014,36047051601,"Census Tract 516.01, Kings County, New York",1970,41,1929,1875,5137,30677,1939,2001,1173,46.1,346,158,1393,50,258,1929,516
2015,36047051601,"Census Tract 516.01, Kings County, New York",1977,31,1946,1903,5030,34118,1939,2001,1198,39.6,461,189,1337,72,286,1946,391
2016,36047051601,"Census Tract 516.01, Kings County, New York",2022,84,1938,1884,5359,42091,1939,2000,1293,34.6,505,135,1400,59,345,1938,333
2017,36047051601,"Census Tract 516.01, Kings County, New York",2086,156,1930,1891,5431,52342,1939,2007,1341,31.8,569,161,1333,59,414,1930,329
2018,36047051601,"Census Tract 516.01, Kings County, New York",2126,180,1946,1896,5097,52131,0,2005,1344,31.6,641,165,1425,74,300,1946,339
2019,36047051601,"Census Tract 516.01, Kings County, New York",2129,220,1909,1871,5141,59426,0,2009,1480,30.3,715,190,1328,50,384,1909,286
2020,36047051601,"Census Tract 516.01, Kings County, New York",2134,198,1936,1864,4858,56111,0,2011,1470,32.2,726,198,1246,26,400,1936,283
2012,36047051602,"Census Tract 516.02, Kings County, New York",1368,138,1230,1138,2732,39086,1939,2004,1123,33.2,242,86,1013,0,116,1230,190
2013,36047051602,"Census Tract 516.02, Kings County, New York",1379,139,1240,1139,3020,34375,1939,2005,1117,37.3,219,89,1004,0,89,1240,242
2014,36047051602,"Census Tract 516.02, Kings County, New York",1357,134,1223,1144,3290,38557,1939,2005,1167,35.2,215,95,967,0,124,1223,204
2015,36047051602,"Census Tract 516.02, Kings County, New York",1395,152,1243,1192,3571,NA,1939,2005,1205,34,242,94,969,10,173,1243,220
2016,36047051602,"Census Tract 516.02, Kings County, New York",1438,127,1311,1247,3931,49810,1939,2006,1289,30.1,326,122,949,22,251,1311,201
2017,36047051602,"Census Tract 516.02, Kings County, New York",1451,79,1372,1291,3793,55048,1939,2009,1372,33.3,326,152,921,29,249,1372,240
2018,36047051602,"Census Tract 516.02, Kings County, New York",1451,75,1376,1311,3566,61382,0,2008,1398,31.3,319,126,941,28,226,1376,214
2019,36047051602,"Census Tract 516.02, Kings County, New York",1497,58,1439,1357,3377,54073,0,2010,1434,34.2,374,133,952,47,296,1439,199
2020,36047051602,"Census Tract 516.02, Kings County, New York",1528,41,1487,1413,3412,65275,0,2010,1482,33.5,338,135,1033,34,356,1487,179
2012,36047051700,"Census Tract 517, Kings County, New York",945,99,846,679,1237,60592,1939,2003,1536,28.3,475,508,26,82,89,846,24
2013,36047051700,"Census Tract 517, Kings County, New York",1013,99,914,743,1410,63281,1939,2004,1498,30.6,507,555,42,84,104,914,65
2014,36047051700,"Census Tract 517, Kings County, New York",1039,115,924,685,1162,76227,1939,2007,1772,24.4,536,474,41,77,109,924,68
2015,36047051700,"Census Tract 517, Kings County, New York",1107,19,1088,779,1305,79107,1944,2010,2214,31.4,596,588,44,82,82,1088,135
2016,36047051700,"Census Tract 517, Kings County, New York",1224,19,1205,888,1474,86000,1954,2011,2334,32,687,686,42,97,79,1205,146
2017,36047051700,"Census Tract 517, Kings County, New York",1348,0,1348,993,1570,105987,1962,2012,2511,26.6,814,811,43,37,85,1348,161
2018,36047051700,"Census Tract 517, Kings County, New York",1465,30,1435,1068,1757,117348,1989,2013,2706,26.7,841,858,50,45,99,1435,142
2019,36047051700,"Census Tract 517, Kings County, New York",1571,51,1520,1207,1923,126676,2002,2014,2806,25.9,985,949,30,79,134,1520,160
2020,36047051700,"Census Tract 517, Kings County, New York",1484,39,1445,1204,2191,161019,2001,2015,2755,20.9,977,881,30,71,177,1445,114
2012,36047051800,"Census Tract 518, Kings County, New York",1424,90,1334,916,2200,27794,1939,1996,1104,37.5,162,155,485,133,175,1334,308
2013,36047051800,"Census Tract 518, Kings County, New York",1432,104,1328,795,1944,51699,1939,2001,1184,28.7,207,118,420,123,156,1328,182
2014,36047051800,"Census Tract 518, Kings County, New York",1479,129,1350,882,2019,50714,1939,2001,1257,32.3,240,120,443,133,209,1350,224
2015,36047051800,"Census Tract 518, Kings County, New York",1485,100,1385,917,2122,52269,1939,2002,1321,33.3,256,139,511,105,195,1385,239
2016,36047051800,"Census Tract 518, Kings County, New York",1487,109,1378,931,2159,44362,1939,2005,1382,34.3,235,124,495,91,216,1378,204
2017,36047051800,"Census Tract 518, Kings County, New York",1513,86,1427,939,2180,44679,1939,2006,1362,34.9,278,98,526,86,220,1427,150
2018,36047051800,"Census Tract 518, Kings County, New York",1522,128,1394,982,2198,47404,0,2007,1417,34.7,288,143,560,68,201,1394,164
2019,36047051800,"Census Tract 518, Kings County, New York",1494,102,1392,938,2335,49122,0,2008,1491,35,303,157,523,55,178,1392,172
2020,36047051800,"Census Tract 518, Kings County, New York",1665,129,1536,1071,2141,65399,1951,2011,1453,29.6,565,113,690,29,230,1536,105
2012,36047051900,"Census Tract 519, Kings County, New York",2022,162,1860,1520,3175,74330,1939,2003,1767,29.1,1122,1068,51,66,196,1860,192
2013,36047051900,"Census Tract 519, Kings County, New York",2103,181,1922,1623,3382,78967,1939,2005,1865,26.8,1219,1167,49,56,237,1922,216
2014,36047051900,"Census Tract 519, Kings County, New York",2295,153,2142,1818,3596,83172,1939,2006,1815,24.5,1285,1299,107,76,220,2142,234
2015,36047051900,"Census Tract 519, Kings County, New York",2465,213,2252,1942,3628,86358,1948,2010,2095,24.4,1421,1485,132,67,194,2252,204
2016,36047051900,"Census Tract 519, Kings County, New York",2602,224,2378,2087,4132,87758,1939,2011,2433,24.9,1561,1596,113,177,156,2378,187
2017,36047051900,"Census Tract 519, Kings County, New York",2825,217,2608,2242,4463,121429,1971,2012,2797,24.6,1764,1638,113,241,191,2608,180
2018,36047051900,"Census Tract 519, Kings County, New York",2959,303,2656,2250,4473,129012,1995,2014,3094,24.7,1855,1707,107,202,150,2656,141
2019,36047051900,"Census Tract 519, Kings County, New York",3093,352,2741,2450,4567,134865,2001,NA,3153,25.1,2057,1828,122,240,175,2741,150
2020,36047051900,"Census Tract 519, Kings County, New York",3282,319,2963,2607,4409,178066,2005,NA,3236,23.6,2362,1630,24,724,168,2963,163
2012,36047052000,"Census Tract 520, Kings County, New York",1502,87,1415,912,2866,39235,1939,2003,1144,36.7,318,209,305,291,81,1415,231
2013,36047052000,"Census Tract 520, Kings County, New York",1501,88,1413,874,2754,37670,1939,2003,1239,39.4,318,211,260,272,114,1413,233
2014,36047052000,"Census Tract 520, Kings County, New York",1497,84,1413,868,2843,37000,1939,2003,1250,40.2,282,181,244,297,131,1413,231
2015,36047052000,"Census Tract 520, Kings County, New York",1522,80,1442,933,3087,37038,1939,2004,1271,39.1,236,173,254,318,179,1442,269
2016,36047052000,"Census Tract 520, Kings County, New York",1534,36,1498,989,3024,40917,1939,2005,1291,37.4,288,202,248,290,260,1498,290
2017,36047052000,"Census Tract 520, Kings County, New York",1546,39,1507,1047,3328,37554,1939,2005,1324,40.4,248,223,247,277,312,1507,275
2018,36047052000,"Census Tract 520, Kings County, New York",1495,74,1421,985,3029,41735,0,2006,1317,38.3,253,257,250,237,252,1421,235
2019,36047052000,"Census Tract 520, Kings County, New York",1406,46,1360,882,2498,52500,0,2009,1355,35.4,256,300,157,208,229,1360,198
2020,36047052000,"Census Tract 520, Kings County, New York",1401,68,1333,835,2186,66991,0,2006,1272,26.5,220,241,285,130,179,1333,126
2012,36047052300,"Census Tract 523, Kings County, New York",2400,73,2327,2151,5095,31015,1939,2000,891,32.6,861,753,173,67,1264,2327,667
2013,36047052300,"Census Tract 523, Kings County, New York",2475,79,2396,2250,5683,32136,1939,1998,841,29.3,814,626,177,62,1428,2396,586
2014,36047052300,"Census Tract 523, Kings County, New York",2504,84,2420,2203,5188,41336,1939,2002,1050,32.6,910,735,87,112,1220,2420,483
2015,36047052300,"Census Tract 523, Kings County, New York",2437,68,2369,2141,5022,NA,1939,2003,1179,30.3,956,729,78,146,1125,2369,498
2016,36047052300,"Census Tract 523, Kings County, New York",2421,140,2281,2121,5056,42981,1946,2005,1214,30.9,921,704,87,133,1148,2281,629
2017,36047052300,"Census Tract 523, Kings County, New York",2446,92,2354,2133,4830,41998,1945,2008,1267,31.5,938,656,118,137,1226,2354,664
2018,36047052300,"Census Tract 523, Kings County, New York",2413,130,2283,2014,4357,53640,1948,2010,1608,31.2,919,729,94,189,1043,2283,686
2019,36047052300,"Census Tract 523, Kings County, New York",2352,147,2205,1974,4210,65663,1954,2011,1732,28.7,915,725,113,153,1054,2205,643
2020,36047052300,"Census Tract 523, Kings County, New York",2395,171,2224,1874,4125,68182,1950,2013,1633,27.2,955,647,149,208,945,2224,468
2012,36047052500,"Census Tract 525, Kings County, New York",1209,113,1096,1052,2842,15665,1956,1998,536,32.8,108,611,72,69,344,1096,583
2013,36047052500,"Census Tract 525, Kings County, New York",1230,96,1134,1073,2938,15890,1954,1996,528,31.3,123,606,85,77,337,1134,590
2014,36047052500,"Census Tract 525, Kings County, New York",1242,73,1169,1091,3095,16568,1956,1999,699,32,158,635,106,62,326,1169,576
2015,36047052500,"Census Tract 525, Kings County, New York",1210,50,1160,1088,3001,19573,1959,1997,719,31.7,186,595,102,75,340,1160,486
2016,36047052500,"Census Tract 525, Kings County, New York",1231,50,1181,1138,3268,25333,1961,1997,805,29.9,268,592,151,77,361,1181,429
2017,36047052500,"Census Tract 525, Kings County, New York",1227,105,1122,1066,3254,35170,1961,2000,954,29.5,350,548,104,79,319,1122,292
2018,36047052500,"Census Tract 525, Kings County, New York",1308,82,1226,1209,3415,33125,1962,2004,950,29.9,396,570,154,67,386,1226,373
2019,36047052500,"Census Tract 525, Kings County, New York",1332,101,1231,1209,3226,35423,1962,2004,847,30.9,309,545,104,95,427,1231,375
2020,36047052500,"Census Tract 525, Kings County, New York",1334,91,1243,1218,3444,36833,1962,2006,939,29.1,367,594,92,95,408,1243,291
2012,36047052600,"Census Tract 526, Kings County, New York",1772,81,1691,1510,3296,52365,1951,2002,1171,26.9,830,681,370,237,209,1691,299
2013,36047052600,"Census Tract 526, Kings County, New York",1770,34,1736,1572,3959,52979,1950,2003,1313,28.8,766,659,401,185,327,1736,295
2014,36047052600,"Census Tract 526, Kings County, New York",1796,43,1753,1519,3762,54515,1948,2005,1443,30.7,821,746,335,207,232,1753,251
2015,36047052600,"Census Tract 526, Kings County, New York",1805,36,1769,1558,3967,55125,1945,2007,1473,30.8,957,826,348,182,188,1769,313
2016,36047052600,"Census Tract 526, Kings County, New York",1796,41,1755,1534,3748,56900,1943,2008,1481,29.8,960,829,303,189,198,1755,292
2017,36047052600,"Census Tract 526, Kings County, New York",1828,41,1787,1557,3952,63580,1945,2009,1531,29.6,966,856,280,196,214,1787,229
2018,36047052600,"Census Tract 526, Kings County, New York",1857,28,1829,1511,3428,64943,1944,2008,1488,28.1,954,821,326,123,232,1829,289
2019,36047052600,"Census Tract 526, Kings County, New York",1837,21,1816,1531,3434,66066,1948,2007,1478,29.1,879,842,282,102,296,1816,266
2020,36047052600,"Census Tract 526, Kings County, New York",1861,27,1834,1497,3287,71683,1950,2008,1631,27.9,817,740,350,129,278,1834,200
2012,36047052700,"Census Tract 527, Kings County, New York",2543,126,2417,2248,5977,24291,1939,2002,928,36.1,592,539,222,90,1523,2417,926
2013,36047052700,"Census Tract 527, Kings County, New York",2581,114,2467,2338,6264,24583,1939,2002,952,35,738,545,133,90,1601,2467,987
2014,36047052700,"Census Tract 527, Kings County, New York",2556,136,2420,2317,6244,26632,1939,2002,985,34.8,672,485,246,99,1677,2420,949
2015,36047052700,"Census Tract 527, Kings County, New York",2524,143,2381,2263,6389,30576,1939,2004,1049,32.8,748,507,238,111,1555,2381,890
2016,36047052700,"Census Tract 527, Kings County, New York",2497,138,2359,2256,6250,37466,1942,2006,1191,31.7,856,483,202,88,1601,2359,761
2017,36047052700,"Census Tract 527, Kings County, New York",2535,153,2382,2294,6486,49703,1949,2006,1286,32.1,884,496,136,94,1610,2382,709
2018,36047052700,"Census Tract 527, Kings County, New York",2548,165,2383,2263,6067,53460,1953,2010,1314,32.2,798,582,121,84,1536,2383,608
2019,36047052700,"Census Tract 527, Kings County, New York",2583,247,2336,2230,6072,63760,1952,2010,1297,29,796,614,103,86,1443,2336,468
2020,36047052700,"Census Tract 527, Kings County, New York",2506,232,2274,2138,5877,61589,1950,2011,1310,25.9,779,593,76,176,1326,2274,266
2012,36047052800,"Census Tract 528, Kings County, New York",730,38,692,330,1204,50227,1939,2000,1322,35,81,107,45,73,105,692,89
2013,36047052800,"Census Tract 528, Kings County, New York",704,38,666,276,965,57500,1939,2002,1375,29.2,118,100,48,80,48,666,38
2014,36047052800,"Census Tract 528, Kings County, New York",733,58,675,339,1071,55208,1939,2004,1379,33.8,151,159,31,77,72,675,49
2015,36047052800,"Census Tract 528, Kings County, New York",718,75,643,289,839,47292,1939,2005,1340,31.1,153,122,26,98,43,643,53
2016,36047052800,"Census Tract 528, Kings County, New York",717,61,656,257,779,47375,1939,2010,1370,36.3,138,97,26,92,42,656,58
2017,36047052800,"Census Tract 528, Kings County, New York",709,55,654,292,898,50769,1939,2012,1441,37.7,140,103,23,109,57,654,81
2018,36047052800,"Census Tract 528, Kings County, New York",715,71,644,272,816,49375,0,2012,1506,38.1,119,111,9,100,52,644,92
2019,36047052800,"Census Tract 528, Kings County, New York",716,69,647,261,751,41595,0,2010,1665,43.2,106,107,21,88,45,647,82
2020,36047052800,"Census Tract 528, Kings County, New York",696,38,658,272,863,54444,0,2015,1797,38.2,113,139,22,83,22,658,89
2012,36047052900,"Census Tract 529, Kings County, New York",1057,133,924,811,3547,19431,1939,NA,927,43.9,69,742,0,9,60,924,479
2013,36047052900,"Census Tract 529, Kings County, New York",1036,54,982,858,3563,19568,1939,2005,1005,44.8,95,747,8,13,90,982,477
2014,36047052900,"Census Tract 529, Kings County, New York",1055,40,1015,861,3617,26955,1939,2005,930,40.4,118,726,25,0,110,1015,422
2015,36047052900,"Census Tract 529, Kings County, New York",1024,63,961,867,3519,30573,1939,2006,980,43.6,135,758,30,0,79,961,417
2016,36047052900,"Census Tract 529, Kings County, New York",1047,79,968,872,3606,27386,1939,2006,1037,45.9,174,768,30,0,62,968,399
2017,36047052900,"Census Tract 529, Kings County, New York",1067,110,957,821,3276,31558,1939,2007,1083,47.2,194,716,35,0,58,957,333
2018,36047052900,"Census Tract 529, Kings County, New York",1078,121,957,830,3113,30038,0,2004,1204,51,148,754,24,0,40,957,347
2019,36047052900,"Census Tract 529, Kings County, New York",1017,142,875,771,2965,25063,0,2004,1327,51,108,754,0,0,17,875,374
2020,36047052900,"Census Tract 529, Kings County, New York",965,86,879,766,2948,25781,0,2003,1155,51,68,666,0,0,100,879,343
2012,36047053000,"Census Tract 530, Kings County, New York",1163,114,1049,735,1861,49583,1939,2003,1260,30.7,330,536,57,96,54,1049,221
2013,36047053000,"Census Tract 530, Kings County, New York",1178,81,1097,795,1966,46713,1939,2004,1259,35.5,345,557,58,131,59,1097,291
2014,36047053000,"Census Tract 530, Kings County, New York",1181,77,1104,775,1973,35156,1939,2005,1274,40,306,553,43,130,58,1104,300
2015,36047053000,"Census Tract 530, Kings County, New York",1197,63,1134,826,2301,32500,1939,2007,1287,48,254,534,48,174,80,1134,343
2016,36047053000,"Census Tract 530, Kings County, New York",1177,52,1125,797,2256,32734,1939,2007,1301,47.1,238,525,38,162,72,1125,304
2017,36047053000,"Census Tract 530, Kings County, New York",1173,32,1141,817,2278,32128,1939,2007,1299,48.2,283,481,41,190,86,1141,298
2018,36047053000,"Census Tract 530, Kings County, New York",1186,61,1125,811,2458,35495,0,2009,1393,47.5,254,453,18,193,125,1125,284
2019,36047053000,"Census Tract 530, Kings County, New York",1140,65,1075,763,2342,38992,0,2011,1460,39,257,385,7,209,142,1075,229
2020,36047053000,"Census Tract 530, Kings County, New York",1275,91,1184,943,2575,45903,0,2012,1513,35.4,435,605,7,192,120,1184,311
2012,36047053100,"Census Tract 531, Kings County, New York",1616,173,1443,1030,5297,23269,2000,NA,1513,50,94,1006,0,0,24,1443,648
2013,36047053100,"Census Tract 531, Kings County, New York",1670,155,1515,1097,5828,25406,2002,2006,1566,50,112,1058,0,0,39,1515,586
2014,36047053100,"Census Tract 531, Kings County, New York",1694,134,1560,1168,5985,26500,1999,2007,1649,50,144,1085,0,29,54,1560,572
2015,36047053100,"Census Tract 531, Kings County, New York",1704,41,1663,1284,6676,24048,1999,2008,1672,50,208,1188,0,28,55,1663,699
2016,36047053100,"Census Tract 531, Kings County, New York",1723,45,1678,1292,6849,22115,1998,2009,1676,50,211,1199,0,28,53,1678,713
2017,36047053100,"Census Tract 531, Kings County, New York",1718,34,1684,1340,7232,24746,1999,2010,1737,50,256,1204,0,38,79,1684,723
2018,36047053100,"Census Tract 531, Kings County, New York",1755,29,1726,1395,7342,25492,1999,2011,1751,51,266,1268,0,43,73,1726,793
2019,36047053100,"Census Tract 531, Kings County, New York",1758,80,1678,1371,7103,38768,2001,2012,1746,47.7,285,1234,14,15,76,1678,671
2020,36047053101,"Census Tract 531.01, Kings County, New York",602,0,602,505,2356,19837,2002,2012,1199,51,49,439,22,0,44,602,329
2020,36047053102,"Census Tract 531.02, Kings County, New York",1205,88,1117,893,4455,50430,2001,2013,1897,47.5,130,769,0,29,63,1117,519
2012,36047053200,"Census Tract 532, Kings County, New York",1015,87,928,476,1123,37232,1944,2004,1205,24.7,252,337,82,57,5,928,147
2013,36047053200,"Census Tract 532, Kings County, New York",1008,90,918,445,980,41918,1945,2005,1187,30,228,353,62,30,6,918,100
2014,36047053200,"Census Tract 532, Kings County, New York",1032,112,920,441,1024,49750,1946,2007,1271,26.3,141,303,74,28,24,920,88
2015,36047053200,"Census Tract 532, Kings County, New York",1017,90,927,395,875,42250,1945,2008,1239,29.6,119,246,76,37,24,927,120
2016,36047053200,"Census Tract 532, Kings County, New York",1035,90,945,420,1015,48092,1944,2009,1248,28.6,159,239,86,67,17,945,143
2017,36047053200,"Census Tract 532, Kings County, New York",1058,62,996,440,1053,49333,1945,2009,1283,27.9,187,236,88,82,22,996,161
2018,36047053200,"Census Tract 532, Kings County, New York",1040,49,991,427,1057,60547,1947,2008,1352,27.9,197,220,72,75,31,991,156
2019,36047053200,"Census Tract 532, Kings County, New York",1014,39,975,383,994,37216,1946,2010,1403,34.2,203,197,56,77,24,975,180
2020,36047053200,"Census Tract 532, Kings County, New York",1091,69,1022,507,1260,27212,1945,2013,1471,38.9,214,200,46,88,50,1022,175
2012,36047053300,"Census Tract 533, Kings County, New York",1895,125,1770,1509,6400,14363,1939,2003,1055,50,106,1427,27,0,44,1770,1089
2013,36047053300,"Census Tract 533, Kings County, New York",1851,124,1727,1426,5864,15024,1939,2003,1030,50,105,1343,27,0,45,1727,934
2014,36047053300,"Census Tract 533, Kings County, New York",1797,111,1686,1401,5731,17192,1939,2003,1103,50,98,1313,31,0,44,1686,824
2015,36047053300,"Census Tract 533, Kings County, New York",1787,109,1678,1397,5883,16835,1939,2004,1165,50,115,1319,31,10,37,1678,892
2016,36047053300,"Census Tract 533, Kings County, New York",1850,106,1744,1421,5757,17180,1939,2004,1123,50,80,1332,39,11,39,1744,816
2017,36047053300,"Census Tract 533, Kings County, New York",1822,81,1741,1345,5646,21157,1939,2004,1114,50,114,1296,13,12,24,1741,749
2018,36047053300,"Census Tract 533, Kings County, New York",1773,119,1654,1308,5663,21189,0,2003,1160,51,93,1250,13,12,33,1654,769
2019,36047053300,"Census Tract 533, Kings County, New York",1777,144,1633,1277,5625,19945,0,2003,1148,51,103,1200,14,13,50,1633,737
2020,36047053300,"Census Tract 533, Kings County, New York",1721,139,1582,1177,5085,24170,0,1998,1167,51,91,1141,15,0,20,1582,582
2012,36047053400,"Census Tract 534, Kings County, New York",1239,63,1176,753,1810,13803,1941,2003,1257,50,299,468,65,108,78,1176,455
2013,36047053400,"Census Tract 534, Kings County, New York",1315,63,1252,891,2240,21535,1943,2002,1135,50,327,497,64,196,94,1252,354
2014,36047053400,"Census Tract 534, Kings County, New York",1372,59,1313,1023,2736,21823,1944,2003,1190,49.2,355,659,92,209,54,1313,503
2015,36047053400,"Census Tract 534, Kings County, New York",1382,103,1279,979,2768,24503,1939,2006,1241,39.4,356,649,38,188,60,1279,398
2016,36047053400,"Census Tract 534, Kings County, New York",1397,81,1316,1023,2823,23393,1944,2006,1214,50,387,664,49,181,78,1316,435
2017,36047053400,"Census Tract 534, Kings County, New York",1427,111,1316,955,2781,24163,1939,2009,1302,50,336,585,86,170,61,1316,440
2018,36047053400,"Census Tract 534, Kings County, New York",1390,109,1281,911,2562,23354,0,2010,1411,51,334,554,111,137,51,1281,467
2019,36047053400,"Census Tract 534, Kings County, New York",1401,121,1280,967,2565,35417,1940,2011,1464,51,334,492,137,128,118,1280,362
2020,36047053400,"Census Tract 534, Kings County, New York",1390,53,1337,1008,2760,40168,0,2011,1397,42.8,286,483,127,274,82,1337,305
2012,36047053500,"Census Tract 535, Kings County, New York",1225,160,1065,876,3266,15899,1939,2003,1018,50,77,764,0,0,112,1065,512
2013,36047053500,"Census Tract 535, Kings County, New York",1231,138,1093,899,3084,15691,1939,2004,1094,50,52,798,0,0,101,1093,560
2014,36047053500,"Census Tract 535, Kings County, New York",1181,87,1094,961,3457,17424,1939,2004,1135,50,98,873,0,0,88,1094,571
2015,36047053500,"Census Tract 535, Kings County, New York",1163,66,1097,997,3854,17587,1939,2006,1059,50,84,858,28,0,89,1097,608
2016,36047053500,"Census Tract 535, Kings County, New York",1119,55,1064,982,3819,20163,1939,2005,1090,50,59,853,31,0,78,1064,579
2017,36047053500,"Census Tract 535, Kings County, New York",1110,58,1052,953,3862,26512,1939,2006,1150,49.7,86,833,35,0,71,1052,452
2018,36047053500,"Census Tract 535, Kings County, New York",1056,70,986,906,3961,28690,0,2008,1080,51,40,797,47,0,59,986,451
2019,36047053500,"Census Tract 535, Kings County, New York",1074,152,922,813,3359,21726,0,2010,1085,51,16,703,40,0,65,922,383
2020,36047053500,"Census Tract 535, Kings County, New York",1015,132,883,790,3462,24569,0,2009,1200,51,74,705,24,0,85,883,318
2012,36047053700,"Census Tract 537, Kings County, New York",690,0,690,480,2230,16456,1981,2002,1024,50,21,475,0,0,0,690,347
2013,36047053700,"Census Tract 537, Kings County, New York",719,0,719,554,2642,17470,1945,2002,1028,50,19,548,0,0,0,719,370
2014,36047053700,"Census Tract 537, Kings County, New York",711,6,705,530,2437,18878,1945,2003,1036,50,34,515,0,0,10,705,372
2015,36047053700,"Census Tract 537, Kings County, New York",701,5,696,563,2520,21893,1964,2005,1168,50,62,535,0,12,11,696,346
2016,36047053700,"Census Tract 537, Kings County, New York",676,15,661,564,2832,24242,1978,2005,1280,50,49,531,0,14,12,661,316
2017,36047053700,"Census Tract 537, Kings County, New York",683,15,668,574,2971,31700,1974,2005,1328,50,56,549,0,13,12,668,285
2018,36047053700,"Census Tract 537, Kings County, New York",702,31,671,586,3108,32823,1991,2006,1241,51,53,563,0,9,14,671,296
2019,36047053700,"Census Tract 537, Kings County, New York",713,28,685,590,3260,38750,1989,2006,1286,44.8,56,580,0,10,0,685,253
2020,36047053700,"Census Tract 537, Kings County, New York",708,31,677,566,3156,36575,1991,2010,1478,51,49,566,0,0,0,677,224
2012,36047053800,"Census Tract 538, Kings County, New York",2125,210,1915,1728,3911,30678,1943,2002,1206,41.6,716,1353,35,71,241,1915,502
2013,36047053800,"Census Tract 538, Kings County, New York",2117,272,1845,1687,3556,28169,1945,2003,1207,48.4,701,1345,38,59,219,1845,571
2014,36047053800,"Census Tract 538, Kings County, New York",2114,242,1872,1763,3459,24205,1946,2004,1235,50,728,1378,39,76,245,1872,607
2015,36047053800,"Census Tract 538, Kings County, New York",2107,87,2020,1917,3844,25805,1944,2005,1268,50,822,1478,58,58,300,2020,612
2016,36047053800,"Census Tract 538, Kings County, New York",2078,115,1963,1803,3710,27277,1945,2007,1330,50,812,1468,21,75,224,1963,618
2017,36047053800,"Census Tract 538, Kings County, New York",2099,109,1990,1817,3779,27168,1942,2009,1318,50,828,1417,23,135,208,1990,625
2018,36047053800,"Census Tract 538, Kings County, New York",2115,61,2054,1852,3837,40532,0,2010,1371,39.1,952,1416,20,128,254,2054,517
2019,36047053800,"Census Tract 538, Kings County, New York",2142,58,2084,1827,4383,50434,1942,2011,1408,33.4,1008,1275,105,130,282,2084,364
2020,36047053800,"Census Tract 538, Kings County, New York",2188,59,2129,1772,4333,57768,1951,2012,1445,33.1,907,1288,114,140,172,2129,394
2012,36047053900,"Census Tract 539, Kings County, New York",877,11,866,754,2491,21739,1974,1986,1147,42.8,89,454,93,0,207,866,419
2013,36047053900,"Census Tract 539, Kings County, New York",853,11,842,719,2397,21813,1975,1987,1011,35,86,495,101,0,123,842,395
2014,36047053900,"Census Tract 539, Kings County, New York",854,14,840,747,2435,21150,1974,1988,1031,36.3,135,507,67,4,169,840,355
2015,36047053900,"Census Tract 539, Kings County, New York",835,14,821,722,2344,NA,1973,1990,1056,36.8,99,492,45,5,185,821,385
2016,36047053900,"Census Tract 539, Kings County, New York",836,7,829,718,2285,18377,1973,1992,1024,34.2,99,492,49,5,178,829,333
2017,36047053900,"Census Tract 539, Kings County, New York",844,19,825,728,2304,19444,1972,1994,1127,35.9,107,503,52,8,173,825,300
2018,36047053900,"Census Tract 539, Kings County, New York",844,18,826,741,2271,20191,1972,1993,1273,44.3,102,517,30,11,191,826,294
2019,36047053900,"Census Tract 539, Kings County, New York",843,18,825,726,2283,19554,1973,1997,1299,51,72,475,42,0,215,825,316
2020,36047053900,"Census Tract 539, Kings County, New York",924,41,883,806,2362,18973,1974,1993,1150,51,96,539,48,1,219,883,386
2012,36047054200,"Census Tract 542, Kings County, New York",1581,80,1501,1004,2235,21768,1948,2002,1176,32.5,445,889,18,42,49,1501,443
2013,36047054200,"Census Tract 542, Kings County, New York",1586,92,1494,1083,2624,27227,1947,2002,1252,32.1,486,932,26,67,52,1494,438
2014,36047054200,"Census Tract 542, Kings County, New York",1599,71,1528,1094,3007,32500,1945,2004,1313,31.6,483,898,33,54,102,1528,477
2015,36047054200,"Census Tract 542, Kings County, New York",1645,74,1571,1198,3362,37344,1945,2005,1293,31.6,553,907,54,59,172,1571,518
2016,36047054200,"Census Tract 542, Kings County, New York",1644,67,1577,1200,3338,39041,1947,2006,1358,29.5,577,935,66,41,151,1577,474
2017,36047054200,"Census Tract 542, Kings County, New York",1652,53,1599,1249,3579,37835,1947,2007,1369,32,534,963,39,48,199,1599,493
2018,36047054200,"Census Tract 542, Kings County, New York",1628,92,1536,1170,3229,40601,1945,2010,1415,32.6,538,907,35,54,174,1536,441
2019,36047054200,"Census Tract 542, Kings County, New York",1643,112,1531,1148,2700,41810,1946,2010,1379,32.8,530,897,53,65,133,1531,358
2020,36047054200,"Census Tract 542, Kings County, New York",1672,132,1540,1179,2707,36475,1959,2011,1416,35.3,588,956,44,54,110,1540,401
2012,36047054300,"Census Tract 543, Kings County, New York",143,11,132,132,260,67000,1949,2007,2001,37.2,70,67,38,0,20,132,19
2013,36047054300,"Census Tract 543, Kings County, New York",124,11,113,113,220,77396,1941,2011,2001,34,70,76,26,6,0,113,13
2014,36047054300,"Census Tract 543, Kings County, New York",176,11,165,165,347,81583,1939,2011,2001,31.4,98,85,38,5,18,165,13
2015,36047054300,"Census Tract 543, Kings County, New York",191,23,168,168,382,92500,1939,2012,2331,26.5,112,89,38,5,18,168,12
2016,36047054300,"Census Tract 543, Kings County, New York",178,25,153,147,335,120625,1939,2013,2583,23.3,106,84,15,6,20,153,0
2017,36047054300,"Census Tract 543, Kings County, New York",176,26,150,136,306,126500,1939,2012,2651,22.3,103,80,11,5,22,150,0
2018,36047054300,"Census Tract 543, Kings County, New York",222,25,197,183,366,116033,0,2013,2842,26.5,104,68,51,5,40,197,17
2019,36047054300,"Census Tract 543, Kings County, New York",188,41,147,137,254,116875,0,2015,2972,29,84,68,38,5,21,147,21
2020,36047054300,"Census Tract 543, Kings County, New York",0,0,0,0,0,NA,NA,NA,NA,NA,0,0,0,0,0,0,0
2012,36047054400,"Census Tract 544, Kings County, New York",1303,87,1216,623,1148,30152,1941,2002,1040,35.8,309,554,0,59,0,1216,187
2013,36047054400,"Census Tract 544, Kings County, New York",1281,78,1203,693,1212,30432,1941,2002,1127,36.5,309,625,0,55,0,1203,228
2014,36047054400,"Census Tract 544, Kings County, New York",1318,100,1218,772,1587,22031,1940,2002,1235,38.1,303,696,0,62,0,1218,330
2015,36047054400,"Census Tract 544, Kings County, New York",1344,127,1217,779,1648,23352,1941,2002,1237,37.8,350,742,0,21,16,1217,351
2016,36047054400,"Census Tract 544, Kings County, New York",1344,152,1192,797,2057,22933,1941,2002,1233,50,307,685,0,52,60,1192,390
2017,36047054400,"Census Tract 544, Kings County, New York",1365,125,1240,797,2139,31438,1943,2003,1288,49.2,317,642,0,73,82,1240,372
2018,36047054400,"Census Tract 544, Kings County, New York",1371,130,1241,761,2450,37371,1945,2007,1246,43.9,264,531,0,135,95,1241,331
2019,36047054400,"Census Tract 544, Kings County, New York",1363,137,1226,678,1979,47045,1951,2009,1257,34.5,285,492,0,80,106,1226,244
2020,36047054400,"Census Tract 544, Kings County, New York",1319,73,1246,731,2144,46806,1951,2011,1496,38.2,400,564,0,87,79,1246,198
2012,36047054500,"Census Tract 545, Kings County, New York",2458,123,2335,2240,6639,15740,1967,2000,354,27.5,263,1097,307,0,794,2335,1256
2013,36047054500,"Census Tract 545, Kings County, New York",2425,91,2334,2249,6172,13935,1970,1999,359,28.7,208,1118,365,0,768,2334,1421
2014,36047054500,"Census Tract 545, Kings County, New York",2433,60,2373,2243,6351,14770,1969,1997,394,29.5,194,1046,384,0,872,2373,1339
2015,36047054500,"Census Tract 545, Kings County, New York",2419,98,2321,2157,6436,NA,1969,1997,406,29.6,163,1111,388,0,723,2321,1185
2016,36047054500,"Census Tract 545, Kings County, New York",2416,34,2382,2199,7251,17012,1970,1998,440,29.4,118,1154,437,0,694,2382,1153
2017,36047054500,"Census Tract 545, Kings County, New York",2407,36,2371,2195,7422,18273,1970,1996,482,29.5,193,1092,471,0,735,2371,1097
2018,36047054500,"Census Tract 545, Kings County, New York",2434,38,2396,2209,7698,19330,1969,1996,517,31.3,98,1054,501,29,705,2396,1066
2019,36047054500,"Census Tract 545, Kings County, New York",2425,43,2382,2228,7383,23008,1970,1998,491,28.5,213,1155,428,18,681,2382,1026
2020,36047054500,"Census Tract 545, Kings County, New York",2443,0,2443,2348,7774,25492,1970,2002,481,26.8,357,1151,392,21,761,2443,1101
2012,36047054600,"Census Tract 546, Kings County, New York",1984,153,1831,1518,3124,25824,1941,2002,1118,41.3,583,1304,21,91,91,1831,562
2013,36047054600,"Census Tract 546, Kings County, New York",2017,160,1857,1543,3357,30964,1943,2003,1131,35.3,623,1361,12,71,86,1857,445
2014,36047054600,"Census Tract 546, Kings County, New York",2014,166,1848,1529,3265,31369,1942,2004,1167,37.5,553,1292,59,86,99,1848,460
2015,36047054600,"Census Tract 546, Kings County, New York",1999,123,1876,1564,3322,27125,1944,2005,1240,41.9,611,1284,71,80,146,1876,570
2016,36047054600,"Census Tract 546, Kings County, New York",1975,160,1815,1545,3456,30675,1945,2006,1252,34.8,624,1247,88,91,126,1815,523
2017,36047054600,"Census Tract 546, Kings County, New York",1971,125,1846,1543,3745,37314,1946,2007,1303,34.5,685,1274,89,69,96,1846,469
2018,36047054600,"Census Tract 546, Kings County, New York",1954,133,1821,1512,3568,39844,1944,2007,1357,37.6,708,1236,102,73,71,1821,436
2019,36047054600,"Census Tract 546, Kings County, New York",2003,114,1889,1578,3730,34808,1946,2008,1411,35.7,804,1293,66,76,71,1889,572
2020,36047054600,"Census Tract 546, Kings County, New York",1984,129,1855,1527,3697,37736,1946,2012,1474,38.6,764,1143,106,116,68,1855,491
2012,36047054700,"Census Tract 547, Kings County, New York",1564,100,1464,1182,4277,27303,1962,2003,979,37.8,386,764,94,0,323,1464,494
2013,36047054700,"Census Tract 547, Kings County, New York",1626,109,1517,1243,4144,32917,1948,2003,1084,33.1,350,721,98,0,437,1517,531
2014,36047054700,"Census Tract 547, Kings County, New York",1662,160,1502,1271,4219,34648,1964,2005,1240,35.6,420,805,83,43,341,1502,549
2015,36047054700,"Census Tract 547, Kings County, New York",1676,104,1572,1408,4478,38818,1968,2007,1464,34.2,536,915,74,58,365,1572,500
2016,36047054700,"Census Tract 547, Kings County, New York",1684,85,1599,1450,4643,36968,1971,2008,1439,34.5,492,948,92,75,350,1599,457
2017,36047054700,"Census Tract 547, Kings County, New York",1709,158,1551,1361,4272,34292,1984,2008,1406,35.5,464,835,120,73,358,1551,512
2018,36047054700,"Census Tract 547, Kings County, New York",1765,132,1633,1383,4570,36782,1992,2009,1642,38.7,489,929,106,73,301,1633,469
2019,36047054700,"Census Tract 547, Kings County, New York",1910,183,1727,1456,4750,42380,1994,2011,1697,36.8,545,973,98,52,317,1727,412
2020,36047054700,"Census Tract 547, Kings County, New York",2019,191,1828,1507,4703,58990,1995,2013,1586,34.7,554,1011,139,21,252,1828,376
2012,36047054800,"Census Tract 548, Kings County, New York",788,17,771,384,893,21133,1939,2003,1084,48.6,147,323,10,33,18,771,118
2013,36047054800,"Census Tract 548, Kings County, New York",788,42,746,350,956,28542,1939,2003,1160,34.6,140,287,8,31,24,746,117
2014,36047054800,"Census Tract 548, Kings County, New York",794,34,760,325,839,43250,1939,2002,1198,34.7,149,274,11,13,27,760,90
2015,36047054800,"Census Tract 548, Kings County, New York",799,31,768,293,752,30208,1939,2001,1240,50,125,246,14,29,4,768,96
2016,36047054800,"Census Tract 548, Kings County, New York",778,30,748,311,719,37383,1939,2004,1269,40.8,187,238,12,16,0,748,75
2017,36047054800,"Census Tract 548, Kings County, New York",797,58,739,290,642,38333,1939,2004,1355,50,192,222,5,15,7,739,88
2018,36047054800,"Census Tract 548, Kings County, New York",807,42,765,347,632,36953,0,2006,1465,51,235,259,6,16,24,765,119
2019,36047054800,"Census Tract 548, Kings County, New York",807,71,736,367,778,38068,0,2009,1553,51,241,268,0,14,25,736,130
2020,36047054800,"Census Tract 548, Kings County, New York",838,87,751,439,1001,73542,0,2012,1713,31.6,304,365,6,0,27,751,156
2012,36047054900,"Census Tract 549, Kings County, New York",1210,90,1120,924,2653,58056,1951,2005,2001,34.2,502,598,37,67,194,1120,245
2013,36047054900,"Census Tract 549, Kings County, New York",1297,72,1225,1006,2885,53676,1939,2007,2001,34.4,468,637,33,65,246,1225,343
2014,36047054900,"Census Tract 549, Kings County, New York",1322,79,1243,988,2605,60405,1945,2009,2001,44.3,453,681,39,45,195,1243,261
2015,36047054900,"Census Tract 549, Kings County, New York",1463,113,1350,1058,2822,67826,1948,2010,2269,32.8,510,731,38,66,188,1350,280
2016,36047054900,"Census Tract 549, Kings County, New York",1558,102,1456,1157,2802,97528,1965,2011,2376,28.2,632,773,44,69,241,1456,254
2017,36047054900,"Census Tract 549, Kings County, New York",1650,137,1513,1235,2902,88884,1947,2011,2512,31.4,657,784,23,77,317,1513,236
2018,36047054900,"Census Tract 549, Kings County, New York",1773,154,1619,1306,2990,99231,2000,2012,3000,28.1,776,814,27,99,334,1619,173
2019,36047054900,"Census Tract 549, Kings County, New York",1871,151,1720,1426,3263,105690,2006,2014,3133,30.8,932,881,31,94,375,1720,205
2020,36047054900,"Census Tract 549, Kings County, New York",1849,136,1713,1493,3677,129531,2008,2015,3178,27,971,899,40,101,410,1713,172
2012,36047055000,"Census Tract 550, Kings County, New York",1539,73,1466,1179,2743,33317,1939,2004,1026,36.7,404,943,25,108,95,1466,389
2013,36047055000,"Census Tract 550, Kings County, New York",1560,76,1484,1163,2892,35149,1939,2005,1102,36,400,904,19,69,151,1484,302
2014,36047055000,"Census Tract 550, Kings County, New York",1549,122,1427,1157,2816,40270,1939,2007,1187,35.9,463,912,27,94,95,1427,299
2015,36047055000,"Census Tract 550, Kings County, New York",1551,86,1465,1158,2867,36124,1939,2008,1156,37,484,947,11,56,115,1465,364
2016,36047055000,"Census Tract 550, Kings County, New York",1530,112,1418,1098,2785,43478,1939,2008,1235,34,469,836,16,76,147,1418,276
2017,36047055000,"Census Tract 550, Kings County, New York",1496,101,1395,1071,2640,58883,1939,2009,1256,28.7,533,811,14,74,138,1395,214
2018,36047055000,"Census Tract 550, Kings County, New York",1508,125,1383,1047,2333,58736,0,2010,1331,31.1,545,819,52,63,109,1383,246
2019,36047055000,"Census Tract 550, Kings County, New York",1522,98,1424,1052,2275,57930,0,2011,1383,32.2,469,825,49,65,125,1424,254
2020,36047055000,"Census Tract 550, Kings County, New York",1431,79,1352,973,2006,55662,0,2013,1370,32.5,435,722,56,69,148,1352,272
2012,36047055100,"Census Tract 551, Kings County, New York",2224,86,2138,1901,4078,53699,1939,2004,1158,28.6,857,845,148,123,845,2138,560
2013,36047055100,"Census Tract 551, Kings County, New York",2267,64,2203,1955,4578,61112,1939,2005,1153,23.7,916,801,92,85,997,2203,465
2014,36047055100,"Census Tract 551, Kings County, New York",2358,94,2264,1999,4802,61045,1939,2006,1202,26.4,924,833,144,55,1020,2264,382
2015,36047055100,"Census Tract 551, Kings County, New York",2400,72,2328,1945,5185,62266,1939,2006,1205,24.5,921,811,181,70,988,2328,350
2016,36047055100,"Census Tract 551, Kings County, New York",2428,131,2297,1910,4898,63929,1939,2009,1329,27.6,1016,816,176,61,966,2297,295
2017,36047055100,"Census Tract 551, Kings County, New York",2408,143,2265,1815,4667,61875,1939,2010,1420,28,1111,829,161,40,875,2265,201
2018,36047055100,"Census Tract 551, Kings County, New York",2509,231,2278,1868,4192,53856,0,2008,1522,33.3,991,771,257,43,958,2278,239
2019,36047055100,"Census Tract 551, Kings County, New York",2551,230,2321,1767,4005,80712,0,2011,1768,28.8,1006,864,153,88,774,2321,245
2020,36047055100,"Census Tract 551, Kings County, New York",2572,303,2269,1848,3902,88365,1953,2015,2191,30.7,1051,887,214,92,671,2269,268
2012,36047055200,"Census Tract 552, Kings County, New York",1471,54,1417,1070,2143,41719,1939,2003,1107,28.8,430,882,23,101,44,1417,244
2013,36047055200,"Census Tract 552, Kings County, New York",1459,72,1387,1069,2273,37650,1939,2004,1133,31.7,431,845,10,154,51,1387,263
2014,36047055200,"Census Tract 552, Kings County, New York",1481,70,1411,1077,2296,38020,1943,2004,1140,31.5,463,820,18,196,42,1411,324
2015,36047055200,"Census Tract 552, Kings County, New York",1479,100,1379,1032,2264,38125,1941,2004,1174,33.4,447,822,10,155,45,1379,287
2016,36047055200,"Census Tract 552, Kings County, New York",1465,111,1354,915,1961,29309,1939,2005,1206,35.8,371,717,10,148,10,1354,360
2017,36047055200,"Census Tract 552, Kings County, New York",1512,93,1419,925,2015,41549,1941,2006,1324,35.8,354,710,11,152,38,1419,277
2018,36047055200,"Census Tract 552, Kings County, New York",1528,80,1448,943,1998,47899,1941,2007,1387,33.9,391,745,13,87,52,1448,235
2019,36047055200,"Census Tract 552, Kings County, New York",1500,101,1399,914,2109,54286,1942,2011,1489,24.5,334,733,0,73,48,1399,147
2020,36047055200,"Census Tract 552, Kings County, New York",1556,101,1455,1021,2130,52614,1944,2006,1373,25.6,421,845,0,70,50,1455,256
2012,36047055300,"Census Tract 553, Kings County, New York",1383,210,1173,988,1973,52292,1939,2005,1561,31,573,767,32,42,156,1173,171
2013,36047055300,"Census Tract 553, Kings County, New York",1434,196,1238,978,1975,63500,1939,2007,1802,30.4,644,768,24,44,142,1238,145
2014,36047055300,"Census Tract 553, Kings County, New York",1504,188,1316,1053,1987,61779,1941,2009,1830,30.8,694,749,11,45,214,1316,148
2015,36047055300,"Census Tract 553, Kings County, New York",1509,79,1430,1126,2133,75000,1939,2010,1929,30,805,779,0,53,256,1430,174
2016,36047055300,"Census Tract 553, Kings County, New York",1538,110,1428,1089,1959,91250,1939,2011,2082,27.9,835,765,0,55,237,1428,182
2017,36047055300,"Census Tract 553, Kings County, New York",1559,152,1407,1055,1882,94208,1939,2012,2196,27.8,814,725,20,46,253,1407,220
2018,36047055300,"Census Tract 553, Kings County, New York",1684,202,1482,1174,2216,97151,0,2013,2434,25.9,975,805,25,65,272,1482,156
2019,36047055300,"Census Tract 553, Kings County, New York",1614,213,1401,1014,1908,122361,0,2015,2423,23.8,831,806,23,16,182,1401,184
2020,36047055300,"Census Tract 553, Kings County, New York",1581,220,1361,1014,2186,115000,1940,2015,2230,24.9,752,743,31,23,241,1361,236
2012,36047055400,"Census Tract 554, Kings County, New York",1642,134,1508,1251,2530,35071,1944,2003,1173,36.4,472,1142,11,43,39,1508,293
2013,36047055400,"Census Tract 554, Kings County, New York",1667,139,1528,1360,3074,44500,1945,2004,1219,31.6,529,1191,18,27,105,1528,282
2014,36047055400,"Census Tract 554, Kings County, New York",1690,179,1511,1323,3086,46827,1947,2005,1283,31.4,563,1173,17,28,79,1511,267
2015,36047055400,"Census Tract 554, Kings County, New York",1714,179,1535,1305,3283,NA,1948,2007,1301,29.7,620,1081,14,50,83,1535,326
2016,36047055400,"Census Tract 554, Kings County, New York",1711,125,1586,1357,3302,52104,1948,2008,1318,29,692,1140,19,77,66,1586,378
2017,36047055400,"Census Tract 554, Kings County, New York",1774,149,1625,1401,3768,50060,1943,2009,1362,31.1,712,1138,7,102,97,1625,364
2018,36047055400,"Census Tract 554, Kings County, New York",1791,174,1617,1416,3833,45912,1941,2011,1440,34.5,693,1125,0,123,100,1617,406
2019,36047055400,"Census Tract 554, Kings County, New York",1811,168,1643,1449,3786,45037,0,2011,1489,35.4,757,1141,10,132,106,1643,362
2020,36047055400,"Census Tract 554, Kings County, New York",1781,149,1632,1422,3525,50000,1943,2012,1520,35.5,846,1175,20,125,75,1632,216
2012,36047055500,"Census Tract 555, Kings County, New York",1833,379,1454,1075,2129,70625,1958,2011,1939,28,740,711,81,57,257,1454,189
2013,36047055500,"Census Tract 555, Kings County, New York",2241,386,1855,1379,2936,81607,1983,2011,1997,27.5,927,921,98,73,333,1855,207
2014,36047055500,"Census Tract 555, Kings County, New York",2708,422,2286,1660,3417,92500,1998,2011,2001,27.4,1093,1079,98,109,390,2286,210
2015,36047055500,"Census Tract 555, Kings County, New York",2975,401,2574,1900,3790,90694,2002,NA,2387,28.6,1272,1245,96,152,411,2574,277
2016,36047055500,"Census Tract 555, Kings County, New York",3193,434,2759,2012,4043,100948,2003,NA,2304,28.1,1367,1390,84,161,377,2759,241
2017,36047055500,"Census Tract 555, Kings County, New York",3529,415,3114,2257,4569,112440,2004,2013,2493,25.7,1573,1607,98,199,333,3114,225
2018,36047055500,"Census Tract 555, Kings County, New York",3708,435,3273,2353,4694,121705,2005,2013,2626,25.2,1692,1647,113,227,338,3273,241
2019,36047055500,"Census Tract 555, Kings County, New York",4203,423,3780,2704,5317,136118,2008,NA,3033,25.4,2075,1917,111,273,406,3780,322
2020,36047055500,"Census Tract 555, Kings County, New York",4584,445,4139,3006,5966,151184,2009,2017,3342,23.8,2320,1890,92,284,675,4139,394
2012,36047055600,"Census Tract 556, Kings County, New York",1403,118,1285,793,1945,36841,1950,2004,1135,39.1,286,723,0,17,53,1285,189
2013,36047055600,"Census Tract 556, Kings County, New York",1427,119,1308,789,1777,37873,1953,2005,1142,40.1,321,702,0,36,51,1308,180
2014,36047055600,"Census Tract 556, Kings County, New York",1402,81,1321,800,2088,37866,1950,2006,1226,41.5,336,728,0,51,21,1321,171
2015,36047055600,"Census Tract 556, Kings County, New York",1373,122,1251,800,2100,39699,1948,2008,1334,40.2,337,691,0,81,28,1251,143
2016,36047055600,"Census Tract 556, Kings County, New York",1393,124,1269,723,1795,43698,1950,2010,1323,33.4,368,603,0,62,28,1269,166
2017,36047055600,"Census Tract 556, Kings County, New York",1411,148,1263,693,1776,45792,1948,2010,1388,34,350,583,0,59,17,1263,131
2018,36047055600,"Census Tract 556, Kings County, New York",1425,164,1261,769,1854,45597,1944,2011,1485,35.8,328,619,0,84,43,1261,225
2019,36047055600,"Census Tract 556, Kings County, New York",1417,168,1249,801,1782,48917,1945,2012,1503,36,329,662,0,72,43,1249,248
2020,36047055600,"Census Tract 556, Kings County, New York",1395,117,1278,794,1821,47417,1951,2009,1632,38.5,386,612,0,100,40,1278,289
2012,36047055700,"Census Tract 557, Kings County, New York",934,116,818,625,1098,56076,1939,2006,1957,30.3,459,467,0,55,78,818,78
2013,36047055700,"Census Tract 557, Kings County, New York",1100,105,995,791,1476,82969,1939,2007,1776,24.9,587,609,11,65,117,995,113
2014,36047055700,"Census Tract 557, Kings County, New York",1193,94,1099,885,1670,85221,1939,2010,1726,24,650,674,27,62,133,1099,134
2015,36047055700,"Census Tract 557, Kings County, New York",1254,70,1184,935,1870,98365,1957,2011,1862,23.1,697,681,32,60,167,1184,153
2016,36047055700,"Census Tract 557, Kings County, New York",1257,50,1207,939,1989,87350,1957,2011,2070,22.7,677,664,29,77,171,1207,180
2017,36047055700,"Census Tract 557, Kings County, New York",1081,32,1049,897,1955,87176,1947,2011,2224,23,667,631,32,55,182,1049,176
2018,36047055700,"Census Tract 557, Kings County, New York",1050,74,976,830,1639,86702,1947,2012,2551,25.6,638,550,29,65,169,976,179
2019,36047055700,"Census Tract 557, Kings County, New York",1017,80,937,788,1682,92083,0,2014,2664,26.1,568,517,7,77,172,937,169
2020,36047055700,"Census Tract 557, Kings County, New York",981,86,895,794,1414,100833,1942,2015,2868,32,666,461,15,63,232,895,105
2012,36047055800,"Census Tract 558, Kings County, New York",948,66,882,559,1340,37625,1939,1999,1101,33.4,201,408,0,69,82,882,89
2013,36047055800,"Census Tract 558, Kings County, New York",977,89,888,539,1320,52031,1939,2000,1119,28.1,176,426,0,60,53,888,113
2014,36047055800,"Census Tract 558, Kings County, New York",988,93,895,578,1448,39167,1939,2001,1154,32.3,178,453,0,60,65,895,138
2015,36047055800,"Census Tract 558, Kings County, New York",1004,125,879,574,1373,34524,1939,2002,1140,34.1,203,441,0,66,67,879,169
2016,36047055800,"Census Tract 558, Kings County, New York",977,88,889,584,1412,33625,1939,2003,1134,38.4,235,503,0,13,61,889,163
2017,36047055800,"Census Tract 558, Kings County, New York",972,87,885,574,1365,43333,1939,2004,1136,31.6,257,516,0,9,43,885,179
2018,36047055800,"Census Tract 558, Kings County, New York",974,66,908,604,1428,46768,0,2007,1203,32.1,280,495,6,39,65,908,170
2019,36047055800,"Census Tract 558, Kings County, New York",1002,113,889,597,1510,64671,0,2007,1240,23.1,313,433,12,69,70,889,136
2020,36047055800,"Census Tract 558, Kings County, New York",1047,87,960,623,1465,61813,0,2004,1197,24.8,274,458,20,73,68,960,217
2012,36047056000,"Census Tract 560, Kings County, New York",1478,95,1383,1075,2159,33882,1943,2002,1180,35.8,374,1018,0,26,31,1383,383
2013,36047056000,"Census Tract 560, Kings County, New York",1514,133,1381,1031,2048,40032,1942,2003,1196,34.1,374,974,0,18,39,1381,328
2014,36047056000,"Census Tract 560, Kings County, New York",1519,93,1426,1014,2123,37917,1940,2003,1263,34.3,399,858,33,55,68,1426,316
2015,36047056000,"Census Tract 560, Kings County, New York",1504,71,1433,969,2077,36823,1939,2007,1260,37.2,485,842,26,57,44,1433,270
2016,36047056000,"Census Tract 560, Kings County, New York",1484,103,1381,888,2070,50700,1939,2008,1369,33.8,482,797,27,37,27,1381,183
2017,36047056000,"Census Tract 560, Kings County, New York",1496,97,1399,900,2010,36196,1939,2010,1390,39.5,400,789,45,36,19,1399,184
2018,36047056000,"Census Tract 560, Kings County, New York",1472,80,1392,860,1914,35735,0,2010,1475,38,352,751,41,40,19,1392,217
2019,36047056000,"Census Tract 560, Kings County, New York",1478,106,1372,840,1880,36357,0,2010,1550,41.8,331,776,15,25,13,1372,196
2020,36047056000,"Census Tract 560, Kings County, New York",1534,121,1413,818,1645,33920,0,2008,1566,35,323,685,14,26,86,1413,277
2012,36047056100,"Census Tract 561, Kings County, New York",1639,130,1509,1227,2303,61705,1939,2003,1383,26.2,649,1018,0,77,114,1509,211
2013,36047056100,"Census Tract 561, Kings County, New York",1633,130,1503,1292,2471,70667,1939,2004,1459,25.1,742,1083,0,97,93,1503,209
2014,36047056100,"Census Tract 561, Kings County, New York",1615,131,1484,1241,2379,74526,1939,2005,1569,26.1,770,969,36,84,133,1484,208
2015,36047056100,"Census Tract 561, Kings County, New York",1586,108,1478,1216,2424,78850,1939,2006,1658,26.4,810,930,52,78,147,1478,180
2016,36047056100,"Census Tract 561, Kings County, New York",1623,101,1522,1260,2599,78000,1939,2007,1720,27.5,832,915,85,83,177,1522,153
2017,36047056100,"Census Tract 561, Kings County, New York",1648,57,1591,1364,2828,83417,1939,2008,1768,26.2,926,1005,97,75,177,1591,130
2018,36047056100,"Census Tract 561, Kings County, New York",1702,93,1609,1315,2652,95039,0,2011,2034,25.6,915,955,90,69,180,1609,80
2019,36047056100,"Census Tract 561, Kings County, New York",1732,104,1628,1337,2802,103719,0,2011,2093,23.2,917,996,60,115,117,1628,134
2020,36047056100,"Census Tract 561, Kings County, New York",1753,111,1642,1358,2835,121154,0,2015,2361,23.4,963,940,27,107,163,1642,66
2012,36047056200,"Census Tract 562, Kings County, New York",601,33,568,42,160,23889,1939,2011,2001,50,4,42,0,0,0,568,53
2013,36047056200,"Census Tract 562, Kings County, New York",615,35,580,42,174,23879,1939,2011,2001,50,3,42,0,0,0,580,48
2014,36047056200,"Census Tract 562, Kings County, New York",607,35,572,54,184,26759,1939,2011,2001,50,9,54,0,0,0,572,63
2015,36047056200,"Census Tract 562, Kings County, New York",604,57,547,24,44,66250,1942,2008,2200,47,9,24,0,0,0,547,50
2016,36047056200,"Census Tract 562, Kings County, New York",612,37,575,18,36,73333,1939,2006,2200,43.1,5,18,0,0,0,575,64
2017,36047056200,"Census Tract 562, Kings County, New York",596,32,564,29,57,51528,1976,2016,NA,14.8,14,20,0,9,0,564,64
2018,36047056200,"Census Tract 562, Kings County, New York",575,29,546,20,41,NA,1977,2009,NA,36.3,8,16,0,4,0,546,37
2019,36047056200,"Census Tract 562, Kings County, New York",608,85,523,11,28,NA,NA,NA,NA,NA,5,6,0,5,0,523,31
2020,36047056200,"Census Tract 562, Kings County, New York",594,60,534,59,190,111250,0,2020,3211,32.1,55,55,0,4,0,534,19
2012,36047056300,"Census Tract 563, Kings County, New York",2128,172,1956,1679,3308,49712,1939,2004,1290,29.9,869,968,111,152,343,1956,434
2013,36047056300,"Census Tract 563, Kings County, New York",2160,115,2045,1777,3598,45757,1939,2004,1271,33.5,851,1038,102,183,397,2045,555
2014,36047056300,"Census Tract 563, Kings County, New York",2160,121,2039,1806,3578,45721,1939,2004,1322,33.2,938,1073,102,169,375,2039,572
2015,36047056300,"Census Tract 563, Kings County, New York",2180,110,2070,1817,3798,64926,1939,2006,1448,30.3,1007,1261,40,143,261,2070,544
2016,36047056300,"Census Tract 563, Kings County, New York",2189,112,2077,1771,3818,63456,1939,2007,1680,31,1048,1282,0,145,263,2077,503
2017,36047056300,"Census Tract 563, Kings County, New York",2313,63,2250,2013,4266,69033,1939,2009,1863,32.6,1161,1362,54,119,394,2250,544
2018,36047056300,"Census Tract 563, Kings County, New York",2364,141,2223,2000,4211,76935,0,2011,2019,28.3,1110,1259,102,117,472,2223,450
2019,36047056300,"Census Tract 563, Kings County, New York",2486,158,2328,2096,4401,79207,0,2013,2027,25.5,1143,1295,144,139,505,2328,445
2020,36047056301,"Census Tract 563.01, Kings County, New York",1949,195,1754,1523,3069,96973,0,2013,2024,27.1,854,1043,25,115,347,1754,360
2020,36047056302,"Census Tract 563.02, Kings County, New York",716,0,716,716,1513,60109,18,2016,1492,28.2,321,276,114,84,242,716,165
2012,36047056400,"Census Tract 564, Kings County, New York",1088,149,939,182,343,46071,1953,2003,866,23.8,55,123,0,31,28,939,54
2013,36047056400,"Census Tract 564, Kings County, New York",1104,115,989,226,494,51071,1953,2002,992,23.2,106,164,0,30,32,989,43
2014,36047056400,"Census Tract 564, Kings County, New York",1111,116,995,217,477,50489,1954,2000,981,23.7,89,164,0,24,29,995,34
2015,36047056400,"Census Tract 564, Kings County, New York",1102,144,958,176,387,48889,1956,1992,1000,24.7,80,143,0,20,13,958,34
2016,36047056400,"Census Tract 564, Kings County, New York",1087,138,949,187,517,85179,1952,2000,1529,17.9,75,177,0,0,10,949,61
2017,36047056400,"Census Tract 564, Kings County, New York",1096,123,973,196,541,70893,1952,2002,1357,18.2,61,187,0,0,9,973,56
2018,36047056400,"Census Tract 564, Kings County, New York",1062,103,959,188,469,62500,1950,2003,1146,21,31,178,0,0,10,959,77
2019,36047056400,"Census Tract 564, Kings County, New York",1035,85,950,198,527,71471,1951,2008,1250,23.7,34,187,0,0,11,950,93
2020,36047056400,"Census Tract 564, Kings County, New York",1059,100,959,181,528,51806,1948,2009,1595,26.5,27,153,0,0,28,959,84
2012,36047056500,"Census Tract 565, Kings County, New York",1792,235,1557,1287,2373,60063,1939,2004,1348,30.3,748,913,16,58,242,1557,147
2013,36047056500,"Census Tract 565, Kings County, New York",1794,208,1586,1278,2339,63177,1939,2005,1442,28.4,735,973,24,69,157,1586,178
2014,36047056500,"Census Tract 565, Kings County, New York",1848,145,1703,1308,2368,66650,1939,2006,1538,27.4,755,965,21,75,195,1703,152
2015,36047056500,"Census Tract 565, Kings County, New York",1729,156,1573,1227,2189,67471,1939,2010,1630,27.4,738,920,0,77,169,1573,170
2016,36047056500,"Census Tract 565, Kings County, New York",1712,114,1598,1243,2114,81895,1939,2011,1797,26,848,911,0,95,186,1598,177
2017,36047056500,"Census Tract 565, Kings County, New York",1714,159,1555,1301,2338,89764,1939,2011,1826,24.6,799,973,0,95,184,1555,174
2018,36047056500,"Census Tract 565, Kings County, New York",1735,215,1520,1274,2283,95417,0,2012,1886,25.2,833,911,0,68,257,1520,153
2019,36047056500,"Census Tract 565, Kings County, New York",1764,182,1582,1345,2429,96036,0,2013,1994,25.1,838,979,0,66,253,1582,139
2020,36047056500,"Census Tract 565, Kings County, New York",1988,237,1751,1509,2565,101977,0,2014,2190,25.1,1050,1186,0,94,212,1751,184
2012,36047056600,"Census Tract 566, Kings County, New York",1095,17,1078,565,1321,55212,1964,2001,1262,26.8,308,363,62,46,94,1078,84
2013,36047056600,"Census Tract 566, Kings County, New York",1098,16,1082,524,1000,41667,1964,2001,1208,29.3,297,378,27,34,85,1082,168
2014,36047056600,"Census Tract 566, Kings County, New York",1098,31,1067,480,1023,39400,1963,2002,1203,30.7,215,325,53,32,75,1067,165
2015,36047056600,"Census Tract 566, Kings County, New York",1073,40,1033,537,1145,48750,1962,2003,1255,31.5,258,352,75,48,68,1033,136
2016,36047056600,"Census Tract 566, Kings County, New York",1059,54,1005,536,1163,51105,1962,2006,1378,32.1,273,346,96,29,46,1005,134
2017,36047056600,"Census Tract 566, Kings County, New York",1068,71,997,548,1166,53214,1962,2008,1412,30.6,272,356,94,38,42,997,122
2018,36047056600,"Census Tract 566, Kings County, New York",1075,79,996,576,1442,58226,1962,2009,1566,28.8,274,313,112,46,68,996,86
2019,36047056600,"Census Tract 566, Kings County, New York",1085,98,987,589,1394,61103,1962,2009,1531,27.7,282,349,109,36,49,987,60
2020,36047056600,"Census Tract 566, Kings County, New York",1120,106,1014,600,1396,55500,1964,2008,1577,29.1,213,311,107,91,49,1014,123
2012,36047056800,"Census Tract 568, Kings County, New York",579,20,559,124,175,81977,1939,2004,1178,17.4,89,117,0,7,0,559,20
2013,36047056800,"Census Tract 568, Kings County, New York",590,45,545,153,231,81192,1939,2003,1192,19.2,102,138,0,15,0,545,31
2014,36047056800,"Census Tract 568, Kings County, New York",594,37,557,179,411,82943,1939,2006,1268,20.4,75,129,0,24,26,557,56
2015,36047056800,"Census Tract 568, Kings County, New York",578,34,544,174,387,82554,1939,2007,1282,21.9,71,129,0,21,24,544,56
2016,36047056800,"Census Tract 568, Kings County, New York",578,33,545,134,308,75125,1939,2010,1366,29.2,33,79,0,16,39,545,56
2017,36047056800,"Census Tract 568, Kings County, New York",579,32,547,105,253,70221,1943,2013,1353,24.7,28,60,0,10,35,547,57
2018,36047056800,"Census Tract 568, Kings County, New York",577,15,562,161,490,70580,0,2012,1442,26.4,56,97,0,7,42,562,75
2019,36047056800,"Census Tract 568, Kings County, New York",587,34,553,143,363,73208,0,2012,1391,26.1,61,96,0,13,20,553,44
2020,36047056800,"Census Tract 568, Kings County, New York",619,77,542,155,447,48894,0,2013,1357,36,62,81,0,38,21,542,56
2012,36047056900,"Census Tract 569, Kings County, New York",777,98,679,552,1202,71818,1939,2003,1553,24.8,319,454,0,31,57,679,21
2013,36047056900,"Census Tract 569, Kings County, New York",784,115,669,541,1201,91042,1939,2004,1684,22.7,319,429,0,38,62,669,18
2014,36047056900,"Census Tract 569, Kings County, New York",824,110,714,549,1127,71477,1939,2005,1584,27,305,436,16,14,68,714,47
2015,36047056900,"Census Tract 569, Kings County, New York",811,79,732,581,1133,70117,1939,2009,1714,27.7,370,482,10,29,44,732,75
2016,36047056900,"Census Tract 569, Kings County, New York",821,56,765,628,1229,79667,1939,2009,1834,26.9,436,536,13,32,23,765,77
2017,36047056900,"Census Tract 569, Kings County, New York",844,55,789,644,1227,74417,1939,2011,1950,28.4,462,554,13,29,34,789,83
2018,36047056900,"Census Tract 569, Kings County, New York",821,52,769,655,1325,86458,0,2011,2152,26.3,478,538,21,24,31,769,68
2019,36047056900,"Census Tract 569, Kings County, New York",809,48,761,625,1324,116875,0,2012,2261,22.7,476,528,6,26,26,761,56
2020,36047056900,"Census Tract 569, Kings County, New York",820,80,740,570,1164,116667,0,2011,2232,22.7,396,497,6,8,14,740,34
2012,36047057000,"Census Tract 570, Kings County, New York",1483,155,1328,282,551,42500,1956,2003,949,30.2,91,178,13,82,9,1328,85
2013,36047057000,"Census Tract 570, Kings County, New York",1488,93,1395,283,585,45991,1957,2003,1140,28.6,90,167,12,84,6,1395,109
2014,36047057000,"Census Tract 570, Kings County, New York",1475,33,1442,302,603,41154,1956,2002,1096,30.2,99,169,0,97,26,1442,87
2015,36047057000,"Census Tract 570, Kings County, New York",1488,50,1438,264,444,40889,1958,2006,1186,32.6,110,167,0,51,37,1438,88
2016,36047057000,"Census Tract 570, Kings County, New York",1512,49,1463,220,389,40429,1958,2010,1170,33.7,83,153,0,31,28,1463,89
2017,36047057000,"Census Tract 570, Kings County, New York",1529,86,1443,155,253,41563,1961,2007,1109,31.3,66,97,0,21,28,1443,141
2018,36047057000,"Census Tract 570, Kings County, New York",1486,75,1411,128,162,40972,1959,2004,1056,32.5,74,92,0,7,29,1411,118
2019,36047057000,"Census Tract 570, Kings County, New York",1480,66,1414,153,404,47188,1966,2009,1169,49.4,34,80,0,0,73,1414,89
2020,36047057000,"Census Tract 570, Kings County, New York",1604,70,1534,132,363,55000,1962,2007,NA,49.8,38,47,7,12,66,1534,102
2012,36047057100,"Census Tract 571, Kings County, New York",2208,238,1970,1697,3572,72821,1939,2004,1355,26.5,899,1576,16,34,16,1970,204
2013,36047057100,"Census Tract 571, Kings County, New York",2186,233,1953,1628,3375,67206,1939,2004,1584,28,968,1502,16,25,76,1953,205
2014,36047057100,"Census Tract 571, Kings County, New York",2194,296,1898,1504,3081,65985,1939,2005,1634,26.8,876,1418,15,0,70,1898,205
2015,36047057100,"Census Tract 571, Kings County, New York",2154,250,1904,1492,3093,77581,1939,2007,1722,28.8,1004,1374,0,0,78,1904,194
2016,36047057100,"Census Tract 571, Kings County, New York",2155,182,1973,1511,2998,68365,1939,2010,1796,30.7,943,1367,0,0,109,1973,239
2017,36047057100,"Census Tract 571, Kings County, New York",2217,217,2000,1494,2725,71458,1939,2011,1817,30.8,914,1328,0,0,132,2000,272
2018,36047057100,"Census Tract 571, Kings County, New York",2131,319,1812,1359,2696,84236,0,2011,1970,30.1,901,1242,0,0,65,1812,168
2019,36047057100,"Census Tract 571, Kings County, New York",2131,234,1897,1504,2918,86645,0,2012,2094,26.8,988,1320,0,23,97,1897,190
2020,36047057100,"Census Tract 571, Kings County, New York",2069,194,1875,1498,2836,93269,1943,2014,2224,25.4,972,1269,0,21,120,1875,171
2012,36047057200,"Census Tract 572, Kings County, New York",2269,85,2184,2161,4675,13960,1955,1997,432,30.1,211,508,1099,77,528,2184,1169
2013,36047057200,"Census Tract 572, Kings County, New York",2252,114,2138,2114,4578,13130,1955,1998,385,29.6,286,487,1139,61,489,2138,1159
2014,36047057200,"Census Tract 572, Kings County, New York",2282,171,2111,2085,4522,19952,1955,2000,439,27.4,221,339,1337,75,401,2111,855
2015,36047057200,"Census Tract 572, Kings County, New York",2321,147,2174,2158,4938,18576,1953,2001,446,29.6,190,432,1175,118,506,2174,972
2016,36047057200,"Census Tract 572, Kings County, New York",2350,104,2246,2232,5316,18885,1953,2001,390,29.1,217,375,1181,124,613,2246,999
2017,36047057200,"Census Tract 572, Kings County, New York",2368,61,2307,2307,5551,18310,1953,2003,395,30.5,274,399,1176,189,643,2307,1021
2018,36047057200,"Census Tract 572, Kings County, New York",2357,53,2304,2304,5427,23402,1953,2005,496,30.4,252,464,1078,226,662,2304,862
2019,36047057200,"Census Tract 572, Kings County, New York",2392,123,2269,2269,5522,24958,1952,2005,437,29.2,243,387,1150,240,594,2269,844
2020,36047057200,"Census Tract 572, Kings County, New York",2278,152,2126,2126,5222,31232,1952,2005,551,30.4,163,392,1080,264,443,2126,711
2012,36047057300,"Census Tract 573, Kings County, New York",1291,156,1135,799,1520,58098,1939,2004,1239,27,413,586,0,56,120,1135,120
2013,36047057300,"Census Tract 573, Kings County, New York",1246,156,1090,803,1687,56118,1939,2005,1371,30.4,390,644,28,45,65,1090,169
2014,36047057300,"Census Tract 573, Kings County, New York",1212,201,1011,699,1610,60662,1939,2005,1449,28.2,385,586,38,32,43,1011,111
2015,36047057300,"Census Tract 573, Kings County, New York",1192,196,996,660,1551,71458,1939,2010,1732,29.7,399,561,37,36,26,996,137
2016,36047057300,"Census Tract 573, Kings County, New York",1160,153,1007,704,1608,81875,1939,2011,2021,30,415,579,57,40,20,1007,145
2017,36047057300,"Census Tract 573, Kings County, New York",1226,155,1071,815,1907,96080,1939,2011,2037,24.8,462,627,59,55,65,1071,152
2018,36047057300,"Census Tract 573, Kings County, New York",1205,141,1064,803,1732,102880,0,2012,2137,24.2,493,648,35,46,66,1064,91
2019,36047057300,"Census Tract 573, Kings County, New York",1212,120,1092,859,1835,99063,0,2012,2173,24.4,491,693,27,47,76,1092,107
2020,36047057300,"Census Tract 573, Kings County, New York",1324,126,1198,885,1718,84850,0,2012,1996,26.6,533,743,26,45,52,1198,123
2012,36047057400,"Census Tract 574, Kings County, New York",1042,78,964,282,726,66786,1939,2003,1331,21.6,90,142,0,114,26,964,32
2013,36047057400,"Census Tract 574, Kings County, New York",1068,72,996,266,517,85500,1939,2003,1349,19.8,99,165,6,74,21,996,47
2014,36047057400,"Census Tract 574, Kings County, New York",1065,53,1012,278,600,35357,1939,2011,989,26.8,78,145,38,78,17,1012,92
2015,36047057400,"Census Tract 574, Kings County, New York",1027,32,995,278,627,29904,1939,2011,989,30.6,70,139,38,79,22,995,126
2016,36047057400,"Census Tract 574, Kings County, New York",1030,4,1026,295,633,NA,1939,2011,1135,31.4,70,181,38,50,26,1026,109
2017,36047057400,"Census Tract 574, Kings County, New York",1034,16,1018,264,595,36759,1939,2011,1283,37.7,75,162,35,61,6,1018,106
2018,36047057400,"Census Tract 574, Kings County, New York",1030,48,982,279,671,36442,0,2011,1293,48.2,89,139,30,105,5,982,114
2019,36047057400,"Census Tract 574, Kings County, New York",1035,73,962,253,690,NA,0,2011,1558,43.3,89,124,0,113,16,962,121
2020,36047057400,"Census Tract 574, Kings County, New York",1098,70,1028,282,742,44231,0,2012,1286,37.2,89,104,0,161,17,1028,152
2012,36047057500,"Census Tract 575, Kings County, New York",2200,456,1744,1446,2966,60275,1939,2003,1377,29.8,775,1094,0,56,268,1744,325
2013,36047057500,"Census Tract 575, Kings County, New York",2216,401,1815,1461,2929,58750,1939,2003,1553,30.4,809,1113,0,65,239,1815,344
2014,36047057500,"Census Tract 575, Kings County, New York",2167,293,1874,1557,2843,65901,1939,2007,1752,29.7,1039,1257,0,63,190,1874,263
2015,36047057500,"Census Tract 575, Kings County, New York",2185,130,2055,1747,3285,82780,1939,2009,1796,26.1,1184,1408,0,77,226,2055,236
2016,36047057500,"Census Tract 575, Kings County, New York",2138,71,2067,1745,2961,75610,1939,2011,1878,26.6,1101,1487,0,79,168,2067,176
2017,36047057500,"Census Tract 575, Kings County, New York",2112,0,2112,1783,3135,72773,1939,2011,1908,28.5,968,1505,0,46,232,2112,203
2018,36047057500,"Census Tract 575, Kings County, New York",2115,0,2115,1789,2958,73542,0,2012,1924,30.9,1103,1486,0,89,214,2115,274
2019,36047057500,"Census Tract 575, Kings County, New York",2179,0,2179,1843,3225,87151,0,2013,1987,24.8,1203,1524,0,85,234,2179,280
2020,36047057500,"Census Tract 575, Kings County, New York",2177,47,2130,1812,3223,86701,0,2014,1964,24.4,1253,1390,104,76,242,2130,211
2012,36047057600,"Census Tract 576, Kings County, New York",1043,19,1024,490,1475,43333,1941,2006,1270,35.7,187,284,28,159,3,1024,118
2013,36047057600,"Census Tract 576, Kings County, New York",1080,20,1060,480,1419,51250,1940,2007,1288,29.6,185,317,18,118,0,1060,127
2014,36047057600,"Census Tract 576, Kings County, New York",1097,59,1038,478,1371,50446,1942,2008,1291,28.2,229,342,18,80,7,1038,114
2015,36047057600,"Census Tract 576, Kings County, New York",1097,72,1025,465,1400,51115,1940,2008,1313,27.1,231,313,15,83,24,1025,140
2016,36047057600,"Census Tract 576, Kings County, New York",1096,66,1030,483,1445,50213,1942,2009,1416,29.3,204,235,38,131,60,1030,122
2017,36047057600,"Census Tract 576, Kings County, New York",1108,65,1043,463,1379,56042,1939,2009,1617,29.6,158,233,28,146,62,1043,101
2018,36047057600,"Census Tract 576, Kings County, New York",1082,72,1010,480,1357,57000,0,2010,1637,30.3,167,233,34,150,69,1010,118
2019,36047057600,"Census Tract 576, Kings County, New York",1080,74,1006,491,1399,57625,0,2010,1567,31.6,148,226,33,155,72,1006,117
2020,36047057600,"Census Tract 576, Kings County, New York",1097,61,1036,479,1213,61607,0,2011,1647,30.8,159,203,37,179,50,1036,101
2012,36047057800,"Census Tract 578, Kings County, New York",1177,18,1159,640,1546,40565,1944,2001,1040,32.6,115,303,38,224,63,1159,102
2013,36047057800,"Census Tract 578, Kings County, New York",1172,54,1118,655,1587,37063,1947,2001,1094,37.3,141,404,35,168,48,1118,150
2014,36047057800,"Census Tract 578, Kings County, New York",1189,73,1116,759,1854,33657,1947,2003,1144,39.4,211,490,31,156,65,1116,186
2015,36047057800,"Census Tract 578, Kings County, New York",1188,69,1119,814,2159,30938,1944,2004,1216,44.6,209,508,20,168,102,1119,256
2016,36047057800,"Census Tract 578, Kings County, New York",1185,65,1120,784,2169,33333,1944,2006,1264,42,245,520,19,125,96,1120,253
2017,36047057800,"Census Tract 578, Kings County, New York",1172,96,1076,737,2159,40347,1946,2007,1320,38.7,277,520,0,83,108,1076,246
2018,36047057800,"Census Tract 578, Kings County, New York",1162,69,1093,737,2271,44208,1942,2010,1356,37.9,225,449,20,103,132,1093,236
2019,36047057800,"Census Tract 578, Kings County, New York",1151,88,1063,708,2243,43158,1944,2011,1405,39.5,186,388,29,144,118,1063,307
2020,36047057800,"Census Tract 578, Kings County, New York",1210,111,1099,696,1795,50333,1951,2011,1419,33,158,384,30,154,98,1099,301
2012,36047057900,"Census Tract 579, Kings County, New York",467,23,444,406,964,62647,1939,2004,1205,28.3,203,289,0,12,105,444,41
2013,36047057900,"Census Tract 579, Kings County, New York",471,31,440,409,875,57411,1939,2005,1196,29.4,189,280,0,8,121,440,61
2014,36047057900,"Census Tract 579, Kings County, New York",483,43,440,396,733,47411,1939,2007,1366,33.2,177,302,8,5,81,440,91
2015,36047057900,"Census Tract 579, Kings County, New York",521,39,482,466,989,56000,1939,2010,1453,32.3,208,317,10,7,125,482,92
2016,36047057900,"Census Tract 579, Kings County, New York",523,45,478,458,996,60333,1939,2010,1481,33,190,281,12,13,132,478,71
2017,36047057900,"Census Tract 579, Kings County, New York",551,57,494,483,977,52250,1939,2011,1506,33.2,213,290,13,13,145,494,105
2018,36047057900,"Census Tract 579, Kings County, New York",528,50,478,459,934,64911,0,2011,1668,32.9,214,288,14,6,130,478,78
2019,36047057900,"Census Tract 579, Kings County, New York",525,67,458,427,927,92434,0,2012,1899,27,231,275,6,6,117,458,55
2020,36047057901,"Census Tract 579.01, Kings County, New York",545,59,486,442,849,96667,0,2013,2099,26.8,211,316,14,7,89,486,57
2020,36047057902,"Census Tract 579.02, Kings County, New York",0,0,0,0,0,NA,NA,NA,NA,NA,0,0,0,0,0,0,0
2012,36047058000,"Census Tract 580, Kings County, New York",1288,73,1215,921,2141,36356,1951,2002,1098,32.5,304,551,11,199,153,1215,241
2013,36047058000,"Census Tract 580, Kings County, New York",1277,29,1248,945,2291,31685,1949,2003,1090,33.1,308,548,13,239,129,1248,271
2014,36047058000,"Census Tract 580, Kings County, New York",1282,25,1257,921,2320,33665,1947,2005,1195,36.3,339,521,15,221,164,1257,216
2015,36047058000,"Census Tract 580, Kings County, New York",1312,19,1293,874,2119,32458,1948,2007,1215,37.4,347,467,32,227,124,1293,251
2016,36047058000,"Census Tract 580, Kings County, New York",1326,22,1304,943,2300,33179,1945,2009,1292,41.2,370,449,29,268,177,1304,250
2017,36047058000,"Census Tract 580, Kings County, New York",1325,18,1307,988,2887,36486,1939,2010,1420,39.3,380,443,41,278,207,1307,249
2018,36047058000,"Census Tract 580, Kings County, New York",1337,22,1315,934,2530,40268,0,2011,1560,40.7,335,376,86,257,183,1315,260
2019,36047058000,"Census Tract 580, Kings County, New York",1333,27,1306,928,2645,44342,0,2011,1678,38,318,340,105,254,198,1306,273
2020,36047058000,"Census Tract 580, Kings County, New York",1372,70,1302,912,2526,35125,0,2010,1693,40.7,265,477,79,180,167,1302,325
2012,36047058200,"Census Tract 582, Kings County, New York",1042,25,1017,734,1967,31453,1939,2004,1063,34.8,208,409,0,205,101,1017,216
2013,36047058200,"Census Tract 582, Kings County, New York",1041,45,996,706,1873,31806,1939,2004,1096,37.6,206,401,0,189,94,996,274
2014,36047058200,"Census Tract 582, Kings County, New York",1032,61,971,705,1959,33899,1939,2005,1161,37.2,188,447,0,144,93,971,261
2015,36047058200,"Census Tract 582, Kings County, New York",1056,52,1004,658,1775,34551,1939,2007,1285,43.2,204,466,0,96,66,1004,339
2016,36047058200,"Census Tract 582, Kings County, New York",1072,77,995,681,1724,32629,1939,2008,1362,45.4,196,472,27,36,114,995,318
2017,36047058200,"Census Tract 582, Kings County, New York",1072,128,944,732,2025,41389,1939,2007,1328,37,150,436,10,109,164,944,261
2018,36047058200,"Census Tract 582, Kings County, New York",1090,113,977,747,2040,46086,0,2009,1372,33.3,194,417,39,92,162,977,219
2019,36047058200,"Census Tract 582, Kings County, New York",1111,142,969,652,1717,49231,0,2011,1426,33.6,150,362,43,89,134,969,207
2020,36047058200,"Census Tract 582, Kings County, New York",992,133,859,607,1911,60150,0,2011,1460,28,120,289,39,69,180,859,124
2012,36047058400,"Census Tract 584, Kings County, New York",1529,65,1464,1039,2169,46576,1962,2004,1139,29.1,527,892,35,72,28,1464,325
2013,36047058400,"Census Tract 584, Kings County, New York",1551,95,1456,1032,2238,48387,1963,2004,1220,31.2,629,908,45,56,10,1456,255
2014,36047058400,"Census Tract 584, Kings County, New York",1575,101,1474,1031,1946,53607,1962,2004,1297,31.1,651,831,64,110,13,1474,253
2015,36047058400,"Census Tract 584, Kings County, New York",1561,121,1440,1105,2288,57848,1959,2006,1330,31.2,632,887,49,117,52,1440,246
2016,36047058400,"Census Tract 584, Kings County, New York",1529,112,1417,1093,2335,45188,1957,2008,1305,33.1,658,912,48,99,34,1417,220
2017,36047058400,"Census Tract 584, Kings County, New York",1529,115,1414,1091,2450,45511,1962,2006,1379,35.2,601,951,26,78,47,1414,209
2018,36047058400,"Census Tract 584, Kings County, New York",1483,65,1418,1056,2513,54076,1960,2006,1431,32.7,527,869,16,119,60,1418,200
2019,36047058400,"Census Tract 584, Kings County, New York",1466,89,1377,1037,2611,59375,1960,2008,1530,29.5,530,827,17,124,78,1377,182
2020,36047058400,"Census Tract 584, Kings County, New York",1480,91,1389,946,2441,49244,1961,2010,1647,38,503,724,16,188,25,1389,156
2012,36047058600,"Census Tract 586, Kings County, New York",888,52,836,360,856,23846,1952,2002,1248,43.6,41,146,47,131,36,836,221
2013,36047058600,"Census Tract 586, Kings County, New York",894,68,826,387,862,31146,1955,2005,1215,33.8,38,164,19,129,75,826,174
2014,36047058600,"Census Tract 586, Kings County, New York",932,124,808,380,962,32222,1953,2005,1154,29.6,45,180,20,117,63,808,172
2015,36047058600,"Census Tract 586, Kings County, New York",865,84,781,346,1037,43214,1956,2005,1048,27.9,61,154,26,79,87,781,129
2016,36047058600,"Census Tract 586, Kings County, New York",882,73,809,361,1089,49861,1950,2008,1195,29.5,96,172,11,97,81,809,167
2017,36047058600,"Census Tract 586, Kings County, New York",881,81,800,329,1183,63375,1945,2009,1267,29.3,103,133,12,90,94,800,132
2018,36047058600,"Census Tract 586, Kings County, New York",878,77,801,285,947,40729,0,2007,1291,36.7,111,135,12,87,51,801,146
2019,36047058600,"Census Tract 586, Kings County, New York",881,38,843,326,961,45786,1941,2009,1468,36.3,142,146,12,111,57,843,133
2020,36047058600,"Census Tract 586, Kings County, New York",1002,46,956,448,1168,41250,1949,2009,1375,38.8,150,207,20,182,39,956,186
2012,36047058800,"Census Tract 588, Kings County, New York",1398,31,1367,803,1756,48015,1963,2002,1084,29.6,357,617,28,48,110,1367,205
2013,36047058800,"Census Tract 588, Kings County, New York",1398,31,1367,843,2207,49844,1963,2002,1097,29.3,417,632,30,76,105,1367,251
2014,36047058800,"Census Tract 588, Kings County, New York",1468,66,1402,817,2195,51964,1963,2003,1057,29.3,484,644,30,71,72,1402,237
2015,36047058800,"Census Tract 588, Kings County, New York",1484,108,1376,732,1951,48125,1964,2005,1167,28.3,368,578,28,88,38,1376,196
2016,36047058800,"Census Tract 588, Kings County, New York",1502,76,1426,668,1848,48750,1963,2007,1261,27.4,305,470,0,128,70,1426,171
2017,36047058800,"Census Tract 588, Kings County, New York",1521,79,1442,710,1883,55000,1961,2008,1312,28.4,360,506,0,116,88,1442,160
2018,36047058800,"Census Tract 588, Kings County, New York",1478,78,1400,612,1407,63594,1961,2008,1483,27.9,324,453,0,97,62,1400,113
2019,36047058800,"Census Tract 588, Kings County, New York",1474,106,1368,620,1467,67813,1960,2011,1492,21.4,360,454,0,91,75,1368,107
2020,36047058800,"Census Tract 588, Kings County, New York",1513,83,1430,777,1572,63940,1960,2010,1454,26.3,394,481,0,70,186,1430,66
2012,36047058900,"Census Tract 589, Kings County, New York",850,113,737,508,1141,73529,1939,2004,1426,25.4,249,435,15,16,42,737,116
2013,36047058900,"Census Tract 589, Kings County, New York",843,58,785,509,1182,83080,1939,2005,1578,26.1,271,434,0,31,34,785,116
2014,36047058900,"Census Tract 589, Kings County, New York",841,65,776,565,1245,82137,1939,2007,1772,26.9,367,454,15,53,31,776,86
2015,36047058900,"Census Tract 589, Kings County, New York",819,32,787,581,1206,81741,1939,2007,1727,25.9,368,474,18,46,39,787,36
2016,36047058900,"Census Tract 589, Kings County, New York",843,50,793,565,1185,80511,1939,2008,1799,28.4,370,441,19,45,60,793,52
2017,36047058900,"Census Tract 589, Kings County, New York",854,60,794,517,1068,83092,1939,2010,1933,31.9,363,383,16,55,63,794,43
2018,36047058900,"Census Tract 589, Kings County, New York",849,81,768,519,1060,74338,0,2011,1955,34.5,396,386,32,43,58,768,48
2019,36047058900,"Census Tract 589, Kings County, New York",832,78,754,504,1041,89500,0,2012,2189,28.1,369,417,0,15,68,754,50
2020,36047058901,"Census Tract 589.01, Kings County, New York",860,93,767,534,1080,88750,0,2012,2116,24.9,355,471,0,18,42,767,54
2020,36047058902,"Census Tract 589.02, Kings County, New York",0,0,0,0,0,NA,NA,NA,NA,NA,0,0,0,0,0,0,0
2012,36047059000,"Census Tract 590, Kings County, New York",691,39,652,337,862,44848,1939,2004,1192,31.8,113,171,11,128,27,652,79
2013,36047059000,"Census Tract 590, Kings County, New York",716,52,664,344,838,42344,1945,2005,1205,33.6,121,146,32,139,27,664,124
2014,36047059000,"Census Tract 590, Kings County, New York",723,26,697,381,923,31050,1946,2006,1207,34.5,137,179,62,84,56,697,180
2015,36047059000,"Census Tract 590, Kings County, New York",691,37,654,356,949,31714,1945,2008,1234,38.9,133,159,57,87,53,654,147
2016,36047059000,"Census Tract 590, Kings County, New York",692,43,649,350,956,31864,1945,2010,1310,41.6,159,139,54,98,59,649,133
2017,36047059000,"Census Tract 590, Kings County, New York",668,54,614,333,937,33875,1945,2010,1375,40.8,155,137,58,73,65,614,129
2018,36047059000,"Census Tract 590, Kings County, New York",674,48,626,331,1006,42404,1955,2011,1516,43.4,173,167,44,61,59,626,131
2019,36047059000,"Census Tract 590, Kings County, New York",679,90,589,327,990,59750,1970,2012,1474,34.2,170,177,12,68,70,589,100
2020,36047059000,"Census Tract 590, Kings County, New York",705,72,633,372,957,73750,1974,2014,1617,31.8,137,185,8,53,126,633,91
2012,36047059100,"Census Tract 591, Kings County, New York",1973,205,1768,1453,2917,60318,1939,2004,1425,26.2,803,1321,0,22,98,1768,156
2013,36047059100,"Census Tract 591, Kings County, New York",2038,228,1810,1529,3109,62147,1939,2005,1479,26.5,840,1334,0,27,145,1810,182
2014,36047059100,"Census Tract 591, Kings County, New York",2057,212,1845,1535,3140,63906,1939,2007,1646,26.8,883,1323,24,7,147,1845,170
2015,36047059100,"Census Tract 591, Kings County, New York",2010,226,1784,1454,2967,73750,1939,2008,1727,26.9,820,1250,37,7,125,1784,189
2016,36047059100,"Census Tract 591, Kings County, New York",1995,135,1860,1556,3071,81100,1939,2011,1846,26.7,991,1293,40,19,172,1860,202
2017,36047059100,"Census Tract 591, Kings County, New York",1996,143,1853,1505,3059,90268,1939,2011,1842,25.8,939,1162,76,18,225,1853,255
2018,36047059100,"Census Tract 591, Kings County, New York",2007,141,1866,1531,3021,94094,0,2011,1985,24,1015,1190,101,18,237,1866,198
2019,36047059100,"Census Tract 591, Kings County, New York",1976,221,1755,1403,2664,94886,0,2012,2028,24,939,1096,66,23,237,1755,179
2020,36047059100,"Census Tract 591, Kings County, New York",1927,155,1772,1521,2929,99511,0,2013,2133,23,1055,1192,62,30,243,1772,177
2012,36047059200,"Census Tract 592, Kings County, New York",1660,45,1615,1004,2060,41200,1945,2003,1100,32.3,411,884,24,28,61,1615,251
2013,36047059200,"Census Tract 592, Kings County, New York",1669,35,1634,1039,2219,39831,1947,2003,1120,33.7,391,899,30,49,55,1634,325
2014,36047059200,"Census Tract 592, Kings County, New York",1707,44,1663,988,2202,43333,1950,2003,1099,29.3,365,887,30,35,30,1663,237
2015,36047059200,"Census Tract 592, Kings County, New York",1687,8,1679,912,2108,39730,1952,2003,1138,31.8,327,811,14,31,50,1679,247
2016,36047059200,"Census Tract 592, Kings County, New York",1745,36,1709,1016,2343,40641,1950,2004,1142,31.5,337,821,81,59,48,1709,246
2017,36047059200,"Census Tract 592, Kings County, New York",1784,63,1721,1056,2600,44688,1946,2005,1199,28.7,375,779,130,74,65,1721,246
2018,36047059200,"Census Tract 592, Kings County, New York",1788,87,1701,1139,2666,45417,1942,2009,1386,29.6,431,792,135,53,112,1701,235
2019,36047059200,"Census Tract 592, Kings County, New York",1786,109,1677,1204,2918,42589,1941,2011,1451,34.7,416,844,107,64,113,1677,306
2020,36047059200,"Census Tract 592, Kings County, New York",1841,125,1716,1313,3062,46202,0,2013,1449,34,463,885,82,101,108,1716,261
2012,36047059300,"Census Tract 593, Kings County, New York",1049,250,799,640,1317,57606,1939,2005,1451,31.9,278,518,0,20,102,799,88
2013,36047059300,"Census Tract 593, Kings County, New York",1005,235,770,660,1405,60538,1939,2006,1439,30.1,307,525,0,21,114,770,69
2014,36047059300,"Census Tract 593, Kings County, New York",998,158,840,678,1498,61210,1939,2006,1476,27.5,306,533,0,20,125,840,79
2015,36047059300,"Census Tract 593, Kings County, New York",957,134,823,654,1460,67386,1939,2009,1477,23.5,293,484,11,32,132,823,92
2016,36047059300,"Census Tract 593, Kings County, New York",962,86,876,705,1520,64906,1939,2010,1570,24.9,304,523,19,36,130,876,135
2017,36047059300,"Census Tract 593, Kings County, New York",938,102,836,653,1551,68313,1939,2011,1667,26.6,296,488,23,25,124,836,146
2018,36047059300,"Census Tract 593, Kings County, New York",948,57,891,705,1616,81964,0,2012,1814,23.3,342,539,25,28,120,891,128
2019,36047059300,"Census Tract 593, Kings County, New York",958,43,915,772,1630,80972,0,2012,1873,24.5,400,576,27,28,132,915,145
2020,36047059300,"Census Tract 593, Kings County, New York",956,40,916,762,1705,90234,0,2014,1936,26,434,616,7,19,96,916,147
2012,36047059401,"Census Tract 594.01, Kings County, New York",3049,224,2825,1675,3287,40852,1947,2004,1087,23.6,557,1383,0,210,82,2825,512
2013,36047059401,"Census Tract 594.01, Kings County, New York",3133,186,2947,1572,3379,34808,1943,2005,1106,24,622,1361,0,176,35,2947,550
2014,36047059401,"Census Tract 594.01, Kings County, New York",3203,155,3048,1622,3364,31336,1941,2004,1153,31.4,645,1479,0,116,27,3048,682
2015,36047059401,"Census Tract 594.01, Kings County, New York",3162,136,3026,1604,3468,31875,1943,2007,1163,32.8,604,1349,0,193,62,3026,715
2016,36047059401,"Census Tract 594.01, Kings County, New York",3201,77,3124,1637,3629,34572,1942,2007,1217,32,661,1371,0,200,55,3124,700
2017,36047059401,"Census Tract 594.01, Kings County, New York",3221,162,3059,1540,3683,32214,1939,2010,1314,40.4,783,1102,16,275,136,3059,660
2018,36047059401,"Census Tract 594.01, Kings County, New York",3228,196,3032,1585,3411,36388,0,2011,1307,40.2,735,1140,18,287,124,3032,672
2019,36047059401,"Census Tract 594.01, Kings County, New York",3197,280,2917,1542,3695,36958,0,2012,1356,32.3,775,1027,33,357,112,2917,634
2012,36047059402,"Census Tract 594.02, Kings County, New York",2127,239,1888,567,944,32171,1948,2003,1062,33,191,481,27,12,46,1888,180
2013,36047059402,"Census Tract 594.02, Kings County, New York",2126,200,1926,517,954,31372,1947,2001,1150,35.6,157,434,24,20,45,1926,187
2014,36047059402,"Census Tract 594.02, Kings County, New York",2109,185,1924,619,1158,33672,1950,2006,1133,31.9,178,526,37,25,38,1924,182
2015,36047059402,"Census Tract 594.02, Kings County, New York",2170,140,2030,644,1275,33611,1950,2006,1200,35.2,208,546,39,21,47,2030,218
2016,36047059402,"Census Tract 594.02, Kings County, New York",2159,91,2068,673,1359,47731,1950,2010,1177,32.1,222,567,44,38,8,2068,227
2017,36047059402,"Census Tract 594.02, Kings County, New York",2155,87,2068,596,1244,NA,1953,2011,1215,35.5,196,515,46,35,0,2068,217
2018,36047059402,"Census Tract 594.02, Kings County, New York",2179,108,2071,586,1239,33833,1956,2012,1266,40.5,180,492,39,55,0,2071,214
2019,36047059402,"Census Tract 594.02, Kings County, New York",2151,149,2002,506,1200,34241,1956,2013,1561,46.5,233,482,0,24,0,2002,219
2020,36047059402,"Census Tract 594.02, Kings County, New York",2198,163,2035,543,1095,30240,1961,2013,1421,51,185,446,0,32,11,2035,180
2020,36047059403,"Census Tract 594.03, Kings County, New York",1507,216,1291,670,1664,29531,0,2012,1383,39.6,307,390,0,224,56,1291,263
2020,36047059404,"Census Tract 594.04, Kings County, New York",1738,158,1580,867,1823,37314,1945,2011,1227,34.7,559,691,90,70,0,1580,349
2012,36047059600,"Census Tract 596, Kings County, New York",1155,105,1050,376,719,28092,1954,2001,682,31.1,83,364,0,0,12,1050,132
2013,36047059600,"Census Tract 596, Kings County, New York",1173,79,1094,353,721,28194,1955,2002,647,28.5,114,341,0,0,12,1094,129
2014,36047059600,"Census Tract 596, Kings County, New York",1182,75,1107,441,1000,39549,1956,2002,815,31.1,113,427,0,0,14,1107,151
2015,36047059600,"Census Tract 596, Kings County, New York",1177,72,1105,413,925,39395,1957,2003,805,30.4,114,413,0,0,0,1105,158
2016,36047059600,"Census Tract 596, Kings County, New York",1171,61,1110,349,736,39896,1956,2004,782,31.9,128,349,0,0,0,1110,170
2017,36047059600,"Census Tract 596, Kings County, New York",1177,35,1142,341,599,34375,1956,2003,697,29.2,141,332,0,9,0,1142,165
2018,36047059600,"Census Tract 596, Kings County, New York",1180,27,1153,393,643,39831,1955,2001,830,27.6,139,383,0,10,0,1153,163
2019,36047059600,"Census Tract 596, Kings County, New York",1192,26,1166,413,738,40913,1952,2005,747,25.9,133,356,20,7,0,1166,144
2020,36047059600,"Census Tract 596, Kings County, New York",1176,0,1176,396,773,40000,1952,2007,900,24.4,91,326,30,17,0,1176,127
2012,36047059800,"Census Tract 598, Kings County, New York",1390,89,1301,496,1396,27167,1958,2004,1230,41.7,158,404,48,34,0,1301,208
2013,36047059800,"Census Tract 598, Kings County, New York",1329,82,1247,524,1362,26695,1959,2004,1299,50,196,452,60,0,0,1247,181
2014,36047059800,"Census Tract 598, Kings County, New York",1355,90,1265,450,1324,37500,1960,2004,1285,22.7,211,333,83,0,0,1265,199
2015,36047059800,"Census Tract 598, Kings County, New York",1303,98,1205,414,1356,NA,1960,2004,1273,24,200,348,52,0,0,1205,237
2016,36047059800,"Census Tract 598, Kings County, New York",1356,109,1247,466,1416,54773,1961,2007,1332,30.5,182,349,66,29,11,1247,208
2017,36047059800,"Census Tract 598, Kings County, New York",1365,106,1259,537,1558,40292,1960,2008,1383,33.4,249,448,26,24,10,1259,232
2018,36047059800,"Census Tract 598, Kings County, New York",1400,101,1299,592,1756,73026,1960,2011,1499,30.3,223,478,20,56,12,1299,225
2019,36047059800,"Census Tract 598, Kings County, New York",1427,97,1330,647,1782,55156,1961,2009,1443,32,210,506,11,91,11,1330,216
2020,36047059800,"Census Tract 598, Kings County, New York",1497,120,1377,754,2072,70756,1962,2012,1589,28.6,190,635,8,80,10,1377,177
2012,36047060000,"Census Tract 600, Kings County, New York",2752,208,2544,1385,2970,36822,1957,2003,1169,29.5,704,1087,85,58,173,2544,361
2013,36047060000,"Census Tract 600, Kings County, New York",2800,188,2612,1449,2924,35727,1958,2003,1241,36.6,573,1128,75,71,198,2612,400
2014,36047060000,"Census Tract 600, Kings County, New York",2848,264,2584,1467,3045,35644,1960,2004,1263,38.4,505,1221,49,61,136,2584,410
2015,36047060000,"Census Tract 600, Kings County, New York",2873,232,2641,1533,3282,38797,1958,2005,1299,37.4,527,1297,35,63,138,2641,428
2016,36047060000,"Census Tract 600, Kings County, New York",2917,237,2680,1485,3346,43808,1958,2007,1324,36.5,512,1297,14,38,136,2680,413
2017,36047060000,"Census Tract 600, Kings County, New York",2883,209,2674,1478,3422,44583,1959,2006,1348,37.4,461,1325,14,48,91,2674,390
2018,36047060000,"Census Tract 600, Kings County, New York",2813,254,2559,1311,3259,49838,1958,2009,1327,35.1,486,1142,45,53,71,2559,389
2019,36047060000,"Census Tract 600, Kings County, New York",2791,207,2584,1318,3188,57872,1955,2011,1429,28.9,559,1080,61,49,90,2584,256
2020,36047060000,"Census Tract 600, Kings County, New York",2706,182,2524,1225,2936,63935,1955,2012,1480,26,588,893,68,14,213,2524,331
2012,36047060600,"Census Tract 606, Kings County, New York",1170,88,1082,739,1801,24861,1956,2002,1145,43,205,563,45,65,66,1082,263
2013,36047060600,"Census Tract 606, Kings County, New York",1177,88,1089,716,1625,22679,1956,2003,1132,45.5,201,572,14,67,63,1089,289
2014,36047060600,"Census Tract 606, Kings County, New York",1193,85,1108,769,1762,20917,1958,2005,1167,49.8,236,605,32,69,63,1108,350
2015,36047060600,"Census Tract 606, Kings County, New York",1202,95,1107,744,1612,26532,1958,2006,1217,44.7,274,548,33,82,69,1107,316
2016,36047060600,"Census Tract 606, Kings County, New York",1198,72,1126,692,1581,29886,1957,2007,1290,36.5,267,495,33,72,52,1126,256
2017,36047060600,"Census Tract 606, Kings County, New York",1207,79,1128,678,1497,36357,1958,2007,1288,34,310,550,8,46,40,1128,233
2018,36047060600,"Census Tract 606, Kings County, New York",1243,130,1113,646,1453,50804,1959,2010,1401,30.1,320,517,8,46,37,1113,232
2019,36047060600,"Census Tract 606, Kings County, New York",1277,111,1166,681,1393,47125,1957,2011,1560,30.9,407,549,13,40,41,1166,228
2020,36047060600,"Census Tract 606, Kings County, New York",1340,85,1255,613,1247,42344,1958,2013,1731,37.2,375,505,13,39,27,1255,180
2012,36047060800,"Census Tract 608, Kings County, New York",1673,370,1303,830,1746,37256,1962,2003,1260,35.1,323,658,25,62,85,1303,232
2013,36047060800,"Census Tract 608, Kings County, New York",1813,353,1460,898,1917,36011,1964,2005,1292,37,345,756,48,35,85,1460,242
2014,36047060800,"Census Tract 608, Kings County, New York",1828,390,1438,895,1954,38424,1963,2007,1354,34.1,352,725,65,41,88,1438,258
2015,36047060800,"Census Tract 608, Kings County, New York",1824,353,1471,909,1982,42546,1964,2010,1382,34.2,410,672,87,76,98,1471,229
2016,36047060800,"Census Tract 608, Kings County, New York",1762,242,1520,969,2041,37862,1966,2011,1422,37.4,511,708,110,87,88,1520,266
2017,36047060800,"Census Tract 608, Kings County, New York",1735,161,1574,1105,2471,44572,1967,2012,1415,33.4,504,790,91,119,100,1574,233
2018,36047060800,"Census Tract 608, Kings County, New York",1654,130,1524,1073,2493,53886,1966,2012,1443,32,553,777,62,149,51,1524,236
2019,36047060800,"Census Tract 608, Kings County, New York",1715,148,1567,1140,2571,54071,1968,2013,1476,34.7,501,809,40,168,84,1567,264
2020,36047060800,"Census Tract 608, Kings County, New York",1799,169,1630,1238,2785,59808,1971,2013,1563,33.3,607,881,32,119,153,1630,327
2012,36047061002,"Census Tract 610.02, Kings County, New York",2170,262,1908,726,1560,21944,1965,2003,1139,42.4,387,709,0,0,0,1908,414
2013,36047061002,"Census Tract 610.02, Kings County, New York",2193,158,2035,871,1893,27083,1965,2004,1192,31.6,460,855,0,0,0,2035,421
2014,36047061002,"Census Tract 610.02, Kings County, New York",2242,240,2002,855,1792,26018,1965,2004,1201,46.7,492,839,0,0,0,2002,394
2015,36047061002,"Census Tract 610.02, Kings County, New York",2268,340,1928,775,1608,30899,1960,2004,1161,36.8,498,775,0,0,0,1928,256
2016,36047061002,"Census Tract 610.02, Kings County, New York",2267,297,1970,823,1574,45982,1962,2008,1244,33.9,482,823,0,0,0,1970,284
2017,36047061002,"Census Tract 610.02, Kings County, New York",2312,315,1997,924,1772,47455,1960,2010,1381,31.1,481,924,0,0,0,1997,327
2018,36047061002,"Census Tract 610.02, Kings County, New York",2283,286,1997,973,1824,50781,1964,2011,1385,35.9,474,916,0,0,40,1997,318
2019,36047061002,"Census Tract 610.02, Kings County, New York",2551,212,2339,1207,2432,57902,1963,2011,1392,28.8,650,1113,0,0,78,2339,294
2020,36047061002,"Census Tract 610.02, Kings County, New York",2612,142,2470,1309,2404,63922,1965,2012,1448,32.3,710,1217,0,0,77,2470,354
2012,36047061003,"Census Tract 610.03, Kings County, New York",594,16,578,386,820,32083,1939,2003,1182,28.8,128,234,40,46,66,578,229
2013,36047061003,"Census Tract 610.03, Kings County, New York",664,31,633,404,1016,36304,1939,2005,1237,28.3,160,255,44,58,47,633,234
2014,36047061003,"Census Tract 610.03, Kings County, New York",630,39,591,380,994,40658,1939,2004,1293,27.9,118,244,0,58,78,591,189
2015,36047061003,"Census Tract 610.03, Kings County, New York",598,63,535,363,1084,38750,1939,2005,1305,30,93,240,0,20,103,535,178
2016,36047061003,"Census Tract 610.03, Kings County, New York",607,71,536,342,1105,38333,1939,2006,1292,33,76,203,0,20,119,536,136
2017,36047061003,"Census Tract 610.03, Kings County, New York",613,89,524,361,1360,51172,1939,2006,1459,33.1,116,181,13,17,163,524,101
2018,36047061003,"Census Tract 610.03, Kings County, New York",606,87,519,366,1279,50217,0,2010,1434,34,117,191,12,25,150,519,135
2019,36047061003,"Census Tract 610.03, Kings County, New York",608,94,514,345,1191,50766,0,2013,1570,37,134,172,13,43,130,514,145
2020,36047061003,"Census Tract 610.03, Kings County, New York",635,69,566,363,1154,32070,1941,2014,1634,43.4,151,141,32,66,147,566,191
2012,36047061004,"Census Tract 610.04, Kings County, New York",3165,331,2834,2481,4933,21875,1945,2003,1023,40.9,1014,2235,42,80,128,2834,973
2013,36047061004,"Census Tract 610.04, Kings County, New York",3234,329,2905,2564,5161,21189,1945,2004,1013,38.6,948,2321,50,54,140,2905,1020
2014,36047061004,"Census Tract 610.04, Kings County, New York",3308,283,3025,2527,5041,18020,1943,2004,948,33.6,856,2280,40,67,134,3025,1240
2015,36047061004,"Census Tract 610.04, Kings County, New York",3282,337,2945,2527,5151,20488,1942,2005,978,33.9,1072,2247,26,83,128,2945,1163
2016,36047061004,"Census Tract 610.04, Kings County, New York",3288,382,2906,2456,4921,21056,1939,2008,991,33.7,1010,2136,33,42,183,2906,1126
2017,36047061004,"Census Tract 610.04, Kings County, New York",3357,268,3089,2543,5328,22388,1939,2009,1114,34.1,1068,2166,0,97,198,3089,1028
2018,36047061004,"Census Tract 610.04, Kings County, New York",3261,271,2990,2526,5205,26540,0,2010,1233,34.9,1280,2255,0,88,123,2990,964
2019,36047061004,"Census Tract 610.04, Kings County, New York",2983,232,2751,2361,5319,30279,0,2011,1287,35.5,1333,2022,0,87,146,2751,701
2020,36047061004,"Census Tract 610.04, Kings County, New York",2851,126,2725,2314,4946,29145,0,2011,1347,37.3,1318,2033,0,84,113,2725,753
2012,36047061200,"Census Tract 612, Kings County, New York",476,73,403,144,312,18816,1953,2004,839,50,63,144,0,0,0,403,123
2013,36047061200,"Census Tract 612, Kings County, New York",468,76,392,129,339,42188,1954,2004,869,32.5,54,129,0,0,0,392,97
2014,36047061200,"Census Tract 612, Kings County, New York",453,70,383,141,399,42679,1947,2005,1387,50,42,141,0,0,0,383,99
2015,36047061200,"Census Tract 612, Kings County, New York",441,73,368,89,183,NA,1946,2004,1269,50,11,89,0,0,0,368,70
2016,36047061200,"Census Tract 612, Kings County, New York",411,64,347,82,173,NA,1946,2004,1348,50,0,82,0,0,0,347,38
2017,36047061200,"Census Tract 612, Kings County, New York",420,31,389,79,211,NA,1946,2004,1446,50,16,79,0,0,0,389,22
2018,36047061200,"Census Tract 612, Kings County, New York",442,37,405,92,202,26154,1947,2004,1417,51,25,77,0,0,15,405,38
2019,36047061200,"Census Tract 612, Kings County, New York",455,33,422,77,161,28558,1953,2002,1295,34.2,46,62,0,0,15,422,26
2020,36047061200,"Census Tract 612, Kings County, New York",428,17,411,88,203,50667,1950,2009,1524,31.2,64,80,0,0,8,411,18
2012,36047061600,"Census Tract 616, Kings County, New York",587,53,534,94,232,72625,1954,1997,1326,24,47,94,0,0,0,534,61
2013,36047061600,"Census Tract 616, Kings County, New York",591,63,528,87,222,44583,1954,1998,1363,24.3,46,87,0,0,0,528,63
2014,36047061600,"Census Tract 616, Kings County, New York",605,70,535,37,92,26339,1952,2006,1482,50,28,37,0,0,0,535,32
2015,36047061600,"Census Tract 616, Kings County, New York",580,90,490,37,91,26771,1954,2007,1568,50,26,37,0,0,0,490,35
2016,36047061600,"Census Tract 616, Kings County, New York",568,72,496,38,84,26458,1956,2012,1396,50,12,26,0,0,12,496,34
2017,36047061600,"Census Tract 616, Kings County, New York",584,93,491,47,89,30114,1948,2012,1281,50,23,36,0,0,11,491,46
2018,36047061600,"Census Tract 616, Kings County, New York",543,70,473,45,82,31635,1956,2012,NA,45,17,31,0,0,14,473,25
2019,36047061600,"Census Tract 616, Kings County, New York",527,58,469,53,83,NA,1949,2011,1573,38.4,36,42,0,0,11,469,13
2020,36047061600,"Census Tract 616, Kings County, New York",550,56,494,70,85,NA,1947,2009,1115,39.2,29,53,0,0,17,494,17
2012,36047062000,"Census Tract 620, Kings County, New York",739,96,643,111,229,85313,1939,2004,1390,21.8,65,99,0,4,8,643,90
2013,36047062000,"Census Tract 620, Kings County, New York",780,77,703,108,265,65833,1939,2007,1469,19,58,99,0,3,6,703,84
2014,36047062000,"Census Tract 620, Kings County, New York",803,107,696,133,372,53750,1939,2007,1637,21.6,55,121,0,0,12,696,118
2015,36047062000,"Census Tract 620, Kings County, New York",795,151,644,164,491,NA,1939,2007,1655,21.1,64,153,0,0,11,644,81
2016,36047062000,"Census Tract 620, Kings County, New York",822,149,673,151,443,NA,1939,2010,1560,17.5,60,146,0,0,5,673,72
2017,36047062000,"Census Tract 620, Kings County, New York",807,91,716,151,542,136518,1939,2010,1970,18.4,63,142,0,0,9,716,54
2018,36047062000,"Census Tract 620, Kings County, New York",786,97,689,202,541,NA,0,2011,1702,30.1,90,176,0,20,6,689,73
2019,36047062000,"Census Tract 620, Kings County, New York",758,78,680,212,583,91389,0,2013,1927,24.3,101,195,0,17,0,680,47
2020,36047062000,"Census Tract 620, Kings County, New York",800,92,708,225,547,83939,1940,2012,2064,34.1,144,209,0,16,0,708,39
2012,36047062200,"Census Tract 622, Kings County, New York",1476,231,1245,774,1750,31705,1960,2003,1402,50,269,661,21,0,92,1245,149
2013,36047062200,"Census Tract 622, Kings County, New York",1537,242,1295,734,1428,31554,1961,2003,1465,50,226,637,24,0,73,1295,174
2014,36047062200,"Census Tract 622, Kings County, New York",1577,284,1293,662,1202,33188,1961,2003,1638,50,251,580,19,0,55,1293,224
2015,36047062200,"Census Tract 622, Kings County, New York",1564,230,1334,632,1136,26887,1963,2005,1629,50,215,535,37,0,52,1334,207
2016,36047062200,"Census Tract 622, Kings County, New York",1526,182,1344,688,1175,40000,1964,2010,1691,42,294,554,49,0,76,1344,156
2017,36047062200,"Census Tract 622, Kings County, New York",1410,186,1224,627,1109,50806,1965,2011,1728,38.7,277,514,53,0,51,1224,106
2018,36047062200,"Census Tract 622, Kings County, New York",1365,181,1184,699,1287,53902,1964,2012,1694,35.3,308,593,57,0,39,1184,126
2019,36047062200,"Census Tract 622, Kings County, New York",1293,202,1091,672,1254,63750,1964,2013,1666,34.1,328,578,37,14,43,1091,90
2020,36047062200,"Census Tract 622, Kings County, New York",1191,206,985,713,1441,57227,1962,2014,1692,36.1,357,510,53,28,122,985,62
2012,36047062600,"Census Tract 626, Kings County, New York",1103,31,1072,455,943,30270,1957,2004,1073,41,131,331,20,23,51,1072,215
2013,36047062600,"Census Tract 626, Kings County, New York",1124,54,1070,416,950,27500,1957,2004,817,31.5,107,303,11,22,49,1070,236
2014,36047062600,"Census Tract 626, Kings County, New York",1155,69,1086,423,971,31215,1956,2004,1028,31.2,130,292,24,24,50,1086,214
2015,36047062600,"Census Tract 626, Kings County, New York",1192,114,1078,413,1033,34219,1956,2005,1063,34.4,159,293,24,25,27,1078,215
2016,36047062600,"Census Tract 626, Kings County, New York",1208,103,1105,397,1119,31219,1955,2008,983,44.9,123,244,25,25,52,1105,239
2017,36047062600,"Census Tract 626, Kings County, New York",1201,109,1092,318,736,36500,1955,2010,971,41,159,221,27,20,29,1092,158
2018,36047062600,"Census Tract 626, Kings County, New York",1162,115,1047,365,829,40842,1955,2010,1290,33.2,194,229,24,21,55,1047,134
2019,36047062600,"Census Tract 626, Kings County, New York",1154,109,1045,372,882,43269,1955,2011,1169,29.9,162,205,0,35,86,1045,164
2020,36047062600,"Census Tract 626, Kings County, New York",1113,60,1053,324,715,44063,1954,2010,1039,26.9,109,177,0,54,80,1053,135
2012,36047062800,"Census Tract 628, Kings County, New York",2029,131,1898,423,802,37316,1945,2003,1038,29.4,112,423,0,0,0,1898,202
2013,36047062800,"Census Tract 628, Kings County, New York",2071,126,1945,318,623,37143,1953,2003,1084,36.7,52,318,0,0,0,1945,204
2014,36047062800,"Census Tract 628, Kings County, New York",2097,117,1980,336,757,52670,1939,2004,1186,35.3,67,336,0,0,0,1980,226
2015,36047062800,"Census Tract 628, Kings County, New York",2078,177,1901,302,582,42019,1939,2002,1315,38.8,84,279,0,0,23,1901,140
2016,36047062800,"Census Tract 628, Kings County, New York",2050,204,1846,278,531,43750,1939,2001,1411,37.8,71,254,0,0,24,1846,177
2017,36047062800,"Census Tract 628, Kings County, New York",2071,239,1832,212,417,41500,1939,1999,1700,50,57,183,0,0,29,1832,186
2018,36047062800,"Census Tract 628, Kings County, New York",1997,305,1692,229,430,41345,0,2000,1559,51,59,200,0,0,29,1692,158
2019,36047062800,"Census Tract 628, Kings County, New York",1939,311,1628,180,266,43311,0,1998,1207,51,32,155,0,0,25,1628,139
2020,36047062800,"Census Tract 628, Kings County, New York",1888,254,1634,160,399,NA,1942,1993,885,40.3,17,160,0,0,0,1634,115
2012,36047063200,"Census Tract 632, Kings County, New York",697,30,667,174,367,41042,1959,2005,1231,35.8,51,127,0,0,47,667,76
2013,36047063200,"Census Tract 632, Kings County, New York",714,65,649,186,389,43188,1959,2006,1190,35,47,144,0,0,42,649,70
2014,36047063200,"Census Tract 632, Kings County, New York",725,88,637,203,412,42985,1957,2006,1119,36.1,83,129,0,6,68,637,40
2015,36047063200,"Census Tract 632, Kings County, New York",736,109,627,158,311,45385,1955,2008,1335,29.3,22,145,0,3,10,627,60
2016,36047063200,"Census Tract 632, Kings County, New York",743,107,636,122,265,45167,1956,2005,1325,34.5,15,117,0,5,0,636,60
2017,36047063200,"Census Tract 632, Kings County, New York",737,120,617,111,229,41771,1957,2002,1303,36.2,33,108,0,3,0,617,67
2018,36047063200,"Census Tract 632, Kings County, New York",741,84,657,139,273,40083,1956,2004,1529,39.8,46,135,0,4,0,657,84
2019,36047063200,"Census Tract 632, Kings County, New York",703,79,624,136,231,44038,1958,1998,1333,36.8,55,136,0,0,0,624,78
2020,36047063200,"Census Tract 632, Kings County, New York",665,48,617,125,218,51563,1957,1994,1169,34.2,51,125,0,0,0,617,50
2012,36047063600,"Census Tract 636, Kings County, New York",503,29,474,89,207,21985,1941,2003,935,19.7,15,89,0,0,0,474,63
2013,36047063600,"Census Tract 636, Kings County, New York",521,41,480,78,170,21111,1939,2002,889,41.1,15,78,0,0,0,480,62
2014,36047063600,"Census Tract 636, Kings County, New York",533,19,514,93,205,22132,1939,2003,950,44.7,17,93,0,0,0,514,52
2015,36047063600,"Census Tract 636, Kings County, New York",514,22,492,60,164,NA,1943,1989,959,44.3,9,60,0,0,0,492,24
2016,36047063600,"Census Tract 636, Kings County, New York",516,24,492,52,118,NA,1939,2011,1375,50,19,52,0,0,0,492,24
2017,36047063600,"Census Tract 636, Kings County, New York",499,26,473,46,104,NA,1939,2011,NA,NA,18,46,0,0,0,473,26
2018,36047063600,"Census Tract 636, Kings County, New York",471,10,461,34,64,NA,0,2012,NA,NA,6,34,0,0,0,461,39
2019,36047063600,"Census Tract 636, Kings County, New York",437,25,412,23,34,NA,NA,NA,NA,NA,6,23,0,0,0,412,46
2020,36047063600,"Census Tract 636, Kings County, New York",448,39,409,25,36,NA,NA,NA,NA,NA,6,25,0,0,0,409,44
2012,36047063800,"Census Tract 638, Kings County, New York",739,42,697,199,436,57991,1947,2001,1213,30.5,85,147,0,37,0,697,42
2013,36047063800,"Census Tract 638, Kings County, New York",749,62,687,161,317,58220,1939,2004,1231,28.5,94,117,0,44,0,687,6
2014,36047063800,"Census Tract 638, Kings County, New York",751,80,671,159,314,58105,1939,2004,1213,30.1,88,119,0,40,0,671,6
2015,36047063800,"Census Tract 638, Kings County, New York",737,83,654,145,195,58750,1939,2008,1212,22.2,73,145,0,0,0,654,18
2016,36047063800,"Census Tract 638, Kings County, New York",699,65,634,128,188,74531,1940,2009,1389,22.2,67,122,6,0,0,634,24
2017,36047063800,"Census Tract 638, Kings County, New York",701,41,660,174,357,104444,1950,2011,1684,23,110,140,11,17,6,660,35
2018,36047063800,"Census Tract 638, Kings County, New York",694,13,681,178,394,113750,1952,2015,1754,21.6,108,116,29,14,19,681,42
2019,36047063800,"Census Tract 638, Kings County, New York",705,0,705,208,445,111500,1951,2015,1870,21.9,138,145,30,14,19,705,39
2020,36047063800,"Census Tract 638, Kings County, New York",787,29,758,270,548,100417,1945,2013,1698,24.3,112,182,28,43,17,758,32
2012,36047064000,"Census Tract 640, Kings County, New York",600,12,588,76,176,46333,1944,2000,697,16.7,18,61,0,15,0,588,64
2013,36047064000,"Census Tract 640, Kings County, New York",620,16,604,98,244,65417,1939,2004,1021,19.5,29,87,0,11,0,604,66
2014,36047064000,"Census Tract 640, Kings County, New York",633,33,600,92,215,49545,1939,2009,925,20.6,17,70,0,22,0,600,73
2015,36047064000,"Census Tract 640, Kings County, New York",627,43,584,90,196,65357,1939,2008,1007,20.1,25,71,0,19,0,584,75
2016,36047064000,"Census Tract 640, Kings County, New York",614,59,555,87,166,69464,1939,2010,1094,20.9,36,69,0,18,0,555,29
2017,36047064000,"Census Tract 640, Kings County, New York",641,69,572,58,97,92857,1939,2010,1633,23.3,31,58,0,0,0,572,20
2018,36047064000,"Census Tract 640, Kings County, New York",609,51,558,28,45,NA,1947,2007,1375,51,16,28,0,0,0,558,31
2019,36047064000,"Census Tract 640, Kings County, New York",627,58,569,36,55,NA,1943,2010,1344,28.6,19,36,0,0,0,569,30
2020,36047064000,"Census Tract 640, Kings County, New York",633,80,553,48,60,98824,1943,2013,1652,22.1,33,48,0,0,0,553,21
2012,36047064200,"Census Tract 642, Kings County, New York",1000,100,900,514,1339,60603,1939,2000,1169,25.1,307,471,0,15,28,900,110
2013,36047064200,"Census Tract 642, Kings County, New York",992,75,917,500,1127,51875,1939,2002,1160,28.1,264,467,0,14,19,917,110
2014,36047064200,"Census Tract 642, Kings County, New York",981,82,899,534,1209,48929,1939,2003,1254,31.6,261,478,0,10,46,899,127
2015,36047064200,"Census Tract 642, Kings County, New York",962,77,885,546,1232,46481,1939,2005,1244,32.6,212,473,0,5,68,885,140
2016,36047064200,"Census Tract 642, Kings County, New York",966,98,868,568,1315,46800,1941,2006,1264,31.7,242,449,6,5,101,868,137
2017,36047064200,"Census Tract 642, Kings County, New York",957,79,878,538,1246,44583,1942,2006,1219,33.3,202,398,26,12,95,878,170
2018,36047064200,"Census Tract 642, Kings County, New York",942,80,862,521,1117,41250,1941,2006,1237,33,235,389,49,5,71,862,189
2019,36047064200,"Census Tract 642, Kings County, New York",979,110,869,533,1098,46331,1941,2006,1306,30.6,225,404,50,14,59,869,158
2020,36047064200,"Census Tract 642, Kings County, New York",949,105,844,487,1063,41083,1940,2007,1340,30.1,215,371,53,25,33,844,146
2012,36047064400,"Census Tract 644, Kings County, New York",903,115,788,283,655,56050,1942,2004,1117,18.9,82,228,0,0,55,788,74
2013,36047064400,"Census Tract 644, Kings County, New York",901,142,759,328,716,78241,1943,2006,1226,18,80,254,5,11,58,759,108
2014,36047064400,"Census Tract 644, Kings County, New York",913,79,834,306,740,79583,1941,2011,1225,18.8,91,222,2,15,67,834,118
2015,36047064400,"Census Tract 644, Kings County, New York",878,91,787,226,616,65476,1942,2012,1212,25.6,67,150,4,14,58,787,116
2016,36047064400,"Census Tract 644, Kings County, New York",938,95,843,251,685,65739,1943,2011,1307,25.5,73,155,4,16,76,843,122
2017,36047064400,"Census Tract 644, Kings County, New York",934,89,845,262,808,66544,1939,2012,1444,31.5,99,146,6,33,77,845,84
2018,36047064400,"Census Tract 644, Kings County, New York",912,57,855,245,737,68125,0,2012,1554,33,95,119,0,26,100,855,59
2019,36047064400,"Census Tract 644, Kings County, New York",898,81,817,272,826,70234,1940,2011,1572,32.3,85,113,0,58,101,817,71
2020,36047064400,"Census Tract 644, Kings County, New York",912,50,862,306,1000,57500,0,2012,1759,40.3,89,133,0,58,74,862,110
2012,36047064600,"Census Tract 646, Kings County, New York",717,10,707,183,513,47019,1939,2006,1356,31.9,73,87,26,17,49,707,73
2013,36047064600,"Census Tract 646, Kings County, New York",716,12,704,192,526,55000,1939,2006,1371,32.5,76,94,28,9,57,704,72
2014,36047064600,"Census Tract 646, Kings County, New York",739,12,727,200,543,60313,1939,2006,1354,31.9,79,94,30,12,60,727,40
2015,36047064600,"Census Tract 646, Kings County, New York",702,25,677,150,410,73875,1939,2011,1431,26.5,81,128,0,11,0,677,23
2016,36047064600,"Census Tract 646, Kings County, New York",699,39,660,117,295,87583,1939,2012,1494,24.6,57,109,0,0,0,660,28
2017,36047064600,"Census Tract 646, Kings County, New York",696,23,673,89,240,64219,1944,2012,1486,23.9,53,67,13,0,0,673,25
2018,36047064600,"Census Tract 646, Kings County, New York",691,25,666,125,382,NA,0,2014,1363,23.8,77,100,15,0,0,666,30
2019,36047064600,"Census Tract 646, Kings County, New York",676,29,647,145,447,64491,0,2014,1323,23.5,100,104,27,6,0,647,33
2020,36047064600,"Census Tract 646, Kings County, New York",696,25,671,130,327,62768,0,2016,1277,22.8,67,70,28,32,0,671,46
2012,36047064800,"Census Tract 648, Kings County, New York",715,68,647,149,445,32150,1939,2005,1174,28.8,56,39,110,0,30,647,63
2013,36047064800,"Census Tract 648, Kings County, New York",714,69,645,158,437,32404,1939,2005,1214,28.5,54,35,108,15,27,645,43
2014,36047064800,"Census Tract 648, Kings County, New York",729,48,681,197,548,34375,1939,2008,1313,41.5,53,31,149,17,31,681,60
2015,36047064800,"Census Tract 648, Kings County, New York",717,68,649,202,572,NA,1939,2008,1432,29.7,26,52,134,16,29,649,61
2016,36047064800,"Census Tract 648, Kings County, New York",713,73,640,187,632,67831,1939,2010,1495,27.2,35,83,83,21,34,640,44
2017,36047064800,"Census Tract 648, Kings County, New York",723,73,650,176,513,61607,1943,2005,1479,43.4,32,74,87,15,0,650,39
2018,36047064800,"Census Tract 648, Kings County, New York",687,63,624,169,520,64554,1942,2005,1592,42.6,37,81,88,0,0,624,46
2019,36047064800,"Census Tract 648, Kings County, New York",680,69,611,135,482,81576,1951,2001,1750,23.1,40,75,60,0,0,611,13
2020,36047064800,"Census Tract 648, Kings County, New York",709,56,653,131,495,101625,1954,2007,1898,22.9,47,70,61,0,0,653,10
2012,36047065000,"Census Tract 650, Kings County, New York",516,18,498,166,423,36964,1945,2002,969,30.2,74,42,110,0,14,498,79
2013,36047065000,"Census Tract 650, Kings County, New York",542,12,530,179,442,36845,1941,2004,1021,32.5,57,40,118,0,21,530,85
2014,36047065000,"Census Tract 650, Kings County, New York",536,23,513,166,394,39250,1950,2004,1132,31.6,53,59,71,16,20,513,67
2015,36047065000,"Census Tract 650, Kings County, New York",529,30,499,158,325,38043,1951,2008,1272,33.8,29,65,44,26,23,499,65
2016,36047065000,"Census Tract 650, Kings County, New York",509,25,484,165,393,27422,1955,2010,1475,42.5,44,51,61,35,18,484,112
2017,36047065000,"Census Tract 650, Kings County, New York",515,13,502,176,544,33594,1951,2011,1492,33.5,36,48,82,29,29,502,100
2018,36047065000,"Census Tract 650, Kings County, New York",513,11,502,164,538,55962,1953,2010,1439,28.7,52,50,70,29,31,502,87
2019,36047065000,"Census Tract 650, Kings County, New York",508,19,489,187,547,69554,1954,2009,1397,26,82,40,102,21,41,489,73
2020,36047065000,"Census Tract 650, Kings County, New York",520,15,505,201,523,69432,1950,2007,1382,24.6,61,29,115,7,65,505,54
2012,36047065200,"Census Tract 652, Kings County, New York",507,42,465,91,272,79315,1948,1997,1162,14.6,31,82,0,9,0,465,49
2013,36047065200,"Census Tract 652, Kings County, New York",522,60,462,89,186,59875,1945,2003,1171,10,56,79,0,10,0,462,20
2014,36047065200,"Census Tract 652, Kings County, New York",540,62,478,76,125,87500,1947,2006,1125,18,45,66,0,10,0,478,10
2015,36047065200,"Census Tract 652, Kings County, New York",516,23,493,124,200,NA,1947,2010,1096,40.3,74,124,0,0,0,493,34
2016,36047065200,"Census Tract 652, Kings County, New York",521,39,482,120,175,40735,1945,2011,1048,44.1,72,120,0,0,0,482,18
2017,36047065200,"Census Tract 652, Kings County, New York",521,37,484,109,158,40486,1952,2011,1295,45.6,70,109,0,0,0,484,21
2018,36047065200,"Census Tract 652, Kings County, New York",525,27,498,94,164,44844,0,2012,975,19,51,88,0,0,6,498,21
2019,36047065200,"Census Tract 652, Kings County, New York",486,17,469,96,176,56250,0,2013,868,14.2,60,90,0,0,6,469,25
2020,36047065200,"Census Tract 652, Kings County, New York",497,37,460,69,135,61813,0,2017,1599,29.6,53,63,0,0,6,460,12
2012,36047065400,"Census Tract 654, Kings County, New York",600,21,579,44,97,25455,1939,2004,1167,28.5,5,44,0,0,0,579,46
2013,36047065400,"Census Tract 654, Kings County, New York",610,21,589,51,125,25859,1939,2003,1528,29.1,6,51,0,0,0,589,72
2014,36047065400,"Census Tract 654, Kings County, New York",620,0,620,32,43,9853,1939,2006,247,26.8,5,32,0,0,0,620,61
2015,36047065400,"Census Tract 654, Kings County, New York",617,5,612,34,50,NA,1939,2007,NA,27,5,34,0,0,0,612,51
2016,36047065400,"Census Tract 654, Kings County, New York",602,8,594,18,42,71250,1939,2013,1500,25,4,18,0,0,0,594,37
2017,36047065400,"Census Tract 654, Kings County, New York",588,24,564,25,48,NA,1952,2008,1625,50,10,25,0,0,0,564,35
2018,36047065400,"Census Tract 654, Kings County, New York",590,43,547,38,75,NA,0,2014,1711,26,23,38,0,0,0,547,26
2019,36047065400,"Census Tract 654, Kings County, New York",584,45,539,57,113,NA,1951,2018,2040,25.5,25,57,0,0,0,539,45
2020,36047065400,"Census Tract 654, Kings County, New York",570,28,542,74,186,NA,0,2009,2560,32.1,49,74,0,0,0,542,30
2012,36047065600,"Census Tract 656, Kings County, New York",633,6,627,55,106,28625,1945,2005,NA,NA,0,55,0,0,0,627,107
2013,36047065600,"Census Tract 656, Kings County, New York",639,7,632,43,82,NA,NA,NA,NA,NA,0,43,0,0,0,632,99
2014,36047065600,"Census Tract 656, Kings County, New York",645,6,639,28,39,30978,1939,2011,NA,NA,6,11,0,0,17,639,78
2015,36047065600,"Census Tract 656, Kings County, New York",648,19,629,34,55,30568,1939,2012,NA,NA,7,19,0,0,15,629,73
2016,36047065600,"Census Tract 656, Kings County, New York",637,11,626,73,154,56141,1939,2014,1211,30.4,8,38,0,0,35,626,56
2017,36047065600,"Census Tract 656, Kings County, New York",633,17,616,76,186,59342,1939,2013,2008,31.6,6,44,0,0,32,616,55
2018,36047065600,"Census Tract 656, Kings County, New York",643,14,629,106,223,58625,0,2015,1151,27.9,6,45,8,0,53,629,41
2019,36047065600,"Census Tract 656, Kings County, New York",625,21,604,96,211,61979,0,2016,1149,26.5,0,41,8,0,47,604,21
2020,36047065600,"Census Tract 656, Kings County, New York",650,6,644,91,195,68750,0,2016,1175,27,10,41,9,0,41,644,12
2012,36047065800,"Census Tract 658, Kings County, New York",748,47,701,115,264,43264,1943,2003,1131,29.7,52,106,0,0,9,701,45
2013,36047065800,"Census Tract 658, Kings County, New York",769,50,719,118,263,32206,1945,2004,1158,31.9,59,110,0,0,8,719,49
2014,36047065800,"Census Tract 658, Kings County, New York",778,43,735,95,223,37361,1944,2006,1149,30.8,64,95,0,0,0,735,38
2015,36047065800,"Census Tract 658, Kings County, New York",787,70,717,134,325,35962,1945,2007,1168,37.4,66,114,0,14,6,717,60
2016,36047065800,"Census Tract 658, Kings County, New York",791,56,735,145,368,36023,1939,2012,1162,39.8,58,123,0,16,6,735,24
2017,36047065800,"Census Tract 658, Kings County, New York",774,58,716,115,330,50750,1950,2011,1375,37.9,40,91,0,17,7,716,21
2018,36047065800,"Census Tract 658, Kings County, New York",778,77,701,118,343,61250,1946,2010,1250,36.2,33,87,0,17,14,701,23
2019,36047065800,"Census Tract 658, Kings County, New York",770,117,653,115,309,53365,1944,2012,1509,39,32,68,6,26,21,653,32
2020,36047065800,"Census Tract 658, Kings County, New York",742,93,649,95,210,48542,0,2011,1528,44.6,20,61,6,6,28,649,22
2012,36047066000,"Census Tract 660, Kings County, New York",711,55,656,23,58,62656,1939,1983,1330,50,15,23,0,0,0,656,56
2013,36047066000,"Census Tract 660, Kings County, New York",743,86,657,27,97,192750,1961,1994,NA,NA,19,27,0,0,0,657,43
2014,36047066000,"Census Tract 660, Kings County, New York",770,84,686,25,92,197596,1960,1993,NA,NA,17,25,0,0,0,686,22
2015,36047066000,"Census Tract 660, Kings County, New York",758,77,681,25,104,198047,1962,1998,1609,13,20,25,0,0,0,681,4
2016,36047066000,"Census Tract 660, Kings County, New York",752,64,688,32,107,NA,1965,2003,1472,14,23,32,0,0,0,688,4
2017,36047066000,"Census Tract 660, Kings County, New York",759,49,710,34,104,NA,1965,1998,1444,14.3,25,34,0,0,0,710,9
2018,36047066000,"Census Tract 660, Kings County, New York",738,20,718,18,27,NA,1972,2008,1225,36,10,18,0,0,0,718,10
2019,36047066000,"Census Tract 660, Kings County, New York",716,37,679,34,43,41071,1956,2011,1500,42.1,11,34,0,0,0,679,11
2020,36047066000,"Census Tract 660, Kings County, New York",752,25,727,94,193,95882,0,2020,1746,23.3,61,93,0,1,0,727,12
2012,36047066200,"Census Tract 662, Kings County, New York",636,72,564,157,380,70156,1981,2002,1227,26.5,40,116,0,0,41,564,17
2013,36047066200,"Census Tract 662, Kings County, New York",641,49,592,154,261,36346,1975,2005,1139,41.4,50,127,0,0,27,592,33
2014,36047066200,"Census Tract 662, Kings County, New York",633,48,585,138,232,41750,1957,2003,1069,35.6,43,107,0,0,31,585,12
2015,36047066200,"Census Tract 662, Kings County, New York",642,45,597,128,263,41176,1956,2006,1246,37.3,24,96,0,0,32,597,28
2016,36047066200,"Census Tract 662, Kings County, New York",644,35,609,147,311,40078,1956,2007,1295,39.7,24,108,0,0,39,609,42
2017,36047066200,"Census Tract 662, Kings County, New York",646,21,625,131,261,76146,1959,2006,1323,20.3,24,103,0,0,28,625,52
2018,36047066200,"Census Tract 662, Kings County, New York",648,22,626,119,266,96528,1961,1999,1439,16.9,24,77,0,4,38,626,38
2019,36047066200,"Census Tract 662, Kings County, New York",630,53,577,108,267,78750,1968,2007,1554,19.4,25,93,0,4,11,577,50
2020,36047066200,"Census Tract 662, Kings County, New York",645,71,574,120,240,48500,1969,2004,1399,32.1,31,89,14,5,12,574,43
2012,36047066600,"Census Tract 666, Kings County, New York",0,0,0,0,0,NA,NA,NA,NA,NA,0,0,0,0,0,0,0
2013,36047066600,"Census Tract 666, Kings County, New York",0,0,0,0,0,NA,NA,NA,NA,NA,0,0,0,0,0,0,0
2014,36047066600,"Census Tract 666, Kings County, New York",0,0,0,0,0,NA,NA,NA,NA,NA,0,0,0,0,0,0,0
2015,36047066600,"Census Tract 666, Kings County, New York",0,0,0,0,0,NA,NA,NA,NA,NA,0,0,0,0,0,0,0
2016,36047066600,"Census Tract 666, Kings County, New York",0,0,0,0,0,NA,NA,NA,NA,NA,0,0,0,0,0,0,0
2017,36047066600,"Census Tract 666, Kings County, New York",0,0,0,0,0,NA,NA,NA,NA,NA,0,0,0,0,0,0,0
2018,36047066600,"Census Tract 666, Kings County, New York",0,0,0,0,0,NA,NA,NA,NA,NA,0,0,0,0,0,0,0
2019,36047066600,"Census Tract 666, Kings County, New York",0,0,0,0,0,NA,NA,NA,NA,NA,0,0,0,0,0,0,0
2020,36047066600,"Census Tract 666, Kings County, New York",0,0,0,0,0,NA,NA,NA,NA,NA,0,0,0,0,0,0,0
2012,36047067000,"Census Tract 670, Kings County, New York",1103,42,1061,543,1463,46313,1958,2005,1450,34.3,89,128,339,0,101,1061,89
2013,36047067000,"Census Tract 670, Kings County, New York",1075,51,1024,433,1145,44145,1959,2005,1419,36.2,67,71,279,0,83,1024,81
2014,36047067000,"Census Tract 670, Kings County, New York",1077,55,1022,477,1254,49688,1961,2006,1430,33.7,49,90,317,0,70,1022,84
2015,36047067000,"Census Tract 670, Kings County, New York",1081,95,986,502,1327,50658,1960,2006,1447,32.5,79,79,333,5,86,986,114
2016,36047067000,"Census Tract 670, Kings County, New York",1077,98,979,428,1198,62576,1961,2007,1569,30,98,59,308,5,86,979,112
2017,36047067000,"Census Tract 670, Kings County, New York",1052,104,948,385,1091,61369,1959,2008,1551,31.1,103,72,259,5,73,948,106
2018,36047067000,"Census Tract 670, Kings County, New York",1081,92,989,456,1253,62619,1960,2010,1606,29.3,128,79,312,18,72,989,97
2019,36047067000,"Census Tract 670, Kings County, New York",1100,84,1016,416,1090,64000,1959,2011,1667,28.7,132,66,269,30,78,1016,105
2020,36047067000,"Census Tract 670, Kings County, New York",1168,94,1074,514,1169,77011,1962,2013,1686,27.4,212,153,265,21,61,1074,103
2012,36047067200,"Census Tract 672, Kings County, New York",464,18,446,179,567,30964,1939,2006,1471,50,0,6,142,0,31,446,33
2013,36047067200,"Census Tract 672, Kings County, New York",464,30,434,173,512,44083,1939,2009,1566,50,32,7,149,0,17,434,31
2014,36047067200,"Census Tract 672, Kings County, New York",467,26,441,163,543,50380,1939,2009,1480,50,23,13,125,0,25,441,67
2015,36047067200,"Census Tract 672, Kings County, New York",479,41,438,124,412,52159,1939,2010,1375,33.8,27,9,82,0,33,438,56
2016,36047067200,"Census Tract 672, Kings County, New York",491,42,449,139,399,51806,1939,2011,1329,33.9,40,16,100,0,23,449,47
2017,36047067200,"Census Tract 672, Kings County, New York",500,38,462,125,298,70078,1939,2011,1347,30.1,57,17,98,0,10,462,40
2018,36047067200,"Census Tract 672, Kings County, New York",497,31,466,143,470,62750,0,2013,1366,33.8,35,27,69,37,10,466,32
2019,36047067200,"Census Tract 672, Kings County, New York",498,33,465,133,391,51420,1943,2014,1438,37.3,36,34,60,27,12,465,11
2020,36047067200,"Census Tract 672, Kings County, New York",576,6,570,114,450,54048,0,2016,1821,41.8,21,37,33,23,21,570,15
2012,36047067400,"Census Tract 674, Kings County, New York",673,25,648,202,722,39545,1952,2006,1602,44.1,25,23,112,0,75,648,29
2013,36047067400,"Census Tract 674, Kings County, New York",674,32,642,173,567,39583,1954,2006,1470,27.9,0,29,96,0,64,642,67
2014,36047067400,"Census Tract 674, Kings County, New York",665,35,630,154,451,62692,1954,2008,1565,29.7,0,31,106,0,34,630,26
2015,36047067400,"Census Tract 674, Kings County, New York",662,40,622,131,449,36094,1954,2010,1616,50,8,0,120,0,26,622,21
2016,36047067400,"Census Tract 674, Kings County, New York",660,13,647,128,497,33382,1953,2012,1614,50,13,19,78,0,34,647,81
2017,36047067400,"Census Tract 674, Kings County, New York",660,49,611,148,607,34857,1939,2012,1588,39.6,16,18,92,0,17,611,68
2018,36047067400,"Census Tract 674, Kings County, New York",629,54,575,125,538,35804,1945,2012,1702,51,20,14,80,0,14,575,39
2019,36047067400,"Census Tract 674, Kings County, New York",628,68,560,144,640,45769,0,2012,1665,29.8,37,19,81,5,17,560,56
2020,36047067400,"Census Tract 674, Kings County, New York",655,102,553,145,513,45341,0,2011,1659,29.1,32,15,77,13,22,553,49
2012,36047067600,"Census Tract 676, Kings County, New York",653,16,637,155,560,27868,1945,2005,1308,49.4,52,40,98,0,17,637,55
2013,36047067600,"Census Tract 676, Kings County, New York",639,15,624,141,347,60058,1948,2005,1301,49,58,42,81,8,10,624,31
2014,36047067600,"Census Tract 676, Kings County, New York",626,13,613,120,278,60500,1951,2008,1754,41.5,47,29,78,6,7,613,25
2015,36047067600,"Census Tract 676, Kings County, New York",624,13,611,92,289,NA,1953,2011,1557,50,11,0,81,5,6,611,20
2016,36047067600,"Census Tract 676, Kings County, New York",632,12,620,158,518,71667,1950,2011,1792,48.8,60,0,147,5,24,620,20
2017,36047067600,"Census Tract 676, Kings County, New York",637,25,612,173,485,72917,1947,2011,1690,43.9,63,0,167,6,15,612,27
2018,36047067600,"Census Tract 676, Kings County, New York",587,34,553,195,640,72250,1947,2013,1720,41.1,60,0,195,0,20,553,40
2019,36047067600,"Census Tract 676, Kings County, New York",613,41,572,239,797,75350,1947,2015,1668,37.5,77,0,219,0,51,572,37
2020,36047067600,"Census Tract 676, Kings County, New York",591,46,545,242,823,74250,1949,2016,1721,37.8,83,12,194,0,73,545,63
2012,36047067800,"Census Tract 678, Kings County, New York",931,37,894,384,991,73438,1956,2004,1379,24,133,63,309,0,12,894,20
2013,36047067800,"Census Tract 678, Kings County, New York",946,59,887,407,980,75250,1960,2005,1483,24.6,181,54,344,0,9,887,21
2014,36047067800,"Census Tract 678, Kings County, New York",1009,122,887,411,954,63674,1962,2005,1567,30.1,149,61,350,0,0,887,33
2015,36047067800,"Census Tract 678, Kings County, New York",998,131,867,352,819,63214,1963,2005,1574,30.5,109,30,318,0,4,867,29
2016,36047067800,"Census Tract 678, Kings County, New York",1002,119,883,382,932,65167,1964,2006,1573,29.9,120,53,325,0,4,883,39
2017,36047067800,"Census Tract 678, Kings County, New York",984,84,900,335,864,66917,1964,2006,1607,29.6,81,42,290,0,3,900,38
2018,36047067800,"Census Tract 678, Kings County, New York",955,79,876,304,861,45625,1960,2007,1650,34.8,38,48,251,0,5,876,57
2019,36047067800,"Census Tract 678, Kings County, New York",957,12,945,324,940,47188,1958,2010,1690,36.8,50,23,294,0,7,945,34
2020,36047067800,"Census Tract 678, Kings County, New York",952,0,952,387,1298,61354,1959,2012,1654,31.4,67,17,359,0,0,952,86
2012,36047068000,"Census Tract 680, Kings County, New York",636,57,579,194,743,23902,1939,2006,779,40,30,18,143,8,36,579,75
2013,36047068000,"Census Tract 680, Kings County, New York",613,57,556,225,962,25221,1939,2006,788,41.1,42,24,163,4,50,556,115
2014,36047068000,"Census Tract 680, Kings County, New York",599,23,576,191,822,38594,1939,2006,862,40.6,32,20,139,6,40,576,90
2015,36047068000,"Census Tract 680, Kings County, New York",597,15,582,172,798,58684,1943,2007,947,26.6,34,25,145,2,17,582,70
2016,36047068000,"Census Tract 680, Kings County, New York",607,13,594,148,747,45278,1945,2010,1395,50,15,10,114,15,33,594,50
2017,36047068000,"Census Tract 680, Kings County, New York",616,13,603,187,952,45703,1948,2011,1379,28.2,37,0,165,0,31,603,52
2018,36047068000,"Census Tract 680, Kings County, New York",640,0,640,185,761,NA,0,2012,1650,25.1,35,0,129,0,64,640,0
2019,36047068000,"Census Tract 680, Kings County, New York",684,20,664,252,873,45903,0,2016,1483,42.7,46,0,173,0,93,664,0
2020,36047068000,"Census Tract 680, Kings County, New York",699,19,680,204,634,45917,0,2016,1482,41.2,25,5,122,0,88,680,5
2012,36047068200,"Census Tract 682, Kings County, New York",900,0,900,167,325,41875,1949,2007,1208,40.4,31,12,130,0,25,900,19
2013,36047068200,"Census Tract 682, Kings County, New York",895,20,875,117,233,36157,1960,2009,1160,45.6,24,4,86,0,27,875,4
2014,36047068200,"Census Tract 682, Kings County, New York",893,26,867,130,282,35721,1960,2009,1265,47,7,28,73,0,29,867,12
2015,36047068200,"Census Tract 682, Kings County, New York",901,24,877,188,534,36806,1957,2010,1338,43.7,7,41,119,0,28,877,13
2016,36047068200,"Census Tract 682, Kings County, New York",899,21,878,159,505,NA,1955,2010,1382,36.7,8,36,81,8,26,878,12
2017,36047068200,"Census Tract 682, Kings County, New York",901,36,865,137,423,67688,1958,2009,1403,27.9,8,37,77,15,0,865,23
2018,36047068200,"Census Tract 682, Kings County, New York",893,51,842,117,356,54464,1958,2011,1488,31.1,8,37,58,15,0,842,39
2019,36047068200,"Census Tract 682, Kings County, New York",910,47,863,174,571,NA,0,2013,1735,18.8,67,12,125,13,16,863,23
2020,36047068200,"Census Tract 682, Kings County, New York",950,65,885,216,466,NA,1941,2016,1589,17.5,50,0,74,13,101,885,55
2012,36047068600,"Census Tract 686, Kings County, New York",668,45,623,145,291,44375,1957,2005,1094,36.1,61,49,65,6,25,623,69
2013,36047068600,"Census Tract 686, Kings County, New York",740,57,683,199,450,57361,1955,2006,1333,31.4,72,51,57,23,33,683,70
2014,36047068600,"Census Tract 686, Kings County, New York",730,57,673,202,443,40313,1955,2008,1375,39,80,62,95,22,29,673,107
2015,36047068600,"Census Tract 686, Kings County, New York",737,41,696,245,528,42750,1955,2010,1336,37.6,105,84,95,21,35,696,93
2016,36047068600,"Census Tract 686, Kings County, New York",733,28,705,249,545,41845,1955,2010,1323,38,101,96,80,15,41,705,79
2017,36047068600,"Census Tract 686, Kings County, New York",722,30,692,242,574,43929,1954,2010,1513,38.7,112,92,74,18,46,692,61
2018,36047068600,"Census Tract 686, Kings County, New York",710,47,663,226,546,41442,1955,2010,1214,44,80,107,80,11,50,663,73
2019,36047068600,"Census Tract 686, Kings County, New York",705,75,630,175,362,55787,1950,2009,1230,34.2,39,98,44,7,26,630,53
2020,36047068600,"Census Tract 686, Kings County, New York",688,63,625,181,519,NA,1959,2015,1232,35.6,23,112,41,9,19,625,63
2012,36047068800,"Census Tract 688, Kings County, New York",636,21,615,196,581,49375,1946,2007,1406,29.7,46,44,152,0,49,615,34
2013,36047068800,"Census Tract 688, Kings County, New York",628,32,596,234,666,55441,1945,2006,1348,29.5,54,86,141,0,61,596,30
2014,36047068800,"Census Tract 688, Kings County, New York",626,39,587,187,475,51691,1947,2005,1299,29,51,100,80,0,27,587,31
2015,36047068800,"Census Tract 688, Kings County, New York",624,17,607,196,452,51579,1946,2003,1314,29.4,41,131,56,0,20,607,30
2016,36047068800,"Census Tract 688, Kings County, New York",605,13,592,133,281,57321,1945,2002,1178,26.7,41,90,37,0,20,592,31
2017,36047068800,"Census Tract 688, Kings County, New York",604,23,581,151,311,71932,1953,2002,1289,26.5,41,107,20,0,24,581,47
2018,36047068800,"Census Tract 688, Kings County, New York",596,13,583,110,203,72167,1963,2006,1618,27,34,74,15,0,21,583,28
2019,36047068800,"Census Tract 688, Kings County, New York",609,22,587,121,275,74083,1956,2012,2077,29.5,43,51,39,0,25,587,26
2020,36047068800,"Census Tract 688, Kings County, New York",701,24,677,169,344,74479,1949,2005,1669,37.5,55,34,93,0,37,677,21
2012,36047069000,"Census Tract 690, Kings County, New York",606,17,589,90,175,36328,1951,2005,1319,50,17,53,37,0,0,589,14
2013,36047069000,"Census Tract 690, Kings County, New York",600,28,572,96,176,36638,1953,2003,1183,50,16,60,36,0,0,572,14
2014,36047069000,"Census Tract 690, Kings County, New York",654,42,612,99,200,65391,1962,2005,1434,40.2,16,36,63,0,0,612,7
2015,36047069000,"Census Tract 690, Kings County, New York",659,37,622,151,378,65045,1970,2005,1570,42.9,20,42,94,15,0,622,26
2016,36047069000,"Census Tract 690, Kings County, New York",656,49,607,202,624,75313,1956,2009,1631,25.2,47,38,131,14,19,607,35
2017,36047069000,"Census Tract 690, Kings County, New York",667,37,630,185,582,78964,1956,2009,1451,22.5,48,31,99,17,22,630,47
2018,36047069000,"Census Tract 690, Kings County, New York",665,35,630,214,639,69625,1958,2009,1492,35.3,92,14,155,17,28,630,53
2019,36047069000,"Census Tract 690, Kings County, New York",657,19,638,212,678,71053,1956,2011,1459,28.3,105,12,127,19,56,638,60
2020,36047069000,"Census Tract 690, Kings County, New York",616,17,599,179,663,86050,1959,2014,1491,19.5,90,0,97,0,84,599,29
2012,36047069200,"Census Tract 692, Kings County, New York",839,70,769,266,761,48500,1959,2004,1438,32.1,68,21,213,0,32,769,52
2013,36047069200,"Census Tract 692, Kings County, New York",841,48,793,297,859,50250,1957,2005,1539,30.3,96,26,242,0,29,793,59
2014,36047069200,"Census Tract 692, Kings County, New York",848,44,804,266,774,61339,1954,2006,1500,24.6,91,28,226,0,6,804,65
2015,36047069200,"Census Tract 692, Kings County, New York",854,46,808,316,1194,86250,1954,2009,1669,26.5,156,14,283,9,4,808,36
2016,36047069200,"Census Tract 692, Kings County, New York",857,46,811,316,1174,88864,1954,2010,1622,24.1,162,10,286,9,0,811,15
2017,36047069200,"Census Tract 692, Kings County, New York",849,38,811,288,1129,108750,1953,2011,1679,20.7,152,15,254,10,0,811,9
2018,36047069200,"Census Tract 692, Kings County, New York",860,40,820,272,1019,109792,1955,2011,1699,20,128,23,216,10,6,820,5
2019,36047069200,"Census Tract 692, Kings County, New York",872,38,834,279,949,115078,1956,2012,1778,22.3,125,25,229,11,7,834,3
2020,36047069200,"Census Tract 692, Kings County, New York",908,70,838,191,550,86813,1963,2012,1701,21.9,66,28,143,0,7,838,4
2012,36047069601,"Census Tract 696.01, Kings County, New York",1587,111,1476,702,1864,43176,1974,2005,1375,37.3,204,350,268,0,79,1476,125
2013,36047069601,"Census Tract 696.01, Kings County, New York",1563,125,1438,721,1773,48906,1973,2006,1437,34.8,207,389,262,0,86,1438,176
2014,36047069601,"Census Tract 696.01, Kings County, New York",1621,103,1518,833,2103,50150,1974,2007,1523,35.7,251,359,327,20,180,1518,233
2015,36047069601,"Census Tract 696.01, Kings County, New York",1655,108,1547,898,2011,40978,1973,2007,1476,34.6,224,369,354,14,225,1547,234
2016,36047069601,"Census Tract 696.01, Kings County, New York",1583,58,1525,964,2239,41094,1972,2009,1478,36.4,267,420,369,16,223,1525,214
2017,36047069601,"Census Tract 696.01, Kings County, New York",1545,112,1433,855,1878,57536,1972,2008,1574,33.1,267,362,358,19,193,1433,225
2018,36047069601,"Census Tract 696.01, Kings County, New York",1584,135,1449,873,2008,65069,1969,2011,1726,34.2,352,279,483,19,138,1449,166
2019,36047069601,"Census Tract 696.01, Kings County, New York",1540,177,1363,850,1838,69773,1967,2011,1756,33.7,297,351,485,0,52,1363,96
2020,36047069601,"Census Tract 696.01, Kings County, New York",1552,237,1315,788,1688,58942,1967,2012,1842,36.7,195,305,483,0,37,1315,111
2012,36047069602,"Census Tract 696.02, Kings County, New York",2187,188,1999,597,1637,54458,1970,2005,1433,33.6,122,426,117,0,54,1999,165
2013,36047069602,"Census Tract 696.02, Kings County, New York",2262,162,2100,698,1974,56618,1973,2006,1415,31.8,174,473,172,0,89,2100,132
2014,36047069602,"Census Tract 696.02, Kings County, New York",2302,232,2070,657,1651,56825,1973,2005,1384,28.5,205,411,190,0,87,2070,120
2015,36047069602,"Census Tract 696.02, Kings County, New York",2353,168,2185,759,1946,46563,1980,2006,1339,28.5,218,395,226,6,164,2185,225
2016,36047069602,"Census Tract 696.02, Kings County, New York",2324,122,2202,730,1781,45776,1979,2007,1359,29.4,221,413,183,8,159,2202,233
2017,36047069602,"Census Tract 696.02, Kings County, New York",2351,132,2219,710,1945,60929,1978,2008,1474,28.5,201,460,131,8,146,2219,218
2018,36047069602,"Census Tract 696.02, Kings County, New York",2359,214,2145,593,1520,49440,1980,2008,1338,32.7,135,392,36,17,148,2145,247
2019,36047069602,"Census Tract 696.02, Kings County, New York",2311,175,2136,558,1533,37583,1979,2008,1339,41.8,115,385,0,41,132,2136,276
2020,36047069602,"Census Tract 696.02, Kings County, New York",2252,187,2065,450,1069,22262,1966,2008,1360,51,139,348,21,25,77,2065,196
2012,36047069800,"Census Tract 698, Kings County, New York",489,22,467,74,164,16250,1963,2005,1778,50,6,74,0,0,0,467,81
2013,36047069800,"Census Tract 698, Kings County, New York",501,0,501,117,224,38250,1965,2008,1647,50,36,110,0,0,7,501,85
2014,36047069800,"Census Tract 698, Kings County, New York",516,24,492,132,223,19135,1969,2011,1227,50,55,121,0,5,6,492,58
2015,36047069800,"Census Tract 698, Kings County, New York",519,25,494,145,328,35568,1983,2011,1596,50,73,126,0,11,8,494,41
2016,36047069800,"Census Tract 698, Kings County, New York",517,39,478,129,323,44250,1965,2012,1520,40.5,81,112,0,11,6,478,13
2017,36047069800,"Census Tract 698, Kings County, New York",517,39,478,120,291,41000,1968,2012,1529,45,70,101,0,12,7,478,14
2018,36047069800,"Census Tract 698, Kings County, New York",496,33,463,84,253,79500,1956,2013,1750,33.5,39,70,0,14,0,463,0
2019,36047069800,"Census Tract 698, Kings County, New York",480,31,449,47,152,84107,1964,2015,2115,24.6,21,42,0,5,0,449,0
2020,36047069800,"Census Tract 698, Kings County, New York",470,48,422,22,40,115208,0,2016,NA,NA,5,22,0,0,0,422,0
2012,36047070000,"Census Tract 700, Kings County, New York",680,36,644,187,479,80938,1958,2003,1486,26.6,35,187,0,0,0,644,12
2013,36047070000,"Census Tract 700, Kings County, New York",668,0,668,198,436,59375,1958,2004,1295,30,10,180,0,0,18,668,8
2014,36047070000,"Census Tract 700, Kings County, New York",672,0,672,249,549,58750,1958,2005,1349,32.6,12,215,13,0,21,672,27
2015,36047070000,"Census Tract 700, Kings County, New York",678,0,678,268,550,43542,1963,2008,1330,35.4,53,232,14,0,22,678,30
2016,36047070000,"Census Tract 700, Kings County, New York",671,0,671,261,594,45329,1961,2010,1480,42.4,61,225,14,0,22,671,44
2017,36047070000,"Census Tract 700, Kings County, New York",649,14,635,238,535,46136,1963,2011,1492,38.4,75,200,15,0,23,635,37
2018,36047070000,"Census Tract 700, Kings County, New York",646,18,628,256,565,46538,1963,2012,1685,34.7,73,234,22,0,0,628,47
2019,36047070000,"Census Tract 700, Kings County, New York",629,19,610,215,473,63125,1966,2013,1789,27.8,96,208,7,0,7,610,39
2020,36047070000,"Census Tract 700, Kings County, New York",724,51,673,341,536,49813,1964,2013,1521,32.5,76,256,67,0,27,673,46
2012,36047070201,"Census Tract 702.01, Kings County, New York",2468,113,2355,595,1492,47301,1963,2005,1448,39.8,251,579,0,0,16,2355,171
2013,36047070201,"Census Tract 702.01, Kings County, New York",2472,137,2335,529,1269,45710,1963,2005,1548,50,200,515,0,0,14,2335,226
2014,36047070201,"Census Tract 702.01, Kings County, New York",2514,172,2342,567,1157,34263,1964,2006,1447,50,216,552,0,0,15,2342,299
2015,36047070201,"Census Tract 702.01, Kings County, New York",2534,226,2308,567,1227,33381,1964,2006,1527,50,182,539,0,0,28,2308,246
2016,36047070201,"Census Tract 702.01, Kings County, New York",2532,200,2332,476,941,40515,1963,2007,1408,50,177,458,0,0,18,2332,223
2017,36047070201,"Census Tract 702.01, Kings County, New York",2617,315,2302,386,683,NA,1962,2006,1452,50,159,349,0,0,37,2302,213
2018,36047070201,"Census Tract 702.01, Kings County, New York",2575,284,2291,364,708,NA,1964,2005,1658,51,136,322,0,0,42,2291,153
2019,36047070201,"Census Tract 702.01, Kings County, New York",2564,240,2324,332,830,54500,1965,2005,2115,49.8,95,291,0,0,41,2324,100
2020,36047070201,"Census Tract 702.01, Kings County, New York",2361,147,2214,315,850,53750,1965,2014,1814,33.2,139,274,0,0,22,2214,58
2012,36047070202,"Census Tract 702.02, Kings County, New York",27,0,27,0,0,NA,NA,NA,NA,NA,0,0,0,0,0,27,27
2013,36047070202,"Census Tract 702.02, Kings County, New York",27,0,27,0,0,NA,NA,NA,NA,NA,0,0,0,0,0,27,27
2014,36047070202,"Census Tract 702.02, Kings County, New York",3,0,3,0,0,NA,NA,NA,NA,NA,0,0,0,0,0,3,0
2015,36047070202,"Census Tract 702.02, Kings County, New York",3,0,3,0,0,NA,NA,NA,NA,NA,0,0,0,0,0,3,0
2016,36047070202,"Census Tract 702.02, Kings County, New York",4,0,4,0,0,NA,NA,NA,NA,NA,0,0,0,0,0,4,0
2017,36047070202,"Census Tract 702.02, Kings County, New York",8,0,8,4,8,NA,NA,NA,NA,NA,4,4,0,0,0,8,0
2018,36047070202,"Census Tract 702.02, Kings County, New York",8,0,8,4,8,NA,NA,NA,NA,NA,4,4,0,0,0,8,0
2019,36047070202,"Census Tract 702.02, Kings County, New York",4,0,4,4,8,NA,NA,NA,NA,NA,4,4,0,0,0,4,0
2020,36047070202,"Census Tract 702.02, Kings County, New York",13,0,13,13,26,NA,NA,NA,NA,NA,13,13,0,0,0,13,0
2012,36047070203,"Census Tract 702.03, Kings County, New York",0,0,0,0,0,NA,NA,NA,NA,NA,0,0,0,0,0,0,0
2013,36047070203,"Census Tract 702.03, Kings County, New York",0,0,0,0,0,NA,NA,NA,NA,NA,0,0,0,0,0,0,0
2014,36047070203,"Census Tract 702.03, Kings County, New York",0,0,0,0,0,NA,NA,NA,NA,NA,0,0,0,0,0,0,0
2015,36047070203,"Census Tract 702.03, Kings County, New York",0,0,0,0,0,NA,NA,NA,NA,NA,0,0,0,0,0,0,0
2016,36047070203,"Census Tract 702.03, Kings County, New York",0,0,0,0,0,NA,NA,NA,NA,NA,0,0,0,0,0,0,0
2017,36047070203,"Census Tract 702.03, Kings County, New York",0,0,0,0,0,NA,NA,NA,NA,NA,0,0,0,0,0,0,0
2018,36047070203,"Census Tract 702.03, Kings County, New York",0,0,0,0,0,NA,NA,NA,NA,NA,0,0,0,0,0,0,0
2019,36047070203,"Census Tract 702.03, Kings County, New York",0,0,0,0,0,NA,NA,NA,NA,NA,0,0,0,0,0,0,0
2020,36047070203,"Census Tract 702.03, Kings County, New York",0,0,0,0,0,NA,NA,NA,NA,NA,0,0,0,0,0,0,0
2012,36047070600,"Census Tract 706, Kings County, New York",1068,57,1011,180,343,57344,1972,2004,1308,30.7,20,164,0,0,16,1011,0
2013,36047070600,"Census Tract 706, Kings County, New York",1072,41,1031,176,354,70714,1974,2006,1448,30.5,28,159,0,0,17,1031,6
2014,36047070600,"Census Tract 706, Kings County, New York",1063,45,1018,134,265,72143,1976,2008,1929,31.4,37,115,0,0,19,1018,13
2015,36047070600,"Census Tract 706, Kings County, New York",1061,41,1020,165,351,58698,1975,2008,1817,33.1,45,131,10,0,24,1020,14
2016,36047070600,"Census Tract 706, Kings County, New York",1028,56,972,137,267,54875,1974,2009,2142,32.6,50,125,12,0,0,972,34
2017,36047070600,"Census Tract 706, Kings County, New York",1040,84,956,170,488,65682,1969,2011,2288,32.5,96,125,45,0,0,956,43
2018,36047070600,"Census Tract 706, Kings County, New York",1035,70,965,180,590,67045,1967,2010,2226,26.1,80,136,44,0,0,965,43
2019,36047070600,"Census Tract 706, Kings County, New York",1047,100,947,204,673,NA,1968,2009,2229,23.1,92,153,51,0,0,947,57
2020,36047070601,"Census Tract 706.01, Kings County, New York",1116,211,905,162,506,NA,1967,2010,2051,13.7,76,129,32,0,0,905,83
2020,36047070602,"Census Tract 706.02, Kings County, New York",0,0,0,0,0,NA,NA,NA,NA,NA,0,0,0,0,0,0,0
2012,36047072000,"Census Tract 720, Kings County, New York",704,44,660,349,1048,60694,1965,2003,1496,29.7,115,15,322,12,16,660,82
2013,36047072000,"Census Tract 720, Kings County, New York",695,55,640,376,1252,62586,1965,2003,1583,32,108,16,348,12,7,640,65
2014,36047072000,"Census Tract 720, Kings County, New York",697,55,642,370,1246,42315,1964,2004,1612,35.9,99,15,343,12,11,642,78
2015,36047072000,"Census Tract 720, Kings County, New York",677,67,610,361,1177,65417,1960,2007,1674,34.3,125,16,320,25,13,610,48
2016,36047072000,"Census Tract 720, Kings County, New York",699,63,636,403,1324,49375,1959,2008,1619,34.6,112,20,331,23,33,636,74
2017,36047072000,"Census Tract 720, Kings County, New York",716,53,663,407,1367,72875,1957,2010,1762,25,148,6,361,14,14,663,73
2018,36047072000,"Census Tract 720, Kings County, New York",717,56,661,437,1491,89279,1958,2011,1742,19.7,166,18,380,14,31,661,68
2019,36047072000,"Census Tract 720, Kings County, New York",734,90,644,462,1529,69423,1959,2012,1784,26.3,160,18,402,17,26,644,89
2020,36047072000,"Census Tract 720, Kings County, New York",709,63,646,401,1316,64955,1962,2012,1793,29.8,132,17,337,15,27,646,113
2012,36047072200,"Census Tract 722, Kings County, New York",1097,100,997,285,771,56902,1956,2001,1311,28,48,0,285,0,21,997,57
2013,36047072200,"Census Tract 722, Kings County, New York",1100,104,996,295,821,47969,1956,2002,1368,32.3,32,5,290,0,11,996,81
2014,36047072200,"Census Tract 722, Kings County, New York",1081,97,984,304,919,40357,1956,2004,1401,40.7,48,4,300,0,25,984,76
2015,36047072200,"Census Tract 722, Kings County, New York",1056,92,964,292,842,45000,1957,2005,1334,30,50,6,286,0,18,964,93
2016,36047072200,"Census Tract 722, Kings County, New York",1054,62,992,275,737,38009,1955,2009,1318,50,105,8,263,4,21,992,74
2017,36047072200,"Census Tract 722, Kings County, New York",1044,51,993,305,989,51563,1955,2008,1405,35.5,96,8,293,4,15,993,92
2018,36047072200,"Census Tract 722, Kings County, New York",1021,56,965,280,905,51667,1951,2007,1422,29.9,95,0,253,4,9,965,58
2019,36047072200,"Census Tract 722, Kings County, New York",1033,60,973,309,952,62417,1953,2011,1475,28,81,0,276,4,20,973,44
2020,36047072200,"Census Tract 722, Kings County, New York",1100,96,1004,329,1032,42232,1953,2012,1597,31.1,94,0,265,4,22,1004,83
2012,36047072400,"Census Tract 724, Kings County, New York",758,120,638,236,808,71500,1947,1998,1585,26,88,0,236,0,0,638,33
2013,36047072400,"Census Tract 724, Kings County, New York",721,94,627,253,853,78750,1949,2001,1507,23.5,96,5,248,0,0,627,32
2014,36047072400,"Census Tract 724, Kings County, New York",704,92,612,247,873,71779,1952,2003,1517,23.4,68,5,242,0,0,612,18
2015,36047072400,"Census Tract 724, Kings County, New York",705,93,612,239,818,71607,1954,2005,1440,24.8,49,5,234,0,0,612,37
2016,36047072400,"Census Tract 724, Kings County, New York",693,83,610,234,735,72000,1954,2006,1429,23.7,43,6,228,0,0,610,31
2017,36047072400,"Census Tract 724, Kings County, New York",684,74,610,243,647,51146,1954,2009,1301,31,23,12,224,0,7,610,61
2018,36047072400,"Census Tract 724, Kings County, New York",717,66,651,234,629,56250,1953,2009,1276,29.1,31,6,222,0,6,651,68
2019,36047072400,"Census Tract 724, Kings County, New York",756,50,706,234,653,49038,1952,2010,1422,31.7,45,5,223,0,12,706,67
2020,36047072400,"Census Tract 724, Kings County, New York",798,33,765,267,590,50977,1957,2009,1322,27.7,87,5,257,0,10,765,55
2012,36047072600,"Census Tract 726, Kings County, New York",856,88,768,96,169,32419,1953,2006,1150,16.9,47,8,88,0,12,768,32
2013,36047072600,"Census Tract 726, Kings County, New York",838,67,771,110,213,34750,1951,2006,1179,18.8,45,10,100,0,12,771,31
2014,36047072600,"Census Tract 726, Kings County, New York",818,69,749,76,153,31607,1951,2006,1202,33.3,30,0,76,0,11,749,34
2015,36047072600,"Census Tract 726, Kings County, New York",772,71,701,87,178,31914,1952,2007,1250,32.7,41,0,87,0,11,701,33
2016,36047072600,"Census Tract 726, Kings County, New York",753,65,688,94,328,44615,1939,2008,1274,24.9,31,0,81,0,13,688,27
2017,36047072600,"Census Tract 726, Kings County, New York",734,80,654,72,297,58889,1939,2006,1300,24.1,20,0,57,0,15,654,0
2018,36047072600,"Census Tract 726, Kings County, New York",724,65,659,61,269,58750,1960,2004,1302,23.3,21,0,46,0,15,659,11
2019,36047072600,"Census Tract 726, Kings County, New York",718,54,664,61,293,NA,0,2005,1165,23.8,23,0,39,0,22,664,11
2020,36047072600,"Census Tract 726, Kings County, New York",711,61,650,59,308,45625,0,2004,1149,30.6,15,0,40,0,23,650,19
2012,36047072800,"Census Tract 728, Kings County, New York",1617,187,1430,440,984,41250,1960,2002,1074,31,49,108,313,0,34,1430,107
2013,36047072800,"Census Tract 728, Kings County, New York",1599,170,1429,428,997,41154,1961,2000,941,28.3,43,94,313,0,34,1429,128
2014,36047072800,"Census Tract 728, Kings County, New York",1588,164,1424,502,1231,38514,1961,1999,1060,37,80,106,386,0,5,1424,168
2015,36047072800,"Census Tract 728, Kings County, New York",1587,156,1431,459,1256,41174,1965,2003,1141,38.5,75,83,366,0,0,1431,87
2016,36047072800,"Census Tract 728, Kings County, New York",1592,148,1444,387,1016,40101,1964,2001,1237,38.4,78,59,328,0,0,1444,91
2017,36047072800,"Census Tract 728, Kings County, New York",1576,65,1511,450,1073,41731,1960,1999,1184,36.3,116,54,396,0,0,1511,144
2018,36047072800,"Census Tract 728, Kings County, New York",1577,56,1521,462,1028,49470,1957,2006,1359,36.1,120,49,413,0,0,1521,167
2019,36047072800,"Census Tract 728, Kings County, New York",1614,57,1557,413,910,71927,1959,2008,1367,23,137,43,370,0,0,1557,136
2020,36047072800,"Census Tract 728, Kings County, New York",1653,30,1623,420,902,80234,1959,2007,1521,21.5,186,18,329,31,0,1623,211
2012,36047073000,"Census Tract 730, Kings County, New York",836,28,808,197,437,35096,1950,2003,1107,33.1,67,40,128,0,29,808,30
2013,36047073000,"Census Tract 730, Kings County, New York",853,28,825,216,557,32813,1949,2004,1074,38.1,55,48,150,0,18,825,43
2014,36047073000,"Census Tract 730, Kings County, New York",847,27,820,204,490,33026,1951,2006,1174,41.9,34,32,155,0,17,820,41
2015,36047073000,"Census Tract 730, Kings County, New York",816,34,782,189,472,34219,1954,2006,1189,33.8,49,29,144,0,16,782,35
2016,36047073000,"Census Tract 730, Kings County, New York",799,55,744,162,529,64000,1959,2010,1619,29.4,38,6,147,0,9,744,25
2017,36047073000,"Census Tract 730, Kings County, New York",781,48,733,141,414,NA,1951,2007,1696,36,43,17,116,0,8,733,20
2018,36047073000,"Census Tract 730, Kings County, New York",788,47,741,138,345,67800,1949,2011,2009,36,59,10,110,0,6,741,6
2019,36047073000,"Census Tract 730, Kings County, New York",778,65,713,129,345,63542,1947,2010,2119,36.7,62,10,94,0,14,713,5
2020,36047073000,"Census Tract 730, Kings County, New York",806,11,795,159,482,67813,1947,2008,2134,38.6,73,11,105,0,29,795,3
2012,36047073200,"Census Tract 732, Kings County, New York",789,11,778,219,743,26971,1953,2008,1136,38,56,17,185,0,17,778,86
2013,36047073200,"Census Tract 732, Kings County, New York",849,22,827,267,916,45066,1946,2009,1165,35.7,60,15,229,0,23,827,89
2014,36047073200,"Census Tract 732, Kings County, New York",891,22,869,343,1158,42083,1946,2008,1202,36.1,75,24,286,7,26,869,100
2015,36047073200,"Census Tract 732, Kings County, New York",859,21,838,343,1088,46645,1939,2007,1141,28.8,68,10,295,11,11,838,82
2016,36047073200,"Census Tract 732, Kings County, New York",837,36,801,307,924,51902,1939,2003,1186,27,47,6,262,10,13,801,54
2017,36047073200,"Census Tract 732, Kings County, New York",820,27,793,370,1069,49512,1939,2005,1219,29,32,13,324,8,8,793,45
2018,36047073200,"Census Tract 732, Kings County, New York",824,29,795,371,904,40515,1942,2007,1240,42.8,32,11,318,21,7,795,91
2019,36047073200,"Census Tract 732, Kings County, New York",831,47,784,350,828,43750,0,2009,1205,42.6,61,6,319,5,7,784,91
2020,36047073200,"Census Tract 732, Kings County, New York",827,42,785,356,909,35735,0,2012,1230,49,67,21,320,7,14,785,105
2012,36047073400,"Census Tract 734, Kings County, New York",695,39,656,39,88,67321,1939,2003,1536,30.4,10,0,39,0,10,656,38
2013,36047073400,"Census Tract 734, Kings County, New York",700,54,646,56,108,68056,1939,1988,1234,23.1,32,11,45,0,11,646,24
2014,36047073400,"Census Tract 734, Kings County, New York",724,49,675,89,229,51641,1939,2000,1387,24.8,34,13,76,0,8,675,26
2015,36047073400,"Census Tract 734, Kings County, New York",710,42,668,72,193,51731,1939,2001,1395,24.7,26,11,61,0,6,668,35
2016,36047073400,"Census Tract 734, Kings County, New York",688,45,643,100,279,52237,1939,2003,1610,27,44,16,84,0,12,643,37
2017,36047073400,"Census Tract 734, Kings County, New York",682,69,613,127,383,54205,1939,2005,1500,24.7,40,14,101,0,18,613,31
2018,36047073400,"Census Tract 734, Kings County, New York",655,85,570,114,378,54911,0,2009,1396,25.2,36,9,93,0,19,570,17
2019,36047073400,"Census Tract 734, Kings County, New York",658,107,551,97,286,54063,0,2011,1330,26.9,38,10,66,0,27,551,28
2020,36047073400,"Census Tract 734, Kings County, New York",650,113,537,113,304,63958,0,2011,1258,24.6,39,11,81,0,29,537,14
2012,36047073600,"Census Tract 736, Kings County, New York",1317,64,1253,773,2051,33169,1943,2004,1141,39.5,113,70,564,99,50,1253,227
2013,36047073600,"Census Tract 736, Kings County, New York",1318,55,1263,809,2115,35855,1942,2003,1133,34.5,194,107,559,93,83,1263,247
2014,36047073600,"Census Tract 736, Kings County, New York",1335,62,1273,870,2417,32115,1939,2003,1166,34.4,222,95,586,90,155,1273,365
2015,36047073600,"Census Tract 736, Kings County, New York",1306,77,1229,829,2235,49028,1939,2005,1159,29.7,246,64,586,58,174,1229,260
2016,36047073600,"Census Tract 736, Kings County, New York",1312,77,1235,855,2199,48472,1939,2007,1122,26.7,242,81,573,46,221,1235,241
2017,36047073600,"Census Tract 736, Kings County, New York",1280,85,1195,773,2006,52260,1943,2006,1169,24.6,242,77,511,46,210,1195,217
2018,36047073600,"Census Tract 736, Kings County, New York",1295,88,1207,721,1891,39548,1942,2007,1338,36.6,145,77,467,52,155,1207,247
2019,36047073600,"Census Tract 736, Kings County, New York",1285,81,1204,686,1638,47600,1945,2007,1387,37.2,153,65,507,58,92,1204,163
2020,36047073600,"Census Tract 736, Kings County, New York",1256,53,1203,623,1621,48007,1951,2010,1392,41.9,134,50,496,57,33,1203,163
2012,36047073800,"Census Tract 738, Kings County, New York",1218,29,1189,549,1464,38385,1939,2001,1001,28.6,127,230,232,9,95,1189,128
2013,36047073800,"Census Tract 738, Kings County, New York",1215,25,1190,533,1352,40521,1939,2002,1078,27.2,139,130,314,8,109,1190,119
2014,36047073800,"Census Tract 738, Kings County, New York",1232,46,1186,554,1621,38250,1939,2001,1163,29.3,148,130,322,30,103,1186,177
2015,36047073800,"Census Tract 738, Kings County, New York",1283,63,1220,649,1825,38472,1939,2001,1172,29.4,204,105,435,46,119,1220,215
2016,36047073800,"Census Tract 738, Kings County, New York",1298,78,1220,598,1581,41667,1939,2003,1179,29.5,225,102,405,35,101,1220,213
2017,36047073800,"Census Tract 738, Kings County, New York",1290,87,1203,606,1891,44917,1939,2004,1346,30,233,89,388,51,115,1203,218
2018,36047073800,"Census Tract 738, Kings County, New York",1267,107,1160,647,2069,43073,0,2006,1471,37.3,284,133,358,70,118,1160,184
2019,36047073800,"Census Tract 738, Kings County, New York",1274,107,1167,641,1851,50125,0,2007,1447,35.5,344,154,330,48,131,1167,205
2020,36047073800,"Census Tract 738, Kings County, New York",1395,92,1303,673,1687,45680,0,2011,1612,41.3,315,235,298,22,96,1303,181
2012,36047074000,"Census Tract 740, Kings County, New York",1225,73,1152,689,1765,36178,1939,2004,1020,33.6,159,104,399,65,121,1152,184
2013,36047074000,"Census Tract 740, Kings County, New York",1224,71,1153,748,1895,40556,1939,2004,1070,31.5,208,87,516,59,86,1153,152
2014,36047074000,"Census Tract 740, Kings County, New York",1266,83,1183,787,2418,40650,1939,2004,1083,30.8,192,65,557,91,74,1183,168
2015,36047074000,"Census Tract 740, Kings County, New York",1227,102,1125,714,2300,42885,1939,2004,1121,30.9,183,33,500,109,65,1125,137
2016,36047074000,"Census Tract 740, Kings County, New York",1220,164,1056,695,2277,40972,1939,2007,1159,31.9,160,19,555,76,37,1056,127
2017,36047074000,"Census Tract 740, Kings County, New York",1174,96,1078,760,2464,48850,1939,2008,1235,27.9,209,59,513,132,49,1078,102
2018,36047074000,"Census Tract 740, Kings County, New York",1140,77,1063,736,2309,50254,0,2009,1266,27.4,170,50,492,143,44,1063,121
2019,36047074000,"Census Tract 740, Kings County, New York",1144,72,1072,723,2059,63379,0,2009,1369,21.3,190,65,488,161,11,1072,109
2020,36047074000,"Census Tract 740, Kings County, New York",1112,92,1020,699,2162,49427,1943,2011,1479,30.1,116,64,561,57,32,1020,66
2012,36047074200,"Census Tract 742, Kings County, New York",1030,20,1010,499,1490,54821,1954,2003,1152,23.2,132,96,374,9,25,1010,81
2013,36047074200,"Census Tract 742, Kings County, New York",1007,7,1000,478,1390,50000,1953,2004,1166,24.2,111,98,328,11,45,1000,99
2014,36047074200,"Census Tract 742, Kings County, New York",1005,38,967,409,1163,58413,1953,2004,1164,23.5,86,62,265,21,60,967,89
2015,36047074200,"Census Tract 742, Kings County, New York",994,60,934,420,1299,59783,1939,2005,1225,26.3,92,72,251,22,63,934,104
2016,36047074200,"Census Tract 742, Kings County, New York",1008,66,942,417,1294,57250,1942,2005,1204,27,79,79,227,22,75,942,92
2017,36047074200,"Census Tract 742, Kings County, New York",992,60,932,375,1123,59306,1947,2005,1329,27.5,66,47,235,15,67,932,112
2018,36047074200,"Census Tract 742, Kings County, New York",978,66,912,452,1440,60000,0,2005,1491,30,86,78,278,15,59,912,87
2019,36047074200,"Census Tract 742, Kings County, New York",989,63,926,472,1426,50500,0,2006,1569,37,103,115,286,5,48,926,112
2020,36047074200,"Census Tract 742, Kings County, New York",1002,34,968,479,1321,51289,0,2008,1717,38.5,90,111,247,0,60,968,105
2012,36047074400,"Census Tract 744, Kings County, New York",679,65,614,135,446,14744,1939,2004,950,50,6,129,0,0,6,614,58
2013,36047074400,"Census Tract 744, Kings County, New York",684,48,636,133,584,23967,1939,2007,644,25.2,18,85,19,0,23,636,58
2014,36047074400,"Census Tract 744, Kings County, New York",702,42,660,149,714,23194,1939,2007,645,28,11,80,31,0,23,660,77
2015,36047074400,"Census Tract 744, Kings County, New York",679,60,619,159,546,NA,1939,2006,NA,31.1,37,109,17,0,22,619,100
2016,36047074400,"Census Tract 744, Kings County, New York",696,44,652,128,508,NA,1939,2009,1219,30.8,44,62,20,0,22,652,88
2017,36047074400,"Census Tract 744, Kings County, New York",700,36,664,132,649,NA,1939,2007,1365,23.5,42,34,46,6,21,664,80
2018,36047074400,"Census Tract 744, Kings County, New York",682,41,641,81,409,101250,0,2006,1839,30.8,32,39,19,4,7,641,68
2019,36047074400,"Census Tract 744, Kings County, New York",700,41,659,98,446,103214,0,2005,1757,30.9,41,51,21,12,8,659,55
2020,36047074400,"Census Tract 744, Kings County, New York",666,34,632,79,218,NA,0,2004,1490,28.4,29,50,11,8,8,632,45
2012,36047074600,"Census Tract 746, Kings County, New York",700,60,640,232,497,31284,1945,2005,1011,42.9,79,126,71,10,46,640,61
2013,36047074600,"Census Tract 746, Kings County, New York",685,46,639,252,579,28125,1945,2006,1167,47.3,81,157,67,9,30,639,78
2014,36047074600,"Census Tract 746, Kings County, New York",697,48,649,253,604,34620,1948,2007,1231,42.8,81,179,54,9,32,649,74
2015,36047074600,"Census Tract 746, Kings County, New York",712,51,661,241,599,39083,1945,2006,1168,40.4,84,166,56,9,30,661,93
2016,36047074600,"Census Tract 746, Kings County, New York",714,27,687,266,698,39231,1945,2007,1500,44.7,100,209,26,10,14,687,95
2017,36047074600,"Census Tract 746, Kings County, New York",717,36,681,261,779,48977,1945,2008,1383,35,65,186,34,11,27,681,69
2018,36047074600,"Census Tract 746, Kings County, New York",752,24,728,247,784,65469,1946,2007,1375,22.2,49,164,44,0,34,728,19
2019,36047074600,"Census Tract 746, Kings County, New York",748,18,730,274,868,52353,1946,2006,1333,26.7,86,190,51,0,30,730,39
2020,36047074600,"Census Tract 746, Kings County, New York",780,33,747,329,794,42039,1946,2006,1386,44.8,76,255,47,0,25,747,104
2012,36047074800,"Census Tract 748, Kings County, New York",707,35,672,311,791,37371,1958,2005,1150,30.2,112,126,168,0,17,672,145
2013,36047074800,"Census Tract 748, Kings County, New York",681,42,639,284,740,35208,1957,2006,1175,32.9,92,115,156,0,13,639,160
2014,36047074800,"Census Tract 748, Kings County, New York",690,38,652,298,648,39423,1956,2008,1317,31,95,123,157,0,18,652,148
2015,36047074800,"Census Tract 748, Kings County, New York",672,24,648,284,670,48750,1958,2006,1250,26.2,123,112,149,0,28,648,148
2016,36047074800,"Census Tract 748, Kings County, New York",660,29,631,272,623,70500,1958,2010,1462,23.6,135,104,155,5,14,631,115
2017,36047074800,"Census Tract 748, Kings County, New York",679,80,599,232,452,60357,1957,2010,1550,29.6,102,87,131,5,15,599,71
2018,36047074800,"Census Tract 748, Kings County, New York",702,64,638,280,519,61827,1955,2010,1598,30.9,126,104,161,5,17,638,84
2019,36047074800,"Census Tract 748, Kings County, New York",704,75,629,260,454,44500,1954,2007,1486,34.6,119,94,149,11,13,629,98
2020,36047074800,"Census Tract 748, Kings County, New York",766,81,685,307,427,NA,1956,2012,1242,34.7,103,74,166,13,54,685,121
2012,36047075000,"Census Tract 750, Kings County, New York",990,48,942,557,1452,36680,1947,2002,1030,33.4,134,311,187,27,32,942,175
2013,36047075000,"Census Tract 750, Kings County, New York",994,21,973,537,1391,38496,1945,2003,1100,32.6,148,295,175,15,52,973,205
2014,36047075000,"Census Tract 750, Kings County, New York",989,39,950,553,1465,38750,1951,2003,1094,30.2,162,326,187,16,21,950,189
2015,36047075000,"Census Tract 750, Kings County, New York",980,53,927,497,1270,39250,1952,2003,1175,33.7,140,283,154,16,40,927,188
2016,36047075000,"Census Tract 750, Kings County, New York",976,59,917,497,1260,44297,1947,2007,1289,33.3,184,274,117,44,42,917,161
2017,36047075000,"Census Tract 750, Kings County, New York",990,79,911,457,1166,45759,1939,2007,1330,33.2,166,260,104,25,44,911,141
2018,36047075000,"Census Tract 750, Kings County, New York",959,106,853,441,1183,50446,0,2010,1395,31.2,155,248,103,23,43,853,88
2019,36047075000,"Census Tract 750, Kings County, New York",959,112,847,457,1353,66823,0,2012,1472,30.2,198,240,125,28,69,847,90
2020,36047075000,"Census Tract 750, Kings County, New York",996,114,882,455,1267,65144,0,2015,1603,31.5,226,258,130,22,74,882,74
2012,36047075200,"Census Tract 752, Kings County, New York",318,0,318,34,105,26875,1939,1999,1583,50,7,34,0,0,0,318,22
2013,36047075200,"Census Tract 752, Kings County, New York",309,12,297,32,97,26364,1939,2000,1521,49.5,5,32,0,0,0,297,28
2014,36047075200,"Census Tract 752, Kings County, New York",326,25,301,24,73,56250,1939,1996,1795,50,9,24,0,0,0,301,12
2015,36047075200,"Census Tract 752, Kings County, New York",323,29,294,31,110,NA,1939,1998,1846,50,13,31,0,0,0,294,5
2016,36047075200,"Census Tract 752, Kings County, New York",329,33,296,34,106,NA,1939,1993,1875,36.7,15,34,0,0,0,296,13
2017,36047075200,"Census Tract 752, Kings County, New York",331,31,300,23,82,NA,1939,1979,2500,27.9,10,23,0,0,0,300,9
2018,36047075200,"Census Tract 752, Kings County, New York",340,24,316,26,73,NA,0,1989,2250,27.5,10,26,0,0,0,316,11
2019,36047075200,"Census Tract 752, Kings County, New York",318,4,314,24,35,NA,0,1989,NA,NA,6,24,0,0,0,314,13
2020,36047075200,"Census Tract 752, Kings County, New York",288,4,284,20,30,NA,0,1989,NA,NA,5,20,0,0,0,284,10
2012,36047075400,"Census Tract 754, Kings County, New York",472,13,459,90,293,105429,1939,2011,2001,33.1,59,90,0,0,0,459,51
2013,36047075400,"Census Tract 754, Kings County, New York",459,13,446,101,270,62321,1939,2011,2001,40.3,47,101,0,0,0,446,37
2014,36047075400,"Census Tract 754, Kings County, New York",470,24,446,72,144,51538,1939,2011,2001,46.5,18,72,0,0,0,446,50
2015,36047075400,"Census Tract 754, Kings County, New York",475,23,452,80,164,117727,1939,2012,3149,34.5,15,80,0,0,0,452,63
2016,36047075400,"Census Tract 754, Kings County, New York",479,35,444,71,174,121827,1939,2013,3097,31.4,19,71,0,0,0,444,38
2017,36047075400,"Census Tract 754, Kings County, New York",482,24,458,55,121,91691,1939,2011,1635,30.6,4,55,0,0,0,458,31
2018,36047075400,"Census Tract 754, Kings County, New York",474,38,436,36,110,94868,1942,2013,1700,20.5,11,36,0,0,0,436,30
2019,36047075400,"Census Tract 754, Kings County, New York",443,37,406,40,119,96389,0,2015,1833,22.6,12,40,0,0,0,406,19
2020,36047075400,"Census Tract 754, Kings County, New York",501,38,463,135,272,NA,0,2001,2147,25.8,44,135,0,0,0,463,17
2012,36047075600,"Census Tract 756, Kings County, New York",719,75,644,216,496,51250,1956,2004,1133,21.3,113,114,43,55,4,644,114
2013,36047075600,"Census Tract 756, Kings County, New York",718,70,648,212,463,63333,1956,2005,1176,19.7,104,111,36,61,4,648,102
2014,36047075600,"Census Tract 756, Kings County, New York",723,41,682,234,478,59265,1955,2004,1100,19.9,111,119,37,61,17,682,112
2015,36047075600,"Census Tract 756, Kings County, New York",712,36,676,238,501,39318,1954,2006,1114,35.7,159,127,42,51,18,676,88
2016,36047075600,"Census Tract 756, Kings County, New York",703,25,678,184,414,58194,1953,2008,1093,25.8,118,135,0,36,13,678,63
2017,36047075600,"Census Tract 756, Kings County, New York",690,33,657,186,360,55900,1950,2012,1161,26.5,112,121,30,25,10,657,53
2018,36047075600,"Census Tract 756, Kings County, New York",726,37,689,212,480,60750,0,2012,1279,23.3,101,136,21,23,27,689,38
2019,36047075600,"Census Tract 756, Kings County, New York",732,34,698,196,482,63333,0,2013,1379,23.3,92,106,27,34,23,698,34
2020,36047075600,"Census Tract 756, Kings County, New York",858,53,805,280,536,61774,1953,2009,1231,25.5,70,193,22,36,23,805,43
2012,36047075800,"Census Tract 758, Kings County, New York",635,0,635,281,860,35625,1956,2001,1010,34.5,121,247,0,4,24,635,71
2013,36047075800,"Census Tract 758, Kings County, New York",661,0,661,315,874,28594,1956,2000,1051,39.1,138,272,0,3,32,661,81
2014,36047075800,"Census Tract 758, Kings County, New York",649,0,649,310,782,29375,1957,2004,1129,36.1,105,252,0,7,43,649,76
2015,36047075800,"Census Tract 758, Kings County, New York",662,15,647,271,596,24744,1956,2005,995,32.5,125,218,0,9,38,647,77
2016,36047075800,"Census Tract 758, Kings County, New York",661,45,616,230,430,29063,1956,2007,1087,37.5,111,210,0,6,11,616,40
2017,36047075800,"Census Tract 758, Kings County, New York",672,51,621,235,446,40625,1956,2010,1149,37.5,127,215,0,5,15,621,53
2018,36047075800,"Census Tract 758, Kings County, New York",681,68,613,220,416,35000,1956,2011,1218,43.3,122,201,0,6,13,613,54
2019,36047075800,"Census Tract 758, Kings County, New York",693,99,594,207,513,41375,1957,2009,1329,51,99,172,0,0,10,594,53
2020,36047075800,"Census Tract 758, Kings County, New York",664,59,605,284,672,30859,1960,2006,1222,39.7,106,235,0,0,21,605,53
2012,36047076000,"Census Tract 760, Kings County, New York",1111,92,1019,688,1454,30603,1939,2001,1078,38.4,268,587,16,46,39,1019,184
2013,36047076000,"Census Tract 760, Kings County, New York",1101,96,1005,766,1537,26429,1939,2003,1035,47.6,319,573,25,64,104,1005,259
2014,36047076000,"Census Tract 760, Kings County, New York",1111,86,1025,758,1691,33059,1939,2001,1130,34.2,310,569,26,56,95,1025,216
2015,36047076000,"Census Tract 760, Kings County, New York",1107,59,1048,768,1721,33629,1939,2004,1118,33.1,329,574,33,58,88,1048,237
2016,36047076000,"Census Tract 760, Kings County, New York",1104,42,1062,751,1675,34436,1939,2003,1131,32.1,313,546,48,65,82,1062,235
2017,36047076000,"Census Tract 760, Kings County, New York",1118,38,1080,691,1394,41729,1939,2005,1131,30.6,348,511,50,38,84,1080,203
2018,36047076000,"Census Tract 760, Kings County, New York",1109,47,1062,644,1323,58229,0,2003,1202,30.1,293,523,64,20,20,1062,163
2019,36047076000,"Census Tract 760, Kings County, New York",1106,33,1073,599,1125,42475,0,2007,1203,33,306,512,69,18,10,1073,221
2020,36047076000,"Census Tract 760, Kings County, New York",1127,22,1105,626,1214,44444,1941,2007,1217,35.7,285,550,56,20,11,1105,249
2012,36047076200,"Census Tract 762, Kings County, New York",1676,44,1632,1341,3683,43098,1939,2000,1096,29.7,411,729,213,167,202,1632,404
2013,36047076200,"Census Tract 762, Kings County, New York",1672,73,1599,1291,3869,40521,1939,2001,1117,30,394,730,170,186,194,1599,496
2014,36047076200,"Census Tract 762, Kings County, New York",1711,68,1643,1332,4176,39421,1939,2000,1169,36,435,690,195,197,241,1643,502
2015,36047076200,"Census Tract 762, Kings County, New York",1709,59,1650,1277,3812,38083,1939,2001,1209,38.6,455,684,133,211,244,1650,481
2016,36047076200,"Census Tract 762, Kings County, New York",1717,102,1615,1276,3857,38944,1939,2004,1243,39,437,688,236,162,176,1615,452
2017,36047076200,"Census Tract 762, Kings County, New York",1709,118,1591,1253,4263,40194,1939,2009,1291,35,448,638,240,172,214,1591,556
2018,36047076200,"Census Tract 762, Kings County, New York",1713,142,1571,1218,3715,38636,1942,2010,1318,33.8,450,707,212,150,160,1571,461
2019,36047076200,"Census Tract 762, Kings County, New York",1662,134,1528,1188,3353,39231,1946,2011,1284,32.7,472,694,233,131,140,1528,434
2020,36047076200,"Census Tract 762, Kings County, New York",1698,86,1612,1377,4011,57396,1946,2012,1322,30.2,677,602,258,209,331,1612,397
2012,36047076400,"Census Tract 764, Kings County, New York",1332,90,1242,990,2914,42308,1946,2002,1145,33,203,136,626,36,180,1242,215
2013,36047076400,"Census Tract 764, Kings County, New York",1304,62,1242,967,2754,40231,1952,2004,1216,34.4,202,150,535,51,216,1242,189
2014,36047076400,"Census Tract 764, Kings County, New York",1324,60,1264,951,2751,45327,1952,2004,1212,32.4,235,191,539,34,170,1264,224
2015,36047076400,"Census Tract 764, Kings County, New York",1380,22,1358,1058,3172,NA,1950,2005,1228,37,315,184,697,54,106,1358,278
2016,36047076400,"Census Tract 764, Kings County, New York",1418,34,1384,1118,3079,52143,1947,2007,1230,32.8,337,223,685,52,140,1384,279
2017,36047076400,"Census Tract 764, Kings County, New York",1435,85,1350,1121,3055,50250,1945,2008,1300,32.8,350,210,665,70,167,1350,349
2018,36047076400,"Census Tract 764, Kings County, New York",1510,98,1412,1176,3076,53500,1943,2008,1340,30.5,377,225,663,61,216,1412,364
2019,36047076400,"Census Tract 764, Kings County, New York",1547,109,1438,1247,2971,57031,1944,2010,1428,31.8,436,280,697,66,208,1438,338
2020,36047076400,"Census Tract 764, Kings County, New York",1602,107,1495,1329,3040,59813,1941,2012,1483,29,559,325,684,109,257,1495,311
2012,36047076600,"Census Tract 766, Kings County, New York",807,38,769,652,1853,50833,1947,1998,1111,27.6,168,45,519,15,123,769,89
2013,36047076600,"Census Tract 766, Kings County, New York",785,45,740,596,1905,54625,1950,2001,1291,27.6,103,49,453,15,88,740,80
2014,36047076600,"Census Tract 766, Kings County, New York",793,30,763,631,1995,49554,1953,2003,1330,30.2,101,51,487,0,95,763,109
2015,36047076600,"Census Tract 766, Kings County, New York",802,31,771,591,1840,NA,1952,2004,1345,32.7,116,40,453,5,96,771,112
2016,36047076600,"Census Tract 766, Kings County, New York",785,40,745,556,1756,52768,1954,2006,1388,34.8,120,38,438,4,58,745,98
2017,36047076600,"Census Tract 766, Kings County, New York",789,29,760,565,1728,54178,1955,2007,1481,35,154,82,379,6,83,760,103
2018,36047076600,"Census Tract 766, Kings County, New York",794,28,766,583,1652,55050,1953,2003,1482,36.2,168,69,402,6,91,766,111
2019,36047076600,"Census Tract 766, Kings County, New York",777,78,699,500,1422,61000,1949,2005,1531,36,164,76,359,4,52,699,94
2020,36047076600,"Census Tract 766, Kings County, New York",755,73,682,502,1469,66917,1950,1999,1512,34.8,140,83,342,0,48,682,82
2012,36047076800,"Census Tract 768, Kings County, New York",1274,99,1175,836,2117,41908,1942,2003,1166,32.9,429,606,19,29,143,1175,182
2013,36047076800,"Census Tract 768, Kings County, New York",1257,113,1144,771,1898,38304,1945,2002,1182,38.2,369,585,26,37,102,1144,227
2014,36047076800,"Census Tract 768, Kings County, New York",1233,109,1124,775,2076,41369,1942,2003,1292,34,343,618,22,51,43,1124,252
2015,36047076800,"Census Tract 768, Kings County, New York",1210,94,1116,823,2139,32417,1942,2005,1278,41.4,343,630,25,68,61,1116,329
2016,36047076800,"Census Tract 768, Kings County, New York",1213,91,1122,805,2083,24427,1939,2007,1295,45.5,323,618,38,55,55,1122,373
2017,36047076800,"Census Tract 768, Kings County, New York",1229,70,1159,898,2217,33643,1939,2009,1288,43.6,347,726,18,64,43,1159,340
2018,36047076800,"Census Tract 768, Kings County, New York",1199,22,1177,921,2316,37113,0,2010,1302,42.4,347,749,9,60,70,1177,294
2019,36047076800,"Census Tract 768, Kings County, New York",1161,22,1139,866,2283,40375,0,2011,1369,43.3,347,746,11,47,45,1139,269
2020,36047076800,"Census Tract 768, Kings County, New York",1215,20,1195,744,2123,53145,0,2012,1358,40.1,342,624,30,54,35,1195,213
2012,36047077000,"Census Tract 770, Kings County, New York",1047,133,914,531,1685,47156,1939,2003,1220,31.3,145,28,459,7,59,914,97
2013,36047077000,"Census Tract 770, Kings County, New York",1038,129,909,524,1772,39242,1939,2004,1259,40.6,123,23,437,6,58,909,145
2014,36047077000,"Census Tract 770, Kings County, New York",1061,124,937,538,1727,40341,1939,2004,1354,39.7,134,29,462,7,40,937,138
2015,36047077000,"Census Tract 770, Kings County, New York",1150,112,1038,619,2117,40398,1946,2005,1331,38.1,189,29,513,6,77,1038,196
2016,36047077000,"Census Tract 770, Kings County, New York",1182,144,1038,646,2162,32432,1944,2007,1406,39.6,209,16,536,10,88,1038,240
2017,36047077000,"Census Tract 770, Kings County, New York",1190,167,1023,586,1816,31471,1943,2008,1336,37.7,176,18,467,10,90,1023,238
2018,36047077000,"Census Tract 770, Kings County, New York",1166,123,1043,677,2029,56094,0,2010,1400,30.7,271,42,542,34,63,1043,232
2019,36047077000,"Census Tract 770, Kings County, New York",1143,107,1036,679,1935,55417,0,2011,1288,28.6,233,36,544,20,74,1036,257
2020,36047077000,"Census Tract 770, Kings County, New York",1193,136,1057,626,1678,72866,0,2014,1422,23.9,163,53,513,22,31,1057,222
2012,36047077200,"Census Tract 772, Kings County, New York",1211,35,1176,701,1796,38281,1939,2002,1074,35.3,160,259,410,0,24,1176,298
2013,36047077200,"Census Tract 772, Kings County, New York",1221,54,1167,735,1881,37628,1941,2004,1101,36.9,168,211,472,8,40,1167,311
2014,36047077200,"Census Tract 772, Kings County, New York",1219,63,1156,673,1633,36821,1944,2005,1133,36.3,198,192,416,20,46,1156,263
2015,36047077200,"Census Tract 772, Kings County, New York",1207,69,1138,676,1621,41618,1939,2006,1179,29.9,243,196,408,25,46,1138,184
2016,36047077200,"Census Tract 772, Kings County, New York",1281,48,1233,828,2063,47273,1939,2006,1286,29.6,259,207,504,23,87,1233,209
2017,36047077200,"Census Tract 772, Kings County, New York",1238,57,1181,761,1845,43682,1939,2006,1323,37.3,279,207,379,26,149,1181,181
2018,36047077200,"Census Tract 772, Kings County, New York",1257,22,1235,731,1655,49494,0,2005,1422,37.2,248,267,305,10,142,1235,163
2019,36047077200,"Census Tract 772, Kings County, New York",1249,34,1215,748,1757,57451,0,2009,1460,33.2,308,334,236,18,160,1215,153
2020,36047077200,"Census Tract 772, Kings County, New York",1232,25,1207,660,1540,57143,0,2011,1492,35,281,324,154,23,143,1207,173
2012,36047077400,"Census Tract 774, Kings County, New York",1193,104,1089,946,2334,43958,1948,2003,1102,30.6,311,274,408,98,185,1089,184
2013,36047077400,"Census Tract 774, Kings County, New York",1168,93,1075,947,2407,53250,1948,2004,1159,27.6,391,255,444,92,162,1075,175
2014,36047077400,"Census Tract 774, Kings County, New York",1172,76,1096,968,2519,50093,1949,2005,1165,31.4,415,229,528,103,127,1096,234
2015,36047077400,"Census Tract 774, Kings County, New York",1187,38,1149,1056,2874,47024,1947,2005,1236,33.6,453,255,620,120,64,1149,206
2016,36047077400,"Census Tract 774, Kings County, New York",1208,38,1170,1074,2848,57243,1942,2008,1291,30.5,442,227,688,79,112,1170,168
2017,36047077400,"Census Tract 774, Kings County, New York",1231,17,1214,1091,2941,62792,1939,2009,1378,28.5,468,199,759,53,118,1214,201
2018,36047077400,"Census Tract 774, Kings County, New York",1275,19,1256,1130,2954,63333,0,2009,1419,30.1,412,177,832,50,124,1256,185
2019,36047077400,"Census Tract 774, Kings County, New York",1268,23,1245,1161,2902,70822,0,2008,1426,25,437,186,852,64,98,1245,104
2020,36047077400,"Census Tract 774, Kings County, New York",1349,42,1307,1135,2716,77361,0,2011,1405,22.7,368,118,724,77,263,1307,98
2012,36047077600,"Census Tract 776, Kings County, New York",1812,121,1691,762,1877,45909,1954,2004,1124,31,226,42,615,0,96,1691,256
2013,36047077600,"Census Tract 776, Kings County, New York",1833,113,1720,724,1750,49286,1958,2003,1138,31.2,167,34,592,0,95,1720,220
2014,36047077600,"Census Tract 776, Kings County, New York",1849,128,1721,721,1587,48844,1962,2004,1159,31.2,170,22,608,21,76,1721,149
2015,36047077600,"Census Tract 776, Kings County, New York",1856,150,1706,628,1420,48333,1962,2007,1212,33.5,167,8,535,18,72,1706,161
2016,36047077600,"Census Tract 776, Kings County, New York",1872,164,1708,747,1654,47406,1961,2008,1256,33.9,280,15,650,19,68,1708,181
2017,36047077600,"Census Tract 776, Kings County, New York",1906,164,1742,741,1616,56188,1961,2009,1409,32.7,296,17,662,17,50,1742,157
2018,36047077600,"Census Tract 776, Kings County, New York",1914,208,1706,784,1645,64375,1954,2009,1441,29,353,20,704,13,54,1706,162
2019,36047077600,"Census Tract 776, Kings County, New York",1920,207,1713,755,1570,68750,1952,2011,1578,28.6,372,52,646,0,59,1713,145
2020,36047077600,"Census Tract 776, Kings County, New York",1962,181,1781,717,1454,73785,1952,2008,1616,27.2,401,67,588,0,53,1781,120
2012,36047078000,"Census Tract 780, Kings County, New York",786,108,678,97,278,56344,1946,2008,1204,22.9,44,0,97,0,0,678,44
2013,36047078000,"Census Tract 780, Kings County, New York",776,118,658,93,263,56321,1948,2007,1231,23.1,40,0,93,0,0,658,45
2014,36047078000,"Census Tract 780, Kings County, New York",766,51,715,90,220,53750,1939,2011,1042,23.3,15,15,50,0,0,715,38
2015,36047078000,"Census Tract 780, Kings County, New York",757,28,729,77,206,52054,1945,2009,1028,23.4,14,14,41,0,0,729,48
2016,36047078000,"Census Tract 780, Kings County, New York",759,24,735,121,302,51620,1939,2011,1402,24.5,28,13,88,0,0,735,31
2017,36047078000,"Census Tract 780, Kings County, New York",750,26,724,140,345,50893,1939,2010,1433,31.7,31,13,108,0,0,724,37
2018,36047078000,"Census Tract 780, Kings County, New York",744,58,686,165,422,53150,0,2011,1428,32.5,27,12,133,0,0,686,48
2019,36047078000,"Census Tract 780, Kings County, New York",756,64,692,198,561,75658,0,2011,1686,24.2,70,0,198,0,0,692,52
2020,36047078000,"Census Tract 780, Kings County, New York",733,81,652,186,471,76397,1954,2012,1720,25,81,0,186,0,0,652,35
2012,36047078200,"Census Tract 782, Kings County, New York",1644,80,1564,1094,2629,35132,1955,2003,940,30.8,193,30,1011,41,25,1564,254
2013,36047078200,"Census Tract 782, Kings County, New York",1622,78,1544,1033,2384,34504,1955,2004,963,32.1,151,28,951,33,21,1544,256
2014,36047078200,"Census Tract 782, Kings County, New York",1643,77,1566,1067,2776,38869,1954,2005,1035,32.4,195,14,999,34,29,1566,270
2015,36047078200,"Census Tract 782, Kings County, New York",1659,82,1577,1065,3073,42420,1953,2006,1086,29.1,247,14,999,30,24,1577,258
2016,36047078200,"Census Tract 782, Kings County, New York",1690,76,1614,1177,3614,46186,1952,2007,1139,27.5,242,8,1125,17,38,1614,229
2017,36047078200,"Census Tract 782, Kings County, New York",1721,61,1660,1176,3603,49643,1947,2010,1168,26.4,234,25,1082,40,36,1660,236
2018,36047078200,"Census Tract 782, Kings County, New York",1756,82,1674,1190,3474,52194,1946,2010,1275,26.5,241,29,1100,38,31,1674,202
2019,36047078200,"Census Tract 782, Kings County, New York",1753,65,1688,1263,3454,52184,1945,2010,1341,27.7,246,21,1153,31,57,1688,193
2020,36047078200,"Census Tract 782, Kings County, New York",1743,80,1663,1271,3216,51728,1944,2010,1348,28.2,223,23,1106,30,91,1663,209
2012,36047078400,"Census Tract 784, Kings County, New York",898,57,841,238,643,62000,1939,2003,1152,22.2,66,36,180,0,11,841,19
2013,36047078400,"Census Tract 784, Kings County, New York",889,89,800,239,650,66424,1939,2001,1219,21,58,11,202,0,16,800,17
2014,36047078400,"Census Tract 784, Kings County, New York",873,96,777,222,528,67981,1939,2003,1237,26.6,74,9,172,0,27,777,38
2015,36047078400,"Census Tract 784, Kings County, New York",893,73,820,275,749,73917,1939,2005,1323,25.6,115,20,221,0,22,820,42
2016,36047078400,"Census Tract 784, Kings County, New York",884,76,808,352,938,48750,1939,2006,1428,34.5,103,25,292,0,17,808,52
2017,36047078400,"Census Tract 784, Kings County, New York",852,84,768,348,946,55000,1942,2006,1462,33.5,107,19,283,6,18,768,44
2018,36047078400,"Census Tract 784, Kings County, New York",853,60,793,353,990,56420,1943,2008,1598,32.4,115,18,286,6,23,793,68
2019,36047078400,"Census Tract 784, Kings County, New York",838,61,777,316,935,53750,1941,2009,1648,34.3,96,21,245,6,22,777,63
2020,36047078400,"Census Tract 784, Kings County, New York",877,72,805,358,1058,73750,0,2011,1629,27.4,109,17,287,9,25,805,75
2012,36047078600,"Census Tract 786, Kings County, New York",1884,147,1737,1257,2969,30139,1939,2003,998,34.3,155,54,1002,67,159,1737,336
2013,36047078600,"Census Tract 786, Kings County, New York",1865,125,1740,1206,3044,30885,1939,2004,1005,33,147,52,876,112,164,1740,331
2014,36047078600,"Census Tract 786, Kings County, New York",1880,133,1747,1311,3443,37869,1939,2005,1130,32,243,43,967,98,218,1747,283
2015,36047078600,"Census Tract 786, Kings County, New York",1883,116,1767,1323,3634,40649,1939,2008,1175,33.4,344,56,998,74,196,1767,266
2016,36047078600,"Census Tract 786, Kings County, New York",1909,114,1795,1221,3351,38554,1939,2009,1197,37.6,301,45,922,78,186,1795,285
2017,36047078600,"Census Tract 786, Kings County, New York",1970,124,1846,1277,3324,45507,1939,2009,1235,33.2,352,47,953,87,193,1846,263
2018,36047078600,"Census Tract 786, Kings County, New York",1993,125,1868,1329,3414,50417,0,2009,1254,29.8,390,51,1068,55,187,1868,275
2019,36047078600,"Census Tract 786, Kings County, New York",2036,137,1899,1359,3265,51090,0,2011,1311,29.6,358,38,1088,53,192,1899,259
2020,36047078601,"Census Tract 786.01, Kings County, New York",1110,53,1057,773,1711,60023,0,2010,1281,27.9,207,10,516,122,138,1057,163
2020,36047078602,"Census Tract 786.02, Kings County, New York",915,88,827,532,1268,42679,1961,2011,1390,38.4,130,5,432,5,91,827,133
2012,36047078800,"Census Tract 788, Kings County, New York",1311,73,1238,930,2625,36136,1942,2004,1053,34.8,105,10,809,16,71,1238,347
2013,36047078800,"Census Tract 788, Kings County, New York",1309,120,1189,962,2893,35476,1947,2003,1078,35.7,93,28,826,7,81,1189,294
2014,36047078800,"Census Tract 788, Kings County, New York",1297,79,1218,984,2876,33777,1950,2004,1071,35.2,82,14,833,10,92,1218,312
2015,36047078800,"Census Tract 788, Kings County, New York",1305,131,1174,923,2503,29228,1944,2005,1084,37,121,16,794,0,89,1174,277
2016,36047078800,"Census Tract 788, Kings County, New York",1319,164,1155,944,2466,28766,1944,2007,1105,39.8,120,21,792,0,126,1155,262
2017,36047078800,"Census Tract 788, Kings County, New York",1283,120,1163,982,2709,29803,1939,2009,1170,40.1,139,25,856,0,94,1163,235
2018,36047078800,"Census Tract 788, Kings County, New York",1312,114,1198,979,2515,31016,0,2011,1243,37.8,181,11,814,20,99,1198,263
2019,36047078800,"Census Tract 788, Kings County, New York",1351,131,1220,1044,3013,41250,0,2011,1317,35.2,211,14,904,24,73,1220,259
2020,36047078801,"Census Tract 788.01, Kings County, New York",854,74,780,642,1653,48833,0,2015,1408,36.5,181,16,535,0,60,780,150
2020,36047078802,"Census Tract 788.02, Kings County, New York",568,55,513,508,1629,51196,1942,2011,1517,36.4,92,0,411,23,25,513,74
2012,36047079000,"Census Tract 790, Kings County, New York",1980,180,1800,1377,3901,34947,1939,2002,1009,37.2,211,16,1234,32,111,1800,347
2013,36047079000,"Census Tract 790, Kings County, New York",1992,214,1778,1365,3686,32951,1939,2002,1068,40.7,211,19,1216,20,104,1778,388
2014,36047079000,"Census Tract 790, Kings County, New York",1994,236,1758,1336,3425,33979,1939,2003,1118,39.2,196,27,1195,0,107,1758,331
2015,36047079000,"Census Tract 790, Kings County, New York",1978,206,1772,1393,3841,37078,1939,2004,1185,36.2,239,24,1279,0,83,1772,281
2016,36047079000,"Census Tract 790, Kings County, New York",1986,229,1757,1441,3928,36638,1939,2006,1234,37.3,237,22,1343,0,60,1757,305
2017,36047079000,"Census Tract 790, Kings County, New York",2012,189,1823,1485,3928,35818,1939,2007,1314,38.6,248,43,1306,0,80,1823,428
2018,36047079000,"Census Tract 790, Kings County, New York",2024,223,1801,1447,3998,42036,0,2009,1381,34.6,234,50,1236,0,81,1801,379
2019,36047079000,"Census Tract 790, Kings County, New York",2110,305,1805,1436,3841,51375,0,2011,1420,31.9,276,58,1200,0,88,1805,407
2020,36047079001,"Census Tract 790.01, Kings County, New York",520,68,452,366,1411,40833,0,2010,1432,40.4,70,67,253,0,9,452,94
2020,36047079002,"Census Tract 790.02, Kings County, New York",1458,277,1181,841,2105,60709,0,2012,1429,34.4,158,7,699,11,88,1181,313
2012,36047079200,"Census Tract 792, Kings County, New York",1439,116,1323,1038,2544,34145,1939,2003,1115,29.3,140,0,994,28,22,1323,279
2013,36047079200,"Census Tract 792, Kings County, New York",1413,113,1300,984,2387,27037,1939,2003,1110,38,84,0,921,0,78,1300,283
2014,36047079200,"Census Tract 792, Kings County, New York",1409,126,1283,1022,2566,27321,1939,2004,1102,38.1,68,0,843,0,115,1283,355
2015,36047079200,"Census Tract 792, Kings County, New York",1381,174,1207,919,2456,36047,1939,2005,1165,37.2,81,32,692,0,118,1207,300
2016,36047079200,"Census Tract 792, Kings County, New York",1414,151,1263,939,2519,34340,1939,2007,1106,37.6,73,48,669,0,151,1263,342
2017,36047079200,"Census Tract 792, Kings County, New York",1388,187,1201,941,2622,38097,1939,2009,1196,37.3,114,71,627,0,191,1201,288
2018,36047079200,"Census Tract 792, Kings County, New York",1401,156,1245,992,2424,45278,0,2010,1270,31.6,255,55,659,0,231,1245,257
2019,36047079200,"Census Tract 792, Kings County, New York",1366,143,1223,908,2467,56918,0,2012,1501,31.9,274,91,653,0,145,1223,217
2020,36047079201,"Census Tract 792.01, Kings County, New York",548,86,462,328,805,54444,0,2012,1284,34.7,41,37,272,0,38,462,60
2020,36047079202,"Census Tract 792.02, Kings County, New York",836,86,750,551,1639,50804,0,2015,1677,33.7,180,27,381,0,116,750,179
2012,36047079400,"Census Tract 794, Kings County, New York",718,132,586,409,1288,39420,1939,2005,1251,27.5,63,0,384,0,25,586,98
2013,36047079400,"Census Tract 794, Kings County, New York",750,113,637,435,1336,34898,1939,2006,1291,34.8,73,0,416,0,19,637,134
2014,36047079400,"Census Tract 794, Kings County, New York",726,121,605,411,1249,32257,1939,2006,1310,45.9,55,0,380,0,31,605,157
2015,36047079400,"Census Tract 794, Kings County, New York",720,92,628,402,1223,35924,1939,2006,1303,36.6,48,0,395,0,7,628,135
2016,36047079400,"Census Tract 794, Kings County, New York",736,96,640,432,1164,31226,1939,2006,1231,42.6,47,0,426,0,6,640,168
2017,36047079400,"Census Tract 794, Kings County, New York",738,117,621,434,1133,31409,1939,2005,1273,44.1,42,13,398,0,23,621,158
2018,36047079400,"Census Tract 794, Kings County, New York",734,161,573,406,1063,34844,0,2006,1173,34.3,58,48,320,0,38,573,124
2019,36047079400,"Census Tract 794, Kings County, New York",742,195,547,375,1022,37665,0,2010,1232,36.4,70,47,266,6,50,547,82
2020,36047079400,"Census Tract 794, Kings County, New York",728,161,567,334,915,34028,0,2013,1333,43.1,62,43,226,5,53,567,80
2012,36047079601,"Census Tract 796.01, Kings County, New York",1888,52,1836,1663,3800,41313,1939,2002,1138,34.1,598,232,1230,0,135,1836,259
2013,36047079601,"Census Tract 796.01, Kings County, New York",1940,79,1861,1597,3705,44304,1939,2002,1125,33.1,633,233,1213,8,108,1861,228
2014,36047079601,"Census Tract 796.01, Kings County, New York",1996,50,1946,1691,3728,43575,1939,2003,1145,35.1,719,306,1214,8,154,1946,212
2015,36047079601,"Census Tract 796.01, Kings County, New York",1982,103,1879,1609,3995,43814,1939,2004,1205,33.5,644,366,1096,7,139,1879,202
2016,36047079601,"Census Tract 796.01, Kings County, New York",1995,91,1904,1600,3961,46964,1939,2006,1250,32.5,578,396,1048,7,189,1904,296
2017,36047079601,"Census Tract 796.01, Kings County, New York",2008,93,1915,1560,3885,52237,1939,2007,1290,29.2,603,366,1086,17,178,1915,269
2018,36047079601,"Census Tract 796.01, Kings County, New York",1988,77,1911,1607,4047,49663,0,2006,1373,29.9,530,373,1126,14,146,1911,264
2019,36047079601,"Census Tract 796.01, Kings County, New York",1961,102,1859,1599,3952,57725,0,2009,1435,30.9,556,379,1045,15,204,1859,345
2020,36047079601,"Census Tract 796.01, Kings County, New York",1745,58,1687,1418,3035,59052,0,2009,1428,30.2,585,354,870,21,264,1687,259
2012,36047079602,"Census Tract 796.02, Kings County, New York",1938,130,1808,1656,4040,29968,1939,2002,1096,41.3,235,160,1327,66,179,1808,510
2013,36047079602,"Census Tract 796.02, Kings County, New York",1974,232,1742,1620,3987,32958,1939,2003,1100,39,292,110,1351,67,189,1742,408
2014,36047079602,"Census Tract 796.02, Kings County, New York",2040,322,1718,1577,3980,32878,1939,2003,1123,37.8,266,80,1273,56,223,1718,434
2015,36047079602,"Census Tract 796.02, Kings County, New York",2038,370,1668,1561,4332,35372,1939,2003,1154,37.7,259,104,1237,32,226,1668,375
2016,36047079602,"Census Tract 796.02, Kings County, New York",2072,296,1776,1643,4557,37238,1939,2006,1197,35.4,371,184,1242,10,224,1776,334
2017,36047079602,"Census Tract 796.02, Kings County, New York",2028,326,1702,1533,4236,41462,1939,2006,1202,31.2,454,218,1088,10,176,1702,297
2018,36047079602,"Census Tract 796.02, Kings County, New York",2023,250,1773,1593,4182,48589,0,2009,1314,27.5,550,328,1021,28,176,1773,271
2019,36047079602,"Census Tract 796.02, Kings County, New York",2066,154,1912,1606,4111,58333,0,2009,1368,27,599,298,1039,29,216,1912,294
2020,36047079602,"Census Tract 796.02, Kings County, New York",2238,98,2140,1832,4305,63202,0,2012,1416,31.6,629,406,990,38,334,2140,387
2012,36047079801,"Census Tract 798.01, Kings County, New York",1421,37,1384,1079,2511,42937,1939,1996,1060,39.5,289,164,825,16,53,1384,209
2013,36047079801,"Census Tract 798.01, Kings County, New York",1377,67,1310,1004,2194,42577,1939,1996,1140,36.5,260,154,756,55,103,1310,177
2014,36047079801,"Census Tract 798.01, Kings County, New York",1384,112,1272,934,2025,44786,1939,1999,1206,36.6,335,170,613,85,114,1272,151
2015,36047079801,"Census Tract 798.01, Kings County, New York",1399,108,1291,946,2031,48194,1939,2001,1201,32.4,427,197,582,102,126,1291,144
2016,36047079801,"Census Tract 798.01, Kings County, New York",1416,73,1343,999,2241,53221,1939,2002,1271,31.3,429,273,541,90,187,1343,171
2017,36047079801,"Census Tract 798.01, Kings County, New York",1412,113,1299,982,2177,70407,1939,2004,1358,26.4,456,312,500,103,150,1299,133
2018,36047079801,"Census Tract 798.01, Kings County, New York",1409,141,1268,944,1952,70625,0,2007,1486,29.7,520,339,463,67,91,1268,122
2019,36047079801,"Census Tract 798.01, Kings County, New York",1442,106,1336,1062,2103,66384,0,2010,1534,28.9,584,386,539,39,118,1336,102
2020,36047079801,"Census Tract 798.01, Kings County, New York",1610,159,1451,1083,2282,73542,0,2013,1650,31.6,662,550,415,25,84,1451,91
2012,36047079802,"Census Tract 798.02, Kings County, New York",2504,76,2428,2356,5561,41588,1944,2000,1115,32.5,701,291,1815,114,185,2428,359
2013,36047079802,"Census Tract 798.02, Kings County, New York",2411,142,2269,2176,5149,44405,1942,2000,1150,31.6,846,361,1586,120,121,2269,328
2014,36047079802,"Census Tract 798.02, Kings County, New York",2434,139,2295,2236,5684,51333,1941,2001,1196,31.2,836,362,1625,113,102,2295,388
2015,36047079802,"Census Tract 798.02, Kings County, New York",2469,98,2371,2337,5873,53125,1939,2004,1191,29.7,912,415,1462,235,164,2371,389
2016,36047079802,"Census Tract 798.02, Kings County, New York",2463,176,2287,2270,5751,60569,1939,2007,1288,28.3,1015,514,1261,214,243,2287,411
2017,36047079802,"Census Tract 798.02, Kings County, New York",2496,160,2336,2293,5834,61691,1939,2008,1365,28.9,1068,617,1174,224,237,2336,391
2018,36047079802,"Census Tract 798.02, Kings County, New York",2589,160,2429,2388,5559,63975,0,2010,1499,27.4,1197,667,1113,257,299,2429,371
2019,36047079802,"Census Tract 798.02, Kings County, New York",2642,142,2500,2445,5288,67159,0,2011,1641,29,1305,775,1027,321,281,2500,327
2020,36047079802,"Census Tract 798.02, Kings County, New York",2586,153,2433,2381,5053,80331,0,2011,1703,26.8,1393,780,1207,206,216,2433,206
2012,36047080000,"Census Tract 800, Kings County, New York",1548,165,1383,901,2493,37772,1939,2003,1094,37.6,176,62,769,35,72,1383,317
2013,36047080000,"Census Tract 800, Kings County, New York",1511,120,1391,843,2230,37952,1939,2003,1094,38.4,209,97,679,33,70,1391,312
2014,36047080000,"Census Tract 800, Kings County, New York",1507,127,1380,826,2330,38103,1939,2003,1090,36.5,232,113,668,17,72,1380,299
2015,36047080000,"Census Tract 800, Kings County, New York",1479,145,1334,723,2055,32006,1939,2006,1250,38.1,197,124,544,32,65,1334,236
2016,36047080000,"Census Tract 800, Kings County, New York",1489,176,1313,676,1773,43256,1939,2008,1315,35.7,163,127,520,22,30,1313,171
2017,36047080000,"Census Tract 800, Kings County, New York",1476,135,1341,700,1872,55682,1939,2008,1269,30.6,201,125,542,16,44,1341,117
2018,36047080000,"Census Tract 800, Kings County, New York",1522,122,1400,798,2021,65294,0,2010,1431,29.3,250,139,614,15,56,1400,115
2019,36047080000,"Census Tract 800, Kings County, New York",1583,184,1399,765,1801,62981,0,2011,1618,29.3,312,202,517,20,36,1399,138
2020,36047080000,"Census Tract 800, Kings County, New York",1572,141,1431,797,1629,49313,0,2008,1396,33.4,375,173,549,30,45,1431,121
2012,36047080200,"Census Tract 802, Kings County, New York",1912,188,1724,1271,3175,40069,1945,2000,996,35.6,252,63,1099,10,123,1724,420
2013,36047080200,"Census Tract 802, Kings County, New York",1952,225,1727,1336,3526,40170,1941,2003,1075,37.6,355,133,1115,5,103,1727,468
2014,36047080200,"Census Tract 802, Kings County, New York",1965,122,1843,1449,3835,40158,1941,2003,1122,37.7,414,107,1234,7,142,1843,421
2015,36047080200,"Census Tract 802, Kings County, New York",1971,95,1876,1500,3777,37593,1939,2006,1182,38.3,445,142,1209,7,149,1876,406
2016,36047080200,"Census Tract 802, Kings County, New York",2023,41,1982,1591,3910,41302,1939,2008,1208,34.2,539,156,1279,9,169,1982,363
2017,36047080200,"Census Tract 802, Kings County, New York",1998,44,1954,1526,3562,39348,1939,2009,1255,34,541,180,1177,27,152,1954,367
2018,36047080200,"Census Tract 802, Kings County, New York",2040,48,1992,1518,3559,42905,0,2009,1291,33.5,498,175,1148,42,192,1992,321
2019,36047080200,"Census Tract 802, Kings County, New York",2030,130,1900,1395,3344,47104,0,2010,1335,32.5,452,188,1031,38,154,1900,317
2020,36047080200,"Census Tract 802, Kings County, New York",2087,105,1982,1270,3063,58788,0,2009,1415,31.9,535,186,936,34,166,1982,200
2012,36047080400,"Census Tract 804, Kings County, New York",1340,119,1221,967,2153,31563,1939,2005,1214,45.1,205,82,629,75,174,1221,253
2013,36047080400,"Census Tract 804, Kings County, New York",1360,150,1210,965,2086,29464,1939,2006,1241,48.2,151,71,692,38,156,1210,317
2014,36047080400,"Census Tract 804, Kings County, New York",1354,130,1224,1004,2396,30106,1939,2007,1260,45.6,163,86,775,44,84,1224,392
2015,36047080400,"Census Tract 804, Kings County, New York",1372,119,1253,1087,2639,29495,1939,2008,1237,42.2,167,85,881,38,77,1253,399
2016,36047080400,"Census Tract 804, Kings County, New York",1442,124,1318,1040,2314,30441,1939,2009,1219,38.2,146,109,843,28,44,1318,338
2017,36047080400,"Census Tract 804, Kings County, New York",1423,147,1276,919,2036,33689,1939,2011,1260,33.3,189,140,687,8,64,1276,290
2018,36047080400,"Census Tract 804, Kings County, New York",1436,130,1306,906,1916,40764,0,2011,1399,40.3,270,171,620,2,82,1306,229
2019,36047080400,"Census Tract 804, Kings County, New York",1453,147,1306,867,1710,40699,0,2012,1532,41.2,268,174,544,39,103,1306,160
2020,36047080400,"Census Tract 804, Kings County, New York",1591,122,1469,1026,1710,45549,0,2006,1393,36.5,287,154,751,41,53,1469,152
2012,36047080600,"Census Tract 806, Kings County, New York",1249,137,1112,816,2409,44850,1939,2001,1108,33.7,262,126,638,0,17,1112,153
2013,36047080600,"Census Tract 806, Kings County, New York",1255,122,1133,793,2116,42958,1941,2003,1184,37,225,154,632,0,16,1133,196
2014,36047080600,"Census Tract 806, Kings County, New York",1248,116,1132,834,2347,38393,1939,2005,1243,38.7,198,227,574,0,33,1132,291
2015,36047080600,"Census Tract 806, Kings County, New York",1266,54,1212,906,2599,37449,1941,2006,1302,37.5,236,222,599,46,39,1212,353
2016,36047080600,"Census Tract 806, Kings County, New York",1269,58,1211,888,2599,37500,1939,2007,1372,37.2,262,230,580,45,33,1211,347
2017,36047080600,"Census Tract 806, Kings County, New York",1287,75,1212,921,2739,38920,1941,2007,1354,34.7,287,219,588,62,52,1212,328
2018,36047080600,"Census Tract 806, Kings County, New York",1312,59,1253,969,2899,53491,1940,2009,1437,32.1,283,224,621,61,55,1253,279
2019,36047080600,"Census Tract 806, Kings County, New York",1319,93,1226,877,2407,53977,1949,2010,1330,26.4,256,174,583,71,40,1226,195
2020,36047080600,"Census Tract 806, Kings County, New York",1429,137,1292,993,2477,65179,1958,2010,1394,29.7,260,183,639,36,49,1292,134
2012,36047080800,"Census Tract 808, Kings County, New York",177,27,150,150,209,11833,2003,2004,275,34.7,6,0,60,83,0,150,85
2013,36047080800,"Census Tract 808, Kings County, New York",171,27,144,144,208,12283,2004,2004,285,30.8,14,0,63,81,0,144,77
2014,36047080800,"Census Tract 808, Kings County, New York",199,28,171,171,246,11012,2003,2005,240,28,21,0,71,97,3,171,107
2015,36047080800,"Census Tract 808, Kings County, New York",225,17,208,208,278,9829,2005,2006,235,28.3,30,0,112,92,13,208,117
2016,36047080800,"Census Tract 808, Kings County, New York",273,15,258,258,357,9740,2006,2007,251,29.3,28,3,143,86,26,258,157
2017,36047080800,"Census Tract 808, Kings County, New York",310,16,294,294,397,10729,2007,2009,309,30.6,39,8,191,67,29,294,168
2018,36047080800,"Census Tract 808, Kings County, New York",420,26,394,391,540,11829,2009,2012,319,31.8,48,17,245,85,48,394,222
2019,36047080800,"Census Tract 808, Kings County, New York",538,40,498,495,731,11117,2011,2013,373,33.5,59,22,330,82,84,498,307
2020,36047080800,"Census Tract 808, Kings County, New York",627,47,580,577,828,11461,2013,2014,NA,39.8,77,25,406,65,99,580,374
2012,36047081000,"Census Tract 810, Kings County, New York",991,70,921,755,1647,39464,1950,2003,1009,30.8,191,5,651,55,19,921,146
2013,36047081000,"Census Tract 810, Kings County, New York",1002,115,887,679,1550,37194,1939,2004,1113,31.6,213,11,599,27,39,887,147
2014,36047081000,"Census Tract 810, Kings County, New York",1035,141,894,663,1412,41120,1939,2005,1215,30.9,246,31,559,31,38,894,199
2015,36047081000,"Census Tract 810, Kings County, New York",1006,134,872,682,1430,NA,1939,2005,1234,32.2,227,43,572,30,52,872,208
2016,36047081000,"Census Tract 810, Kings County, New York",1025,158,867,658,1430,40870,1939,2006,1257,34.7,188,52,569,7,39,867,149
2017,36047081000,"Census Tract 810, Kings County, New York",1031,189,842,619,1326,40680,1939,2006,1282,36.8,168,49,531,0,50,842,213
2018,36047081000,"Census Tract 810, Kings County, New York",1062,167,895,710,1608,43000,0,2010,1329,35.7,194,78,570,0,50,895,186
2019,36047081000,"Census Tract 810, Kings County, New York",1041,157,884,688,1669,57569,0,2011,1372,35.5,187,78,531,0,59,884,150
2020,36047081000,"Census Tract 810, Kings County, New York",1191,278,913,725,1696,59403,1953,2013,1516,36.8,178,98,548,12,37,913,245
2012,36047081400,"Census Tract 814, Kings County, New York",1103,86,1017,560,1584,50227,1939,2003,1222,28.3,136,0,532,14,84,1017,160
2013,36047081400,"Census Tract 814, Kings County, New York",1089,123,966,570,1306,40435,1939,2005,1148,32.2,58,0,540,13,80,966,229
2014,36047081400,"Census Tract 814, Kings County, New York",1134,123,1011,579,1453,33787,1939,2007,1145,39.3,77,0,557,11,88,1011,289
2015,36047081400,"Census Tract 814, Kings County, New York",1123,132,991,545,1371,32098,1939,2010,1235,42.5,68,0,521,12,8,991,265
2016,36047081400,"Census Tract 814, Kings County, New York",1156,100,1056,616,1539,30000,1939,2010,1310,48.5,109,0,575,27,24,1056,281
2017,36047081400,"Census Tract 814, Kings County, New York",1157,120,1037,601,1349,28882,1939,2011,1344,50,86,0,571,13,26,1037,237
2018,36047081400,"Census Tract 814, Kings County, New York",1143,108,1035,601,1406,32250,0,2011,1394,51,150,0,566,20,28,1035,182
2019,36047081400,"Census Tract 814, Kings County, New York",1136,104,1032,649,1611,43365,0,2011,1429,51,130,0,618,23,23,1032,199
2020,36047081400,"Census Tract 814, Kings County, New York",1106,141,965,565,1350,52946,0,2011,1427,30.7,107,0,502,38,37,965,138
2012,36047081600,"Census Tract 816, Kings County, New York",1011,41,970,713,1812,35037,1939,2002,1129,43.8,116,32,582,10,102,970,203
2013,36047081600,"Census Tract 816, Kings County, New York",1030,62,968,684,1907,41071,1939,2003,1176,34.1,106,17,545,11,121,968,169
2014,36047081600,"Census Tract 816, Kings County, New York",1040,93,947,643,1788,42734,1939,2004,1167,31.9,112,19,550,20,62,947,194
2015,36047081600,"Census Tract 816, Kings County, New York",1061,115,946,654,1808,43269,1939,2004,1186,32.1,117,0,557,27,58,946,189
2016,36047081600,"Census Tract 816, Kings County, New York",1081,141,940,684,1822,40857,1939,2006,1277,34.2,151,11,546,42,69,940,196
2017,36047081600,"Census Tract 816, Kings County, New York",1062,133,929,663,1908,46023,1939,2006,1350,31.4,126,17,531,39,64,929,152
2018,36047081600,"Census Tract 816, Kings County, New York",1075,142,933,700,1915,40000,0,2008,1380,37.5,135,26,568,43,45,933,163
2019,36047081600,"Census Tract 816, Kings County, New York",1078,111,967,694,1880,38641,0,2008,1411,39.9,147,37,528,49,60,967,182
2020,36047081600,"Census Tract 816, Kings County, New York",1118,118,1000,702,1762,44479,0,2008,1428,36.8,181,37,564,54,47,1000,138
2012,36047081800,"Census Tract 818, Kings County, New York",1910,195,1715,1441,3972,35951,1939,2002,1054,33.9,257,11,1171,54,293,1715,458
2013,36047081800,"Census Tract 818, Kings County, New York",1859,190,1669,1408,4035,44519,1939,2003,1126,28.6,304,44,1123,60,276,1669,494
2014,36047081800,"Census Tract 818, Kings County, New York",1884,228,1656,1478,4057,45056,1939,2004,1126,29.6,376,45,1176,56,296,1656,477
2015,36047081800,"Census Tract 818, Kings County, New York",1816,195,1621,1456,3747,41810,1939,2006,1139,32.3,409,39,1219,59,207,1621,408
2016,36047081800,"Census Tract 818, Kings County, New York",1804,179,1625,1430,3728,46250,1939,2007,1200,30.4,448,58,1182,60,208,1625,391
2017,36047081800,"Census Tract 818, Kings County, New York",1783,126,1657,1380,3540,52647,1939,2006,1259,28.8,489,76,1096,85,153,1657,299
2018,36047081800,"Census Tract 818, Kings County, New York",1790,183,1607,1275,2983,64602,0,2010,1307,26.5,523,84,1108,53,99,1607,192
2019,36047081800,"Census Tract 818, Kings County, New York",1891,207,1684,1394,3290,70417,1941,2011,1364,24.9,533,96,1121,54,157,1684,182
2020,36047081800,"Census Tract 818, Kings County, New York",1940,224,1716,1362,3094,82050,1951,2012,1417,23.4,628,125,1021,56,126,1716,188
2012,36047082000,"Census Tract 820, Kings County, New York",2080,249,1831,1802,4898,42120,1939,2001,1091,29.5,300,29,1657,19,189,1831,278
2013,36047082000,"Census Tract 820, Kings County, New York",2058,283,1775,1712,4784,42143,1939,2002,1100,28.9,338,34,1540,32,172,1775,339
2014,36047082000,"Census Tract 820, Kings County, New York",2043,235,1808,1737,4760,42271,1939,2002,1155,30.1,288,65,1507,36,159,1808,354
2015,36047082000,"Census Tract 820, Kings County, New York",2070,203,1867,1769,4500,36123,1939,2005,1178,33.8,248,85,1498,56,162,1867,440
2016,36047082000,"Census Tract 820, Kings County, New York",2110,293,1817,1723,4590,36829,1939,2005,1211,32.9,239,114,1429,45,157,1817,474
2017,36047082000,"Census Tract 820, Kings County, New York",2123,300,1823,1728,4703,41162,1939,2007,1297,33.2,293,154,1342,59,192,1823,541
2018,36047082000,"Census Tract 820, Kings County, New York",2115,235,1880,1843,5097,43583,0,2008,1341,32.6,349,150,1425,55,226,1880,545
2019,36047082000,"Census Tract 820, Kings County, New York",2212,244,1968,1911,4968,47090,0,2010,1406,29.1,357,143,1517,46,185,1968,560
2020,36047082000,"Census Tract 820, Kings County, New York",2412,244,2168,2137,5089,45982,0,2011,1504,31.6,474,190,1633,49,163,2168,430
2012,36047082200,"Census Tract 822, Kings County, New York",2989,237,2752,2654,6216,32887,1939,2002,1052,42.8,339,79,2415,10,240,2752,649
2013,36047082200,"Census Tract 822, Kings County, New York",2952,282,2670,2538,6245,36385,1939,2002,1064,33.6,350,91,2235,38,203,2670,710
2014,36047082200,"Census Tract 822, Kings County, New York",3003,288,2715,2523,6490,36486,1939,2002,1129,37,392,88,2230,44,229,2715,661
2015,36047082200,"Census Tract 822, Kings County, New York",3102,347,2755,2593,6941,36792,1939,2003,1171,40.9,445,102,2311,37,244,2755,557
2016,36047082200,"Census Tract 822, Kings County, New York",3140,319,2821,2637,6642,40160,1939,2004,1205,40.3,611,133,2361,42,241,2821,540
2017,36047082200,"Census Tract 822, Kings County, New York",3123,323,2800,2611,6641,40166,1939,2004,1218,39.2,558,148,2238,60,279,2800,534
2018,36047082200,"Census Tract 822, Kings County, New York",3122,313,2809,2649,6733,38750,0,2004,1283,41.8,646,233,2219,20,273,2809,513
2019,36047082200,"Census Tract 822, Kings County, New York",3120,346,2774,2582,6203,46042,0,2009,1353,40.4,768,323,2079,34,202,2774,493
2020,36047082200,"Census Tract 822, Kings County, New York",2954,245,2709,2542,6261,57993,0,2009,1334,31.2,836,393,1855,77,215,2709,445
2012,36047082400,"Census Tract 824, Kings County, New York",1913,230,1683,1346,3046,30254,1939,2004,1096,39,107,0,1102,32,197,1683,308
2013,36047082400,"Census Tract 824, Kings County, New York",1873,276,1597,1271,2980,28042,1939,2004,1130,38.8,113,0,1081,0,183,1597,346
2014,36047082400,"Census Tract 824, Kings County, New York",1860,319,1541,1242,2948,29453,1939,2005,1229,38.5,113,0,1093,0,132,1541,379
2015,36047082400,"Census Tract 824, Kings County, New York",1866,319,1547,1233,3057,34934,1939,2006,1254,36.1,152,18,1068,0,130,1547,366
2016,36047082400,"Census Tract 824, Kings County, New York",1895,365,1530,1210,3111,33986,1939,2008,1300,36.7,157,25,1050,24,87,1530,344
2017,36047082400,"Census Tract 824, Kings County, New York",1842,306,1536,1227,3075,35024,1939,2009,1357,38.9,214,47,1107,21,49,1536,356
2018,36047082400,"Census Tract 824, Kings County, New York",1858,272,1586,1261,3239,37917,0,2009,1378,38.2,248,52,1113,31,61,1586,295
2019,36047082400,"Census Tract 824, Kings County, New York",1915,275,1640,1311,3519,44969,0,2010,1437,33.5,338,78,1124,36,60,1640,217
2020,36047082400,"Census Tract 824, Kings County, New York",1969,252,1717,1427,3440,42277,0,2012,1432,37.7,331,75,1225,35,61,1717,232
2012,36047082600,"Census Tract 826, Kings County, New York",2156,287,1869,1397,3837,26237,1939,2003,1097,45.6,156,0,1297,0,101,1869,448
2013,36047082600,"Census Tract 826, Kings County, New York",2121,277,1844,1342,3546,30556,1939,2004,1120,45,154,9,1296,0,43,1844,357
2014,36047082600,"Census Tract 826, Kings County, New York",2096,217,1879,1335,3247,31021,1939,2004,1124,42.6,178,8,1237,7,79,1879,338
2015,36047082600,"Census Tract 826, Kings County, New York",2113,254,1859,1333,3033,35020,1939,2004,1116,34.9,206,13,1229,17,95,1859,296
2016,36047082600,"Census Tract 826, Kings County, New York",2148,193,1955,1406,3228,36827,1939,2005,1157,38.2,264,18,1314,10,79,1955,287
2017,36047082600,"Census Tract 826, Kings County, New York",2180,228,1952,1390,3332,37653,1939,2006,1176,33.3,286,17,1281,9,106,1952,293
2018,36047082600,"Census Tract 826, Kings County, New York",2181,225,1956,1374,3368,39188,0,2007,1228,33.7,307,19,1243,10,120,1956,303
2019,36047082600,"Census Tract 826, Kings County, New York",2192,338,1854,1318,3148,45197,0,2010,1312,32.4,341,26,1207,7,99,1854,212
2020,36047082600,"Census Tract 826, Kings County, New York",2173,318,1855,1398,3263,48649,0,2012,1334,35.5,540,25,1229,0,112,1855,236
2012,36047082800,"Census Tract 828, Kings County, New York",1460,214,1246,1015,2754,45331,1939,2003,1125,31.5,130,0,952,17,85,1246,185
2013,36047082800,"Census Tract 828, Kings County, New York",1435,241,1194,981,2624,45605,1939,2004,1110,29.5,143,8,885,22,106,1194,169
2014,36047082800,"Census Tract 828, Kings County, New York",1407,199,1208,919,2580,46146,1939,2006,1148,29.7,177,8,806,33,92,1208,217
2015,36047082800,"Census Tract 828, Kings County, New York",1470,236,1234,948,2703,42778,1939,2007,1147,31.2,194,31,805,35,120,1234,212
2016,36047082800,"Census Tract 828, Kings County, New York",1535,252,1283,933,2784,38697,1939,2009,1173,32,196,50,779,12,99,1283,196
2017,36047082800,"Census Tract 828, Kings County, New York",1570,223,1347,1017,3039,39254,1939,2011,1317,32.6,213,49,871,10,93,1347,206
2018,36047082800,"Census Tract 828, Kings County, New York",1583,218,1365,1003,2851,41420,0,2012,1376,34,215,75,853,0,77,1365,222
2019,36047082800,"Census Tract 828, Kings County, New York",1583,302,1281,923,2634,51328,0,2012,1420,32.2,171,77,765,0,73,1281,118
2020,36047082800,"Census Tract 828, Kings County, New York",1662,302,1360,1064,2761,68818,0,2013,1458,28.7,347,55,835,0,153,1360,156
2012,36047083000,"Census Tract 830, Kings County, New York",2345,123,2222,1891,4604,43162,1951,2004,1071,31.2,324,0,1717,12,153,2222,299
2013,36047083000,"Census Tract 830, Kings County, New York",2314,138,2176,1814,4668,46848,1942,2005,1112,31,296,0,1652,0,135,2176,238
2014,36047083000,"Census Tract 830, Kings County, New York",2337,108,2229,1829,4817,43926,1939,2006,1133,32.5,385,13,1714,29,86,2229,322
2015,36047083000,"Census Tract 830, Kings County, New York",2357,180,2177,1804,4572,40667,1939,2007,1150,32.4,499,24,1660,27,54,2177,268
2016,36047083000,"Census Tract 830, Kings County, New York",2416,180,2236,1890,5156,46563,1941,2008,1238,31.1,546,30,1681,44,103,2236,338
2017,36047083000,"Census Tract 830, Kings County, New York",2429,185,2244,1845,4837,45082,1943,2010,1263,33.7,503,32,1644,42,102,2244,347
2018,36047083000,"Census Tract 830, Kings County, New York",2502,216,2286,1952,5148,47126,1946,2010,1344,33.9,478,24,1721,48,142,2286,345
2019,36047083000,"Census Tract 830, Kings County, New York",2544,243,2301,1996,5406,51013,1945,2011,1422,32.7,459,13,1700,22,262,2301,361
2020,36047083000,"Census Tract 830, Kings County, New York",2680,219,2461,1888,5001,51085,1949,2012,1497,34.4,378,0,1645,24,247,2461,461
2012,36047083200,"Census Tract 832, Kings County, New York",815,104,711,248,604,42845,1939,2004,1085,29.5,68,15,213,20,0,711,26
2013,36047083200,"Census Tract 832, Kings County, New York",791,117,674,215,577,38807,1939,2006,1143,34.8,53,4,181,17,13,674,27
2014,36047083200,"Census Tract 832, Kings County, New York",797,89,708,203,468,51932,1939,2006,1196,29.3,60,0,174,17,12,708,44
2015,36047083200,"Census Tract 832, Kings County, New York",801,74,727,225,534,54375,1939,2007,1273,32.1,73,0,199,15,11,727,42
2016,36047083200,"Census Tract 832, Kings County, New York",808,53,755,292,696,54712,1939,2007,1369,32.2,114,0,274,8,10,755,36
2017,36047083200,"Census Tract 832, Kings County, New York",802,57,745,283,676,38661,1939,2008,1360,41,85,0,265,0,12,745,55
2018,36047083200,"Census Tract 832, Kings County, New York",778,73,705,270,628,42500,0,2007,1327,36.8,84,0,262,0,0,705,68
2019,36047083200,"Census Tract 832, Kings County, New York",776,69,707,279,718,41875,0,2008,1399,40,72,0,271,0,0,707,71
2020,36047083200,"Census Tract 832, Kings County, New York",813,76,737,295,696,42067,0,2006,1368,39.2,58,0,262,0,0,737,61
2012,36047083400,"Census Tract 834, Kings County, New York",638,28,610,130,228,22432,1939,2006,1069,50,30,13,117,0,0,610,50
2013,36047083400,"Census Tract 834, Kings County, New York",617,27,590,144,280,22256,1939,2006,1096,50,31,15,129,0,0,590,39
2014,36047083400,"Census Tract 834, Kings County, New York",592,37,555,142,272,55500,1939,2006,1145,19.8,33,12,125,0,0,555,38
2015,36047083400,"Census Tract 834, Kings County, New York",591,16,575,139,292,NA,1939,2005,1144,37.1,6,11,121,0,0,575,47
2016,36047083400,"Census Tract 834, Kings County, New York",594,39,555,122,319,NA,1939,2003,1181,38,7,11,103,0,0,555,60
2017,36047083400,"Census Tract 834, Kings County, New York",605,63,542,120,322,24265,1947,1998,1198,39.5,33,0,112,0,0,542,73
2018,36047083400,"Census Tract 834, Kings County, New York",610,73,537,149,373,43977,1940,2004,1301,39.7,31,0,130,13,0,537,63
2019,36047083400,"Census Tract 834, Kings County, New York",647,64,583,160,431,44375,1941,2007,1492,39.3,43,0,148,12,10,583,61
2020,36047083400,"Census Tract 834, Kings County, New York",674,98,576,197,507,53482,1945,2007,1605,32.5,95,0,185,12,8,576,67
2012,36047083600,"Census Tract 836, Kings County, New York",817,76,741,326,725,35185,1939,2003,1160,26.6,86,10,308,0,8,741,120
2013,36047083600,"Census Tract 836, Kings County, New York",820,65,755,337,790,38264,1939,2005,1208,27.8,87,9,321,0,7,755,104
2014,36047083600,"Census Tract 836, Kings County, New York",817,67,750,310,583,30000,1939,2005,1176,38.1,101,0,302,0,8,750,91
2015,36047083600,"Census Tract 836, Kings County, New York",838,83,755,317,678,35469,1939,2008,1262,33.2,80,0,307,0,10,755,78
2016,36047083600,"Census Tract 836, Kings County, New York",817,72,745,310,756,29847,1939,2011,1348,44.7,59,0,310,0,0,745,63
2017,36047083600,"Census Tract 836, Kings County, New York",792,47,745,287,692,29960,1939,2011,1366,47.7,42,0,287,0,0,745,56
2018,36047083600,"Census Tract 836, Kings County, New York",781,52,729,284,746,30588,0,2011,1428,51,42,0,284,0,0,729,74
2019,36047083600,"Census Tract 836, Kings County, New York",804,77,727,301,741,32798,0,2012,1438,51,41,0,301,0,0,727,74
2020,36047083600,"Census Tract 836, Kings County, New York",776,82,694,242,631,31875,0,2012,1391,43.1,56,0,242,0,0,694,77
2012,36047083800,"Census Tract 838, Kings County, New York",799,10,789,197,463,32083,1943,2003,1095,39.4,24,6,179,0,12,789,44
2013,36047083800,"Census Tract 838, Kings County, New York",787,11,776,160,413,30000,1939,2007,1117,48.2,46,5,155,0,0,776,52
2014,36047083800,"Census Tract 838, Kings County, New York",778,0,778,202,401,33750,1939,2007,1141,44,42,5,187,10,0,778,61
2015,36047083800,"Census Tract 838, Kings County, New York",778,0,778,194,408,36731,1939,2007,1254,50,46,4,167,9,14,778,43
2016,36047083800,"Census Tract 838, Kings County, New York",801,9,792,207,404,31696,1939,2008,1277,50,37,4,181,8,14,792,61
2017,36047083800,"Census Tract 838, Kings County, New York",821,25,796,193,368,31696,1939,2010,1287,50,32,0,170,9,14,796,38
2018,36047083800,"Census Tract 838, Kings County, New York",845,25,820,199,311,41172,0,2008,1301,30.8,25,0,174,12,13,820,32
2019,36047083800,"Census Tract 838, Kings County, New York",806,24,782,160,300,38667,0,2006,1346,33.7,11,0,149,0,11,782,34
2020,36047083800,"Census Tract 838, Kings County, New York",781,27,754,166,294,NA,0,2005,1296,48.6,10,0,166,0,0,754,78
2012,36047084000,"Census Tract 840, Kings County, New York",789,6,783,292,667,38077,1941,2005,1064,24.4,65,68,195,0,29,783,73
2013,36047084000,"Census Tract 840, Kings County, New York",804,20,784,272,636,41250,1939,2006,1137,29.9,93,49,201,0,29,784,34
2014,36047084000,"Census Tract 840, Kings County, New York",808,31,777,285,679,40313,1939,2008,1124,28.1,85,53,202,0,48,777,47
2015,36047084000,"Census Tract 840, Kings County, New York",815,29,786,310,802,45781,1939,2008,1157,30,50,20,255,0,43,786,78
2016,36047084000,"Census Tract 840, Kings County, New York",861,44,817,284,761,40227,1942,2010,1178,30,45,16,232,0,42,817,84
2017,36047084000,"Census Tract 840, Kings County, New York",871,52,819,242,592,39167,1943,2008,1362,41.5,54,0,230,0,34,819,88
2018,36047084000,"Census Tract 840, Kings County, New York",845,41,804,238,579,40303,1948,2008,1387,42.7,29,0,226,0,24,804,88
2019,36047084000,"Census Tract 840, Kings County, New York",864,41,823,299,738,40195,1946,2009,1380,42.2,30,0,293,0,18,823,94
2020,36047084000,"Census Tract 840, Kings County, New York",874,44,830,279,692,42621,1944,2011,1406,51,26,0,279,0,20,830,85
2012,36047084600,"Census Tract 846, Kings County, New York",706,71,635,294,706,64545,1947,2003,1093,22.7,58,18,226,0,38,635,98
2013,36047084600,"Census Tract 846, Kings County, New York",703,60,643,318,698,36875,1947,2004,1133,31.5,51,30,244,0,31,643,118
2014,36047084600,"Census Tract 846, Kings County, New York",719,64,655,278,661,35568,1941,2003,1197,38.8,35,21,243,0,0,655,132
2015,36047084600,"Census Tract 846, Kings County, New York",739,53,686,339,789,27614,1944,2006,1207,50,41,19,290,0,10,686,146
2016,36047084600,"Census Tract 846, Kings County, New York",753,66,687,352,841,29904,1946,2006,1254,46.2,44,30,295,0,8,687,107
2017,36047084600,"Census Tract 846, Kings County, New York",747,44,703,305,777,35057,1947,2007,1292,40.1,41,9,283,0,13,703,59
2018,36047084600,"Census Tract 846, Kings County, New York",760,48,712,265,692,32383,1949,2009,1363,39.8,48,12,238,0,15,712,50
2019,36047084600,"Census Tract 846, Kings County, New York",776,45,731,301,792,32250,1948,2011,1425,44.9,37,13,273,0,26,731,38
2020,36047084600,"Census Tract 846, Kings County, New York",758,43,715,250,616,41500,1943,2012,1356,38.6,38,14,213,0,18,715,6
2012,36047084800,"Census Tract 848, Kings County, New York",608,62,546,170,533,23500,1939,2004,1305,45,55,0,170,0,7,546,69
2013,36047084800,"Census Tract 848, Kings County, New York",614,54,560,190,584,41667,1939,2006,1336,38.9,53,0,190,0,7,560,74
2014,36047084800,"Census Tract 848, Kings County, New York",607,55,552,176,455,24459,1954,2011,1465,48.8,13,0,176,0,6,552,90
2015,36047084800,"Census Tract 848, Kings County, New York",615,64,551,200,511,28750,1955,2010,1500,48.7,11,0,200,0,7,551,111
2016,36047084800,"Census Tract 848, Kings County, New York",614,65,549,178,374,30893,1953,2010,1215,43.5,13,0,178,0,6,549,89
2017,36047084800,"Census Tract 848, Kings County, New York",598,42,556,172,372,35357,1952,2010,1381,44.6,6,0,172,0,0,556,85
2018,36047084800,"Census Tract 848, Kings County, New York",608,30,578,193,426,41607,1950,2011,1500,39,25,0,182,0,0,578,59
2019,36047084800,"Census Tract 848, Kings County, New York",587,37,550,188,419,41818,0,2011,1547,37.3,31,0,176,0,0,550,53
2020,36047084800,"Census Tract 848, Kings County, New York",604,47,557,235,520,NA,0,2008,1335,25.5,88,0,199,0,25,557,61
2012,36047085000,"Census Tract 850, Kings County, New York",470,8,462,148,519,21862,1939,2004,1154,50,0,23,113,0,12,462,24
2013,36047085000,"Census Tract 850, Kings County, New York",473,10,463,124,522,32955,1939,2006,1215,38.9,0,23,101,0,0,463,32
2014,36047085000,"Census Tract 850, Kings County, New York",460,30,430,105,567,63512,1939,2005,1427,31.9,0,21,84,0,0,430,34
2015,36047085000,"Census Tract 850, Kings County, New York",508,46,462,68,254,NA,1939,2005,1417,39.1,0,0,68,0,0,462,43
2016,36047085000,"Census Tract 850, Kings County, New York",515,48,467,83,274,32426,1939,2006,1644,50,0,0,83,0,0,467,43
2017,36047085000,"Census Tract 850, Kings County, New York",512,47,465,79,327,NA,1941,2000,1250,50,0,0,79,0,0,465,41
2018,36047085000,"Census Tract 850, Kings County, New York",512,60,452,93,309,31518,0,2011,1378,49.7,0,0,93,0,0,452,50
2019,36047085000,"Census Tract 850, Kings County, New York",514,36,478,87,244,NA,0,2012,1392,51,0,0,87,0,0,478,47
2020,36047085000,"Census Tract 850, Kings County, New York",486,19,467,100,340,33553,0,2011,1358,50,12,0,100,0,0,467,42
2012,36047085200,"Census Tract 852, Kings County, New York",0,0,0,0,0,NA,NA,NA,NA,NA,0,0,0,0,0,0,0
2013,36047085200,"Census Tract 852, Kings County, New York",8,0,8,0,0,NA,NA,NA,NA,NA,0,0,0,0,0,8,0
2014,36047085200,"Census Tract 852, Kings County, New York",8,0,8,0,0,NA,NA,NA,NA,NA,0,0,0,0,0,8,0
2015,36047085200,"Census Tract 852, Kings County, New York",8,0,8,0,0,NA,NA,NA,NA,NA,0,0,0,0,0,8,0
2016,36047085200,"Census Tract 852, Kings County, New York",8,0,8,0,0,NA,NA,NA,NA,NA,0,0,0,0,0,8,0
2017,36047085200,"Census Tract 852, Kings County, New York",9,0,9,0,0,NA,NA,NA,NA,NA,0,0,0,0,0,9,0
2018,36047085200,"Census Tract 852, Kings County, New York",0,0,0,0,0,NA,NA,NA,NA,NA,0,0,0,0,0,0,0
2019,36047085200,"Census Tract 852, Kings County, New York",5,0,5,0,0,NA,NA,NA,NA,NA,0,0,0,0,0,5,0
2020,36047085200,"Census Tract 852, Kings County, New York",4,0,4,0,0,NA,NA,NA,NA,NA,0,0,0,0,0,4,0
2012,36047085400,"Census Tract 854, Kings County, New York",783,108,675,303,677,36573,1939,2004,1146,32.5,58,0,285,9,9,675,74
2013,36047085400,"Census Tract 854, Kings County, New York",795,94,701,350,835,35917,1939,2004,1136,33.3,43,0,328,10,12,701,89
2014,36047085400,"Census Tract 854, Kings County, New York",792,120,672,354,795,35556,1939,2004,1146,32.2,50,0,334,8,9,672,54
2015,36047085400,"Census Tract 854, Kings County, New York",768,79,689,334,858,34000,1939,2005,1110,33.6,48,0,295,10,23,689,77
2016,36047085400,"Census Tract 854, Kings County, New York",780,64,716,363,1051,36985,1939,2006,1213,37.2,71,0,326,0,32,716,129
2017,36047085400,"Census Tract 854, Kings County, New York",775,84,691,293,864,41750,1939,2006,1320,39.1,47,0,260,0,27,691,104
2018,36047085400,"Census Tract 854, Kings County, New York",784,83,701,339,878,34375,0,2010,1285,39.2,65,3,289,0,65,701,129
2019,36047085400,"Census Tract 854, Kings County, New York",809,81,728,365,918,43250,0,2011,1375,39.6,82,3,319,0,69,728,143
2020,36047085400,"Census Tract 854, Kings County, New York",901,94,807,436,919,55000,0,2012,1321,38.1,77,3,312,0,56,807,171
2012,36047085600,"Census Tract 856, Kings County, New York",1530,141,1389,875,1896,45842,1951,1998,1135,29.9,215,0,826,0,99,1389,114
2013,36047085600,"Census Tract 856, Kings County, New York",1555,148,1407,896,1926,42452,1948,2000,1149,34.1,235,0,875,0,81,1407,144
2014,36047085600,"Census Tract 856, Kings County, New York",1577,140,1437,956,2012,47831,1949,2002,1177,28.8,272,0,938,0,89,1437,165
2015,36047085600,"Census Tract 856, Kings County, New York",1616,138,1478,1090,2174,48587,1944,2006,1165,28.1,304,0,1019,0,91,1478,197
2016,36047085600,"Census Tract 856, Kings County, New York",1615,170,1445,1156,2365,49718,1943,2007,1194,29,321,31,1051,0,85,1445,212
2017,36047085600,"Census Tract 856, Kings County, New York",1644,174,1470,1132,2557,52008,1942,2010,1251,28.8,278,30,1001,7,104,1470,238
2018,36047085600,"Census Tract 856, Kings County, New York",1636,182,1454,1144,2594,56111,1944,2010,1268,28.2,291,28,1001,8,107,1454,261
2019,36047085600,"Census Tract 856, Kings County, New York",1632,222,1410,1051,2477,62756,1949,2012,1403,29.5,265,28,922,8,93,1410,251
2020,36047085600,"Census Tract 856, Kings County, New York",1650,180,1470,1091,2648,60938,1950,2014,1532,30.9,316,26,985,7,59,1470,280
2012,36047085800,"Census Tract 858, Kings County, New York",948,74,874,510,1281,44700,1939,2005,1033,36,71,10,475,0,31,874,123
2013,36047085800,"Census Tract 858, Kings County, New York",932,91,841,478,1207,45813,1939,2006,1161,31.7,76,9,437,0,37,841,108
2014,36047085800,"Census Tract 858, Kings County, New York",934,103,831,524,1248,45326,1946,2006,1202,32.3,84,9,483,0,38,831,125
2015,36047085800,"Census Tract 858, Kings County, New York",916,100,816,507,1249,34779,1953,2008,1247,36.7,96,0,468,0,45,816,120
2016,36047085800,"Census Tract 858, Kings County, New York",939,95,844,466,1193,35500,1954,2008,1261,33.5,96,0,440,0,37,844,92
2017,36047085800,"Census Tract 858, Kings County, New York",932,82,850,451,1075,45865,1955,2009,1350,26.8,101,0,426,0,27,850,83
2018,36047085800,"Census Tract 858, Kings County, New York",934,59,875,450,962,46000,1963,2009,1403,31.5,78,0,437,0,30,875,72
2019,36047085800,"Census Tract 858, Kings County, New York",898,85,813,406,892,59167,0,2010,1488,30.8,71,0,379,0,40,813,48
2020,36047085800,"Census Tract 858, Kings County, New York",843,78,765,349,753,60885,0,2009,1570,30.7,56,0,330,0,32,765,47
2012,36047086000,"Census Tract 860, Kings County, New York",1276,88,1188,862,2251,40213,1939,2000,1145,32.1,98,0,776,21,116,1188,231
2013,36047086000,"Census Tract 860, Kings County, New York",1276,96,1180,838,2192,35667,1939,2002,1131,34.3,106,0,796,19,59,1180,247
2014,36047086000,"Census Tract 860, Kings County, New York",1306,97,1209,848,2130,34662,1942,2002,1176,37,137,0,794,20,77,1209,217
2015,36047086000,"Census Tract 860, Kings County, New York",1325,89,1236,845,2185,32363,1946,2003,1184,42.4,111,0,758,19,92,1236,245
2016,36047086000,"Census Tract 860, Kings County, New York",1363,121,1242,784,2088,41507,1942,2005,1170,31.9,154,0,710,21,79,1242,173
2017,36047086000,"Census Tract 860, Kings County, New York",1423,168,1255,792,2055,43864,1945,2006,1252,32.5,166,9,729,0,54,1255,170
2018,36047086000,"Census Tract 860, Kings County, New York",1429,155,1274,832,2294,49444,0,2008,1416,31.5,254,9,740,0,83,1274,132
2019,36047086000,"Census Tract 860, Kings County, New York",1465,147,1318,883,2344,52212,0,2011,1381,32.2,225,9,795,0,72,1318,118
2020,36047086000,"Census Tract 860, Kings County, New York",1497,169,1328,804,1982,50909,0,2014,1381,36.9,165,9,749,0,51,1328,87
2012,36047086200,"Census Tract 862, Kings County, New York",1218,152,1066,762,2122,34415,1939,2000,996,29.1,164,0,666,35,32,1066,232
2013,36047086200,"Census Tract 862, Kings County, New York",1199,181,1018,725,1905,41280,1939,2002,1039,27.1,170,0,645,0,48,1018,190
2014,36047086200,"Census Tract 862, Kings County, New York",1201,191,1010,692,1874,34917,1939,2004,1038,31.4,85,0,622,0,64,1010,191
2015,36047086200,"Census Tract 862, Kings County, New York",1214,145,1069,762,1940,34821,1939,2005,1112,32.8,23,0,738,0,17,1069,223
2016,36047086200,"Census Tract 862, Kings County, New York",1231,203,1028,743,1883,42992,1939,2007,1146,31,64,32,693,0,17,1028,199
2017,36047086200,"Census Tract 862, Kings County, New York",1255,116,1139,749,1926,30218,1939,2009,1240,50,125,35,641,0,64,1139,251
2018,36047086200,"Census Tract 862, Kings County, New York",1233,119,1114,876,2075,31885,0,2008,1236,51,141,35,778,0,54,1114,303
2019,36047086200,"Census Tract 862, Kings County, New York",1233,109,1124,919,2262,44427,0,2011,1306,34.3,157,38,808,0,41,1124,204
2020,36047086200,"Census Tract 862, Kings County, New York",1341,82,1259,954,2159,43617,0,2011,1309,34.7,315,66,804,0,42,1259,168
2012,36047086400,"Census Tract 864, Kings County, New York",834,60,774,415,1252,46615,1942,2002,1131,24.1,106,0,399,5,18,774,40
2013,36047086400,"Census Tract 864, Kings County, New York",821,73,748,353,1013,43393,1939,2003,1203,37,93,0,337,5,17,748,79
2014,36047086400,"Census Tract 864, Kings County, New York",840,67,773,375,1037,36250,1939,2004,1191,37.9,79,0,356,6,18,773,75
2015,36047086400,"Census Tract 864, Kings County, New York",834,68,766,394,1025,32685,1939,2006,1145,46.7,62,0,373,5,24,766,108
2016,36047086400,"Census Tract 864, Kings County, New York",800,68,732,402,1126,32823,1939,2009,1168,50,57,0,387,0,15,732,142
2017,36047086400,"Census Tract 864, Kings County, New York",787,92,695,371,1017,33264,1939,2008,1136,50,24,0,371,0,0,695,142
2018,36047086400,"Census Tract 864, Kings County, New York",820,80,740,384,1012,41429,0,2009,1164,41.7,41,0,384,0,0,740,92
2019,36047086400,"Census Tract 864, Kings County, New York",860,58,802,426,1030,43750,0,2010,1176,36,60,0,426,0,0,802,115
2020,36047086400,"Census Tract 864, Kings County, New York",833,38,795,444,1135,47951,0,2011,1333,35.8,91,0,435,9,0,795,107
2012,36047086600,"Census Tract 866, Kings County, New York",1234,82,1152,655,1668,32218,1939,2004,1142,44.3,69,0,623,1,20,1152,207
2013,36047086600,"Census Tract 866, Kings County, New York",1274,93,1181,678,1706,40464,1939,2006,1221,44.4,57,0,659,0,19,1181,186
2014,36047086600,"Census Tract 866, Kings County, New York",1326,148,1178,676,1604,24366,1939,2006,1263,50,44,0,628,0,40,1178,215
2015,36047086600,"Census Tract 866, Kings County, New York",1390,160,1230,702,1532,35700,1939,2009,1189,39.3,99,0,682,0,12,1230,191
2016,36047086600,"Census Tract 866, Kings County, New York",1396,186,1210,743,1615,35341,1939,2010,1197,39.3,115,0,721,0,15,1210,204
2017,36047086600,"Census Tract 866, Kings County, New York",1409,226,1183,734,1689,33500,1939,2010,1264,41.8,144,0,693,0,32,1183,218
2018,36047086600,"Census Tract 866, Kings County, New York",1456,290,1166,685,1646,42228,0,2010,1221,33.9,185,0,618,0,32,1166,168
2019,36047086600,"Census Tract 866, Kings County, New York",1467,283,1184,688,1769,45769,0,2011,1273,32,220,22,626,0,35,1184,183
2020,36047086600,"Census Tract 866, Kings County, New York",1436,287,1149,748,2011,65319,0,2014,1384,31.1,308,21,659,0,42,1149,145
2012,36047086800,"Census Tract 868, Kings County, New York",1278,162,1116,918,2393,30608,1945,2004,1193,47.6,107,17,849,0,43,1116,217
2013,36047086800,"Census Tract 868, Kings County, New York",1282,147,1135,967,2818,41292,1942,2004,1228,41.7,135,18,916,0,10,1135,244
2014,36047086800,"Census Tract 868, Kings County, New York",1296,164,1132,985,2643,37388,1942,2005,1203,39.3,115,18,886,20,34,1132,263
2015,36047086800,"Census Tract 868, Kings County, New York",1341,164,1177,1005,2576,40757,1943,2006,1218,33.9,146,36,905,18,35,1177,289
2016,36047086800,"Census Tract 868, Kings County, New York",1359,154,1205,971,2622,49148,1939,2008,1268,30.6,146,36,832,21,70,1205,244
2017,36047086800,"Census Tract 868, Kings County, New York",1371,118,1253,959,2620,38711,1939,2010,1300,34.3,161,20,839,19,60,1253,234
2018,36047086800,"Census Tract 868, Kings County, New York",1368,140,1228,878,2298,38182,0,2011,1312,34.5,129,18,760,27,65,1228,197
2019,36047086800,"Census Tract 868, Kings County, New York",1394,123,1271,959,2540,39260,0,2010,1323,35,181,17,883,6,51,1271,178
2020,36047086800,"Census Tract 868, Kings County, New York",1542,93,1449,1177,2905,38201,0,2014,1202,36.6,317,0,1120,7,46,1449,201
2012,36047087000,"Census Tract 870, Kings County, New York",1234,59,1175,832,2080,36786,1939,2003,1116,39,76,0,804,0,54,1175,255
2013,36047087000,"Census Tract 870, Kings County, New York",1243,68,1175,813,1983,36301,1939,2003,1146,36.9,54,0,762,0,77,1175,263
2014,36047087000,"Census Tract 870, Kings County, New York",1254,43,1211,805,1892,35096,1939,2007,1220,39.2,56,7,751,0,101,1211,258
2015,36047087000,"Census Tract 870, Kings County, New York",1301,55,1246,816,1863,25156,1939,2008,1226,46.8,99,8,754,0,56,1246,308
2016,36047087000,"Census Tract 870, Kings County, New York",1296,98,1198,811,2011,26193,1939,2008,1244,45.5,129,7,752,0,53,1198,312
2017,36047087000,"Census Tract 870, Kings County, New York",1304,119,1185,803,1912,25057,1939,2008,1273,50,157,8,742,0,81,1185,315
2018,36047087000,"Census Tract 870, Kings County, New York",1310,145,1165,769,1837,23750,0,2011,1296,51,180,25,728,0,55,1165,325
2019,36047087000,"Census Tract 870, Kings County, New York",1295,131,1164,770,1861,25762,0,2009,1299,51,128,19,713,0,43,1164,325
2020,36047087000,"Census Tract 870, Kings County, New York",1249,135,1114,748,1737,25299,0,2009,1289,51,90,18,659,12,62,1114,332
2012,36047087200,"Census Tract 872, Kings County, New York",1157,74,1083,538,1317,37391,1942,2002,1034,35.7,46,0,514,0,40,1083,142
2013,36047087200,"Census Tract 872, Kings County, New York",1134,52,1082,569,1315,35313,1939,2004,1170,40.1,58,0,523,18,46,1082,171
2014,36047087200,"Census Tract 872, Kings County, New York",1145,70,1075,587,1362,33798,1939,2004,1215,43.7,98,0,568,19,31,1075,213
2015,36047087200,"Census Tract 872, Kings County, New York",1168,49,1119,636,1524,37628,1939,2004,1233,35.4,155,0,618,18,25,1119,166
2016,36047087200,"Census Tract 872, Kings County, New York",1215,73,1142,692,1775,32813,1939,2006,1365,40.1,172,8,666,18,42,1142,155
2017,36047087200,"Census Tract 872, Kings County, New York",1207,123,1084,637,1690,38750,1946,2008,1339,36.2,198,8,607,22,27,1084,147
2018,36047087200,"Census Tract 872, Kings County, New York",1240,133,1107,647,1618,41118,0,2010,1447,32.2,181,8,639,0,43,1107,150
2019,36047087200,"Census Tract 872, Kings County, New York",1264,140,1124,648,1615,36310,0,2012,1426,34.4,193,9,639,0,40,1124,117
2020,36047087200,"Census Tract 872, Kings County, New York",1175,131,1044,564,1516,34568,1944,2013,1569,46.6,175,16,539,0,50,1044,157
2012,36047087401,"Census Tract 874.01, Kings County, New York",1396,96,1300,933,2416,19171,1952,2000,966,38.6,85,35,800,13,160,1300,444
2013,36047087401,"Census Tract 874.01, Kings County, New York",1425,63,1362,1009,2511,20424,1954,2002,987,38.8,76,49,832,14,186,1362,440
2014,36047087401,"Census Tract 874.01, Kings County, New York",1434,110,1324,1058,2478,19846,1953,2004,992,39.1,119,34,859,19,194,1324,476
2015,36047087401,"Census Tract 874.01, Kings County, New York",1456,98,1358,1105,2620,23281,1956,2005,1039,38.5,118,26,974,0,122,1358,399
2016,36047087401,"Census Tract 874.01, Kings County, New York",1465,126,1339,1010,2406,21893,1960,2006,1037,42.2,92,29,898,0,121,1339,385
2017,36047087401,"Census Tract 874.01, Kings County, New York",1504,126,1378,1103,2732,26674,1965,2006,1156,38.1,163,30,1014,0,100,1378,356
2018,36047087401,"Census Tract 874.01, Kings County, New York",1534,142,1392,1146,2999,27429,1965,2005,1219,37.7,204,27,1028,0,78,1392,385
2019,36047087401,"Census Tract 874.01, Kings County, New York",1564,108,1456,1126,2803,35872,1959,2006,1257,30.3,265,28,1006,0,82,1456,325
2020,36047087401,"Census Tract 874.01, Kings County, New York",1673,163,1510,1278,3236,46250,1962,2009,1217,28.6,333,36,959,0,151,1510,322
2012,36047087600,"Census Tract 876, Kings County, New York",658,61,597,343,926,38934,1953,2003,1019,30.5,78,19,289,0,93,597,82
2013,36047087600,"Census Tract 876, Kings County, New York",643,60,583,350,926,30962,1952,2004,1024,31.7,68,32,288,0,90,583,84
2014,36047087600,"Census Tract 876, Kings County, New York",661,62,599,343,843,25919,1955,2006,1001,33.6,50,60,259,0,68,599,83
2015,36047087600,"Census Tract 876, Kings County, New York",715,77,638,374,911,23289,1948,2008,1004,35,68,56,285,11,23,638,117
2016,36047087600,"Census Tract 876, Kings County, New York",736,61,675,383,837,13984,1953,2011,944,50,79,46,296,12,23,675,187
2017,36047087600,"Census Tract 876, Kings County, New York",741,62,679,369,762,15057,1968,2012,932,50,66,66,268,13,22,679,171
2018,36047087600,"Census Tract 876, Kings County, New York",752,46,706,390,840,21324,1966,2012,1099,45.6,76,83,288,12,7,706,166
2019,36047087600,"Census Tract 876, Kings County, New York",785,68,717,411,897,23472,1980,2014,1138,46.6,70,75,311,14,11,717,168
2020,36047087600,"Census Tract 876, Kings County, New York",815,54,761,432,1033,35532,2007,2015,1200,42.8,66,81,310,5,13,761,157
2012,36047087800,"Census Tract 878, Kings County, New York",1055,118,937,811,2639,45851,1939,2002,1107,33.5,81,0,782,0,60,937,246
2013,36047087800,"Census Tract 878, Kings County, New York",1068,95,973,835,2652,41320,1939,2004,1163,36.8,77,0,797,0,68,973,301
2014,36047087800,"Census Tract 878, Kings County, New York",1093,87,1006,888,2641,41250,1939,2004,1132,35.7,84,0,873,0,59,1006,357
2015,36047087800,"Census Tract 878, Kings County, New York",1104,117,987,841,1891,35031,1939,2005,1146,38.7,109,0,832,0,27,987,226
2016,36047087800,"Census Tract 878, Kings County, New York",1108,131,977,851,1829,33264,1939,2007,1190,40.8,85,0,833,0,32,977,222
2017,36047087800,"Census Tract 878, Kings County, New York",1116,130,986,861,1903,30750,1939,2007,1219,42,95,0,843,0,40,986,219
2018,36047087800,"Census Tract 878, Kings County, New York",1125,148,977,876,1774,33462,0,2007,1281,42.7,106,0,870,0,10,977,204
2019,36047087800,"Census Tract 878, Kings County, New York",1144,150,994,887,1899,42703,0,2008,1343,37.6,152,0,877,0,12,994,157
2020,36047087800,"Census Tract 878, Kings County, New York",1115,130,985,867,1961,52723,0,2011,1351,29.8,154,0,789,0,31,985,173
2012,36047088000,"Census Tract 880, Kings County, New York",1216,42,1174,598,1522,40867,1939,2004,1072,28.4,198,0,564,0,48,1174,164
2013,36047088000,"Census Tract 880, Kings County, New York",1215,52,1163,640,1514,42381,1939,2004,1069,34.6,220,0,606,0,69,1163,192
2014,36047088000,"Census Tract 880, Kings County, New York",1254,56,1198,636,1521,42500,1939,2004,977,27.6,214,0,636,0,36,1198,216
2015,36047088000,"Census Tract 880, Kings County, New York",1294,66,1228,656,1612,39875,1946,2005,1052,30.7,219,0,656,0,32,1228,257
2016,36047088000,"Census Tract 880, Kings County, New York",1282,131,1151,672,1698,43750,1949,2007,1101,30.3,192,0,672,0,37,1151,249
2017,36047088000,"Census Tract 880, Kings County, New York",1300,161,1139,664,1562,36272,1948,2007,1126,34.2,158,0,664,0,58,1139,244
2018,36047088000,"Census Tract 880, Kings County, New York",1313,160,1153,668,1487,41667,1948,2004,1118,31.5,164,0,643,0,32,1153,204
2019,36047088000,"Census Tract 880, Kings County, New York",1312,174,1138,723,1593,43727,1949,2004,1155,30.1,159,0,695,0,35,1138,172
2020,36047088001,"Census Tract 880.01, Kings County, New York",766,100,666,364,652,45667,0,1991,1031,20.8,46,0,364,0,34,666,152
2020,36047088002,"Census Tract 880.02, Kings County, New York",548,100,448,225,460,43159,1941,2010,1205,33,43,0,195,0,0,448,34
2012,36047088200,"Census Tract 882, Kings County, New York",2746,242,2504,2097,5173,35780,1954,2003,1166,34.9,186,0,1981,28,45,2504,396
2013,36047088200,"Census Tract 882, Kings County, New York",2760,285,2475,2085,5172,36979,1953,2003,1199,33.7,199,0,1957,0,84,2475,497
2014,36047088200,"Census Tract 882, Kings County, New York",2815,294,2521,2098,5044,39110,1939,2003,1243,33,321,0,2043,0,61,2521,472
2015,36047088200,"Census Tract 882, Kings County, New York",2847,247,2600,2117,4964,42982,1939,2003,1217,30.2,396,0,2071,0,61,2600,395
2016,36047088200,"Census Tract 882, Kings County, New York",2871,223,2648,2097,4604,42098,1939,2004,1244,31.1,493,36,1952,0,123,2648,486
2017,36047088200,"Census Tract 882, Kings County, New York",2767,263,2504,2042,4566,44655,1941,2005,1177,31.4,568,35,1843,0,196,2504,540
2018,36047088200,"Census Tract 882, Kings County, New York",2760,223,2537,2011,4537,43602,1947,2008,1191,31.3,533,27,1797,0,214,2537,427
2019,36047088200,"Census Tract 882, Kings County, New York",2768,322,2446,2001,4770,39591,1951,2011,1166,31.6,520,33,1699,0,302,2446,355
2020,36047088200,"Census Tract 882, Kings County, New York",2642,327,2315,1840,4150,45157,1953,2010,1203,33.5,486,33,1465,0,280,2315,268
2012,36047088400,"Census Tract 884, Kings County, New York",2178,340,1838,1511,3856,35042,1939,2002,1091,31.2,155,33,1400,23,79,1838,383
2013,36047088400,"Census Tract 884, Kings County, New York",2164,322,1842,1551,4003,36563,1939,2003,1126,31.8,208,54,1449,22,78,1842,275
2014,36047088400,"Census Tract 884, Kings County, New York",2160,262,1898,1576,4234,32962,1939,2004,1143,33.6,284,70,1474,19,53,1898,380
2015,36047088400,"Census Tract 884, Kings County, New York",2133,286,1847,1569,3987,32734,1939,2007,1136,33.8,268,116,1453,0,47,1847,415
2016,36047088400,"Census Tract 884, Kings County, New York",2073,272,1801,1500,4273,41031,1939,2008,1262,33.2,234,66,1434,0,59,1801,441
2017,36047088400,"Census Tract 884, Kings County, New York",2077,229,1848,1562,4056,41694,1939,2010,1282,34.7,266,71,1477,0,89,1848,455
2018,36047088400,"Census Tract 884, Kings County, New York",2024,195,1829,1529,3639,40313,0,2010,1290,36.1,296,46,1457,0,59,1829,442
2019,36047088400,"Census Tract 884, Kings County, New York",2034,212,1822,1487,3426,46446,0,2011,1335,34.4,301,59,1368,0,58,1822,392
2020,36047088400,"Census Tract 884, Kings County, New York",1894,145,1749,1435,3752,40848,1943,2008,1461,39.3,295,32,1107,0,31,1749,520
2012,36047088600,"Census Tract 886, Kings County, New York",1911,147,1764,1497,3590,38209,1939,2002,1085,33.3,119,0,1429,0,92,1764,360
2013,36047088600,"Census Tract 886, Kings County, New York",1929,165,1764,1491,3571,33627,1941,2003,1103,37.7,116,0,1417,0,88,1764,440
2014,36047088600,"Census Tract 886, Kings County, New York",1967,186,1781,1532,3618,33269,1939,2004,1088,39.6,161,10,1410,0,143,1781,440
2015,36047088600,"Census Tract 886, Kings County, New York",1980,165,1815,1485,3384,35371,1939,2007,1144,40.3,209,9,1410,6,87,1815,416
2016,36047088600,"Census Tract 886, Kings County, New York",2004,131,1873,1612,3677,34150,1939,2010,1185,36.3,257,10,1456,8,138,1873,519
2017,36047088600,"Census Tract 886, Kings County, New York",2015,147,1868,1579,3427,29620,1941,2011,1220,40.6,342,29,1363,9,159,1868,538
2018,36047088600,"Census Tract 886, Kings County, New York",2024,104,1920,1650,3433,26798,0,2011,1231,44.7,368,40,1406,10,167,1920,581
2019,36047088600,"Census Tract 886, Kings County, New York",1989,70,1919,1675,3346,28886,0,2011,1253,41.5,363,54,1433,11,148,1919,541
2020,36047088600,"Census Tract 886, Kings County, New York",1975,57,1918,1740,3437,36087,1947,2011,1330,51,373,55,1390,0,153,1918,554
2012,36047088800,"Census Tract 888, Kings County, New York",1545,106,1439,1030,2737,37841,1951,2004,1126,33.3,111,17,945,0,79,1439,247
2013,36047088800,"Census Tract 888, Kings County, New York",1511,151,1360,976,2699,37857,1953,2005,1163,34.2,89,18,896,0,88,1360,237
2014,36047088800,"Census Tract 888, Kings County, New York",1557,154,1403,1109,2979,34785,1957,2005,1145,35.4,93,19,960,0,154,1403,293
2015,36047088800,"Census Tract 888, Kings County, New York",1580,121,1459,1102,3130,36522,1958,2006,1202,36.2,131,16,997,0,114,1459,281
2016,36047088800,"Census Tract 888, Kings County, New York",1540,141,1399,1000,2605,40479,1947,2007,1208,36.4,143,25,919,0,66,1399,249
2017,36047088800,"Census Tract 888, Kings County, New York",1519,125,1394,1035,2694,37250,1947,2008,1224,41.2,163,8,926,15,100,1394,291
2018,36047088800,"Census Tract 888, Kings County, New York",1534,67,1467,1098,2838,44539,0,2009,1306,37.5,173,8,974,8,118,1467,265
2019,36047088800,"Census Tract 888, Kings County, New York",1573,95,1478,1049,2628,45972,0,2010,1371,34.3,173,0,958,12,127,1478,225
2020,36047088800,"Census Tract 888, Kings County, New York",1649,85,1564,1198,3004,33986,0,2009,1270,38.3,167,0,1099,12,128,1564,385
2012,36047089000,"Census Tract 890, Kings County, New York",2484,330,2154,2061,5454,30721,1939,2004,1121,39.2,294,46,1912,41,141,2154,738
2013,36047089000,"Census Tract 890, Kings County, New York",2421,340,2081,1930,5165,26496,1939,2004,1137,41.4,187,47,1770,42,155,2081,821
2014,36047089000,"Census Tract 890, Kings County, New York",2403,283,2120,1955,5244,27866,1939,2005,1141,42.6,255,50,1807,30,114,2120,735
2015,36047089000,"Census Tract 890, Kings County, New York",2415,259,2156,1957,5175,27847,1939,2006,1141,44.2,214,44,1739,26,187,2156,712
2016,36047089000,"Census Tract 890, Kings County, New York",2552,262,2290,2068,4868,28338,1939,2008,1177,39.7,295,0,1870,35,234,2290,601
2017,36047089000,"Census Tract 890, Kings County, New York",2519,253,2266,1989,4283,28316,1939,2010,1284,43.2,323,0,1826,0,148,2266,544
2018,36047089000,"Census Tract 890, Kings County, New York",2547,257,2290,1983,3926,29246,0,2010,1288,40.3,466,17,1735,0,198,2290,496
2019,36047089000,"Census Tract 890, Kings County, New York",2576,314,2262,1974,4351,34694,0,2009,1297,37,427,17,1730,0,190,2262,492
2020,36047089000,"Census Tract 890, Kings County, New York",2444,236,2208,1976,4376,50000,0,2008,1350,36.8,402,20,1770,0,126,2208,405
2012,36047089200,"Census Tract 892, Kings County, New York",1640,190,1450,1311,3150,25504,1939,2004,1067,41.6,126,15,1227,0,72,1450,424
2013,36047089200,"Census Tract 892, Kings County, New York",1627,158,1469,1305,3403,25250,1939,2005,1103,42.4,107,7,1251,0,67,1469,381
2014,36047089200,"Census Tract 892, Kings County, New York",1628,198,1430,1337,3420,22033,1939,2004,1105,45.4,88,12,1285,0,67,1430,440
2015,36047089200,"Census Tract 892, Kings County, New York",1643,224,1419,1351,3529,25250,1939,2005,1096,43.7,107,18,1262,0,82,1419,477
2016,36047089200,"Census Tract 892, Kings County, New York",1693,174,1519,1475,3647,20425,1939,2005,1136,50,87,14,1326,0,162,1519,656
2017,36047089200,"Census Tract 892, Kings County, New York",1692,194,1498,1450,3339,18596,1939,2007,1152,50,71,12,1222,0,198,1498,769
2018,36047089200,"Census Tract 892, Kings County, New York",1687,162,1525,1454,2891,22434,0,2009,1127,51,125,20,1255,0,168,1525,647
2019,36047089200,"Census Tract 892, Kings County, New York",1762,108,1654,1588,3080,25660,0,2010,1141,51,178,27,1307,0,215,1654,654
2020,36047089200,"Census Tract 892, Kings County, New York",1724,96,1628,1571,3029,19356,0,2013,1269,51,453,17,1359,0,157,1628,818
2012,36047089400,"Census Tract 894, Kings County, New York",1228,97,1131,784,2303,31719,1939,2003,1121,35.6,54,0,729,0,57,1131,317
2013,36047089400,"Census Tract 894, Kings County, New York",1257,44,1213,869,2727,36611,1939,2004,1158,34.9,89,39,781,0,55,1213,264
2014,36047089400,"Census Tract 894, Kings County, New York",1275,96,1179,929,3026,39694,1939,2006,1166,34,118,30,851,0,69,1179,279
2015,36047089400,"Census Tract 894, Kings County, New York",1290,117,1173,914,2952,41122,1939,2006,1217,33.8,152,25,841,0,79,1173,278
2016,36047089400,"Census Tract 894, Kings County, New York",1316,128,1188,881,2723,39263,1939,2007,1303,37.9,142,40,776,0,86,1188,315
2017,36047089400,"Census Tract 894, Kings County, New York",1292,201,1091,802,2427,41824,1939,2010,1438,44.4,153,48,713,0,73,1091,256
2018,36047089400,"Census Tract 894, Kings County, New York",1295,270,1025,717,2064,40967,0,2009,1453,51,125,17,639,0,106,1025,268
2019,36047089400,"Census Tract 894, Kings County, New York",1302,228,1074,691,1957,37386,0,2012,1603,51,113,18,620,0,72,1074,305
2020,36047089400,"Census Tract 894, Kings County, New York",1264,185,1079,665,1886,27820,0,2013,1557,51,84,19,616,15,50,1079,345
2012,36047089600,"Census Tract 896, Kings County, New York",1479,169,1310,1193,2781,31764,1939,2004,1052,37.6,134,51,1030,68,30,1310,345
2013,36047089600,"Census Tract 896, Kings County, New York",1463,159,1304,1207,2855,32286,1939,2005,1108,40.3,166,46,1028,77,66,1304,314
2014,36047089600,"Census Tract 896, Kings County, New York",1499,113,1386,1314,3136,34244,1939,2005,1093,36.4,182,55,1133,74,52,1386,350
2015,36047089600,"Census Tract 896, Kings County, New York",1585,85,1500,1352,3047,33171,1939,2007,1119,40.4,226,63,1131,73,85,1500,433
2016,36047089600,"Census Tract 896, Kings County, New York",1635,120,1515,1281,2831,33438,1939,2008,1153,39.2,233,47,1079,56,98,1515,392
2017,36047089600,"Census Tract 896, Kings County, New York",1726,154,1572,1382,2728,24877,1939,2010,1161,41.8,221,45,1134,45,192,1572,561
2018,36047089600,"Census Tract 896, Kings County, New York",1745,181,1564,1323,2384,26984,0,2010,1226,45.1,185,23,1182,39,142,1564,525
2019,36047089600,"Census Tract 896, Kings County, New York",1746,188,1558,1312,2366,28796,0,2012,1266,51,148,7,1122,15,223,1558,481
2020,36047089600,"Census Tract 896, Kings County, New York",1860,171,1689,1495,2404,17166,1949,2015,1079,38.7,94,0,1131,14,224,1689,690
2012,36047089800,"Census Tract 898, Kings County, New York",727,75,652,279,873,30417,1939,2002,1295,50,7,5,264,0,13,652,138
2013,36047089800,"Census Tract 898, Kings County, New York",749,85,664,366,1184,33571,1951,2004,1337,50,17,5,355,0,11,664,138
2014,36047089800,"Census Tract 898, Kings County, New York",754,120,634,349,1049,26607,1939,2007,1171,50,60,6,340,0,9,634,167
2015,36047089800,"Census Tract 898, Kings County, New York",762,121,641,374,1051,22955,1958,2008,1225,50,71,5,367,0,7,641,167
2016,36047089800,"Census Tract 898, Kings County, New York",733,117,616,397,1089,22596,1940,2008,1321,50,83,5,390,0,8,616,164
2017,36047089800,"Census Tract 898, Kings County, New York",733,108,625,431,1165,20284,1939,2009,1324,50,82,10,409,0,12,625,200
2018,36047089800,"Census Tract 898, Kings County, New York",755,108,647,433,1002,19836,0,2010,1247,51,85,11,398,0,12,647,217
2019,36047089800,"Census Tract 898, Kings County, New York",776,78,698,523,1348,32321,0,2012,1487,46.5,98,19,471,0,21,698,178
2020,36047089800,"Census Tract 898, Kings County, New York",741,77,664,509,1467,45583,0,2013,1459,41.5,105,16,397,0,19,664,145
2012,36047090000,"Census Tract 900, Kings County, New York",2130,170,1960,1725,4579,28996,1965,2004,947,34.8,93,14,1329,0,426,1960,560
2013,36047090000,"Census Tract 900, Kings County, New York",2114,104,2010,1759,4909,29393,1967,2004,949,34.7,169,24,1395,0,416,2010,573
2014,36047090000,"Census Tract 900, Kings County, New York",2142,119,2023,1818,5069,27661,1966,2005,917,36.2,168,13,1488,7,371,2023,681
2015,36047090000,"Census Tract 900, Kings County, New York",2121,138,1983,1836,4910,NA,1961,2005,919,35.9,213,21,1502,7,360,1983,735
2016,36047090000,"Census Tract 900, Kings County, New York",2167,174,1993,1870,4941,22938,1961,2005,849,35.1,268,23,1527,8,380,1993,829
2017,36047090000,"Census Tract 900, Kings County, New York",2160,226,1934,1756,4284,19494,1966,2005,797,37.2,188,8,1356,9,378,1934,835
2018,36047090000,"Census Tract 900, Kings County, New York",2192,270,1922,1705,3610,19487,1961,2006,886,38.1,178,8,1260,8,399,1922,803
2019,36047090000,"Census Tract 900, Kings County, New York",2152,323,1829,1619,3270,21395,1964,2007,887,34,204,9,1098,0,434,1829,711
2020,36047090000,"Census Tract 900, Kings County, New York",2032,274,1758,1465,3232,23967,1968,2006,960,34.3,167,0,976,0,420,1758,624
2012,36047090200,"Census Tract 902, Kings County, New York",990,127,863,520,1547,9655,1970,2000,494,50,33,0,427,0,120,863,343
2013,36047090200,"Census Tract 902, Kings County, New York",925,38,887,511,1719,9601,1971,2001,595,50,37,0,417,0,134,887,333
2014,36047090200,"Census Tract 902, Kings County, New York",929,71,858,476,1475,15513,1967,2002,540,31.9,55,0,396,0,112,858,274
2015,36047090200,"Census Tract 902, Kings County, New York",968,87,881,518,1637,21250,1966,2005,536,31.8,59,0,447,14,74,881,253
2016,36047090200,"Census Tract 902, Kings County, New York",957,118,839,473,1223,21250,1969,2008,527,30.9,32,0,421,14,54,839,203
2017,36047090200,"Census Tract 902, Kings County, New York",953,97,856,493,1251,20104,1969,2009,579,33,38,0,431,17,66,856,238
2018,36047090200,"Census Tract 902, Kings County, New York",960,106,854,513,1080,20486,1963,2010,542,37.3,35,0,444,20,55,854,249
2019,36047090200,"Census Tract 902, Kings County, New York",995,74,921,572,1297,19911,1964,2012,621,42.4,22,0,500,26,53,921,299
2020,36047090200,"Census Tract 902, Kings County, New York",861,64,797,538,1281,21211,1959,2011,801,42.6,27,0,446,21,71,797,246
2012,36047090600,"Census Tract 906, Kings County, New York",1665,110,1555,1547,3907,14782,1960,1998,501,27.8,122,21,1161,15,402,1555,840
2013,36047090600,"Census Tract 906, Kings County, New York",1673,92,1581,1564,4246,18069,1960,2000,456,26.2,135,22,1165,9,413,1581,768
2014,36047090600,"Census Tract 906, Kings County, New York",1686,101,1585,1567,4263,18446,1960,2002,500,27.6,180,15,1170,8,446,1585,772
2015,36047090600,"Census Tract 906, Kings County, New York",1728,137,1591,1573,4175,15378,1960,2002,433,29.1,193,9,1193,8,440,1591,811
2016,36047090600,"Census Tract 906, Kings County, New York",1716,150,1566,1548,3875,13750,1959,2003,446,32,135,28,1115,8,448,1566,831
2017,36047090600,"Census Tract 906, Kings County, New York",1743,113,1630,1620,3782,10569,1960,2006,430,34.5,137,14,1206,0,460,1630,976
2018,36047090600,"Census Tract 906, Kings County, New York",1762,175,1587,1578,3239,10877,1961,2008,434,40.8,118,9,1134,0,523,1587,947
2019,36047090600,"Census Tract 906, Kings County, New York",1799,183,1616,1604,3244,15122,1959,2010,440,39.1,83,11,1098,0,585,1616,927
2020,36047090600,"Census Tract 906, Kings County, New York",1882,132,1750,1737,3261,16774,1958,2011,602,35.1,67,9,1271,0,464,1750,913
2012,36047090800,"Census Tract 908, Kings County, New York",1319,64,1255,1231,2926,15321,1964,2002,524,31.6,66,21,928,0,306,1255,674
2013,36047090800,"Census Tract 908, Kings County, New York",1302,96,1206,1206,2643,12008,1963,2002,416,34.1,38,0,998,0,230,1206,785
2014,36047090800,"Census Tract 908, Kings County, New York",1391,97,1294,1294,3107,13235,1961,2002,446,34,90,0,1048,0,271,1294,813
2015,36047090800,"Census Tract 908, Kings County, New York",1432,93,1339,1339,3213,12863,1962,2001,410,33.7,64,0,1045,7,335,1339,827
2016,36047090800,"Census Tract 908, Kings County, New York",1419,139,1280,1269,3093,11950,1962,2003,422,34.8,79,0,995,10,316,1280,793
2017,36047090800,"Census Tract 908, Kings County, New York",1431,168,1263,1253,3007,10688,1964,2006,458,41.4,62,0,982,13,300,1263,816
2018,36047090800,"Census Tract 908, Kings County, New York",1427,209,1218,1208,2597,10762,1964,2007,487,46.4,71,0,883,15,323,1218,780
2019,36047090800,"Census Tract 908, Kings County, New York",1473,226,1247,1236,2016,9676,1966,2006,538,49,42,0,930,9,319,1247,832
2020,36047090800,"Census Tract 908, Kings County, New York",1509,195,1314,1306,1914,12152,1965,2010,621,43.6,47,0,1075,0,339,1314,707
2012,36047091000,"Census Tract 910, Kings County, New York",2494,137,2357,2325,5568,11061,1960,2000,345,29.2,39,0,1739,0,761,2357,1408
2013,36047091000,"Census Tract 910, Kings County, New York",2449,93,2356,2310,5809,10507,1961,2001,319,29.9,39,0,1822,0,651,2356,1473
2014,36047091000,"Census Tract 910, Kings County, New York",2461,127,2334,2308,6432,11681,1960,2002,334,31.1,21,0,1875,0,572,2334,1427
2015,36047091000,"Census Tract 910, Kings County, New York",2501,68,2433,2406,6052,10627,1957,2004,358,33.2,57,0,1916,0,536,2433,1554
2016,36047091000,"Census Tract 910, Kings County, New York",2510,172,2338,2314,5166,10894,1955,2004,394,33.9,61,0,1927,0,491,2338,1423
2017,36047091000,"Census Tract 910, Kings County, New York",2549,193,2356,2337,4837,11512,1955,2005,362,35,100,0,1914,0,555,2356,1533
2018,36047091000,"Census Tract 910, Kings County, New York",2617,199,2418,2418,4250,11858,1954,2006,411,34.9,122,0,1887,0,663,2418,1492
2019,36047091000,"Census Tract 910, Kings County, New York",2702,174,2528,2528,4196,11585,1954,2006,397,37.8,198,0,1823,0,800,2528,1534
2020,36047091000,"Census Tract 910, Kings County, New York",2587,192,2395,2395,4199,13128,1955,2005,422,33.2,151,0,1513,0,979,2395,1226
2012,36047091200,"Census Tract 912, Kings County, New York",2414,146,2268,2268,6067,18008,1956,1999,427,29.2,124,13,1841,44,523,2268,1088
2013,36047091200,"Census Tract 912, Kings County, New York",2400,164,2236,2236,6187,18979,1955,2001,495,29.7,128,15,1834,30,458,2236,1000
2014,36047091200,"Census Tract 912, Kings County, New York",2445,156,2289,2289,6425,19427,1952,2000,470,29.6,129,10,1833,24,580,2289,995
2015,36047091200,"Census Tract 912, Kings County, New York",2479,150,2329,2329,6627,20360,1953,2002,485,31.2,137,9,1583,52,758,2329,1069
2016,36047091200,"Census Tract 912, Kings County, New York",2537,170,2367,2367,6920,21747,1953,2003,522,30.9,96,8,1749,55,628,2367,1097
2017,36047091200,"Census Tract 912, Kings County, New York",2552,70,2482,2482,6039,14347,1949,2004,515,38.7,111,0,1888,35,615,2482,1310
2018,36047091200,"Census Tract 912, Kings County, New York",2598,120,2478,2478,5587,14311,1946,2004,499,36.7,89,0,1884,70,658,2478,1274
2019,36047091200,"Census Tract 912, Kings County, New York",2624,128,2496,2473,5418,15116,1947,2004,551,34.1,153,0,1864,54,697,2496,1298
2020,36047091200,"Census Tract 912, Kings County, New York",2510,165,2345,2326,5401,15931,1944,2003,578,32.6,114,0,1737,38,705,2345,1183
2012,36047091600,"Census Tract 916, Kings County, New York",1596,155,1441,1242,3247,17375,1960,2003,967,39.3,14,9,1116,0,126,1441,641
2013,36047091600,"Census Tract 916, Kings County, New York",1645,192,1453,1273,3226,19592,1961,2004,963,39.6,35,8,1127,0,127,1453,582
2014,36047091600,"Census Tract 916, Kings County, New York",1704,132,1572,1352,3615,19963,1964,2005,963,37.9,79,7,1162,0,205,1572,634
2015,36047091600,"Census Tract 916, Kings County, New York",1778,109,1669,1483,4109,26914,1967,2006,955,36.1,90,9,1300,0,201,1669,617
2016,36047091600,"Census Tract 916, Kings County, New York",1858,195,1663,1486,3601,30728,1967,2009,925,33.5,152,8,1273,0,204,1663,617
2017,36047091600,"Census Tract 916, Kings County, New York",1900,263,1637,1432,3452,30525,1974,2010,792,34.4,147,0,1233,0,235,1637,653
2018,36047091600,"Census Tract 916, Kings County, New York",1870,255,1615,1409,3135,14899,1979,2011,867,39.8,98,21,1195,0,243,1615,763
2019,36047091600,"Census Tract 916, Kings County, New York",1884,270,1614,1427,2842,15554,1977,2012,837,46,91,23,1257,0,188,1614,791
2020,36047091600,"Census Tract 916, Kings County, New York",1817,246,1571,1403,2660,14432,1984,2012,846,40.8,76,23,1125,13,260,1571,756
2012,36047091800,"Census Tract 918, Kings County, New York",1068,11,1057,621,1600,29241,1972,2001,545,26.9,43,0,370,8,308,1057,291
2013,36047091800,"Census Tract 918, Kings County, New York",1065,10,1055,677,1937,20506,1973,2001,732,31.1,45,0,436,8,332,1055,369
2014,36047091800,"Census Tract 918, Kings County, New York",1073,21,1052,698,1968,21628,1972,2003,736,32.2,72,0,464,0,344,1052,327
2015,36047091800,"Census Tract 918, Kings County, New York",1075,23,1052,702,1934,20326,1973,2004,677,35,86,0,431,0,392,1052,381
2016,36047091800,"Census Tract 918, Kings County, New York",1091,65,1026,682,1751,17151,1972,2005,713,35.5,102,0,439,0,371,1026,366
2017,36047091800,"Census Tract 918, Kings County, New York",1095,101,994,641,1539,12078,1973,2005,753,44.9,71,0,430,0,312,994,433
2018,36047091800,"Census Tract 918, Kings County, New York",1116,103,1013,669,1266,14040,1970,2008,586,42.4,63,0,430,0,299,1013,405
2019,36047091800,"Census Tract 918, Kings County, New York",1118,86,1032,691,1335,14446,1970,2010,594,42.9,21,0,305,0,440,1032,436
2020,36047091800,"Census Tract 918, Kings County, New York",1181,109,1072,606,1199,13958,1968,2011,572,44.6,9,0,261,0,388,1072,376
2012,36047092000,"Census Tract 920, Kings County, New York",1179,200,979,619,1878,17216,1972,2004,947,32.4,96,0,519,0,116,979,343
2013,36047092000,"Census Tract 920, Kings County, New York",1179,95,1084,650,1826,17266,1972,2005,1004,33.8,103,0,561,0,98,1084,369
2014,36047092000,"Census Tract 920, Kings County, New York",1220,95,1125,723,2039,17114,1973,2007,1105,39.5,102,0,627,0,126,1125,441
2015,36047092000,"Census Tract 920, Kings County, New York",1257,61,1196,754,1981,16471,1974,2007,1062,37.5,101,0,637,0,144,1196,452
2016,36047092000,"Census Tract 920, Kings County, New York",1299,82,1217,721,1763,16399,1977,2009,1088,48.4,85,0,627,0,136,1217,392
2017,36047092000,"Census Tract 920, Kings County, New York",1314,115,1199,796,1963,12214,1975,2008,1119,50,53,0,664,39,156,1199,602
2018,36047092000,"Census Tract 920, Kings County, New York",1321,165,1156,775,1705,12762,1978,2010,1174,51,42,0,698,27,135,1156,542
2019,36047092000,"Census Tract 920, Kings County, New York",1336,165,1171,772,1706,14136,1981,2009,1203,51,69,0,651,26,166,1171,420
2020,36047092000,"Census Tract 920, Kings County, New York",1292,153,1139,636,1315,27250,1985,2011,1164,51,66,0,567,15,125,1139,303
2012,36047092200,"Census Tract 922, Kings County, New York",1346,234,1112,815,1997,50865,1954,2001,1024,24.4,213,0,761,10,35,1112,183
2013,36047092200,"Census Tract 922, Kings County, New York",1340,146,1194,774,1846,32079,1959,2001,1058,30.8,200,0,726,0,32,1194,155
2014,36047092200,"Census Tract 922, Kings County, New York",1363,130,1233,824,2044,31885,1961,2000,1107,34.1,140,22,749,0,30,1233,171
2015,36047092200,"Census Tract 922, Kings County, New York",1387,114,1273,837,1929,30383,1958,2002,1079,40.2,127,21,796,0,0,1273,191
2016,36047092200,"Census Tract 922, Kings County, New York",1419,84,1335,848,1933,33889,1956,2004,1099,31.4,130,45,772,0,9,1335,242
2017,36047092200,"Census Tract 922, Kings County, New York",1437,98,1339,912,1819,28176,1959,2006,1104,34.2,143,51,824,0,9,1339,255
2018,36047092200,"Census Tract 922, Kings County, New York",1440,121,1319,959,1853,29042,1953,2007,1058,34.3,115,54,878,0,10,1319,278
2019,36047092200,"Census Tract 922, Kings County, New York",1468,125,1343,1020,1913,43984,1951,2009,1105,33.6,95,35,925,0,41,1343,269
2020,36047092200,"Census Tract 922, Kings County, New York",1398,133,1265,1009,1828,32290,1951,2007,1069,35,75,132,848,0,39,1265,197
2012,36047092400,"Census Tract 924, Kings County, New York",1018,92,926,654,1928,29222,1973,2004,956,37,119,0,602,0,95,926,226
2013,36047092400,"Census Tract 924, Kings County, New York",1059,110,949,659,1908,29097,1979,2005,1047,36.9,141,0,634,0,83,949,242
2014,36047092400,"Census Tract 924, Kings County, New York",1115,79,1036,720,2051,27778,1976,2007,1038,37.5,177,0,666,0,103,1036,246
2015,36047092400,"Census Tract 924, Kings County, New York",1183,81,1102,808,2374,27794,1979,2007,1041,38,172,0,704,0,174,1102,250
2016,36047092400,"Census Tract 924, Kings County, New York",1191,101,1090,887,2459,28835,1977,2005,1023,37.8,165,0,781,0,155,1090,247
2017,36047092400,"Census Tract 924, Kings County, New York",1153,162,991,814,2248,29355,1984,2007,936,37,129,0,725,0,150,991,248
2018,36047092400,"Census Tract 924, Kings County, New York",1153,151,1002,867,2165,29306,1981,2006,779,33.6,120,0,742,0,149,1002,263
2019,36047092400,"Census Tract 924, Kings County, New York",1141,151,990,854,2205,26815,1987,2006,900,39.9,77,0,724,0,163,990,299
2020,36047092400,"Census Tract 924, Kings County, New York",1032,127,905,790,1838,26727,1977,2006,583,31.8,52,12,712,0,86,905,313
2012,36047092800,"Census Tract 928, Kings County, New York",1096,89,1007,615,1472,56701,1955,2004,1178,29.9,148,8,524,60,33,1007,95
2013,36047092800,"Census Tract 928, Kings County, New York",1123,73,1050,654,1541,47344,1956,2005,1185,33.6,173,8,586,35,34,1050,152
2014,36047092800,"Census Tract 928, Kings County, New York",1109,64,1045,672,1504,46000,1957,2006,1183,34.3,166,7,608,21,37,1045,162
2015,36047092800,"Census Tract 928, Kings County, New York",1172,63,1109,699,1528,41116,1957,2008,1205,35.1,145,0,613,23,48,1109,188
2016,36047092800,"Census Tract 928, Kings County, New York",1198,47,1151,742,1716,45577,1950,2010,1307,34.5,161,0,678,7,52,1151,173
2017,36047092800,"Census Tract 928, Kings County, New York",1198,36,1162,739,1750,47574,1943,2010,1307,33.5,202,0,709,0,26,1162,183
2018,36047092800,"Census Tract 928, Kings County, New York",1231,22,1209,747,1664,45063,0,2011,1310,33.3,202,0,710,0,29,1209,183
2019,36047092800,"Census Tract 928, Kings County, New York",1203,31,1172,724,1561,48958,0,2011,1392,33.2,213,0,696,0,28,1172,171
2020,36047092800,"Census Tract 928, Kings County, New York",1190,47,1143,716,1461,54881,0,2011,1507,31,209,0,716,0,0,1143,130
2012,36047093000,"Census Tract 930, Kings County, New York",1017,77,940,412,919,47109,1954,2005,1189,34.4,98,0,384,0,0,940,88
2013,36047093000,"Census Tract 930, Kings County, New York",1034,53,981,422,942,49821,1957,2007,1184,30.9,143,0,395,0,0,981,70
2014,36047093000,"Census Tract 930, Kings County, New York",1054,92,962,455,1012,49877,1961,2008,1177,27.2,135,0,412,0,0,962,83
2015,36047093000,"Census Tract 930, Kings County, New York",1096,100,996,494,1061,50100,1959,2008,1146,27.5,119,0,453,0,0,996,100
2016,36047093000,"Census Tract 930, Kings County, New York",1101,104,997,503,1135,52694,1956,2008,1217,26.5,156,0,493,0,0,997,112
2017,36047093000,"Census Tract 930, Kings County, New York",1094,133,961,475,1131,58397,1946,2007,1233,24.6,129,0,464,0,0,961,107
2018,36047093000,"Census Tract 930, Kings County, New York",1107,119,988,457,1168,60688,1945,2006,1228,24.7,113,5,442,0,0,988,130
2019,36047093000,"Census Tract 930, Kings County, New York",1117,86,1031,420,1167,62083,0,2006,1249,26.6,120,5,415,0,0,1031,152
2020,36047093000,"Census Tract 930, Kings County, New York",1099,62,1037,377,1082,72829,0,2007,1276,22.6,144,5,372,0,0,1037,169
2012,36047093200,"Census Tract 932, Kings County, New York",464,19,445,91,213,38125,1939,2002,900,36.4,28,0,80,0,0,445,30
2013,36047093200,"Census Tract 932, Kings County, New York",459,10,449,101,222,27031,1941,2004,960,36.7,14,0,101,0,0,449,14
2014,36047093200,"Census Tract 932, Kings County, New York",463,14,449,165,353,37723,1952,2005,1107,34.6,20,0,165,0,0,449,18
2015,36047093200,"Census Tract 932, Kings County, New York",469,15,454,161,345,NA,1960,2006,1061,38.2,19,0,161,0,0,454,45
2016,36047093200,"Census Tract 932, Kings County, New York",463,14,449,180,372,29107,1959,2008,1146,36.9,13,0,180,0,0,449,42
2017,36047093200,"Census Tract 932, Kings County, New York",468,34,434,157,338,46328,1963,2011,1239,30.3,5,12,145,0,0,434,29
2018,36047093200,"Census Tract 932, Kings County, New York",471,27,444,123,215,45859,1963,2011,1226,31.3,6,12,111,0,0,444,46
2019,36047093200,"Census Tract 932, Kings County, New York",481,28,453,100,170,46389,1965,2011,1000,31.5,13,13,70,17,0,453,31
2020,36047093200,"Census Tract 932, Kings County, New York",494,26,468,148,270,NA,0,2002,958,18.9,11,10,103,13,22,468,46
2012,36047093400,"Census Tract 934, Kings County, New York",1038,87,951,474,1109,49813,1955,2003,1115,27,154,0,423,0,51,951,53
2013,36047093400,"Census Tract 934, Kings County, New York",1037,57,980,472,1101,48403,1957,2004,1139,30,121,0,427,0,45,980,76
2014,36047093400,"Census Tract 934, Kings County, New York",1056,77,979,461,1071,43852,1960,2006,1108,37.3,111,0,411,16,39,979,105
2015,36047093400,"Census Tract 934, Kings County, New York",1071,76,995,448,1017,41613,1960,2007,1017,37.1,112,0,413,15,24,995,131
2016,36047093400,"Census Tract 934, Kings County, New York",1086,84,1002,461,1035,42244,1949,2008,1074,34.6,111,0,441,13,12,1002,139
2017,36047093400,"Census Tract 934, Kings County, New York",1084,116,968,406,925,42120,1939,2008,1092,29,113,0,388,12,11,968,147
2018,36047093400,"Census Tract 934, Kings County, New York",1100,145,955,423,906,44201,0,2008,1101,28.1,117,0,395,10,24,955,106
2019,36047093400,"Census Tract 934, Kings County, New York",1132,104,1028,431,880,46576,0,2009,1148,26.4,151,0,405,0,26,1028,95
2020,36047093400,"Census Tract 934, Kings County, New York",1162,110,1052,472,1066,53542,0,2011,1234,30.9,146,0,432,0,40,1052,122
2012,36047093600,"Census Tract 936, Kings County, New York",676,51,625,272,858,36364,1952,2000,1256,35.7,85,8,258,6,0,625,36
2013,36047093600,"Census Tract 936, Kings County, New York",662,54,608,262,923,64271,1946,2002,1247,19.9,85,8,240,14,0,608,34
2014,36047093600,"Census Tract 936, Kings County, New York",681,72,609,242,788,66389,1952,2002,1128,19.3,74,0,224,18,7,609,39
2015,36047093600,"Census Tract 936, Kings County, New York",683,64,619,261,831,60859,1949,2004,1217,23.1,15,0,244,17,7,619,49
2016,36047093600,"Census Tract 936, Kings County, New York",702,58,644,269,766,51125,1951,2004,1275,28,18,0,253,16,6,644,57
2017,36047093600,"Census Tract 936, Kings County, New York",703,52,651,250,651,51563,1943,2004,1306,32,41,0,242,8,6,651,42
2018,36047093600,"Census Tract 936, Kings County, New York",687,56,631,217,480,40313,0,2004,1395,36.9,44,0,209,8,7,631,52
2019,36047093600,"Census Tract 936, Kings County, New York",715,45,670,256,584,40547,1942,2004,1486,39,55,0,256,0,0,670,43
2020,36047093600,"Census Tract 936, Kings County, New York",732,39,693,214,434,38750,1942,2003,1377,40.6,58,0,209,5,0,693,49
2012,36047093800,"Census Tract 938, Kings County, New York",964,102,862,628,1334,25417,1942,2006,1159,34.7,56,12,593,0,23,862,205
2013,36047093800,"Census Tract 938, Kings County, New York",960,119,841,650,1614,26635,1946,2006,1193,41.3,42,12,623,0,15,841,200
2014,36047093800,"Census Tract 938, Kings County, New York",955,128,827,633,1648,27750,1950,2007,1180,34.2,81,18,603,0,12,827,193
2015,36047093800,"Census Tract 938, Kings County, New York",968,110,858,662,1704,32093,1951,2008,1160,33.9,71,7,642,0,13,858,184
2016,36047093800,"Census Tract 938, Kings County, New York",1016,145,871,600,1572,33261,1939,2010,1209,38.1,86,10,582,0,18,871,170
2017,36047093800,"Census Tract 938, Kings County, New York",1019,152,867,533,1486,37208,1939,2010,1217,33.8,100,0,513,0,30,867,148
2018,36047093800,"Census Tract 938, Kings County, New York",1031,124,907,511,1293,40398,0,2011,1307,32.6,117,0,492,0,28,907,113
2019,36047093800,"Census Tract 938, Kings County, New York",1059,97,962,512,1205,42197,0,2013,1388,34.7,122,0,490,0,31,962,72
2020,36047093800,"Census Tract 938, Kings County, New York",1063,111,952,571,1435,61985,0,2015,1447,33.3,180,34,515,0,31,952,114
2012,36047094401,"Census Tract 944.01, Kings County, New York",1264,43,1221,710,1800,50098,1946,2004,1109,28.3,190,8,690,0,20,1221,175
2013,36047094401,"Census Tract 944.01, Kings County, New York",1289,69,1220,670,1931,44500,1946,2004,1118,29.4,182,8,662,0,16,1220,172
2014,36047094401,"Census Tract 944.01, Kings County, New York",1310,57,1253,667,1825,42656,1949,2005,1179,34.3,137,8,659,0,49,1253,181
2015,36047094401,"Census Tract 944.01, Kings County, New York",1302,52,1250,665,1742,47569,1951,2006,1211,33.3,87,8,657,0,57,1250,190
2016,36047094401,"Census Tract 944.01, Kings County, New York",1255,59,1196,606,1637,47039,1952,2006,1348,35,68,0,591,0,76,1196,158
2017,36047094401,"Census Tract 944.01, Kings County, New York",1271,82,1189,521,1427,46736,1954,2006,1423,36.1,10,0,507,0,81,1189,127
2018,36047094401,"Census Tract 944.01, Kings County, New York",1258,82,1176,501,1184,49273,1956,2006,1462,35.5,20,0,471,0,98,1176,124
2019,36047094401,"Census Tract 944.01, Kings County, New York",1254,85,1169,514,1237,56058,1962,2003,1453,30.6,112,0,466,0,75,1169,161
2020,36047094401,"Census Tract 944.01, Kings County, New York",1245,69,1176,513,1060,34861,1959,2006,1571,51,149,0,439,0,54,1176,209
2012,36047094402,"Census Tract 944.02, Kings County, New York",1231,32,1199,1199,2823,20168,1951,1997,478,25.6,63,111,971,9,107,1199,499
2013,36047094402,"Census Tract 944.02, Kings County, New York",1222,54,1168,1168,2798,26905,1951,1997,479,25,86,97,929,10,126,1168,382
2014,36047094402,"Census Tract 944.02, Kings County, New York",1253,64,1189,1189,2723,27650,1949,1998,488,23.6,79,97,912,6,177,1189,383
2015,36047094402,"Census Tract 944.02, Kings County, New York",1268,65,1203,1203,2907,23417,1950,2002,495,26.3,69,41,1076,6,101,1203,439
2016,36047094402,"Census Tract 944.02, Kings County, New York",1300,46,1254,1254,2897,17000,1950,2001,430,28.1,88,39,1072,2,289,1254,598
2017,36047094402,"Census Tract 944.02, Kings County, New York",1300,44,1256,1256,3071,19604,1950,2001,478,27,93,22,1058,20,271,1256,545
2018,36047094402,"Census Tract 944.02, Kings County, New York",1319,17,1302,1302,3122,19799,1949,2002,520,28.4,76,18,1094,26,253,1302,476
2019,36047094402,"Census Tract 944.02, Kings County, New York",1342,0,1342,1342,3248,23920,1951,2004,521,28.1,89,52,1109,24,242,1342,441
2020,36047094402,"Census Tract 944.02, Kings County, New York",1330,0,1330,1330,3127,25313,1953,2006,469,27,131,51,1110,33,230,1330,393
2012,36047094600,"Census Tract 946, Kings County, New York",768,86,682,244,535,54688,1951,2000,1103,27.3,79,12,218,0,3,682,59
2013,36047094600,"Census Tract 946, Kings County, New York",760,88,672,233,516,42054,1949,2001,1135,34.6,65,20,197,0,3,672,59
2014,36047094600,"Census Tract 946, Kings County, New York",768,63,705,267,582,52813,1952,2002,1172,32.4,34,17,230,0,7,705,93
2015,36047094600,"Census Tract 946, Kings County, New York",777,91,686,252,525,46250,1947,2003,1173,35.6,52,18,211,0,12,686,96
2016,36047094600,"Census Tract 946, Kings County, New York",762,88,674,219,447,51406,1946,2003,1196,36.1,62,13,194,0,12,674,96
2017,36047094600,"Census Tract 946, Kings County, New York",776,70,706,190,374,50156,1944,2002,1230,37.6,49,5,178,0,7,706,94
2018,36047094600,"Census Tract 946, Kings County, New York",794,61,733,223,497,55774,1945,2004,1469,33,75,7,208,0,8,733,94
2019,36047094600,"Census Tract 946, Kings County, New York",813,62,751,191,420,62583,1946,2006,1456,31.7,56,0,184,0,7,751,88
2020,36047094600,"Census Tract 946, Kings County, New York",806,100,706,153,373,54732,1951,2008,1620,36.8,41,0,153,0,0,706,57
2012,36047095000,"Census Tract 950, Kings County, New York",1009,47,962,399,1218,63920,1960,2004,1281,24.9,92,0,386,0,13,962,128
2013,36047095000,"Census Tract 950, Kings County, New York",1004,50,954,388,1212,67500,1962,2004,1306,22.7,95,0,376,0,12,954,113
2014,36047095000,"Census Tract 950, Kings County, New York",1010,61,949,338,965,59474,1964,2004,1297,22.8,63,5,321,0,12,949,81
2015,36047095000,"Census Tract 950, Kings County, New York",1043,40,1003,397,1104,50795,1965,2004,1358,25.5,87,5,364,0,12,1003,102
2016,36047095000,"Census Tract 950, Kings County, New York",1049,48,1001,368,1029,51667,1965,2005,1415,28.6,98,15,328,0,13,1001,69
2017,36047095000,"Census Tract 950, Kings County, New York",1051,58,993,402,1034,49231,1963,2006,1392,29.8,132,20,370,0,0,993,71
2018,36047095000,"Census Tract 950, Kings County, New York",1053,68,985,450,1124,61591,1961,2008,1518,29.4,156,28,398,0,0,985,75
2019,36047095000,"Census Tract 950, Kings County, New York",1057,84,973,491,1193,59886,1959,2009,1561,29.3,153,25,449,0,0,973,66
2020,36047095000,"Census Tract 950, Kings County, New York",1029,112,917,441,1001,59519,1955,2011,1600,29,130,34,397,0,0,917,52
2012,36047095400,"Census Tract 954, Kings County, New York",1549,128,1421,805,2463,44728,1962,2005,1427,37.6,165,0,805,0,11,1421,101
2013,36047095400,"Census Tract 954, Kings County, New York",1530,85,1445,765,2339,51004,1962,2005,1406,35.3,167,0,765,0,29,1445,74
2014,36047095400,"Census Tract 954, Kings County, New York",1514,82,1432,741,2238,44350,1963,2007,1435,36.5,192,0,680,34,44,1432,169
2015,36047095400,"Census Tract 954, Kings County, New York",1515,81,1434,722,2193,40903,1963,2008,1427,36.9,133,0,668,27,41,1434,207
2016,36047095400,"Census Tract 954, Kings County, New York",1565,109,1456,703,1985,40486,1963,2008,1457,34.2,140,0,644,23,59,1456,214
2017,36047095400,"Census Tract 954, Kings County, New York",1550,115,1435,666,1860,49643,1961,2009,1524,30.7,116,0,595,31,63,1435,164
2018,36047095400,"Census Tract 954, Kings County, New York",1545,82,1463,717,1875,55699,1962,2010,1567,30.6,139,0,653,23,41,1463,167
2019,36047095400,"Census Tract 954, Kings County, New York",1603,120,1483,715,1950,55565,1951,2010,1589,29.3,63,0,670,6,39,1483,194
2020,36047095400,"Census Tract 954, Kings County, New York",1671,95,1576,750,1764,57949,1961,2012,1586,30.3,160,0,692,9,49,1576,153
2012,36047095600,"Census Tract 956, Kings County, New York",1312,54,1258,702,2402,64211,1961,2004,1464,26.6,208,27,600,0,89,1258,163
2013,36047095600,"Census Tract 956, Kings County, New York",1322,38,1284,773,2780,62621,1962,2004,1507,27.4,189,52,639,15,103,1284,159
2014,36047095600,"Census Tract 956, Kings County, New York",1307,0,1307,753,2595,63750,1964,2005,1592,29.4,231,45,649,18,75,1307,207
2015,36047095600,"Census Tract 956, Kings County, New York",1340,16,1324,719,2388,54213,1964,2005,1602,32.9,185,50,629,20,55,1324,244
2016,36047095600,"Census Tract 956, Kings County, New York",1349,17,1332,720,2413,48000,1963,2006,1705,40.1,154,57,642,21,36,1332,186
2017,36047095600,"Census Tract 956, Kings County, New York",1376,45,1331,782,2708,37295,1962,2010,1656,49.7,208,51,688,21,30,1331,222
2018,36047095600,"Census Tract 956, Kings County, New York",1415,57,1358,775,2562,40428,1952,2011,1693,47.2,193,70,683,0,4,1358,199
2019,36047095600,"Census Tract 956, Kings County, New York",1453,53,1400,738,2320,36573,1954,2012,1751,48.4,217,38,677,0,4,1400,206
2020,36047095600,"Census Tract 956, Kings County, New York",1546,44,1502,913,2532,58177,1953,2013,1647,36.5,285,35,854,0,29,1502,129
2012,36047095800,"Census Tract 958, Kings County, New York",1197,70,1127,516,1308,38000,1963,2004,1382,40.3,130,10,374,21,111,1127,98
2013,36047095800,"Census Tract 958, Kings County, New York",1236,69,1167,540,1426,33977,1963,2004,1373,37.8,71,0,487,20,22,1167,88
2014,36047095800,"Census Tract 958, Kings County, New York",1243,60,1183,439,1223,40579,1966,2005,1395,38.9,60,0,388,19,22,1183,102
2015,36047095800,"Census Tract 958, Kings County, New York",1271,59,1212,438,1270,41544,1965,2006,1362,41.7,36,0,390,17,21,1212,128
2016,36047095800,"Census Tract 958, Kings County, New York",1292,42,1250,505,1483,53113,1964,2007,1423,37.8,59,0,468,26,0,1250,173
2017,36047095800,"Census Tract 958, Kings County, New York",1296,47,1249,543,1474,52618,1963,2008,1601,37.1,154,23,488,21,0,1249,173
2018,36047095800,"Census Tract 958, Kings County, New York",1265,47,1218,472,1351,55208,1962,2009,1665,35.8,182,28,423,21,0,1218,169
2019,36047095800,"Census Tract 958, Kings County, New York",1277,116,1161,455,1310,57450,1961,2008,1642,27.7,170,29,406,20,0,1161,155
2020,36047095800,"Census Tract 958, Kings County, New York",1270,115,1155,576,1585,63026,1964,2012,1774,43,159,35,523,18,0,1155,211
2012,36047096000,"Census Tract 960, Kings County, New York",0,0,0,0,0,NA,NA,NA,NA,NA,0,0,0,0,0,0,0
2013,36047096000,"Census Tract 960, Kings County, New York",0,0,0,0,0,NA,NA,NA,NA,NA,0,0,0,0,0,0,0
2014,36047096000,"Census Tract 960, Kings County, New York",0,0,0,0,0,NA,NA,NA,NA,NA,0,0,0,0,0,0,0
2015,36047096000,"Census Tract 960, Kings County, New York",0,0,0,0,0,NA,NA,NA,NA,NA,0,0,0,0,0,0,0
2016,36047096000,"Census Tract 960, Kings County, New York",0,0,0,0,0,NA,NA,NA,NA,NA,0,0,0,0,0,0,0
2017,36047096000,"Census Tract 960, Kings County, New York",0,0,0,0,0,NA,NA,NA,NA,NA,0,0,0,0,0,0,0
2018,36047096000,"Census Tract 960, Kings County, New York",0,0,0,0,0,NA,NA,NA,NA,NA,0,0,0,0,0,0,0
2019,36047096000,"Census Tract 960, Kings County, New York",0,0,0,0,0,NA,NA,NA,NA,NA,0,0,0,0,0,0,0
2020,36047096000,"Census Tract 960, Kings County, New York",0,0,0,0,0,NA,NA,NA,NA,NA,0,0,0,0,0,0,0
2012,36047096200,"Census Tract 962, Kings County, New York",583,51,532,198,476,50000,1943,2002,1384,40.1,32,13,169,0,16,532,38
2013,36047096200,"Census Tract 962, Kings County, New York",569,47,522,245,645,52188,1951,2004,1382,33.4,38,22,189,0,34,522,39
2014,36047096200,"Census Tract 962, Kings County, New York",554,49,505,252,663,40800,1962,2005,1423,43.8,38,19,211,0,22,505,44
2015,36047096200,"Census Tract 962, Kings County, New York",538,31,507,222,665,42143,1962,2007,1463,43.1,24,4,198,10,10,507,62
2016,36047096200,"Census Tract 962, Kings County, New York",558,21,537,226,778,50313,1963,2009,1571,26.5,25,0,197,12,17,537,53
2017,36047096200,"Census Tract 962, Kings County, New York",560,32,528,252,809,47102,1961,2011,1546,31.1,41,0,204,19,29,528,45
2018,36047096200,"Census Tract 962, Kings County, New York",558,43,515,249,775,48798,1961,2012,1593,33.1,27,0,208,14,27,515,46
2019,36047096200,"Census Tract 962, Kings County, New York",578,76,502,249,822,62386,1955,2012,1560,26.3,53,0,210,9,25,502,42
2020,36047096200,"Census Tract 962, Kings County, New York",543,70,473,216,800,73971,1950,2012,1622,27.3,38,0,192,0,20,473,21
2012,36047096400,"Census Tract 964, Kings County, New York",883,151,732,335,1044,32047,1956,2004,1291,42.4,14,35,163,0,127,732,72
2013,36047096400,"Census Tract 964, Kings County, New York",876,139,737,355,1225,34917,1958,2004,1322,41.5,38,39,205,0,111,737,98
2014,36047096400,"Census Tract 964, Kings County, New York",852,117,735,381,1418,34088,1959,2005,1344,43.4,43,28,252,0,101,735,129
2015,36047096400,"Census Tract 964, Kings County, New York",834,123,711,334,1026,46389,1962,2009,1376,34.8,73,16,300,0,18,711,142
2016,36047096400,"Census Tract 964, Kings County, New York",821,125,696,325,858,49554,1963,2010,1366,33.3,65,12,289,0,24,696,109
2017,36047096400,"Census Tract 964, Kings County, New York",811,143,668,311,768,48583,1960,2012,1300,32.9,72,6,298,0,7,668,104
2018,36047096400,"Census Tract 964, Kings County, New York",807,153,654,263,571,53359,0,2012,1354,29.1,46,7,248,0,8,654,78
2019,36047096400,"Census Tract 964, Kings County, New York",832,130,702,314,631,58000,0,2014,1483,31.4,76,0,306,0,8,702,101
2020,36047096400,"Census Tract 964, Kings County, New York",858,107,751,317,561,57734,0,2016,1478,33.8,72,0,277,0,39,751,153
2012,36047096600,"Census Tract 966, Kings County, New York",755,56,699,249,849,40139,1961,2006,1367,33.1,5,44,133,0,66,699,64
2013,36047096600,"Census Tract 966, Kings County, New York",783,62,721,271,913,38750,1963,2006,1425,32.9,20,30,163,0,60,721,77
2014,36047096600,"Census Tract 966, Kings County, New York",807,50,757,309,1091,47768,1965,2007,1368,31.3,26,27,240,0,31,757,78
2015,36047096600,"Census Tract 966, Kings County, New York",785,32,753,321,1044,40724,1964,2009,1317,37,33,38,283,0,17,753,78
2016,36047096600,"Census Tract 966, Kings County, New York",794,43,751,368,1144,46500,1962,2006,1376,26.8,41,31,331,6,15,751,80
2017,36047096600,"Census Tract 966, Kings County, New York",816,53,763,326,986,49737,1962,2006,1358,28.2,42,29,277,20,0,763,53
2018,36047096600,"Census Tract 966, Kings County, New York",835,38,797,329,1035,71193,1961,2008,1443,22.3,43,27,282,20,0,797,69
2019,36047096600,"Census Tract 966, Kings County, New York",854,48,806,331,910,57991,1954,2006,1475,28.4,62,22,286,23,0,806,91
2020,36047096600,"Census Tract 966, Kings County, New York",893,77,816,381,1084,50977,0,2007,1608,34.8,66,12,343,26,0,816,118
2012,36047096800,"Census Tract 968, Kings County, New York",504,63,441,201,462,50598,1939,2005,1454,36.9,41,34,156,0,11,441,61
2013,36047096800,"Census Tract 968, Kings County, New York",477,37,440,183,532,37386,1939,2005,1645,50,61,24,149,0,10,440,77
2014,36047096800,"Census Tract 968, Kings County, New York",458,19,439,183,453,38550,1955,2006,1588,38.2,105,20,150,0,13,439,86
2015,36047096800,"Census Tract 968, Kings County, New York",457,32,425,171,498,37232,1954,2006,1448,41.1,78,19,139,0,13,425,90
2016,36047096800,"Census Tract 968, Kings County, New York",457,31,426,175,539,36771,1954,2007,1436,40,76,0,163,0,12,426,98
2017,36047096800,"Census Tract 968, Kings County, New York",455,44,411,147,568,37969,1961,2006,1530,39.3,65,0,147,0,0,411,58
2018,36047096800,"Census Tract 968, Kings County, New York",454,36,418,140,575,71136,0,2008,1473,25.7,35,0,129,0,0,418,41
2019,36047096800,"Census Tract 968, Kings County, New York",470,43,427,156,689,76111,0,2008,1522,25.1,39,0,146,0,1,427,34
2020,36047096800,"Census Tract 968, Kings County, New York",479,56,423,138,578,73750,0,2008,1632,26.3,42,0,129,0,1,423,34
2012,36047097000,"Census Tract 970, Kings County, New York",731,6,725,389,1015,43464,1959,2004,1186,35.2,107,27,307,1,67,725,158
2013,36047097000,"Census Tract 970, Kings County, New York",726,37,689,373,964,45107,1962,2004,1474,35.7,97,27,312,2,45,689,118
2014,36047097000,"Census Tract 970, Kings County, New York",731,64,667,354,931,45000,1961,2005,1425,38.1,64,51,284,5,26,667,98
2015,36047097000,"Census Tract 970, Kings County, New York",767,77,690,356,1101,54167,1962,2007,1480,35.6,74,41,300,0,31,690,101
2016,36047097000,"Census Tract 970, Kings County, New York",823,76,747,405,1249,53125,1962,2007,1377,36.8,103,45,345,0,31,747,85
2017,36047097000,"Census Tract 970, Kings County, New York",828,98,730,353,1088,62083,1959,2007,1366,35.3,119,37,305,0,0,730,69
2018,36047097000,"Census Tract 970, Kings County, New York",854,88,766,387,1252,68068,1951,2007,1404,32.7,136,33,343,0,4,766,79
2019,36047097000,"Census Tract 970, Kings County, New York",891,68,823,467,1503,57969,1944,2009,1543,31.6,185,52,396,0,9,823,95
2020,36047097000,"Census Tract 970, Kings County, New York",846,38,808,423,1262,56146,0,2008,1457,31.1,144,47,315,0,45,808,98
2012,36047097400,"Census Tract 974, Kings County, New York",744,32,712,365,993,45489,1962,2004,1218,32.5,107,0,314,0,34,712,82
2013,36047097400,"Census Tract 974, Kings County, New York",772,10,762,395,1151,51250,1963,2004,1369,31.5,98,14,346,0,35,762,48
2014,36047097400,"Census Tract 974, Kings County, New York",800,25,775,380,1273,50714,1964,2003,1409,33.5,100,27,307,0,46,775,72
2015,36047097400,"Census Tract 974, Kings County, New York",802,47,755,440,1350,52125,1963,2004,1354,32.9,96,34,335,0,71,755,71
2016,36047097400,"Census Tract 974, Kings County, New York",784,64,720,406,1309,59516,1964,2006,1439,31.6,84,35,335,9,27,720,68
2017,36047097400,"Census Tract 974, Kings County, New York",821,61,760,396,1180,60678,1963,2007,1418,28.2,48,31,322,9,31,760,102
2018,36047097400,"Census Tract 974, Kings County, New York",796,89,707,340,994,62826,1963,2008,1532,27.6,46,17,280,8,34,707,93
2019,36047097400,"Census Tract 974, Kings County, New York",801,102,699,383,982,63102,1958,2011,1610,27.2,50,13,318,6,43,699,84
2020,36047097400,"Census Tract 974, Kings County, New York",801,110,691,300,797,66250,1957,2013,1675,25.3,54,5,265,7,15,691,54
2012,36047098200,"Census Tract 982, Kings County, New York",1682,18,1664,1664,4165,20306,1956,1995,512,26.6,153,22,1291,0,358,1664,707
2013,36047098200,"Census Tract 982, Kings County, New York",1655,18,1637,1637,4038,20586,1956,1996,510,26.8,116,23,1253,0,387,1637,670
2014,36047098200,"Census Tract 982, Kings County, New York",1669,0,1669,1669,4040,21156,1958,1997,523,27.5,139,10,1351,0,356,1669,650
2015,36047098200,"Census Tract 982, Kings County, New York",1688,22,1666,1657,4078,19794,1958,1998,528,29.1,133,0,1389,0,332,1666,646
2016,36047098200,"Census Tract 982, Kings County, New York",1716,40,1676,1667,4194,23425,1957,1998,531,27.2,147,0,1404,6,330,1676,605
2017,36047098200,"Census Tract 982, Kings County, New York",1730,37,1693,1684,4488,20511,1956,1998,520,27.5,126,0,1421,6,332,1693,713
2018,36047098200,"Census Tract 982, Kings County, New York",1776,51,1725,1716,4384,21261,1956,1999,520,27.8,141,0,1423,5,358,1725,744
2019,36047098200,"Census Tract 982, Kings County, New York",1796,61,1735,1727,4489,20811,1954,2002,534,27.7,111,0,1375,5,396,1735,817
2020,36047098200,"Census Tract 982, Kings County, New York",1807,105,1702,1702,4532,23667,1954,2004,583,25.8,96,0,1385,6,373,1702,677
2012,36047098400,"Census Tract 984, Kings County, New York",693,82,611,204,567,67500,1962,2005,1380,25.1,54,0,204,0,14,611,103
2013,36047098400,"Census Tract 984, Kings County, New York",714,108,606,241,754,67083,1962,2004,1389,29.5,49,0,241,0,12,606,109
2014,36047098400,"Census Tract 984, Kings County, New York",730,80,650,212,735,68148,1962,2005,1385,29.7,59,0,212,0,7,650,116
2015,36047098400,"Census Tract 984, Kings County, New York",706,99,607,195,658,49063,1964,2006,1556,43.8,72,0,195,0,3,607,89
2016,36047098400,"Census Tract 984, Kings County, New York",732,82,650,288,871,57963,1961,2009,1607,33.8,89,0,288,0,0,650,80
2017,36047098400,"Census Tract 984, Kings County, New York",745,78,667,266,795,58333,1953,2010,1698,40.9,43,0,247,0,19,667,52
2018,36047098400,"Census Tract 984, Kings County, New York",749,56,693,297,753,60729,1952,2009,1719,34.4,50,14,266,0,17,693,42
2019,36047098400,"Census Tract 984, Kings County, New York",743,83,660,263,663,62344,1950,2009,1685,32.8,28,12,237,0,14,660,25
2020,36047098400,"Census Tract 984, Kings County, New York",749,58,691,277,698,63750,1952,2009,1541,27.1,39,11,252,0,14,691,26
2012,36047098600,"Census Tract 986, Kings County, New York",1083,45,1038,563,1606,48304,1963,2004,1225,31.6,126,0,502,40,21,1038,76
2013,36047098600,"Census Tract 986, Kings County, New York",1057,29,1028,502,1401,41875,1963,2004,1344,33.4,120,0,453,21,28,1028,79
2014,36047098600,"Census Tract 986, Kings County, New York",1097,31,1066,549,1465,48750,1964,2005,1317,31.9,112,0,504,7,25,1066,88
2015,36047098600,"Census Tract 986, Kings County, New York",1090,37,1053,587,1670,57829,1962,2005,1361,32.6,150,0,541,7,25,1053,111
2016,36047098600,"Census Tract 986, Kings County, New York",1061,46,1015,547,1550,44063,1962,2008,1370,33.1,178,0,502,8,24,1015,77
2017,36047098600,"Census Tract 986, Kings County, New York",1056,62,994,525,1583,46910,1954,2010,1392,32.3,168,0,494,9,10,994,61
2018,36047098600,"Census Tract 986, Kings County, New York",1047,73,974,522,1497,64083,1950,2011,1423,30.1,183,0,502,9,0,974,87
2019,36047098600,"Census Tract 986, Kings County, New York",1048,80,968,503,1436,62697,0,2013,1535,30.5,209,0,485,7,11,968,96
2020,36047098600,"Census Tract 986, Kings County, New York",1142,164,978,542,1365,69653,1945,2013,1695,25.7,223,7,496,7,23,978,75
2012,36047098800,"Census Tract 988, Kings County, New York",1074,60,1014,640,1723,46583,1959,2005,1262,30.1,167,25,578,11,48,1014,116
2013,36047098800,"Census Tract 988, Kings County, New York",1062,55,1007,650,1717,45333,1961,2006,1261,32.3,188,16,597,16,30,1007,97
2014,36047098800,"Census Tract 988, Kings County, New York",1065,59,1006,674,1725,44435,1961,2007,1240,28.7,128,23,626,7,27,1006,97
2015,36047098800,"Census Tract 988, Kings County, New York",1063,41,1022,679,1731,51375,1962,2010,1248,27.7,158,26,619,10,33,1022,105
2016,36047098800,"Census Tract 988, Kings County, New York",1048,18,1030,702,1821,46250,1960,2010,1317,28.4,186,50,601,9,64,1030,140
2017,36047098800,"Census Tract 988, Kings County, New York",1073,17,1056,698,1778,65769,1941,2011,1379,27.4,223,47,604,9,78,1056,138
2018,36047098800,"Census Tract 988, Kings County, New York",1106,0,1106,674,1536,57222,0,2011,1384,28.1,199,38,602,0,78,1106,138
2019,36047098800,"Census Tract 988, Kings County, New York",1145,15,1130,698,1670,78295,0,2012,1597,27.9,289,17,643,0,130,1130,104
2020,36047098800,"Census Tract 988, Kings County, New York",1111,15,1096,620,1494,85450,0,2011,1691,27,236,20,580,0,106,1096,132
2012,36047099000,"Census Tract 990, Kings County, New York",527,56,471,112,331,85441,1974,2004,821,13.9,35,0,55,57,0,471,76
2013,36047099000,"Census Tract 990, Kings County, New York",508,50,458,139,462,85865,1965,2006,884,17.5,42,0,87,52,0,458,81
2014,36047099000,"Census Tract 990, Kings County, New York",519,60,459,139,453,65729,1964,2007,1465,28.3,20,0,113,6,20,459,97
2015,36047099000,"Census Tract 990, Kings County, New York",536,75,461,171,503,65804,1963,2008,1410,29.2,31,13,131,6,21,461,75
2016,36047099000,"Census Tract 990, Kings County, New York",533,47,486,155,541,87721,1962,2009,1498,25.6,29,10,120,8,17,486,59
2017,36047099000,"Census Tract 990, Kings County, New York",535,75,460,184,551,69750,1943,2009,1393,23.9,41,9,142,8,25,460,107
2018,36047099000,"Census Tract 990, Kings County, New York",547,68,479,181,494,70529,0,2009,1306,23.7,50,11,134,4,32,479,108
2019,36047099000,"Census Tract 990, Kings County, New York",558,58,500,190,500,73750,0,2009,1488,23.5,52,11,160,5,14,500,80
2020,36047099000,"Census Tract 990, Kings County, New York",574,57,517,211,590,63393,0,2007,1574,36.8,60,0,195,4,12,517,61
2012,36047099200,"Census Tract 992, Kings County, New York",659,123,536,211,569,44943,1961,2004,1307,29.8,53,24,137,15,15,536,74
2013,36047099200,"Census Tract 992, Kings County, New York",642,71,571,211,595,47614,1959,2005,1500,33,73,27,125,16,33,571,98
2014,36047099200,"Census Tract 992, Kings County, New York",660,35,625,245,685,50673,1966,2005,1573,33.5,80,29,163,6,28,625,141
2015,36047099200,"Census Tract 992, Kings County, New York",660,12,648,255,739,50481,1964,2006,1512,36.9,70,14,193,5,23,648,150
2016,36047099200,"Census Tract 992, Kings County, New York",640,12,628,275,845,60114,1963,2006,1588,29.2,63,21,227,0,23,628,137
2017,36047099200,"Census Tract 992, Kings County, New York",677,21,656,246,796,62292,1964,2007,1701,29,40,13,218,0,24,656,80
2018,36047099200,"Census Tract 992, Kings County, New York",676,30,646,239,755,64896,1962,2009,1662,29.3,40,12,208,6,7,646,80
2019,36047099200,"Census Tract 992, Kings County, New York",702,28,674,236,729,64352,1953,2013,1559,28.7,37,16,207,6,7,674,60
2020,36047099200,"Census Tract 992, Kings County, New York",742,24,718,236,697,72917,0,2015,1468,28.5,31,20,211,5,0,718,67
2012,36047099400,"Census Tract 994, Kings County, New York",657,52,605,335,1153,57171,1964,2004,1562,27.8,86,0,285,0,59,605,91
2013,36047099400,"Census Tract 994, Kings County, New York",696,52,644,382,1150,57283,1964,2004,1546,30.7,130,0,320,0,46,644,81
2014,36047099400,"Census Tract 994, Kings County, New York",689,40,649,383,1073,56932,1964,2005,1578,30.9,118,0,314,0,50,649,89
2015,36047099400,"Census Tract 994, Kings County, New York",718,18,700,425,1154,56480,1964,2005,1571,31.3,108,0,356,0,47,700,104
2016,36047099400,"Census Tract 994, Kings County, New York",698,25,673,356,873,57097,1964,2006,1606,30.2,116,0,316,0,13,673,67
2017,36047099400,"Census Tract 994, Kings County, New York",701,24,677,369,935,59009,1960,2008,1538,31.6,112,0,332,8,5,677,30
2018,36047099400,"Census Tract 994, Kings County, New York",697,18,679,345,907,54427,1952,2011,1709,33.8,103,0,319,20,6,679,30
2019,36047099400,"Census Tract 994, Kings County, New York",699,15,684,343,1042,78203,0,2012,1675,32.7,96,0,314,23,6,684,46
2020,36047099400,"Census Tract 994, Kings County, New York",682,37,645,286,916,80556,0,2013,1719,32.9,73,0,262,19,5,645,42
2012,36047099600,"Census Tract 996, Kings County, New York",1160,58,1102,544,1432,51250,1960,2005,1386,34.3,127,16,509,0,19,1102,100
2013,36047099600,"Census Tract 996, Kings County, New York",1169,48,1121,518,1395,54085,1960,2004,1441,32.3,135,8,485,8,17,1121,107
2014,36047099600,"Census Tract 996, Kings County, New York",1212,90,1122,465,1327,53363,1963,2005,1412,32,112,8,431,8,18,1122,90
2015,36047099600,"Census Tract 996, Kings County, New York",1272,105,1167,521,1459,46953,1962,2006,1408,31.3,139,14,473,18,16,1167,105
2016,36047099600,"Census Tract 996, Kings County, New York",1292,96,1196,544,1671,55494,1962,2007,1429,29.9,181,15,481,21,27,1196,70
2017,36047099600,"Census Tract 996, Kings County, New York",1280,93,1187,488,1425,44800,1960,2011,1407,30.6,163,7,453,19,9,1187,84
2018,36047099600,"Census Tract 996, Kings County, New York",1205,95,1110,488,1481,49597,1962,2012,1509,30.8,135,7,444,11,26,1110,57
2019,36047099600,"Census Tract 996, Kings County, New York",1192,58,1134,575,1671,51729,1962,2012,1590,32.4,158,8,523,12,32,1134,47
2020,36047099600,"Census Tract 996, Kings County, New York",1183,45,1138,576,1549,63092,1962,2014,1528,27.5,214,0,545,0,31,1138,29
2012,36047099800,"Census Tract 998, Kings County, New York",1406,110,1296,632,1755,56250,1964,2004,1581,30.4,183,70,554,8,43,1296,179
2013,36047099800,"Census Tract 998, Kings County, New York",1393,160,1233,651,1968,57768,1964,2005,1567,29.1,240,50,589,12,42,1233,88
2014,36047099800,"Census Tract 998, Kings County, New York",1415,161,1254,648,1986,56300,1965,2006,1589,29.5,235,8,625,15,44,1254,108
2015,36047099800,"Census Tract 998, Kings County, New York",1418,186,1232,609,1669,55677,1965,2007,1589,36.6,222,8,593,8,44,1232,62
2016,36047099800,"Census Tract 998, Kings County, New York",1403,197,1206,572,1557,41934,1964,2009,1504,42.8,201,7,565,0,0,1206,54
2017,36047099800,"Census Tract 998, Kings County, New York",1431,193,1238,608,1702,41709,1963,2010,1603,43.3,225,8,565,0,35,1238,47
2018,36047099800,"Census Tract 998, Kings County, New York",1464,146,1318,689,1712,42380,1964,2009,1618,42.4,204,8,648,0,33,1318,68
2019,36047099800,"Census Tract 998, Kings County, New York",1446,201,1245,601,1706,47448,1964,2010,1474,37.9,93,21,543,0,37,1245,63
2020,36047099800,"Census Tract 998, Kings County, New York",1529,252,1277,649,1757,48802,1964,2013,1479,38.4,149,20,576,0,53,1277,86
2012,36047100400,"Census Tract 1004, Kings County, New York",1009,51,958,543,1477,63239,1958,2004,1431,27.9,214,21,511,0,11,958,72
2013,36047100400,"Census Tract 1004, Kings County, New York",1012,51,961,557,1609,69960,1959,2004,1441,25.1,188,32,492,0,11,961,99
2014,36047100400,"Census Tract 1004, Kings County, New York",1010,63,947,516,1443,65429,1963,2005,1388,26.2,151,39,439,0,11,947,100
2015,36047100400,"Census Tract 1004, Kings County, New York",1034,68,966,417,1189,62986,1963,2006,1456,29.9,96,38,350,0,0,966,108
2016,36047100400,"Census Tract 1004, Kings County, New York",1046,54,992,419,1258,62891,1963,2007,1550,29.8,85,14,378,0,0,992,123
2017,36047100400,"Census Tract 1004, Kings County, New York",1044,83,961,408,1209,53333,1962,2008,1511,31.9,86,18,371,0,0,961,122
2018,36047100400,"Census Tract 1004, Kings County, New York",1055,75,980,438,1182,60978,1961,2008,1619,32.8,129,4,427,0,0,980,97
2019,36047100400,"Census Tract 1004, Kings County, New York",1063,74,989,462,1233,62778,1955,2009,1656,33.3,157,6,456,0,0,989,114
2020,36047100400,"Census Tract 1004, Kings County, New York",1048,76,972,515,1200,48854,1954,2010,1639,38.3,165,7,508,0,0,972,81
2012,36047100600,"Census Tract 1006, Kings County, New York",897,51,846,281,738,78920,1955,2004,1274,17.5,89,13,234,12,22,846,43
2013,36047100600,"Census Tract 1006, Kings County, New York",903,53,850,320,897,77143,1960,2006,1351,19.1,137,0,282,15,23,850,36
2014,36047100600,"Census Tract 1006, Kings County, New York",892,52,840,342,809,51406,1963,2009,1515,33.5,133,0,334,0,8,840,95
2015,36047100600,"Census Tract 1006, Kings County, New York",905,55,850,322,758,49722,1964,2009,1542,33.6,108,0,313,0,9,850,114
2016,36047100600,"Census Tract 1006, Kings County, New York",938,65,873,274,649,51667,1963,2010,1640,33.5,103,0,262,0,12,873,101
2017,36047100600,"Census Tract 1006, Kings County, New York",926,59,867,352,824,45735,1961,2011,1593,34.3,139,0,334,0,18,867,94
2018,36047100600,"Census Tract 1006, Kings County, New York",934,65,869,338,791,40500,1961,2012,1700,46.1,103,0,319,0,19,869,121
2019,36047100600,"Census Tract 1006, Kings County, New York",963,43,920,328,916,42419,0,2012,1698,34.7,71,0,305,0,23,920,71
2020,36047100600,"Census Tract 1006, Kings County, New York",984,59,925,312,913,51316,0,2012,1684,31.5,70,0,294,0,18,925,54
2012,36047100800,"Census Tract 1008, Kings County, New York",746,30,716,258,709,47750,1960,2005,1474,32,81,37,184,20,17,716,124
2013,36047100800,"Census Tract 1008, Kings County, New York",746,50,696,220,646,39524,1963,2007,1352,32.5,42,50,158,0,0,696,94
2014,36047100800,"Census Tract 1008, Kings County, New York",746,45,701,241,637,36771,1962,2009,1362,34.9,41,32,198,0,13,701,109
2015,36047100800,"Census Tract 1008, Kings County, New York",746,49,697,259,677,33313,1962,2008,1269,49.8,60,16,232,0,17,697,153
2016,36047100800,"Census Tract 1008, Kings County, New York",750,58,692,307,827,36823,1961,2010,1317,43.4,77,15,281,0,17,692,145
2017,36047100800,"Census Tract 1008, Kings County, New York",773,67,706,317,804,37083,1960,2011,1357,43.1,51,19,273,0,33,706,132
2018,36047100800,"Census Tract 1008, Kings County, New York",777,86,691,309,801,40104,1952,2012,1415,44.9,67,13,283,0,32,691,103
2019,36047100800,"Census Tract 1008, Kings County, New York",767,77,690,297,833,48516,0,2013,1496,40.6,68,14,270,0,18,690,96
2020,36047100800,"Census Tract 1008, Kings County, New York",739,78,661,329,982,68819,0,2013,1665,26.4,120,14,303,0,12,661,79
2012,36047101000,"Census Tract 1010, Kings County, New York",808,39,769,352,1109,36000,1962,2005,1489,37.1,30,0,261,41,67,769,89
2013,36047101000,"Census Tract 1010, Kings County, New York",759,36,723,299,977,36898,1961,2006,1372,36.2,31,4,238,38,35,723,99
2014,36047101000,"Census Tract 1010, Kings County, New York",734,31,703,319,1004,33250,1961,2009,1483,30.4,42,3,234,52,45,703,127
2015,36047101000,"Census Tract 1010, Kings County, New York",740,54,686,327,955,48977,1961,2011,1516,29.6,32,10,258,22,55,686,94
2016,36047101000,"Census Tract 1010, Kings County, New York",755,51,704,355,1067,48594,1961,2011,1605,30.3,29,15,287,23,30,704,125
2017,36047101000,"Census Tract 1010, Kings County, New York",751,49,702,366,1029,60375,1939,2012,1663,30.4,50,18,314,16,18,702,123
2018,36047101000,"Census Tract 1010, Kings County, New York",819,51,768,385,1015,71875,0,2012,1645,29.1,40,20,334,14,17,768,97
2019,36047101000,"Census Tract 1010, Kings County, New York",820,45,775,319,917,52159,0,2013,1624,33.5,55,30,278,0,11,775,102
2020,36047101000,"Census Tract 1010, Kings County, New York",896,24,872,448,1112,23846,0,2010,1202,39.3,79,23,375,0,58,872,166
2012,36047101200,"Census Tract 1012, Kings County, New York",806,83,723,226,711,37900,1957,2006,1104,32.6,32,4,208,14,0,723,73
2013,36047101200,"Census Tract 1012, Kings County, New York",791,73,718,262,763,39700,1960,2007,1158,29.9,32,5,246,11,0,718,84
2014,36047101200,"Census Tract 1012, Kings County, New York",791,72,719,280,754,44412,1962,2007,1255,30.5,59,9,261,10,0,719,47
2015,36047101200,"Census Tract 1012, Kings County, New York",792,69,723,298,813,44833,1961,2008,1281,31.5,77,12,282,4,0,723,63
2016,36047101200,"Census Tract 1012, Kings County, New York",824,42,782,354,935,43750,1960,2010,1326,32.3,83,12,331,11,5,782,119
2017,36047101200,"Census Tract 1012, Kings County, New York",839,26,813,333,804,46146,1956,2013,1386,33.2,80,12,313,8,16,813,127
2018,36047101200,"Census Tract 1012, Kings County, New York",841,26,815,365,992,57109,1954,2012,1386,30.9,136,18,325,18,19,815,113
2019,36047101200,"Census Tract 1012, Kings County, New York",874,20,854,404,1059,56250,1951,2013,1338,30.5,136,16,366,12,24,854,130
2020,36047101200,"Census Tract 1012, Kings County, New York",920,51,869,426,1026,46944,1952,2013,1350,33.1,136,17,383,13,28,869,124
2012,36047101400,"Census Tract 1014, Kings County, New York",865,45,820,232,488,26029,1959,2003,1251,50,57,9,218,5,0,820,139
2013,36047101400,"Census Tract 1014, Kings County, New York",858,75,783,206,439,27315,1961,2004,1186,50,26,10,191,5,0,783,113
2014,36047101400,"Census Tract 1014, Kings County, New York",858,66,792,238,569,43077,1963,2005,1186,31.6,9,20,198,5,24,792,93
2015,36047101400,"Census Tract 1014, Kings County, New York",862,45,817,292,715,34583,1963,2007,1281,40,55,15,248,10,25,817,126
2016,36047101400,"Census Tract 1014, Kings County, New York",837,58,779,256,633,39583,1963,2007,1257,37.5,54,10,213,13,25,779,116
2017,36047101400,"Census Tract 1014, Kings County, New York",853,65,788,262,718,44886,1962,2010,1309,32.9,59,9,220,10,17,788,95
2018,36047101400,"Census Tract 1014, Kings County, New York",864,74,790,287,745,43869,1961,2010,1260,34,68,8,234,12,28,790,87
2019,36047101400,"Census Tract 1014, Kings County, New York",879,77,802,285,724,62813,1952,2013,1327,24.3,113,0,241,12,24,802,75
2020,36047101400,"Census Tract 1014, Kings County, New York",909,95,814,309,863,61932,1949,2016,1578,32.5,76,0,275,9,18,814,64
2012,36047101600,"Census Tract 1016, Kings County, New York",481,48,433,130,389,54844,1965,2005,1371,34.4,50,0,130,0,0,433,38
2013,36047101600,"Census Tract 1016, Kings County, New York",494,47,447,148,406,52969,1965,2004,1328,32.8,46,4,138,6,0,447,13
2014,36047101600,"Census Tract 1016, Kings County, New York",490,51,439,84,246,43214,1964,2006,1156,36.3,0,4,73,7,0,439,12
2015,36047101600,"Census Tract 1016, Kings County, New York",509,38,471,124,358,55250,1964,2007,1205,36.1,0,5,113,6,0,471,12
2016,36047101600,"Census Tract 1016, Kings County, New York",519,18,501,120,290,44643,1963,2007,1196,35.7,12,6,107,7,0,501,17
2017,36047101600,"Census Tract 1016, Kings County, New York",533,0,533,147,332,45750,1963,2006,1240,31.8,30,7,129,5,0,533,28
2018,36047101600,"Census Tract 1016, Kings County, New York",544,14,530,120,281,59722,1963,2007,1384,29.6,32,6,106,0,0,530,27
2019,36047101600,"Census Tract 1016, Kings County, New York",549,20,529,137,321,65865,1963,2004,1470,28.6,39,5,119,0,0,529,16
2020,36047101600,"Census Tract 1016, Kings County, New York",552,32,520,124,237,51429,1959,1997,1324,30.5,40,5,81,0,24,520,16
2012,36047101800,"Census Tract 1018, Kings County, New York",864,126,738,211,338,45982,1972,2005,1117,30,79,0,193,0,14,738,39
2013,36047101800,"Census Tract 1018, Kings County, New York",834,115,719,240,258,43125,1969,2006,1239,33.3,83,0,210,0,11,719,28
2014,36047101800,"Census Tract 1018, Kings County, New York",836,43,793,260,341,48409,1969,2008,1291,31,106,0,251,0,0,793,29
2015,36047101800,"Census Tract 1018, Kings County, New York",836,38,798,306,489,49167,1970,2008,1359,33.6,82,0,296,0,0,798,56
2016,36047101800,"Census Tract 1018, Kings County, New York",846,35,811,278,473,43333,1969,2007,1351,35.7,88,0,265,0,0,811,64
2017,36047101800,"Census Tract 1018, Kings County, New York",840,20,820,283,459,53563,1967,2006,1264,32.4,90,0,274,0,7,820,96
2018,36047101800,"Census Tract 1018, Kings County, New York",862,30,832,209,370,64531,1965,2006,1147,18.9,69,6,193,0,6,832,75
2019,36047101800,"Census Tract 1018, Kings County, New York",866,47,819,215,322,58750,1966,2007,1169,24.8,49,4,211,0,5,819,97
2020,36047101800,"Census Tract 1018, Kings County, New York",862,62,800,157,213,NA,1963,2009,1047,31,27,8,149,0,6,800,73
2012,36047102000,"Census Tract 1020, Kings County, New York",669,25,644,171,550,58686,1963,2005,1622,34.1,26,30,141,0,0,644,26
2013,36047102000,"Census Tract 1020, Kings County, New York",652,21,631,178,595,55500,1963,2005,1655,34.6,17,24,143,11,0,631,31
2014,36047102000,"Census Tract 1020, Kings County, New York",650,44,606,184,572,43250,1963,2008,1641,43.6,26,0,176,8,0,606,57
2015,36047102000,"Census Tract 1020, Kings County, New York",666,57,609,195,562,42589,1961,2011,1666,49.6,43,0,180,15,0,609,91
2016,36047102000,"Census Tract 1020, Kings County, New York",672,62,610,176,492,38333,1960,2011,1600,50,32,0,158,18,11,610,103
2017,36047102000,"Census Tract 1020, Kings County, New York",675,37,638,146,416,61125,1964,2012,1628,37.2,58,4,128,14,11,638,83
2018,36047102000,"Census Tract 1020, Kings County, New York",707,36,671,158,375,62656,1965,2011,1620,34.7,92,5,153,0,12,671,69
2019,36047102000,"Census Tract 1020, Kings County, New York",741,16,725,234,624,68056,1966,2012,1290,17.9,140,6,228,0,13,725,68
2020,36047102000,"Census Tract 1020, Kings County, New York",728,0,728,239,670,92054,1965,2014,1520,16.6,124,6,233,0,14,728,27
2012,36047102200,"Census Tract 1022, Kings County, New York",804,76,728,368,939,39286,1959,2004,1229,33.8,91,60,260,48,0,728,98
2013,36047102200,"Census Tract 1022, Kings County, New York",777,65,712,335,792,39145,1962,2004,1256,35.1,98,54,243,38,0,712,84
2014,36047102200,"Census Tract 1022, Kings County, New York",782,41,741,352,866,40804,1963,2004,1263,34.2,125,42,251,45,14,741,78
2015,36047102200,"Census Tract 1022, Kings County, New York",782,54,728,305,847,38295,1962,2004,1265,35.1,85,25,211,46,23,728,87
2016,36047102200,"Census Tract 1022, Kings County, New York",783,67,716,330,922,40667,1961,2005,1304,33.8,108,18,234,43,35,716,72
2017,36047102200,"Census Tract 1022, Kings County, New York",804,82,722,313,783,41932,1959,2006,1340,33.7,98,23,211,33,36,722,52
2018,36047102200,"Census Tract 1022, Kings County, New York",837,83,754,333,840,61513,1948,2009,1493,29.7,94,26,225,37,33,754,50
2019,36047102200,"Census Tract 1022, Kings County, New York",867,85,782,347,888,63750,1950,2011,1558,27.6,125,22,271,24,22,782,45
2020,36047102200,"Census Tract 1022, Kings County, New York",882,120,762,355,972,52271,1952,2013,1446,31.6,101,74,221,20,12,762,25
2012,36047102400,"Census Tract 1024, Kings County, New York",657,26,631,254,688,46513,1964,2004,1207,31.6,55,23,211,0,20,631,72
2013,36047102400,"Census Tract 1024, Kings County, New York",661,52,609,293,741,46055,1964,2005,1218,32.2,77,43,216,0,34,609,51
2014,36047102400,"Census Tract 1024, Kings County, New York",694,45,649,324,862,48417,1964,2006,1300,32.5,99,40,259,3,22,649,54
2015,36047102400,"Census Tract 1024, Kings County, New York",695,50,645,282,796,49318,1963,2007,1364,31.5,111,33,226,4,19,645,38
2016,36047102400,"Census Tract 1024, Kings County, New York",706,55,651,243,679,60885,1961,2009,1556,30.9,91,17,209,8,9,651,37
2017,36047102400,"Census Tract 1024, Kings County, New York",715,41,674,247,645,61806,1952,2009,1532,28.6,109,10,215,8,9,674,49
2018,36047102400,"Census Tract 1024, Kings County, New York",741,18,723,318,928,64808,0,2011,1525,28.6,95,0,293,8,11,723,58
2019,36047102400,"Census Tract 1024, Kings County, New York",757,31,726,290,824,69531,0,2013,1485,27.4,96,0,259,5,12,726,42
2020,36047102400,"Census Tract 1024, Kings County, New York",744,34,710,290,791,63333,1946,2015,1703,28,86,0,257,6,0,710,86
2012,36047102600,"Census Tract 1026, Kings County, New York",931,75,856,402,1135,42550,1960,2004,1326,33.5,113,10,374,0,18,856,122
2013,36047102600,"Census Tract 1026, Kings County, New York",938,76,862,395,1102,44663,1962,2003,1398,33.7,125,10,380,0,0,862,76
2014,36047102600,"Census Tract 1026, Kings County, New York",964,79,885,389,1023,49688,1964,2004,1438,31.1,134,0,384,0,0,885,32
2015,36047102600,"Census Tract 1026, Kings County, New York",959,79,880,426,1127,49250,1964,2005,1400,34,146,5,399,0,6,880,42
2016,36047102600,"Census Tract 1026, Kings County, New York",965,86,879,374,849,51019,1962,2005,1394,35.1,148,4,344,0,7,879,55
2017,36047102600,"Census Tract 1026, Kings County, New York",974,86,888,387,897,52850,1957,2007,1531,35.5,133,5,362,0,7,888,19
2018,36047102600,"Census Tract 1026, Kings County, New York",1016,81,935,445,1156,76641,0,2010,1598,27,189,5,415,11,6,935,14
2019,36047102600,"Census Tract 1026, Kings County, New York",1046,97,949,488,1253,97661,0,2011,1661,24.3,190,5,448,11,6,949,33
2020,36047102600,"Census Tract 1026, Kings County, New York",1038,94,944,451,1117,88967,0,2012,1665,24.4,163,0,431,12,0,944,23
2012,36047102800,"Census Tract 1028, Kings County, New York",484,21,463,224,551,68696,1967,2005,1152,20.7,66,0,224,0,0,463,79
2013,36047102800,"Census Tract 1028, Kings County, New York",489,32,457,216,541,64038,1967,2005,1490,27.6,74,0,216,0,0,457,64
2014,36047102800,"Census Tract 1028, Kings County, New York",502,33,469,218,574,65278,1966,2005,1324,30.2,67,0,218,0,0,469,44
2015,36047102800,"Census Tract 1028, Kings County, New York",522,31,491,223,575,52708,1965,2007,1408,33.7,70,0,223,0,0,491,57
2016,36047102800,"Census Tract 1028, Kings County, New York",528,18,510,224,733,61463,1965,2008,1489,32.3,63,0,224,0,0,510,46
2017,36047102800,"Census Tract 1028, Kings County, New York",562,24,538,245,774,67938,1963,2009,1564,30.5,78,0,239,0,6,538,29
2018,36047102800,"Census Tract 1028, Kings County, New York",545,24,521,235,714,69602,1963,2011,1663,28.3,67,11,217,0,7,521,28
2019,36047102800,"Census Tract 1028, Kings County, New York",548,21,527,215,662,81953,1961,2010,1702,24.6,62,10,199,0,6,527,18
2020,36047102801,"Census Tract 1028.01, Kings County, New York",544,22,522,171,602,85950,1962,2011,1756,22.9,44,10,156,0,5,522,8
2020,36047102802,"Census Tract 1028.02, Kings County, New York",0,0,0,0,0,NA,NA,NA,NA,NA,0,0,0,0,0,0,0
2012,36047103400,"Census Tract 1034, Kings County, New York",1571,173,1398,1398,3478,23981,1956,1998,565,25.1,203,241,936,0,249,1398,591
2013,36047103400,"Census Tract 1034, Kings County, New York",1611,70,1541,1541,3672,21550,1957,2000,414,24.8,291,262,995,0,300,1541,701
2014,36047103400,"Census Tract 1034, Kings County, New York",1653,52,1601,1601,3697,17092,1957,2002,361,27.5,299,248,976,0,371,1601,789
2015,36047103400,"Census Tract 1034, Kings County, New York",1678,0,1678,1678,4029,18158,1958,2001,383,29,290,178,1112,0,334,1678,825
2016,36047103400,"Census Tract 1034, Kings County, New York",1701,0,1701,1701,3918,23133,1957,2001,439,27.6,320,164,1158,0,347,1701,706
2017,36047103400,"Census Tract 1034, Kings County, New York",1771,22,1749,1749,4046,23450,1957,2003,468,27.3,252,107,1211,0,390,1749,683
2018,36047103400,"Census Tract 1034, Kings County, New York",1761,24,1737,1737,4145,23870,1957,2002,490,28.5,172,81,1252,0,371,1737,643
2019,36047103400,"Census Tract 1034, Kings County, New York",1772,24,1748,1748,4294,25691,1957,2002,556,28.2,189,85,1247,0,369,1748,684
2020,36047103401,"Census Tract 1034.01, Kings County, New York",1741,28,1713,1713,3873,20655,1957,2003,451,26.7,147,99,1189,0,343,1713,703
2020,36047103402,"Census Tract 1034.02, Kings County, New York",0,0,0,0,0,NA,NA,NA,NA,NA,0,0,0,0,0,0,0
2012,36047105801,"Census Tract 1058.01, Kings County, New York",3327,39,3288,3261,6780,24311,1974,1997,843,29.7,716,1259,1620,43,357,3288,1049
2013,36047105801,"Census Tract 1058.01, Kings County, New York",3348,0,3348,3335,6664,25373,1974,1998,943,30.9,744,1128,1676,70,512,3348,995
2014,36047105801,"Census Tract 1058.01, Kings County, New York",3341,0,3341,3329,6594,27760,1974,1998,985,30,864,1235,1668,54,434,3341,968
2015,36047105801,"Census Tract 1058.01, Kings County, New York",3347,39,3308,3308,6352,25276,1974,1999,923,30.4,832,1275,1690,18,396,3308,1064
2016,36047105801,"Census Tract 1058.01, Kings County, New York",3388,32,3356,3324,5829,21280,1974,2001,718,31,690,1088,1795,20,500,3356,1083
2017,36047105801,"Census Tract 1058.01, Kings County, New York",3432,30,3402,3355,5772,23115,1973,2000,640,31.5,675,1126,1777,27,497,3402,1052
2018,36047105801,"Census Tract 1058.01, Kings County, New York",3479,55,3424,3381,5674,22340,1973,2000,634,31.8,680,1118,1739,36,517,3424,1099
2019,36047105801,"Census Tract 1058.01, Kings County, New York",3543,108,3435,3395,5720,26352,1973,2002,639,32.8,636,968,1891,36,524,3435,1021
2020,36047105801,"Census Tract 1058.01, Kings County, New York",3655,74,3581,3547,5763,21544,1974,2004,610,33.1,662,1067,1866,33,443,3581,1368
2012,36047105804,"Census Tract 1058.04, Kings County, New York",3139,49,3090,3002,5810,21528,1975,2000,849,30.2,804,894,1331,48,816,3090,1094
2013,36047105804,"Census Tract 1058.04, Kings County, New York",3113,98,3015,2903,5836,24417,1975,2000,821,29,729,888,1364,98,644,3015,1034
2014,36047105804,"Census Tract 1058.04, Kings County, New York",3127,146,2981,2814,5701,25128,1975,2001,629,30.7,732,820,1403,78,546,2981,1012
2015,36047105804,"Census Tract 1058.04, Kings County, New York",3175,175,3000,2855,5925,22409,1975,2001,585,31,641,867,1391,137,476,3000,1020
2016,36047105804,"Census Tract 1058.04, Kings County, New York",3224,172,3052,2949,6123,26528,1975,2001,597,30.2,580,742,1663,112,382,3052,934
2017,36047105804,"Census Tract 1058.04, Kings County, New York",3286,203,3083,3018,6412,29878,1975,2002,833,30.9,582,733,1747,131,379,3083,890
2018,36047105804,"Census Tract 1058.04, Kings County, New York",3348,143,3205,3088,6811,29471,1975,2002,819,30.4,631,704,1782,110,441,3205,914
2019,36047105804,"Census Tract 1058.04, Kings County, New York",3337,170,3167,3096,6544,31700,1975,2001,945,28.2,605,804,1695,180,398,3167,729
2020,36047105804,"Census Tract 1058.04, Kings County, New York",3161,104,3057,2968,6352,32885,1975,2002,887,28.7,496,598,1786,162,444,3057,751
2012,36047107000,"Census Tract 1070, Kings County, New York",187,4,183,65,164,60809,2001,2006,854,17.7,0,0,36,0,32,183,4
2013,36047107000,"Census Tract 1070, Kings County, New York",256,4,252,105,291,67361,2008,2011,1258,21.7,0,0,77,0,31,252,20
2014,36047107000,"Census Tract 1070, Kings County, New York",356,4,352,154,394,65938,2004,2011,1197,22.4,37,0,134,0,24,352,32
2015,36047107000,"Census Tract 1070, Kings County, New York",474,10,464,244,631,63571,2010,2012,1139,23.9,63,0,191,0,58,464,14
2016,36047107000,"Census Tract 1070, Kings County, New York",624,53,571,292,699,56094,2011,NA,1133,33.3,76,0,207,0,94,571,47
2017,36047107000,"Census Tract 1070, Kings County, New York",795,92,703,375,998,38265,2011,2013,987,34.2,69,12,239,0,137,703,102
2018,36047107000,"Census Tract 1070, Kings County, New York",975,90,885,515,1142,40211,2011,2013,959,32.5,158,30,380,0,211,885,135
2019,36047107000,"Census Tract 1070, Kings County, New York",1175,106,1069,600,1301,38462,2012,2014,958,32.5,111,33,411,0,266,1069,212
2020,36047107001,"Census Tract 1070.01, Kings County, New York",1262,91,1171,721,1460,31458,2013,2016,972,35.7,113,35,468,0,267,1171,317
2020,36047107002,"Census Tract 1070.02, Kings County, New York",0,0,0,0,0,NA,NA,NA,NA,NA,0,0,0,0,0,0,0
2020,36047107003,"Census Tract 1070.03, Kings County, New York",0,0,0,0,0,NA,NA,NA,NA,NA,0,0,0,0,0,0,0
2012,36047107800,"Census Tract 1078, Kings County, New York",1874,124,1750,990,2208,49600,1964,2002,1164,30.8,272,35,873,0,85,1750,121
2013,36047107800,"Census Tract 1078, Kings County, New York",1864,133,1731,895,1939,57153,1964,2002,1153,27,205,30,777,0,74,1731,99
2014,36047107800,"Census Tract 1078, Kings County, New York",1890,161,1729,853,1675,51953,1964,2001,1140,30.1,149,46,730,0,64,1729,86
2015,36047107800,"Census Tract 1078, Kings County, New York",1942,196,1746,789,1697,45179,1965,2000,1139,34.4,95,55,670,0,69,1746,183
2016,36047107800,"Census Tract 1078, Kings County, New York",2037,189,1848,710,1565,50833,1966,1998,1189,30.4,63,27,642,0,64,1848,188
2017,36047107800,"Census Tract 1078, Kings County, New York",2043,214,1829,624,1353,38906,1966,1996,1165,33.9,41,28,583,0,26,1829,230
2018,36047107800,"Census Tract 1078, Kings County, New York",2071,204,1867,718,1543,32700,1964,1997,1263,34.7,41,34,622,0,66,1867,313
2019,36047107800,"Census Tract 1078, Kings County, New York",2086,121,1965,688,1635,26250,1964,1993,1310,35.7,111,10,618,0,66,1965,333
2020,36047107800,"Census Tract 1078, Kings County, New York",2039,107,1932,780,1872,51389,1967,1991,1355,30.9,149,0,748,0,24,1932,219
2012,36047109800,"Census Tract 1098, Kings County, New York",624,56,568,436,1177,40909,1949,2004,1198,24.4,100,59,346,0,11,568,95
2013,36047109800,"Census Tract 1098, Kings County, New York",646,58,588,480,1318,41250,1960,2006,1286,27.8,124,58,377,0,23,588,109
2014,36047109800,"Census Tract 1098, Kings County, New York",671,59,612,492,1320,37250,1952,2007,1433,27.8,159,68,370,0,22,612,138
2015,36047109800,"Census Tract 1098, Kings County, New York",681,80,601,494,1482,43190,1957,2009,1524,34.9,191,45,384,0,38,601,142
2016,36047109800,"Census Tract 1098, Kings County, New York",672,83,589,477,1497,45382,1950,2011,1541,31.3,138,7,421,0,43,589,104
2017,36047109800,"Census Tract 1098, Kings County, New York",701,74,627,510,1521,49400,1955,2011,1537,31.5,158,27,425,0,44,627,110
2018,36047109800,"Census Tract 1098, Kings County, New York",695,87,608,463,1512,60764,1944,2011,1615,27.6,141,30,369,0,54,608,126
2019,36047109800,"Census Tract 1098, Kings County, New York",721,75,646,470,1400,56176,1946,2013,1711,29.8,101,30,381,0,47,646,97
2020,36047109800,"Census Tract 1098, Kings County, New York",698,41,657,488,1429,57969,0,2015,1634,29.6,42,18,380,0,33,657,74
2012,36047110400,"Census Tract 1104, Kings County, New York",1806,158,1648,1206,2914,29180,1950,2004,879,32.6,151,38,1012,0,204,1648,492
2013,36047110400,"Census Tract 1104, Kings County, New York",1816,182,1634,1160,2999,30765,1952,2004,862,31.3,146,43,949,0,224,1634,448
2014,36047110400,"Census Tract 1104, Kings County, New York",1795,177,1618,1165,3168,31996,1955,2005,891,31.4,122,43,935,0,238,1618,494
2015,36047110400,"Census Tract 1104, Kings County, New York",1801,198,1603,1127,3041,32563,1956,2006,857,30.7,138,34,879,0,271,1603,388
2016,36047110400,"Census Tract 1104, Kings County, New York",1848,190,1658,1174,3027,31705,1953,2007,972,31.4,125,25,995,0,213,1658,434
2017,36047110400,"Census Tract 1104, Kings County, New York",1861,193,1668,1177,2771,25219,1953,2007,1045,33.2,102,9,957,0,243,1668,456
2018,36047110400,"Census Tract 1104, Kings County, New York",1882,202,1680,1196,2761,22826,1955,2007,1048,33.9,99,10,965,0,233,1680,492
2019,36047110400,"Census Tract 1104, Kings County, New York",1940,194,1746,1163,2362,20901,1954,2007,887,34,133,8,956,0,206,1746,484
2020,36047110400,"Census Tract 1104, Kings County, New York",1892,170,1722,1179,2648,22377,1954,2010,1155,48.2,112,10,924,0,197,1722,496
2012,36047110600,"Census Tract 1106, Kings County, New York",1666,92,1574,1574,4616,25938,1956,1998,520,24.5,109,0,1270,0,352,1574,534
2013,36047110600,"Census Tract 1106, Kings County, New York",1661,96,1565,1565,4599,28690,1955,1997,541,23.8,109,0,1259,0,349,1565,505
2014,36047110600,"Census Tract 1106, Kings County, New York",1671,88,1583,1583,4513,27846,1955,1999,535,24.9,107,0,1280,0,371,1583,567
2015,36047110600,"Census Tract 1106, Kings County, New York",1703,83,1620,1612,4421,24448,1955,2001,447,25.9,84,0,1302,0,358,1620,636
2016,36047110600,"Census Tract 1106, Kings County, New York",1744,91,1653,1641,4260,21607,1954,2002,430,26.6,120,0,1382,7,317,1653,680
2017,36047110600,"Census Tract 1106, Kings County, New York",1753,104,1649,1635,4053,17215,1955,2003,423,28.1,111,0,1281,9,426,1649,703
2018,36047110600,"Census Tract 1106, Kings County, New York",1817,78,1739,1726,3967,17183,1955,2004,449,30.4,118,0,1303,9,476,1739,750
2019,36047110600,"Census Tract 1106, Kings County, New York",1937,122,1815,1802,4166,19620,1958,2004,516,31.4,96,0,1342,9,505,1815,794
2020,36047110600,"Census Tract 1106, Kings County, New York",2027,159,1868,1868,4298,25203,1957,2004,669,32.2,91,0,1401,11,499,1868,767
2012,36047111000,"Census Tract 1110, Kings County, New York",1501,42,1459,1451,3325,17228,1954,2000,343,26,83,34,1156,0,294,1459,698
2013,36047111000,"Census Tract 1110, Kings County, New York",1503,47,1456,1451,3339,18680,1955,2002,415,25,148,12,1152,0,331,1456,681
2014,36047111000,"Census Tract 1110, Kings County, New York",1526,51,1475,1465,3493,20425,1955,2003,409,23.8,91,9,1171,0,320,1475,686
2015,36047111000,"Census Tract 1110, Kings County, New York",1544,66,1478,1469,3364,16621,1954,2003,411,26.1,100,9,1139,0,334,1478,756
2016,36047111000,"Census Tract 1110, Kings County, New York",1560,104,1456,1448,3366,16355,1953,2003,346,27.8,129,8,1123,0,292,1456,744
2017,36047111000,"Census Tract 1110, Kings County, New York",1579,122,1457,1440,3290,17537,1954,2006,419,29.2,126,20,1146,0,286,1457,702
2018,36047111000,"Census Tract 1110, Kings County, New York",1606,94,1512,1512,3330,18388,1954,2005,428,30.2,91,34,1147,0,307,1512,672
2019,36047111000,"Census Tract 1110, Kings County, New York",1605,152,1453,1453,2986,21060,1954,2005,501,29.8,116,41,1087,7,332,1453,616
2020,36047111000,"Census Tract 1110, Kings County, New York",1520,142,1378,1378,2891,22888,1955,2008,526,29.3,158,42,1042,9,302,1378,523
2012,36047111600,"Census Tract 1116, Kings County, New York",1086,173,913,565,1883,31302,1974,2006,1358,33,33,0,461,0,126,913,241
2013,36047111600,"Census Tract 1116, Kings County, New York",1110,192,918,686,2307,26818,1973,2007,1359,32.9,33,0,548,0,159,918,300
2014,36047111600,"Census Tract 1116, Kings County, New York",1153,170,983,761,2473,35724,1972,2007,1369,36.1,40,14,579,0,182,983,293
2015,36047111600,"Census Tract 1116, Kings County, New York",1200,164,1036,783,2685,35238,1973,2008,1542,38.5,54,18,544,0,228,1036,278
2016,36047111600,"Census Tract 1116, Kings County, New York",1210,185,1025,793,2847,36165,1974,2008,1553,38.6,44,23,530,0,254,1025,337
2017,36047111600,"Census Tract 1116, Kings County, New York",1227,231,996,701,2489,35436,1974,2009,1288,35.8,48,20,493,0,203,996,261
2018,36047111600,"Census Tract 1116, Kings County, New York",1244,219,1025,610,2246,39643,1976,2008,1307,35.2,23,12,415,0,196,1025,166
2019,36047111600,"Census Tract 1116, Kings County, New York",1274,179,1095,754,2243,26237,1963,2015,1358,51,245,13,592,0,156,1095,200
2020,36047111600,"Census Tract 1116, Kings County, New York",1184,203,981,582,1620,25493,1959,2016,1372,51,221,0,534,0,53,981,137
2012,36047111800,"Census Tract 1118, Kings County, New York",1110,232,878,655,2105,30068,1965,2004,1113,44.8,17,0,515,0,140,878,302
2013,36047111800,"Census Tract 1118, Kings County, New York",1142,246,896,686,2098,15926,1968,2005,1165,46.7,39,0,566,0,120,896,357
2014,36047111800,"Census Tract 1118, Kings County, New York",1232,331,901,648,1990,23750,1977,2005,1286,44.7,64,19,592,0,58,901,352
2015,36047111800,"Census Tract 1118, Kings County, New York",1261,282,979,653,2129,31599,1967,2006,1325,43.6,71,18,593,0,65,979,312
2016,36047111800,"Census Tract 1118, Kings County, New York",1278,233,1045,621,1797,NA,1966,2007,1286,50,84,29,490,0,123,1045,408
2017,36047111800,"Census Tract 1118, Kings County, New York",1286,210,1076,655,2074,20815,1964,2008,1256,49.5,91,36,500,0,145,1076,428
2018,36047111800,"Census Tract 1118, Kings County, New York",1314,187,1127,653,2052,32813,1964,2010,1195,45.5,78,34,482,0,165,1127,345
2019,36047111800,"Census Tract 1118, Kings County, New York",1377,159,1218,820,2520,38227,1962,2015,1164,36.9,80,9,595,0,216,1218,382
2020,36047111800,"Census Tract 1118, Kings County, New York",1556,176,1380,1034,2675,70546,1942,2017,1491,36.8,430,18,505,26,485,1380,311
2012,36047112000,"Census Tract 1120, Kings County, New York",1325,214,1111,750,2309,38962,1954,2005,1171,35.2,111,0,504,0,299,1111,271
2013,36047112000,"Census Tract 1120, Kings County, New York",1336,224,1112,787,2418,34728,1954,2006,1187,36.3,69,0,502,0,373,1112,324
2014,36047112000,"Census Tract 1120, Kings County, New York",1360,230,1130,784,2196,17455,1957,2007,1194,46.9,34,14,521,0,337,1130,427
2015,36047112000,"Census Tract 1120, Kings County, New York",1335,232,1103,809,2131,15584,1960,2009,1225,50,41,27,524,0,324,1103,446
2016,36047112000,"Census Tract 1120, Kings County, New York",1317,250,1067,796,2150,16798,1943,2011,1403,50,88,27,469,0,349,1067,415
2017,36047112000,"Census Tract 1120, Kings County, New York",1325,255,1070,835,2331,15618,1939,2011,1358,49.1,96,30,472,0,376,1070,461
2018,36047112000,"Census Tract 1120, Kings County, New York",1362,253,1109,872,2372,24881,0,2010,1315,38.7,100,29,496,0,410,1109,377
2019,36047112000,"Census Tract 1120, Kings County, New York",1393,265,1128,822,2169,24451,0,2011,1247,42.9,108,8,499,0,387,1128,360
2020,36047112000,"Census Tract 1120, Kings County, New York",1325,215,1110,775,2095,34688,0,2011,1202,39.6,100,0,498,0,353,1110,291
2012,36047112200,"Census Tract 1122, Kings County, New York",1180,171,1009,779,2174,24966,1939,2005,1245,44.9,34,31,615,17,125,1009,341
2013,36047112200,"Census Tract 1122, Kings County, New York",1145,138,1007,830,2460,26813,1940,2007,1251,47.6,22,31,653,17,141,1007,334
2014,36047112200,"Census Tract 1122, Kings County, New York",1189,116,1073,888,2824,26632,1943,2008,1233,48.8,44,30,696,17,160,1073,404
2015,36047112200,"Census Tract 1122, Kings County, New York",1215,98,1117,905,2973,26969,1944,2009,1181,49.8,62,8,651,27,203,1117,435
2016,36047112200,"Census Tract 1122, Kings County, New York",1252,79,1173,962,3002,27911,1945,2009,1288,50,82,0,710,19,223,1173,455
2017,36047112200,"Census Tract 1122, Kings County, New York",1285,89,1196,923,2712,30609,1950,2010,1391,50,104,0,697,35,193,1196,411
2018,36047112200,"Census Tract 1122, Kings County, New York",1360,132,1228,895,2418,31234,1947,2011,1362,44.4,99,0,617,40,213,1228,422
2019,36047112200,"Census Tract 1122, Kings County, New York",1357,117,1240,839,1983,30920,1946,2011,1526,51,101,0,589,58,156,1240,430
2020,36047112200,"Census Tract 1122, Kings County, New York",1557,122,1435,1067,1930,NA,0,2013,1640,51,48,0,667,42,349,1435,650
2012,36047112400,"Census Tract 1124, Kings County, New York",1223,146,1077,668,1882,29519,1939,2005,1268,50,0,0,581,0,115,1077,334
2013,36047112400,"Census Tract 1124, Kings County, New York",1202,129,1073,687,1913,29890,1939,2009,1141,34.4,0,0,635,0,62,1073,347
2014,36047112400,"Census Tract 1124, Kings County, New York",1228,119,1109,773,1977,33433,1939,2009,1153,35.6,0,0,678,0,112,1109,396
2015,36047112400,"Census Tract 1124, Kings County, New York",1262,123,1139,771,1902,32736,1939,2010,1189,40.9,89,0,646,0,180,1139,399
2016,36047112400,"Census Tract 1124, Kings County, New York",1296,151,1145,759,1874,28185,1939,2011,1222,45.8,93,0,647,0,143,1145,373
2017,36047112400,"Census Tract 1124, Kings County, New York",1338,103,1235,851,1997,35893,1939,2011,1273,45.4,146,15,736,0,152,1235,402
2018,36047112400,"Census Tract 1124, Kings County, New York",1405,176,1229,744,1750,35000,0,2011,1359,51,128,19,628,0,141,1229,342
2019,36047112400,"Census Tract 1124, Kings County, New York",1390,235,1155,755,1883,26152,0,2012,1345,51,138,22,628,0,140,1155,341
2020,36047112400,"Census Tract 1124, Kings County, New York",1448,201,1247,914,2245,30400,0,2013,1347,51,135,18,777,0,208,1247,297
2012,36047112600,"Census Tract 1126, Kings County, New York",1431,174,1257,980,2923,18631,1947,2004,1081,50,77,51,670,8,275,1257,426
2013,36047112600,"Census Tract 1126, Kings County, New York",1411,210,1201,951,2798,22015,1954,2006,1139,50,58,42,685,8,239,1201,360
2014,36047112600,"Census Tract 1126, Kings County, New York",1452,191,1261,1026,3124,29565,1953,2006,1154,46.2,10,43,755,4,286,1261,396
2015,36047112600,"Census Tract 1126, Kings County, New York",1472,192,1280,1043,3022,27153,1951,2008,1140,45,46,62,714,8,324,1280,447
2016,36047112600,"Census Tract 1126, Kings County, New York",1505,200,1305,1058,2759,26193,1954,2009,1178,41.1,54,61,730,0,322,1305,419
2017,36047112600,"Census Tract 1126, Kings County, New York",1586,245,1341,1117,2610,19330,1949,2010,1219,43.8,66,42,806,13,295,1341,484
2018,36047112600,"Census Tract 1126, Kings County, New York",1620,219,1401,1166,2634,22024,1944,2011,1213,38,86,46,844,17,291,1401,493
2019,36047112600,"Census Tract 1126, Kings County, New York",1701,233,1468,1188,2286,14440,0,2011,1188,49.1,117,35,873,24,245,1468,559
2020,36047112600,"Census Tract 1126, Kings County, New York",1748,130,1618,1290,2453,31840,1965,2013,1360,33.2,138,14,853,27,374,1618,472
2012,36047112800,"Census Tract 1128, Kings County, New York",1582,90,1492,1030,2620,25847,1939,2004,1128,35.7,110,6,823,8,222,1492,486
2013,36047112800,"Census Tract 1128, Kings County, New York",1585,145,1440,988,2412,29783,1939,2006,1171,33.4,125,16,773,30,195,1440,426
2014,36047112800,"Census Tract 1128, Kings County, New York",1592,182,1410,1002,2657,30076,1939,2006,1175,33.9,168,29,786,32,187,1410,436
2015,36047112800,"Census Tract 1128, Kings County, New York",1588,194,1394,990,2540,24745,1939,2008,1193,39.2,174,44,816,29,120,1394,488
2016,36047112800,"Census Tract 1128, Kings County, New York",1617,240,1377,1011,2539,34097,1939,2010,1240,36.7,219,45,856,20,90,1377,448
2017,36047112800,"Census Tract 1128, Kings County, New York",1665,188,1477,1108,2680,29803,1939,2011,1298,37.8,256,45,925,20,118,1477,468
2018,36047112800,"Census Tract 1128, Kings County, New York",1711,223,1488,1057,2661,32401,1941,2011,1344,39.8,233,34,917,0,106,1488,484
2019,36047112800,"Census Tract 1128, Kings County, New York",1729,232,1497,1015,2374,30339,0,2012,1316,43.6,163,22,920,0,85,1497,582
2020,36047112800,"Census Tract 1128, Kings County, New York",1577,234,1343,944,2621,33993,0,2013,1352,38,130,0,890,0,66,1343,570
2012,36047113000,"Census Tract 1130, Kings County, New York",1463,20,1443,1071,3350,17311,1951,2004,908,32,100,48,807,0,244,1443,605
2013,36047113000,"Census Tract 1130, Kings County, New York",1444,25,1419,1076,3493,17939,1954,2005,1021,29.9,151,14,834,0,267,1419,604
2014,36047113000,"Census Tract 1130, Kings County, New York",1446,44,1402,1115,3622,19777,1951,2005,1100,32.1,162,17,899,0,218,1402,590
2015,36047113000,"Census Tract 1130, Kings County, New York",1475,81,1394,1080,3554,26385,1958,2006,1120,33.9,146,0,911,0,189,1394,493
2016,36047113000,"Census Tract 1130, Kings County, New York",1529,100,1429,1075,3198,24688,1965,2007,1131,37.2,116,0,947,0,154,1429,499
2017,36047113000,"Census Tract 1130, Kings County, New York",1600,118,1482,1118,3122,27620,1963,2008,1029,35.6,158,10,983,0,116,1482,468
2018,36047113000,"Census Tract 1130, Kings County, New York",1650,105,1545,1006,2512,28848,1966,2010,1137,44,116,16,840,0,100,1545,386
2019,36047113000,"Census Tract 1130, Kings County, New York",1691,142,1549,995,2253,32472,1963,2012,982,34.7,148,18,833,0,180,1549,303
2020,36047113000,"Census Tract 1130, Kings County, New York",1669,110,1559,996,2339,37292,1968,2014,1099,33.8,182,32,759,0,236,1559,346
2012,36047113200,"Census Tract 1132, Kings County, New York",722,61,661,332,956,31343,1971,2004,1212,40.2,16,0,265,0,81,661,143
2013,36047113200,"Census Tract 1132, Kings County, New York",741,41,700,366,1116,34500,1972,2004,1134,36.2,15,0,240,0,129,700,153
2014,36047113200,"Census Tract 1132, Kings County, New York",738,58,680,278,833,48750,1965,2006,1220,31.1,21,0,226,0,67,680,87
2015,36047113200,"Census Tract 1132, Kings County, New York",723,73,650,275,830,41875,1960,2007,1243,36.7,36,0,243,0,25,650,116
2016,36047113200,"Census Tract 1132, Kings County, New York",735,87,648,266,788,41466,1959,2008,1341,38.9,22,0,209,10,46,648,140
2017,36047113200,"Census Tract 1132, Kings County, New York",718,107,611,203,580,41211,1963,2008,1402,44.2,11,0,164,9,38,611,121
2018,36047113200,"Census Tract 1132, Kings County, New York",729,107,622,210,631,36389,1955,2007,1568,45.5,22,0,164,8,46,622,120
2019,36047113200,"Census Tract 1132, Kings County, New York",748,124,624,247,740,39097,1954,2008,1536,48.9,51,0,189,7,58,624,107
2020,36047113200,"Census Tract 1132, Kings County, New York",691,92,599,276,874,43910,1953,2009,1550,51,39,0,191,9,91,599,76
2012,36047113400,"Census Tract 1134, Kings County, New York",859,37,822,747,2383,12207,1977,2003,599,37.9,47,0,444,8,321,822,414
2013,36047113400,"Census Tract 1134, Kings County, New York",870,46,824,739,2190,16131,1976,2004,656,34.1,49,0,443,0,315,824,408
2014,36047113400,"Census Tract 1134, Kings County, New York",897,43,854,809,2335,15817,1980,2004,658,35.4,33,20,549,0,276,854,456
2015,36047113400,"Census Tract 1134, Kings County, New York",925,41,884,850,2468,18068,1976,2006,626,33,44,13,602,0,288,884,460
2016,36047113400,"Census Tract 1134, Kings County, New York",960,47,913,877,2490,17468,1974,2007,527,31.8,38,10,646,11,299,913,481
2017,36047113400,"Census Tract 1134, Kings County, New York",981,73,908,866,2359,18235,1974,2008,587,33.3,48,11,613,10,314,908,484
2018,36047113400,"Census Tract 1134, Kings County, New York",987,84,903,862,2389,22679,1975,2008,682,32.3,65,16,651,10,280,903,428
2019,36047113400,"Census Tract 1134, Kings County, New York",993,88,905,870,2300,25000,1972,2009,635,29.2,88,9,692,3,247,905,408
2020,36047113400,"Census Tract 1134, Kings County, New York",1052,109,943,877,2085,35406,1979,2009,695,29.5,57,15,690,3,222,943,346
2012,36047114201,"Census Tract 1142.01, Kings County, New York",618,36,582,214,487,41250,1945,2004,1254,32.5,14,0,59,0,155,582,70
2013,36047114201,"Census Tract 1142.01, Kings County, New York",607,61,546,194,438,19231,1946,2006,1278,50,18,0,10,0,184,546,68
2014,36047114201,"Census Tract 1142.01, Kings County, New York",614,83,531,227,727,27986,1949,2008,1147,39.7,20,0,12,0,215,531,122
2015,36047114201,"Census Tract 1142.01, Kings County, New York",627,67,560,223,614,32813,1939,2011,1199,34.8,30,0,27,13,183,560,93
2016,36047114201,"Census Tract 1142.01, Kings County, New York",606,83,523,291,917,25391,1939,2010,1190,46.6,32,0,53,13,225,523,162
2017,36047114201,"Census Tract 1142.01, Kings County, New York",603,73,530,311,985,24250,1939,2011,1248,43.8,47,0,52,12,247,530,183
2018,36047114201,"Census Tract 1142.01, Kings County, New York",613,55,558,316,991,23684,0,2011,1246,47.1,54,7,63,12,206,558,179
2019,36047114201,"Census Tract 1142.01, Kings County, New York",606,39,567,350,927,33316,0,2010,1377,51,61,6,104,12,229,567,159
2020,36047114201,"Census Tract 1142.01, Kings County, New York",618,44,574,257,709,NA,0,2009,1503,51,27,7,94,3,148,574,114
2012,36047114202,"Census Tract 1142.02, Kings County, New York",933,138,795,664,1818,24141,1940,2004,1074,37.6,31,33,304,12,374,795,281
2013,36047114202,"Census Tract 1142.02, Kings County, New York",928,113,815,684,1670,24324,1939,2005,1081,39.9,61,32,321,0,409,815,305
2014,36047114202,"Census Tract 1142.02, Kings County, New York",935,89,846,665,1533,28185,1939,2005,1079,41,50,42,324,0,345,846,245
2015,36047114202,"Census Tract 1142.02, Kings County, New York",981,77,904,648,1623,31136,1939,2006,1132,41.7,39,27,301,0,344,904,180
2016,36047114202,"Census Tract 1142.02, Kings County, New York",960,74,886,583,1458,41250,1939,2007,1164,35.8,64,9,290,0,320,886,114
2017,36047114202,"Census Tract 1142.02, Kings County, New York",953,55,898,539,1222,38405,1939,2010,1185,40.2,65,11,225,0,307,898,173
2018,36047114202,"Census Tract 1142.02, Kings County, New York",973,68,905,512,1219,40988,0,2011,1329,40.7,82,23,181,0,286,905,179
2019,36047114202,"Census Tract 1142.02, Kings County, New York",985,69,916,566,1429,45250,0,2011,1388,37.4,84,29,269,0,268,916,180
2020,36047114202,"Census Tract 1142.02, Kings County, New York",1019,52,967,680,1830,55152,0,2010,1558,36.1,119,17,233,0,395,967,247
2012,36047114400,"Census Tract 1144, Kings County, New York",809,41,768,671,2182,27275,1951,2004,1195,32.9,77,4,434,0,228,768,266
2013,36047114400,"Census Tract 1144, Kings County, New York",826,39,787,695,2347,24848,1953,2005,1054,33.9,58,4,463,0,212,787,316
2014,36047114400,"Census Tract 1144, Kings County, New York",852,66,786,683,2204,21932,1955,2006,1149,42.1,26,3,424,0,239,786,385
2015,36047114400,"Census Tract 1144, Kings County, New York",869,97,772,665,2027,25946,1951,2007,1124,34.9,23,4,377,0,275,772,286
2016,36047114400,"Census Tract 1144, Kings County, New York",820,110,710,604,1548,20270,1960,2009,1014,41.4,31,0,323,0,277,710,305
2017,36047114400,"Census Tract 1144, Kings County, New York",844,142,702,550,1582,20625,1962,2010,1066,45,30,0,313,0,243,702,291
2018,36047114400,"Census Tract 1144, Kings County, New York",855,123,732,602,1571,32188,1962,2012,1322,33.1,44,0,330,0,288,732,242
2019,36047114400,"Census Tract 1144, Kings County, New York",848,99,749,634,1806,44531,1969,2014,1498,31.6,45,0,371,0,307,749,189
2020,36047114400,"Census Tract 1144, Kings County, New York",855,101,754,570,1699,43986,1971,2015,1568,33.5,52,0,368,0,246,754,172
2012,36047114600,"Census Tract 1146, Kings County, New York",942,117,825,594,1597,23207,1939,2004,1026,44.3,49,38,186,0,401,825,292
2013,36047114600,"Census Tract 1146, Kings County, New York",944,77,867,647,1947,23996,1939,2006,1105,38.9,70,26,215,0,439,867,296
2014,36047114600,"Census Tract 1146, Kings County, New York",970,40,930,668,2172,24599,1939,2006,1186,47.6,86,29,192,0,482,930,297
2015,36047114600,"Census Tract 1146, Kings County, New York",1029,60,969,730,2205,24980,1939,2008,1197,46.5,121,18,199,10,522,969,307
2016,36047114600,"Census Tract 1146, Kings County, New York",1052,66,986,672,2237,31600,1941,2009,1291,39.6,133,20,183,24,447,986,289
2017,36047114600,"Census Tract 1146, Kings County, New York",1060,57,1003,667,2064,29279,1939,2011,1351,45.6,110,18,184,43,416,1003,273
2018,36047114600,"Census Tract 1146, Kings County, New York",1032,81,951,632,2028,30000,1940,2011,1378,45.6,104,10,185,38,403,951,243
2019,36047114600,"Census Tract 1146, Kings County, New York",1073,111,962,633,1843,27344,0,2012,1475,51,80,51,155,47,395,962,249
2020,36047114600,"Census Tract 1146, Kings County, New York",944,101,843,526,1960,32000,0,2014,1616,51,52,48,116,35,342,843,132
2012,36047115000,"Census Tract 1150, Kings County, New York",910,144,766,620,1601,31422,1968,2005,1246,43.3,63,21,342,15,192,766,234
2013,36047115000,"Census Tract 1150, Kings County, New York",956,139,817,627,1624,30378,1965,2006,1195,42.7,102,21,379,18,202,817,286
2014,36047115000,"Census Tract 1150, Kings County, New York",1008,120,888,682,1900,30357,1965,2008,1331,50,115,34,359,21,261,888,323
2015,36047115000,"Census Tract 1150, Kings County, New York",1043,135,908,708,1929,31225,1965,2009,1307,48,86,7,407,21,262,908,285
2016,36047115000,"Census Tract 1150, Kings County, New York",1034,150,884,662,1842,33289,1963,2010,1277,42.6,78,8,359,19,278,884,260
2017,36047115000,"Census Tract 1150, Kings County, New York",1030,138,892,653,1840,31681,1958,2011,1226,47.3,66,8,343,0,305,892,258
2018,36047115000,"Census Tract 1150, Kings County, New York",1031,144,887,626,1797,31094,1956,2011,1300,47.5,44,0,307,0,327,887,281
2019,36047115000,"Census Tract 1150, Kings County, New York",1038,150,888,608,1612,32292,1966,2012,1429,45.9,45,0,345,0,276,888,242
2020,36047115000,"Census Tract 1150, Kings County, New York",961,102,859,574,1749,39322,1953,2012,1203,34.7,70,0,306,0,281,859,223
2012,36047115200,"Census Tract 1152, Kings County, New York",1023,124,899,682,2288,12089,1970,2004,912,50,54,4,457,16,259,899,528
2013,36047115200,"Census Tract 1152, Kings County, New York",1053,127,926,659,2093,14657,1964,2005,1040,36,65,7,405,22,248,926,428
2014,36047115200,"Census Tract 1152, Kings County, New York",1086,112,974,749,2281,17375,1962,2005,1102,36.1,78,12,495,20,247,974,433
2015,36047115200,"Census Tract 1152, Kings County, New York",1117,117,1000,769,2399,27578,1970,2007,1164,35.9,107,8,508,44,192,1000,388
2016,36047115200,"Census Tract 1152, Kings County, New York",1111,111,1000,750,2148,30588,1966,2008,1155,37.8,104,16,486,39,200,1000,378
2017,36047115200,"Census Tract 1152, Kings County, New York",1152,155,997,712,2025,29310,1967,2009,1164,42.9,95,24,459,29,193,997,326
2018,36047115200,"Census Tract 1152, Kings County, New York",1167,140,1027,839,2413,31344,1961,2010,1314,48.1,77,42,554,23,222,1027,321
2019,36047115200,"Census Tract 1152, Kings County, New York",1200,143,1057,809,2301,27875,1955,2010,1225,48.6,72,43,501,24,245,1057,321
2020,36047115200,"Census Tract 1152, Kings County, New York",1138,123,1015,754,1842,24069,1953,2011,1085,43.9,65,32,484,13,243,1015,284
2012,36047115600,"Census Tract 1156, Kings County, New York",1552,73,1479,1397,3709,14782,1972,2001,440,31.3,58,0,945,37,462,1479,768
2013,36047115600,"Census Tract 1156, Kings County, New York",1590,61,1529,1469,4019,12663,1972,2002,466,35.4,33,11,987,33,527,1529,874
2014,36047115600,"Census Tract 1156, Kings County, New York",1652,86,1566,1493,4161,13452,1972,2003,548,36.3,42,9,995,34,525,1566,826
2015,36047115600,"Census Tract 1156, Kings County, New York",1676,102,1574,1488,3958,14415,1971,2004,551,33,116,14,948,36,506,1574,774
2016,36047115600,"Census Tract 1156, Kings County, New York",1674,93,1581,1515,3936,14258,1972,2006,512,38,109,13,1117,25,370,1581,798
2017,36047115600,"Census Tract 1156, Kings County, New York",1700,95,1605,1491,3746,13932,1971,2007,518,44.8,101,12,1091,14,359,1605,830
2018,36047115600,"Census Tract 1156, Kings County, New York",1720,124,1596,1459,3418,20342,1971,2010,628,40.5,112,0,1069,15,353,1596,680
2019,36047115600,"Census Tract 1156, Kings County, New York",1765,92,1673,1527,3478,20036,1971,2010,621,39.3,181,0,1197,11,317,1673,768
2020,36047115600,"Census Tract 1156, Kings County, New York",1789,28,1761,1614,3675,16659,1971,2011,712,39.7,64,0,1237,0,453,1761,820
2012,36047115800,"Census Tract 1158, Kings County, New York",1006,96,910,660,2082,35053,1943,2004,1261,39,35,0,410,0,276,910,234
2013,36047115800,"Census Tract 1158, Kings County, New York",1060,139,921,676,1934,36216,1939,2004,1271,40.5,5,0,403,0,298,921,231
2014,36047115800,"Census Tract 1158, Kings County, New York",1109,163,946,554,1512,30833,1941,2006,1377,44.3,17,0,356,0,244,946,233
2015,36047115800,"Census Tract 1158, Kings County, New York",1117,216,901,529,1591,33938,1951,2008,1245,42.1,14,0,348,0,222,901,225
2016,36047115800,"Census Tract 1158, Kings County, New York",1132,189,943,532,1394,26563,1941,2009,1149,39.2,24,3,338,0,206,943,243
2017,36047115800,"Census Tract 1158, Kings County, New York",1162,214,948,541,1434,33618,1942,2010,1202,38.1,19,17,329,0,217,948,243
2018,36047115800,"Census Tract 1158, Kings County, New York",1163,210,953,557,1501,22596,1942,2011,1289,45.1,35,17,364,0,199,953,266
2019,36047115800,"Census Tract 1158, Kings County, New York",1148,177,971,580,1488,21897,1940,2011,1433,51,48,24,331,0,201,971,297
2020,36047115800,"Census Tract 1158, Kings County, New York",1119,137,982,543,1305,22399,0,2013,1503,51,56,23,282,0,203,982,260
2012,36047116000,"Census Tract 1160, Kings County, New York",942,112,830,566,1647,15403,1981,2003,526,42.5,49,0,321,0,261,830,378
2013,36047116000,"Census Tract 1160, Kings County, New York",933,104,829,611,1741,22156,1982,2004,713,36.4,74,0,356,0,266,829,327
2014,36047116000,"Census Tract 1160, Kings County, New York",936,87,849,632,1367,16591,1981,2003,735,35.6,119,0,327,0,300,849,384
2015,36047116000,"Census Tract 1160, Kings County, New York",954,85,869,580,1287,17304,1983,2002,683,35.4,107,0,379,0,243,869,314
2016,36047116000,"Census Tract 1160, Kings County, New York",984,88,896,631,1240,20391,1973,2004,780,33.7,111,0,415,0,268,896,310
2017,36047116000,"Census Tract 1160, Kings County, New York",991,69,922,673,1395,24050,1967,2007,818,36.7,127,0,449,0,274,922,334
2018,36047116000,"Census Tract 1160, Kings County, New York",1006,105,901,642,1471,17500,1961,2007,822,35.4,52,0,470,0,213,901,343
2019,36047116000,"Census Tract 1160, Kings County, New York",1023,97,926,652,1516,32396,1964,2008,972,38.8,49,4,431,0,309,926,246
2020,36047116000,"Census Tract 1160, Kings County, New York",969,80,889,582,1545,37391,1965,2010,1309,29.8,45,3,350,0,280,889,198
2012,36047116200,"Census Tract 1162, Kings County, New York",857,101,756,355,905,26326,1956,2003,1128,50,55,0,285,0,86,756,160
2013,36047116200,"Census Tract 1162, Kings County, New York",854,136,718,314,849,30122,1960,2004,1199,50,35,0,266,0,70,718,150
2014,36047116200,"Census Tract 1162, Kings County, New York",839,106,733,293,770,30380,1968,2004,1233,49.2,10,0,249,0,44,733,138
2015,36047116200,"Census Tract 1162, Kings County, New York",865,130,735,349,835,26458,1964,2004,1189,48.1,20,0,296,7,58,735,173
2016,36047116200,"Census Tract 1162, Kings County, New York",915,143,772,358,1020,30517,1957,2007,1315,48.3,6,0,286,6,50,772,167
2017,36047116200,"Census Tract 1162, Kings County, New York",901,127,774,419,1282,36875,1943,2010,1326,47.2,35,0,348,6,57,774,216
2018,36047116200,"Census Tract 1162, Kings County, New York",895,94,801,433,1230,33563,1948,2011,1301,49.2,41,0,362,5,65,801,200
2019,36047116200,"Census Tract 1162, Kings County, New York",933,119,814,487,1431,40313,0,2012,1291,42.8,48,0,386,7,87,814,216
2020,36047116200,"Census Tract 1162, Kings County, New York",917,77,840,498,1575,42882,0,2014,1415,42.4,45,0,390,0,79,840,202
2012,36047116400,"Census Tract 1164, Kings County, New York",1090,158,932,395,1223,21488,1959,2003,1241,44.3,22,0,239,0,163,932,315
2013,36047116400,"Census Tract 1164, Kings County, New York",1085,166,919,450,1499,28125,1962,2004,1212,46.1,26,17,336,0,104,919,281
2014,36047116400,"Census Tract 1164, Kings County, New York",1065,179,886,497,1609,29688,1960,2004,1220,40.2,27,11,361,16,134,886,280
2015,36047116400,"Census Tract 1164, Kings County, New York",1075,181,894,535,1670,27321,1946,2006,1182,38,20,9,306,16,235,894,261
2016,36047116400,"Census Tract 1164, Kings County, New York",1076,122,954,557,1631,35188,1943,2006,1147,31.2,50,16,357,17,194,954,210
2017,36047116400,"Census Tract 1164, Kings County, New York",1092,92,1000,606,1970,41111,1939,2008,1194,28.9,71,14,412,17,208,1000,174
2018,36047116400,"Census Tract 1164, Kings County, New York",1111,78,1033,619,2086,46941,1953,2011,1411,35.9,90,0,397,17,261,1033,186
2019,36047116400,"Census Tract 1164, Kings County, New York",1169,72,1097,693,2265,49191,1955,2011,1608,38.6,77,0,484,0,251,1097,237
2020,36047116400,"Census Tract 1164, Kings County, New York",1240,84,1156,629,1998,50457,1963,2011,1619,39.2,85,34,438,0,198,1156,179
2012,36047116600,"Census Tract 1166, Kings County, New York",1100,281,819,570,2176,27024,1961,2004,1245,38,40,28,405,0,155,819,282
2013,36047116600,"Census Tract 1166, Kings County, New York",1079,268,811,604,2135,22708,1963,2003,1252,44,50,25,408,17,176,811,328
2014,36047116600,"Census Tract 1166, Kings County, New York",1074,263,811,614,1990,19257,1961,2005,1326,50,63,34,383,17,215,811,327
2015,36047116600,"Census Tract 1166, Kings County, New York",1072,191,881,687,2101,27961,1939,2007,1289,41.9,86,28,450,19,220,881,274
2016,36047116600,"Census Tract 1166, Kings County, New York",1092,171,921,716,2213,37500,1948,2009,1293,32.6,140,16,449,19,238,921,213
2017,36047116600,"Census Tract 1166, Kings County, New York",1075,111,964,784,2368,38409,1939,2011,1447,38.5,121,13,496,21,252,964,175
2018,36047116600,"Census Tract 1166, Kings County, New York",1091,129,962,764,2242,41795,0,2011,1443,34.9,113,12,492,0,273,962,147
2019,36047116600,"Census Tract 1166, Kings County, New York",1141,124,1017,757,2271,47148,1957,2011,1541,29.6,79,15,444,22,271,1017,142
2020,36047116600,"Census Tract 1166, Kings County, New York",1151,133,1018,753,2133,47574,1976,2012,1563,36.1,51,20,379,26,342,1018,147
2012,36047116800,"Census Tract 1168, Kings County, New York",764,117,647,512,1555,32833,1939,2004,1252,48.5,10,32,199,0,294,647,300
2013,36047116800,"Census Tract 1168, Kings County, New York",744,146,598,490,1320,29500,1939,2006,1221,45.6,46,43,161,26,267,598,230
2014,36047116800,"Census Tract 1168, Kings County, New York",749,188,561,455,1145,21563,1939,2007,1201,33.5,76,17,174,28,249,561,236
2015,36047116800,"Census Tract 1168, Kings County, New York",733,169,564,482,1267,31121,1939,2009,1089,29.7,75,18,205,31,242,564,207
2016,36047116800,"Census Tract 1168, Kings County, New York",728,172,556,469,1092,33229,1939,2009,1127,29.8,77,14,196,25,244,556,189
2017,36047116800,"Census Tract 1168, Kings County, New York",754,160,594,493,1251,51932,1939,2010,1219,31.1,90,17,194,25,267,594,143
2018,36047116800,"Census Tract 1168, Kings County, New York",764,130,634,524,1478,52250,1964,2010,1377,39.1,52,0,188,0,343,634,151
2019,36047116800,"Census Tract 1168, Kings County, New York",782,136,646,477,1288,55938,1957,2010,1571,39.2,37,0,186,0,296,646,124
2020,36047116800,"Census Tract 1168, Kings County, New York",749,78,671,560,1699,46688,0,2008,1629,51,75,0,181,0,387,671,115
2012,36047117000,"Census Tract 1170, Kings County, New York",620,10,610,459,1424,36725,1948,2004,1065,34.4,31,28,195,5,184,610,164
2013,36047117000,"Census Tract 1170, Kings County, New York",613,23,590,468,1486,35761,1949,2005,1143,36.4,26,0,186,13,225,590,171
2014,36047117000,"Census Tract 1170, Kings County, New York",617,40,577,486,1517,35882,1939,2006,1220,39.4,28,0,217,13,231,577,152
2015,36047117000,"Census Tract 1170, Kings County, New York",613,109,504,395,1289,33309,1939,2007,1210,41.2,31,0,157,16,230,504,132
2016,36047117000,"Census Tract 1170, Kings County, New York",603,102,501,409,1473,34844,1939,2010,1377,44.7,24,0,129,21,293,501,108
2017,36047117000,"Census Tract 1170, Kings County, New York",622,123,499,429,1646,35492,1939,2011,1491,47.7,33,0,145,30,299,499,132
2018,36047117000,"Census Tract 1170, Kings County, New York",633,140,493,421,1535,38375,0,2011,1457,48,15,0,142,16,324,493,146
2019,36047117000,"Census Tract 1170, Kings County, New York",638,151,487,414,1531,39444,0,2012,1548,51,14,6,121,15,326,487,155
2020,36047117000,"Census Tract 1170, Kings County, New York",845,114,731,648,1702,15993,0,2016,1719,51,14,6,88,16,591,731,439
2012,36047117201,"Census Tract 1172.01, Kings County, New York",787,86,701,358,1215,43306,1939,2003,1152,37.1,36,44,72,0,257,701,108
2013,36047117201,"Census Tract 1172.01, Kings County, New York",796,84,712,402,1357,47422,1941,2004,1314,36.2,26,22,77,0,322,712,98
2014,36047117201,"Census Tract 1172.01, Kings County, New York",818,65,753,430,1430,45909,1939,2005,1353,38.3,23,19,85,0,337,753,191
2015,36047117201,"Census Tract 1172.01, Kings County, New York",848,91,757,465,1471,47386,1939,2007,1339,36,16,11,111,5,349,757,192
2016,36047117201,"Census Tract 1172.01, Kings County, New York",818,87,731,429,1321,48750,1939,2007,1354,35.6,21,10,85,5,340,731,150
2017,36047117201,"Census Tract 1172.01, Kings County, New York",834,88,746,465,1385,49479,1939,2010,1379,38.3,14,0,108,8,355,746,183
2018,36047117201,"Census Tract 1172.01, Kings County, New York",848,74,774,429,1377,40050,0,2008,1332,37.4,33,0,105,9,312,774,227
2019,36047117201,"Census Tract 1172.01, Kings County, New York",872,77,795,453,1351,43531,0,2008,1292,37.1,48,0,114,9,338,795,202
2020,36047117201,"Census Tract 1172.01, Kings County, New York",814,80,734,370,939,42817,0,2011,1407,39.6,46,0,103,0,275,734,202
2012,36047117202,"Census Tract 1172.02, Kings County, New York",1299,212,1087,708,2019,27054,1939,2005,1244,41.7,0,15,249,0,502,1087,285
2013,36047117202,"Census Tract 1172.02, Kings County, New York",1312,212,1100,769,2233,37303,1939,2005,1283,43,0,16,295,10,518,1100,252
2014,36047117202,"Census Tract 1172.02, Kings County, New York",1318,290,1028,731,2051,39601,1939,2006,1317,39,15,13,296,16,446,1028,188
2015,36047117202,"Census Tract 1172.02, Kings County, New York",1383,294,1089,784,2137,46818,1939,2008,1293,28,49,14,334,18,477,1089,162
2016,36047117202,"Census Tract 1172.02, Kings County, New York",1341,298,1043,723,1938,46736,1939,2008,1336,31.2,56,0,271,19,464,1043,111
2017,36047117202,"Census Tract 1172.02, Kings County, New York",1360,207,1153,780,2074,49250,1939,2009,1381,31.9,55,0,298,28,480,1153,122
2018,36047117202,"Census Tract 1172.02, Kings County, New York",1396,165,1231,776,2116,48889,0,2011,1349,32,88,10,293,18,460,1231,164
2019,36047117202,"Census Tract 1172.02, Kings County, New York",1431,109,1322,866,2382,48581,0,2013,1327,31,99,19,229,25,597,1322,153
2020,36047117202,"Census Tract 1172.02, Kings County, New York",1570,85,1485,881,1926,32142,0,2015,1610,40.1,99,9,364,23,619,1485,175
2012,36047117400,"Census Tract 1174, Kings County, New York",1331,187,1144,878,3184,42500,1939,2004,1383,33.3,123,38,208,27,614,1144,239
2013,36047117400,"Census Tract 1174, Kings County, New York",1361,280,1081,798,2804,43897,1939,2004,1423,34.9,117,40,175,32,581,1081,243
2014,36047117400,"Census Tract 1174, Kings County, New York",1416,324,1092,764,2813,43629,1939,2004,1458,35.5,82,34,155,23,583,1092,266
2015,36047117400,"Census Tract 1174, Kings County, New York",1408,317,1091,707,2821,48159,1939,2007,1521,36.4,96,33,118,27,563,1091,216
2016,36047117400,"Census Tract 1174, Kings County, New York",1408,301,1107,743,3098,47592,1939,2009,1523,34.1,37,7,191,32,555,1107,261
2017,36047117400,"Census Tract 1174, Kings County, New York",1434,295,1139,782,3135,51220,1939,2010,1511,32.1,0,0,262,9,551,1139,260
2018,36047117400,"Census Tract 1174, Kings County, New York",1452,269,1183,856,3235,50612,0,2010,1594,32,15,0,248,10,610,1183,332
2019,36047117400,"Census Tract 1174, Kings County, New York",1464,331,1133,792,2851,55549,0,2010,1678,31.5,30,0,196,10,598,1133,257
2020,36047117400,"Census Tract 1174, Kings County, New York",1619,334,1285,1066,3079,47596,0,2005,1691,28.1,179,0,320,4,673,1285,231
2012,36047117601,"Census Tract 1176.01, Kings County, New York",953,97,856,639,2331,36756,1939,2004,1320,38,36,8,128,0,537,856,265
2013,36047117601,"Census Tract 1176.01, Kings County, New York",937,120,817,591,2150,42050,1939,2004,1356,36.7,40,12,165,0,444,817,218
2014,36047117601,"Census Tract 1176.01, Kings County, New York",949,107,842,615,2149,42724,1939,2004,1362,37.6,44,13,176,3,451,842,211
2015,36047117601,"Census Tract 1176.01, Kings County, New York",958,125,833,631,2251,43477,1939,2006,1332,34.7,58,27,158,4,470,833,205
2016,36047117601,"Census Tract 1176.01, Kings County, New York",949,73,876,646,2252,45611,1939,2010,1335,35.8,53,26,202,5,463,876,230
2017,36047117601,"Census Tract 1176.01, Kings County, New York",976,83,893,671,2221,45642,1939,2011,1289,35.1,67,52,225,17,438,893,219
2018,36047117601,"Census Tract 1176.01, Kings County, New York",1000,58,942,694,2284,49182,0,2012,1342,32.3,53,62,216,32,449,942,187
2019,36047117601,"Census Tract 1176.01, Kings County, New York",1019,58,961,711,2272,48315,0,2013,1382,32.6,54,61,231,24,488,961,205
2020,36047117601,"Census Tract 1176.01, Kings County, New York",1096,46,1050,743,2174,50394,0,2014,1541,37.2,41,47,259,25,506,1050,164
2012,36047117602,"Census Tract 1176.02, Kings County, New York",1108,121,987,805,2585,30861,1939,2003,1186,44,82,99,263,27,488,987,331
2013,36047117602,"Census Tract 1176.02, Kings County, New York",1108,192,916,747,2150,30382,1939,2003,1158,30,70,98,238,35,436,916,374
2014,36047117602,"Census Tract 1176.02, Kings County, New York",1135,209,926,732,2183,27500,1939,2006,1180,37.1,42,33,242,33,469,926,366
2015,36047117602,"Census Tract 1176.02, Kings County, New York",1131,184,947,762,2080,25221,1939,2006,1101,35.6,52,49,265,28,455,947,392
2016,36047117602,"Census Tract 1176.02, Kings County, New York",1131,174,957,684,2070,31923,1939,2009,1142,32.9,33,21,221,28,415,957,356
2017,36047117602,"Census Tract 1176.02, Kings County, New York",1124,171,953,628,2040,40726,1939,2011,1165,33.6,23,27,192,19,389,953,303
2018,36047117602,"Census Tract 1176.02, Kings County, New York",1171,158,1013,673,2087,39183,0,2011,1317,38.5,47,31,180,11,405,1013,294
2019,36047117602,"Census Tract 1176.02, Kings County, New York",1168,193,975,648,1919,44009,0,2011,1319,33.8,47,46,140,20,416,975,279
2020,36047117602,"Census Tract 1176.02, Kings County, New York",1111,201,910,564,1609,50938,0,2013,1414,31,69,47,119,21,346,910,181
2012,36047117800,"Census Tract 1178, Kings County, New York",527,101,426,322,1102,30000,1939,2004,1209,38,26,15,130,11,167,426,129
2013,36047117800,"Census Tract 1178, Kings County, New York",533,121,412,313,940,34750,1939,2005,1259,35.9,22,27,109,22,147,412,125
2014,36047117800,"Census Tract 1178, Kings County, New York",560,83,477,382,1296,33750,1939,2005,1240,37.2,53,14,145,36,202,477,167
2015,36047117800,"Census Tract 1178, Kings County, New York",574,80,494,384,1200,35152,1939,2006,1226,36.1,48,16,134,42,222,494,144
2016,36047117800,"Census Tract 1178, Kings County, New York",576,69,507,375,1194,43523,1939,2008,1324,33.6,16,3,99,55,236,507,143
2017,36047117800,"Census Tract 1178, Kings County, New York",572,87,485,339,1120,43875,1939,2009,1338,33.8,19,0,107,60,200,485,138
2018,36047117800,"Census Tract 1178, Kings County, New York",573,92,481,332,1148,45547,0,2009,1386,34,15,4,92,58,204,481,135
2019,36047117800,"Census Tract 1178, Kings County, New York",584,97,487,322,945,36324,0,2011,1387,42.1,13,3,93,48,180,487,145
2020,36047117800,"Census Tract 1178, Kings County, New York",611,88,523,342,1065,29418,0,2014,1299,32,13,8,74,48,218,523,171
2012,36047118000,"Census Tract 1180, Kings County, New York",0,0,0,0,0,NA,NA,NA,NA,NA,0,0,0,0,0,0,0
2013,36047118000,"Census Tract 1180, Kings County, New York",0,0,0,0,0,NA,NA,NA,NA,NA,0,0,0,0,0,0,0
2014,36047118000,"Census Tract 1180, Kings County, New York",0,0,0,0,0,NA,NA,NA,NA,NA,0,0,0,0,0,0,0
2015,36047118000,"Census Tract 1180, Kings County, New York",0,0,0,0,0,NA,NA,NA,NA,NA,0,0,0,0,0,0,0
2016,36047118000,"Census Tract 1180, Kings County, New York",0,0,0,0,0,NA,NA,NA,NA,NA,0,0,0,0,0,0,0
2017,36047118000,"Census Tract 1180, Kings County, New York",0,0,0,0,0,NA,NA,NA,NA,NA,0,0,0,0,0,0,0
2018,36047118000,"Census Tract 1180, Kings County, New York",0,0,0,0,0,NA,NA,NA,NA,NA,0,0,0,0,0,0,0
2019,36047118000,"Census Tract 1180, Kings County, New York",0,0,0,0,0,NA,NA,NA,NA,NA,0,0,0,0,0,0,0
2020,36047118000,"Census Tract 1180, Kings County, New York",0,0,0,0,0,NA,NA,NA,NA,NA,0,0,0,0,0,0,0
2012,36047118201,"Census Tract 1182.01, Kings County, New York",1016,149,867,654,2204,35278,1939,2005,1374,44.2,23,0,123,11,534,867,235
2013,36047118201,"Census Tract 1182.01, Kings County, New York",1025,147,878,691,2239,31250,1939,2005,1318,43.6,26,21,167,5,516,878,303
2014,36047118201,"Census Tract 1182.01, Kings County, New York",1033,153,880,671,2117,30662,1939,2006,1231,40.1,57,30,205,9,455,880,297
2015,36047118201,"Census Tract 1182.01, Kings County, New York",1035,152,883,680,2115,40616,1939,2008,1264,36.9,66,35,172,18,479,883,193
2016,36047118201,"Census Tract 1182.01, Kings County, New York",1002,130,872,601,1803,34837,1939,2010,1144,30.8,72,40,188,0,418,872,203
2017,36047118201,"Census Tract 1182.01, Kings County, New York",1011,112,899,631,1807,36402,1939,2011,1076,28.9,74,66,198,0,411,899,221
2018,36047118201,"Census Tract 1182.01, Kings County, New York",1039,132,907,585,1596,40993,0,2012,1271,29.7,87,46,140,0,425,907,150
2019,36047118201,"Census Tract 1182.01, Kings County, New York",1053,126,927,618,1769,50556,0,2013,1333,28.2,118,34,187,13,411,927,156
2020,36047118201,"Census Tract 1182.01, Kings County, New York",1044,111,933,691,2017,58563,0,2014,1569,29.5,141,24,180,14,501,933,183
2012,36047118202,"Census Tract 1182.02, Kings County, New York",1029,157,872,568,1712,23438,1939,2004,1166,47.6,43,39,138,35,392,872,333
2013,36047118202,"Census Tract 1182.02, Kings County, New York",1052,175,877,505,1542,26550,1939,2005,1288,34.7,58,39,148,14,368,877,332
2014,36047118202,"Census Tract 1182.02, Kings County, New York",1072,209,863,514,1588,28750,1939,2004,1238,35,74,43,144,12,386,863,292
2015,36047118202,"Census Tract 1182.02, Kings County, New York",1084,202,882,520,1648,41304,1939,2007,1401,35.3,46,21,149,14,432,882,266
2016,36047118202,"Census Tract 1182.02, Kings County, New York",1083,139,944,567,1854,40288,1939,2008,1389,34.7,58,23,170,16,439,944,260
2017,36047118202,"Census Tract 1182.02, Kings County, New York",1105,158,947,543,1830,40284,1939,2008,1449,36.2,53,6,188,0,435,947,226
2018,36047118202,"Census Tract 1182.02, Kings County, New York",1103,219,884,560,1845,44103,0,2009,1434,32.9,46,6,200,0,402,884,127
2019,36047118202,"Census Tract 1182.02, Kings County, New York",1103,181,922,598,1969,42206,0,2010,1447,33.7,36,13,174,0,437,922,156
2020,36047118202,"Census Tract 1182.02, Kings County, New York",1154,153,1001,632,2047,37258,0,2009,1648,31,37,15,198,0,416,1001,208
2012,36047118400,"Census Tract 1184, Kings County, New York",1684,344,1340,809,2906,30240,1939,2004,1233,40.8,98,100,95,40,592,1340,314
2013,36047118400,"Census Tract 1184, Kings County, New York",1735,407,1328,785,2895,24821,1939,2006,1306,43.2,54,87,162,50,521,1328,375
2014,36047118400,"Census Tract 1184, Kings County, New York",1776,419,1357,818,3049,36029,1939,2007,1251,38.9,47,80,177,83,541,1357,326
2015,36047118400,"Census Tract 1184, Kings County, New York",1803,391,1412,826,3246,36500,1939,2010,1362,38.5,69,66,186,62,590,1412,349
2016,36047118400,"Census Tract 1184, Kings County, New York",1789,335,1454,886,3368,31809,1939,2011,1403,41.4,69,45,198,71,625,1454,352
2017,36047118400,"Census Tract 1184, Kings County, New York",1819,365,1454,863,3130,32750,1939,2011,1455,40.4,99,54,205,75,593,1454,372
2018,36047118400,"Census Tract 1184, Kings County, New York",1833,325,1508,999,3196,37448,0,2011,1490,31.9,157,62,247,87,661,1508,410
2019,36047118400,"Census Tract 1184, Kings County, New York",1848,304,1544,975,2921,36326,0,2012,1548,37.9,152,59,260,56,677,1544,404
2020,36047118400,"Census Tract 1184, Kings County, New York",1809,306,1503,1051,3058,45121,0,2012,1622,37.4,203,137,328,67,663,1503,305
2012,36047118600,"Census Tract 1186, Kings County, New York",1002,200,802,472,1771,37727,1939,2004,1272,39.4,44,45,115,4,286,802,202
2013,36047118600,"Census Tract 1186, Kings County, New York",964,208,756,458,1833,36627,1942,2004,1298,39.8,33,28,120,20,286,756,234
2014,36047118600,"Census Tract 1186, Kings County, New York",972,233,739,485,1896,35727,1939,2005,1320,40.9,45,41,144,20,303,739,247
2015,36047118600,"Census Tract 1186, Kings County, New York",996,256,740,477,1732,31705,1954,2007,1282,45.7,26,38,135,26,290,740,248
2016,36047118600,"Census Tract 1186, Kings County, New York",992,282,710,483,1548,32438,1956,2009,1299,42.1,32,37,140,22,314,710,232
2017,36047118600,"Census Tract 1186, Kings County, New York",991,249,742,425,1469,37266,1958,2010,1379,43.9,15,43,145,15,253,742,210
2018,36047118600,"Census Tract 1186, Kings County, New York",1011,224,787,450,1420,35700,1952,2010,1497,43.9,24,34,123,6,311,787,187
2019,36047118600,"Census Tract 1186, Kings County, New York",1024,215,809,443,1521,48346,1950,2010,1376,32.7,14,42,91,21,289,809,143
2020,36047118600,"Census Tract 1186, Kings County, New York",933,184,749,350,1318,49662,0,2009,1483,28.9,36,43,85,21,192,749,84
2012,36047118800,"Census Tract 1188, Kings County, New York",1379,243,1136,836,2832,23105,1939,2004,1146,46.1,73,55,406,59,290,1136,532
2013,36047118800,"Census Tract 1188, Kings County, New York",1403,229,1174,899,3327,24256,1939,2004,1131,37.2,50,37,469,71,291,1174,498
2014,36047118800,"Census Tract 1188, Kings County, New York",1433,240,1193,954,3604,23971,1939,2005,1136,37.4,80,35,538,74,299,1193,524
2015,36047118800,"Census Tract 1188, Kings County, New York",1482,223,1259,1017,3748,25182,1939,2006,1170,37.7,149,50,577,82,301,1259,489
2016,36047118800,"Census Tract 1188, Kings County, New York",1514,166,1348,1058,3603,31231,1939,2008,1216,29.5,196,22,592,103,364,1348,414
2017,36047118800,"Census Tract 1188, Kings County, New York",1501,100,1401,1096,3742,41023,1939,2009,1270,28,233,20,570,147,372,1401,376
2018,36047118800,"Census Tract 1188, Kings County, New York",1500,108,1392,1043,3276,31722,0,2011,1356,28.6,276,56,471,169,386,1392,388
2019,36047118800,"Census Tract 1188, Kings County, New York",1474,112,1362,983,3072,32138,0,2012,1358,28.4,226,74,433,188,312,1362,351
2020,36047118800,"Census Tract 1188, Kings County, New York",1562,134,1428,1041,3172,38750,0,2012,1339,29.5,378,59,420,336,274,1428,446
2012,36047119000,"Census Tract 1190, Kings County, New York",739,61,678,428,1612,19844,1939,2005,1268,41.9,0,30,149,14,211,678,248
2013,36047119000,"Census Tract 1190, Kings County, New York",727,41,686,486,1764,14539,1939,2005,1359,49.4,15,30,151,28,254,686,304
2014,36047119000,"Census Tract 1190, Kings County, New York",744,63,681,478,1812,24044,1939,2007,1358,42.4,12,39,199,0,211,681,308
2015,36047119000,"Census Tract 1190, Kings County, New York",741,41,700,487,1784,24240,1939,2008,1330,43.9,27,12,206,20,216,700,296
2016,36047119000,"Census Tract 1190, Kings County, New York",741,47,694,518,1830,26250,1939,2010,1382,47,34,13,239,20,230,694,273
2017,36047119000,"Census Tract 1190, Kings County, New York",756,45,711,537,1920,26771,1939,2011,1523,50,59,13,270,21,225,711,265
2018,36047119000,"Census Tract 1190, Kings County, New York",757,64,693,499,1782,27289,1941,2012,1470,48.8,38,10,286,22,206,693,216
2019,36047119000,"Census Tract 1190, Kings County, New York",766,78,688,483,1590,27250,1950,2013,1580,46.8,65,11,246,24,222,688,186
2020,36047119000,"Census Tract 1190, Kings County, New York",887,101,786,579,1693,NA,1940,2014,1373,51,131,13,270,6,300,786,233
2012,36047119200,"Census Tract 1192, Kings County, New York",1224,361,863,638,2196,28500,1946,2003,1311,46,30,8,322,0,349,863,396
2013,36047119200,"Census Tract 1192, Kings County, New York",1304,265,1039,751,2593,30078,1951,2006,1381,48.3,79,41,302,15,458,1039,417
2014,36047119200,"Census Tract 1192, Kings County, New York",1294,341,953,737,2382,28317,1962,2006,1343,49,59,27,356,17,393,953,453
2015,36047119200,"Census Tract 1192, Kings County, New York",1328,314,1014,742,2317,38841,1960,2007,1307,34.3,89,29,324,19,396,1014,332
2016,36047119200,"Census Tract 1192, Kings County, New York",1340,303,1037,789,2423,36936,1953,2009,1284,37,82,29,330,20,425,1037,321
2017,36047119200,"Census Tract 1192, Kings County, New York",1362,289,1073,827,2329,30815,1957,2011,1309,39.1,74,30,354,20,435,1073,351
2018,36047119200,"Census Tract 1192, Kings County, New York",1360,363,997,733,2053,31487,1961,2011,1261,34.5,75,0,370,8,345,997,306
2019,36047119200,"Census Tract 1192, Kings County, New York",1409,289,1120,818,2161,30732,1966,2012,1372,36.3,72,0,419,9,365,1120,340
2020,36047119200,"Census Tract 1192, Kings County, New York",1376,279,1097,782,2058,28667,1972,2013,1294,51,73,0,411,10,344,1097,380
2012,36047119400,"Census Tract 1194, Kings County, New York",1497,297,1200,805,2360,20592,1945,2004,1113,50,27,0,560,0,293,1200,359
2013,36047119400,"Census Tract 1194, Kings County, New York",1468,339,1129,741,2436,21148,1946,2004,1106,50,29,0,528,0,253,1129,335
2014,36047119400,"Census Tract 1194, Kings County, New York",1501,383,1118,709,2372,23420,1943,2008,1164,48.2,40,0,551,0,167,1118,309
2015,36047119400,"Census Tract 1194, Kings County, New York",1525,423,1102,731,2371,23767,1953,2011,1158,50,27,0,529,16,198,1102,252
2016,36047119400,"Census Tract 1194, Kings County, New York",1510,338,1172,780,2673,24640,1939,2011,1260,50,51,15,556,15,218,1172,348
2017,36047119400,"Census Tract 1194, Kings County, New York",1466,279,1187,868,3290,28800,1939,2012,1368,35.7,38,14,579,21,283,1187,389
2018,36047119400,"Census Tract 1194, Kings County, New York",1527,229,1298,938,3445,31724,0,2013,1394,35.6,64,43,608,20,303,1298,360
2019,36047119400,"Census Tract 1194, Kings County, New York",1567,229,1338,921,3625,41947,0,2013,1452,36.2,66,42,616,14,288,1338,395
2020,36047119400,"Census Tract 1194, Kings County, New York",1549,155,1394,1039,4200,42067,0,2013,1551,38.1,68,44,703,21,251,1394,440
2012,36047119600,"Census Tract 1196, Kings County, New York",1913,373,1540,1213,3850,25271,1939,2004,1164,50,119,35,691,116,327,1540,509
2013,36047119600,"Census Tract 1196, Kings County, New York",1974,389,1585,1218,3657,26116,1939,2004,1164,46.6,74,45,737,110,286,1585,500
2014,36047119600,"Census Tract 1196, Kings County, New York",2062,404,1658,1288,3693,26814,1939,2006,1170,49.1,84,26,841,138,251,1658,471
2015,36047119600,"Census Tract 1196, Kings County, New York",2117,379,1738,1322,3413,26295,1939,2006,1114,47.4,66,9,813,165,302,1738,471
2016,36047119600,"Census Tract 1196, Kings County, New York",2135,273,1862,1379,3420,22831,1939,2007,1112,50,78,14,817,180,335,1862,518
2017,36047119600,"Census Tract 1196, Kings County, New York",2131,352,1779,1292,3229,26016,1939,2010,1134,47.7,108,13,689,190,356,1779,501
2018,36047119600,"Census Tract 1196, Kings County, New York",2150,396,1754,1266,3317,32250,0,2011,1221,44.5,114,17,662,177,389,1754,447
2019,36047119600,"Census Tract 1196, Kings County, New York",2198,385,1813,1338,3388,37279,1951,2013,1289,38,117,61,692,138,449,1813,445
2020,36047119600,"Census Tract 1196, Kings County, New York",2292,351,1941,1542,3491,40943,1954,2013,1435,37.1,176,61,597,95,724,1941,526
2012,36047119800,"Census Tract 1198, Kings County, New York",1088,51,1037,884,2414,33750,1939,2004,1162,33.4,78,5,345,22,531,1037,320
2013,36047119800,"Census Tract 1198, Kings County, New York",985,52,933,713,2117,20694,1939,2005,1149,50,71,6,339,0,389,933,347
2014,36047119800,"Census Tract 1198, Kings County, New York",1042,53,989,824,2285,28750,1948,2006,1219,36.6,131,5,396,0,479,989,284
2015,36047119800,"Census Tract 1198, Kings County, New York",1135,80,1055,922,2856,28986,1945,2008,1277,46.2,118,4,414,0,544,1055,363
2016,36047119800,"Census Tract 1198, Kings County, New York",1111,125,986,874,2575,22714,1941,2010,1448,50,95,0,395,0,498,986,449
2017,36047119800,"Census Tract 1198, Kings County, New York",1114,109,1005,818,2277,22674,1939,2011,1533,50,84,0,427,0,442,1005,452
2018,36047119800,"Census Tract 1198, Kings County, New York",1183,171,1012,872,2121,28910,1941,2012,1757,51,100,5,478,0,441,1012,403
2019,36047119800,"Census Tract 1198, Kings County, New York",1223,118,1105,888,2283,33542,0,2012,1787,49.4,100,8,462,0,469,1105,414
2020,36047119800,"Census Tract 1198, Kings County, New York",1185,121,1064,812,1841,34531,0,2013,1937,51,89,7,418,0,466,1064,389
2012,36047120000,"Census Tract 1200, Kings County, New York",697,71,626,386,1126,27583,1939,2004,1282,49.2,44,24,219,55,107,626,164
2013,36047120000,"Census Tract 1200, Kings County, New York",681,110,571,406,1276,24444,1939,2005,1328,50,30,17,204,52,159,571,196
2014,36047120000,"Census Tract 1200, Kings County, New York",739,138,601,441,1330,25906,1959,2006,1224,50,36,35,207,40,177,601,191
2015,36047120000,"Census Tract 1200, Kings County, New York",747,141,606,471,1453,31307,1954,2006,1146,39.8,40,16,307,46,130,606,143
2016,36047120000,"Census Tract 1200, Kings County, New York",791,135,656,502,1550,30672,1962,2009,1191,44,32,4,345,65,121,656,178
2017,36047120000,"Census Tract 1200, Kings County, New York",822,86,736,585,1792,30951,1962,2011,1189,46.3,27,5,395,65,157,736,189
2018,36047120000,"Census Tract 1200, Kings County, New York",861,63,798,605,1800,31182,1965,2011,1252,45.7,26,5,405,62,167,798,168
2019,36047120000,"Census Tract 1200, Kings County, New York",874,97,777,575,1581,33092,1967,2012,1211,41.5,34,0,388,56,169,777,162
2020,36047120000,"Census Tract 1200, Kings County, New York",928,103,825,586,1562,34667,1970,2014,1344,44.7,52,0,367,107,129,825,150
2012,36047120200,"Census Tract 1202, Kings County, New York",545,9,536,317,1082,38625,1939,2003,1485,47.6,33,12,136,53,72,536,108
2013,36047120200,"Census Tract 1202, Kings County, New York",568,35,533,262,969,16696,1944,2003,1440,50,9,0,86,37,125,533,169
2014,36047120200,"Census Tract 1202, Kings County, New York",592,58,534,258,941,30750,1948,2003,1415,47.2,26,0,119,35,90,534,136
2015,36047120200,"Census Tract 1202, Kings County, New York",592,70,522,265,954,41902,1954,2005,1437,43.1,32,0,114,33,104,522,134
2016,36047120200,"Census Tract 1202, Kings County, New York",583,62,521,302,1062,27794,1950,2007,1439,50,33,0,155,70,62,521,170
2017,36047120200,"Census Tract 1202, Kings County, New York",589,62,527,339,1169,22276,1955,2010,1396,50,34,0,202,55,82,527,194
2018,36047120200,"Census Tract 1202, Kings County, New York",606,31,575,398,1331,35100,1955,2011,1408,46.5,30,0,298,65,35,575,164
2019,36047120200,"Census Tract 1202, Kings County, New York",606,21,585,406,1178,31857,1954,2012,1411,51,16,7,268,81,50,585,169
2020,36047120200,"Census Tract 1202, Kings County, New York",615,31,584,340,1095,31184,1952,2011,1415,51,6,6,197,106,31,584,166
2012,36047120800,"Census Tract 1208, Kings County, New York",3480,344,3136,2484,6456,31054,1969,2002,1053,36.5,206,1,2136,0,389,3136,755
2013,36047120800,"Census Tract 1208, Kings County, New York",3533,432,3101,2521,6290,31891,1969,2002,1088,37.8,257,46,2102,0,440,3101,741
2014,36047120800,"Census Tract 1208, Kings County, New York",3647,566,3081,2483,6394,31172,1970,2002,1075,38.1,288,48,2123,0,376,3081,817
2015,36047120800,"Census Tract 1208, Kings County, New York",3731,644,3087,2446,6291,30804,1970,2003,1088,38.7,386,49,2211,0,236,3087,801
2016,36047120800,"Census Tract 1208, Kings County, New York",3813,656,3157,2553,6586,32380,1969,2005,1136,35.7,477,76,2312,0,217,3157,749
2017,36047120800,"Census Tract 1208, Kings County, New York",3858,544,3314,2723,6688,33212,1971,2005,1283,39.7,528,103,2396,0,190,3314,829
2018,36047120800,"Census Tract 1208, Kings County, New York",3892,465,3427,2800,6985,32220,1972,2008,1312,37.3,566,66,2433,0,286,3427,811
2019,36047120800,"Census Tract 1208, Kings County, New York",3981,400,3581,2763,6677,32108,1972,2008,1374,37.7,497,66,2343,0,367,3581,716
2020,36047120801,"Census Tract 1208.01, Kings County, New York",1625,203,1422,772,2359,66635,0,2008,1786,28.2,140,0,725,0,109,1422,201
2020,36047120802,"Census Tract 1208.02, Kings County, New York",1752,85,1667,1632,3932,29161,1971,2009,1316,40.3,316,0,1401,0,217,1667,418
2020,36047120803,"Census Tract 1208.03, Kings County, New York",656,50,606,407,1009,NA,1975,2016,1348,40.7,147,116,218,0,73,606,129
2012,36047121000,"Census Tract 1210, Kings County, New York",1547,23,1524,1510,4452,15036,1954,2000,486,28.6,57,80,784,20,682,1524,854
2013,36047121000,"Census Tract 1210, Kings County, New York",1536,47,1489,1474,4165,15856,1954,2001,510,28,40,70,818,19,605,1489,852
2014,36047121000,"Census Tract 1210, Kings County, New York",1547,38,1509,1487,4277,16671,1956,2001,580,26.5,19,63,815,11,672,1509,778
2015,36047121000,"Census Tract 1210, Kings County, New York",1574,48,1526,1526,4258,17139,1956,2000,572,27,71,19,892,0,706,1526,771
2016,36047121000,"Census Tract 1210, Kings County, New York",1588,74,1514,1514,4157,18777,1956,2002,533,28.5,91,17,862,2,721,1514,711
2017,36047121000,"Census Tract 1210, Kings County, New York",1596,71,1525,1525,4299,20099,1956,2003,525,27.8,88,0,958,7,652,1525,632
2018,36047121000,"Census Tract 1210, Kings County, New York",1610,61,1549,1549,4110,15566,1955,2003,424,31.4,132,0,970,11,672,1549,723
2019,36047121000,"Census Tract 1210, Kings County, New York",1622,64,1558,1558,4196,15833,1955,2004,447,31.9,164,0,985,14,626,1558,775
2020,36047121000,"Census Tract 1210, Kings County, New York",1666,37,1629,1629,4203,12470,1954,2005,394,32.3,111,0,923,13,749,1629,918
2012,36047121400,"Census Tract 1214, Kings County, New York",1568,63,1505,1505,4141,17123,1955,2001,428,25.7,21,19,974,0,518,1505,729
2013,36047121400,"Census Tract 1214, Kings County, New York",1550,49,1501,1501,4202,17669,1956,2001,438,26,35,23,1018,0,467,1501,683
2014,36047121400,"Census Tract 1214, Kings County, New York",1575,14,1561,1561,4306,17839,1957,2002,422,26.8,71,48,1037,0,509,1561,725
2015,36047121400,"Census Tract 1214, Kings County, New York",1615,14,1601,1601,4465,19264,1957,2003,436,27.4,90,21,1103,0,557,1601,791
2016,36047121400,"Census Tract 1214, Kings County, New York",1643,0,1643,1643,4608,21285,1956,2004,498,26.3,93,25,1127,0,572,1643,744
2017,36047121400,"Census Tract 1214, Kings County, New York",1659,0,1659,1659,4851,20601,1956,2006,455,30.3,89,24,1113,0,604,1659,770
2018,36047121400,"Census Tract 1214, Kings County, New York",1674,0,1674,1674,4716,21085,1956,2006,466,29.5,70,30,1134,0,618,1674,844
2019,36047121400,"Census Tract 1214, Kings County, New York",1710,0,1710,1710,4820,18457,1957,2007,456,31.4,48,0,1115,0,673,1710,928
2020,36047121400,"Census Tract 1214, Kings County, New York",1656,17,1639,1639,4342,20154,1958,2006,410,27.6,39,0,1053,0,622,1639,823
2012,36047122000,"Census Tract 1220, Kings County, New York",2231,311,1920,1567,3882,38399,1993,2005,1133,34.8,178,11,1397,0,215,1920,429
2013,36047122000,"Census Tract 1220, Kings County, New York",2319,257,2062,1684,4146,31071,1995,2006,1125,36.4,145,13,1423,0,293,2062,599
2014,36047122000,"Census Tract 1220, Kings County, New York",2358,313,2045,1720,4278,29845,1995,2007,1139,35.2,170,0,1527,0,265,2045,607
2015,36047122000,"Census Tract 1220, Kings County, New York",2348,238,2110,1729,4280,33724,1995,2010,1184,34.8,329,0,1508,0,275,2110,530
2016,36047122000,"Census Tract 1220, Kings County, New York",2366,190,2176,1731,4544,38491,2001,2010,1240,37.7,390,0,1482,0,317,2176,513
2017,36047122000,"Census Tract 1220, Kings County, New York",2346,183,2163,1708,4618,40485,2001,2011,1241,39,382,42,1394,0,331,2163,493
2018,36047122000,"Census Tract 1220, Kings County, New York",2341,227,2114,1768,4547,35852,1995,2011,1330,45.4,396,26,1504,0,303,2114,534
2019,36047122000,"Census Tract 1220, Kings County, New York",2433,203,2230,1889,4981,35359,1990,2011,1283,45.5,409,24,1583,0,284,2230,561
2020,36047122000,"Census Tract 1220, Kings County, New York",2343,162,2181,1830,5002,42279,1986,2011,1232,39.8,268,26,1636,0,199,2181,470
2012,36047123700,"Census Tract 1237, Kings County, New York",1373,164,1209,981,5182,27311,1999,NA,1373,50,112,659,77,0,232,1209,552
2013,36047123700,"Census Tract 1237, Kings County, New York",1400,142,1258,1062,5778,28849,1995,2005,1344,46.8,128,717,94,0,237,1258,599
2014,36047123700,"Census Tract 1237, Kings County, New York",1434,152,1282,1077,5391,26893,2000,2006,1338,50,162,720,108,0,222,1282,624
2015,36047123700,"Census Tract 1237, Kings County, New York",1411,97,1314,1116,5394,23958,1993,2007,1399,50,208,780,105,0,206,1314,696
2016,36047123700,"Census Tract 1237, Kings County, New York",1414,121,1293,1132,5612,25932,2001,2008,1549,50,255,847,93,0,171,1293,687
2017,36047123700,"Census Tract 1237, Kings County, New York",1427,148,1279,1106,5367,29631,1980,2010,1581,50,254,764,95,0,234,1279,611
2018,36047123700,"Census Tract 1237, Kings County, New York",1392,197,1195,997,5155,30677,2000,2010,1718,51,289,735,75,0,163,1195,564
2019,36047123700,"Census Tract 1237, Kings County, New York",1507,258,1249,961,5099,38090,2000,2011,1944,47.2,266,720,85,0,142,1249,514
2020,36047123700,"Census Tract 1237, Kings County, New York",1405,234,1171,912,5460,37143,2003,2010,1902,51,187,726,42,0,129,1171,559
2012,36047150200,"Census Tract 1502, Kings County, New York",1160,48,1112,535,1164,76250,1939,2004,1590,28,269,412,33,35,55,1112,15
2013,36047150200,"Census Tract 1502, Kings County, New York",1153,64,1089,535,1222,77083,1939,2005,1696,28.1,329,363,12,68,60,1089,33
2014,36047150200,"Census Tract 1502, Kings County, New York",1148,65,1083,497,1170,79440,1939,2007,1753,28.5,325,355,0,38,71,1083,27
2015,36047150200,"Census Tract 1502, Kings County, New York",1124,63,1061,519,1254,77933,1939,2010,1737,27.8,334,347,8,31,98,1061,81
2016,36047150200,"Census Tract 1502, Kings County, New York",1099,96,1003,489,1255,81639,1939,2012,1830,23.8,352,347,8,37,54,1003,87
2017,36047150200,"Census Tract 1502, Kings County, New York",1078,71,1007,466,1254,85764,1939,2012,1944,23.1,338,327,10,38,59,1007,117
2018,36047150200,"Census Tract 1502, Kings County, New York",1067,60,1007,491,1279,101083,0,2013,2167,22.4,367,403,10,9,61,1007,119
2019,36047150200,"Census Tract 1502, Kings County, New York",1061,63,998,512,1292,110000,1951,2013,2128,21.3,405,414,10,9,72,998,122
2020,36047150200,"Census Tract 1502, Kings County, New York",1040,76,964,411,1178,130066,1951,2015,2628,21.7,360,359,0,8,36,964,38
2012,36047152200,"Census Tract 1522, Kings County, New York",1157,91,1066,400,971,60083,1939,2001,1397,35.7,134,91,125,110,41,1066,138
2013,36047152200,"Census Tract 1522, Kings County, New York",1116,82,1034,388,1087,65833,1947,2003,1482,34.4,186,119,86,107,38,1034,126
2014,36047152200,"Census Tract 1522, Kings County, New York",1106,28,1078,412,1259,72500,1942,2004,1472,32.9,167,139,21,167,24,1078,158
2015,36047152200,"Census Tract 1522, Kings County, New York",1109,31,1078,455,1396,61635,1942,2006,1614,36.8,243,146,44,111,119,1078,166
2016,36047152200,"Census Tract 1522, Kings County, New York",1094,30,1064,430,1408,54423,1939,2006,1532,38.2,215,146,26,129,102,1064,176
2017,36047152200,"Census Tract 1522, Kings County, New York",1120,30,1090,405,1322,63272,1940,2009,1710,37.4,257,126,36,116,119,1090,152
2018,36047152200,"Census Tract 1522, Kings County, New York",1114,28,1086,417,1265,70625,0,2009,1728,33.7,262,147,65,87,134,1086,134
2019,36047152200,"Census Tract 1522, Kings County, New York",1152,45,1107,402,1169,72778,0,2010,1782,28.2,254,142,89,51,125,1107,112
2020,36047152200,"Census Tract 1522, Kings County, New York",1201,27,1174,382,901,80400,0,2012,1971,24.9,227,198,118,28,55,1174,43
2012,36047990100,"Census Tract 9901, Kings County, New York",0,0,0,0,0,NA,NA,NA,NA,NA,0,0,0,0,0,0,0
2013,36047990100,"Census Tract 9901, Kings County, New York",0,0,0,0,0,NA,NA,NA,NA,NA,0,0,0,0,0,0,0
2014,36047990100,"Census Tract 9901, Kings County, New York",0,0,0,0,0,NA,NA,NA,NA,NA,0,0,0,0,0,0,0
2015,36047990100,"Census Tract 9901, Kings County, New York",0,0,0,0,0,NA,NA,NA,NA,NA,0,0,0,0,0,0,0
2016,36047990100,"Census Tract 9901, Kings County, New York",0,0,0,0,0,NA,NA,NA,NA,NA,0,0,0,0,0,0,0
2017,36047990100,"Census Tract 9901, Kings County, New York",0,0,0,0,0,NA,NA,NA,NA,NA,0,0,0,0,0,0,0
2018,36047990100,"Census Tract 9901, Kings County, New York",0,0,0,0,0,NA,NA,NA,NA,NA,0,0,0,0,0,0,0
2019,36047990100,"Census Tract 9901, Kings County, New York",0,0,0,0,0,NA,NA,NA,NA,NA,0,0,0,0,0,0,0
2020,36047990100,"Census Tract 9901, Kings County, New York",0,0,0,0,0,NA,NA,NA,NA,NA,0,0,0,0,0,0,0
2012,36061000100,"Census Tract 1, New York County, New York",0,0,0,0,0,NA,NA,NA,NA,NA,0,0,0,0,0,0,0
2013,36061000100,"Census Tract 1, New York County, New York",0,0,0,0,0,NA,NA,NA,NA,NA,0,0,0,0,0,0,0
2014,36061000100,"Census Tract 1, New York County, New York",0,0,0,0,0,NA,NA,NA,NA,NA,0,0,0,0,0,0,0
2015,36061000100,"Census Tract 1, New York County, New York",0,0,0,0,0,NA,NA,NA,NA,NA,0,0,0,0,0,0,0
2016,36061000100,"Census Tract 1, New York County, New York",0,0,0,0,0,NA,NA,NA,NA,NA,0,0,0,0,0,0,0
2017,36061000100,"Census Tract 1, New York County, New York",0,0,0,0,0,NA,NA,NA,NA,NA,0,0,0,0,0,0,0
2018,36061000100,"Census Tract 1, New York County, New York",0,0,0,0,0,NA,NA,NA,NA,NA,0,0,0,0,0,0,0
2019,36061000100,"Census Tract 1, New York County, New York",0,0,0,0,0,NA,NA,NA,NA,NA,0,0,0,0,0,0,0
2020,36061000100,"Census Tract 1, New York County, New York",0,0,0,0,0,NA,NA,NA,NA,NA,0,0,0,0,0,0,0
2012,36061000201,"Census Tract 2.01, New York County, New York",1031,45,986,986,2762,17282,1956,1996,593,30.6,73,93,46,409,447,986,516
2013,36061000201,"Census Tract 2.01, New York County, New York",1026,86,940,933,2669,19188,1954,2000,634,30.3,93,113,52,421,355,940,478
2014,36061000201,"Census Tract 2.01, New York County, New York",1042,115,927,921,2578,22883,1954,2002,654,30.2,110,95,51,433,342,927,423
2015,36061000201,"Census Tract 2.01, New York County, New York",1068,90,978,972,2651,20417,1954,1997,697,32.6,116,96,62,441,380,978,492
2016,36061000201,"Census Tract 2.01, New York County, New York",1065,87,978,973,2551,20996,1956,2000,628,32.5,141,135,104,438,315,978,499
2017,36061000201,"Census Tract 2.01, New York County, New York",1095,110,985,979,2608,23457,1956,2000,627,31.6,100,74,123,409,401,985,463
2018,36061000201,"Census Tract 2.01, New York County, New York",1097,26,1071,1071,2819,28328,1960,1996,689,31.2,112,66,124,493,455,1071,464
2019,36061000201,"Census Tract 2.01, New York County, New York",1125,33,1092,1092,2735,29500,1959,2001,765,30.1,206,109,150,476,431,1092,461
2020,36061000201,"Census Tract 2.01, New York County, New York",874,10,864,864,2699,30435,1954,2006,785,32.1,177,84,78,257,428,864,323
2012,36061000202,"Census Tract 2.02, New York County, New York",3631,249,3382,2865,6554,20461,1947,1993,532,29.7,357,569,375,762,1238,3382,1179
2013,36061000202,"Census Tract 2.02, New York County, New York",3598,260,3338,2698,6211,23529,1947,1995,620,29.6,419,426,382,617,1286,3338,989
2014,36061000202,"Census Tract 2.02, New York County, New York",3662,215,3447,2786,6383,24503,1947,2000,621,28.6,455,429,421,799,1096,3447,935
2015,36061000202,"Census Tract 2.02, New York County, New York",3660,164,3496,2649,5730,24630,1948,2000,628,27.9,573,345,450,786,1066,3496,876
2016,36061000202,"Census Tract 2.02, New York County, New York",3697,156,3541,2754,6138,26859,1948,2002,720,26.6,664,286,507,700,1284,3541,754
2017,36061000202,"Census Tract 2.02, New York County, New York",3668,234,3434,2606,5810,24887,1948,2003,702,26.8,658,358,512,676,1121,3434,896
2018,36061000202,"Census Tract 2.02, New York County, New York",3718,283,3435,2670,5822,23784,1947,2003,641,27.2,698,339,621,648,1117,3435,1009
2019,36061000202,"Census Tract 2.02, New York County, New York",3709,320,3389,2581,5700,21190,1948,2004,542,28.3,617,402,549,517,1165,3389,1167
2020,36061000202,"Census Tract 2.02, New York County, New York",3512,296,3216,2398,5235,23026,1948,2005,511,29.5,503,381,470,540,1042,3216,1145
2012,36061000500,"Census Tract 5, New York County, New York",10,10,0,0,0,NA,NA,NA,NA,NA,0,0,0,0,0,0,0
2013,36061000500,"Census Tract 5, New York County, New York",10,10,0,0,0,NA,NA,NA,NA,NA,0,0,0,0,0,0,0
2014,36061000500,"Census Tract 5, New York County, New York",9,9,0,0,0,NA,NA,NA,NA,NA,0,0,0,0,0,0,0
2015,36061000500,"Census Tract 5, New York County, New York",10,10,0,0,0,NA,NA,NA,NA,NA,0,0,0,0,0,0,0
2016,36061000500,"Census Tract 5, New York County, New York",0,0,0,0,0,NA,NA,NA,NA,NA,0,0,0,0,0,0,0
2017,36061000500,"Census Tract 5, New York County, New York",40,40,0,0,0,NA,NA,NA,NA,NA,0,0,0,0,0,0,0
2018,36061000500,"Census Tract 5, New York County, New York",41,41,0,0,0,NA,NA,NA,NA,NA,0,0,0,0,0,0,0
2019,36061000500,"Census Tract 5, New York County, New York",40,40,0,0,0,NA,NA,NA,NA,NA,0,0,0,0,0,0,0
2020,36061000500,"Census Tract 5, New York County, New York",38,38,0,0,0,NA,NA,NA,NA,NA,0,0,0,0,0,0,0
2012,36061000600,"Census Tract 6, New York County, New York",4008,170,3838,3785,10297,18349,1962,1998,573,33.2,637,365,213,2178,990,3838,1733
2013,36061000600,"Census Tract 6, New York County, New York",4083,171,3912,3790,10800,18771,1963,1998,619,31.7,680,339,220,2152,1093,3912,1739
2014,36061000600,"Census Tract 6, New York County, New York",4084,130,3954,3845,10817,18545,1964,2000,589,31.5,593,315,208,2088,1173,3954,1787
2015,36061000600,"Census Tract 6, New York County, New York",4270,38,4232,4113,11940,NA,1961,2001,645,31.8,782,283,252,2210,1329,4232,1897
2016,36061000600,"Census Tract 6, New York County, New York",4252,91,4161,3994,10215,17816,1959,2001,652,32.7,801,296,367,2184,1099,4161,1821
2017,36061000600,"Census Tract 6, New York County, New York",4336,238,4098,3876,10199,18621,1958,1999,655,32.1,607,217,228,2348,1021,4098,1663
2018,36061000600,"Census Tract 6, New York County, New York",4295,264,4031,3887,9322,18072,1957,2001,568,32,594,240,325,2353,910,4031,1681
2019,36061000600,"Census Tract 6, New York County, New York",4362,313,4049,3881,9250,16254,1955,1998,571,33.5,706,257,331,2339,926,4049,1888
2020,36061000600,"Census Tract 6, New York County, New York",5003,533,4470,4283,10017,17027,1961,1999,672,33,647,322,466,2355,1000,4470,1983
2012,36061000700,"Census Tract 7, New York County, New York",4916,812,4104,3363,5545,121116,1955,2008,2001,27.9,2956,2143,64,940,136,4104,385
2013,36061000700,"Census Tract 7, New York County, New York",5201,976,4225,3540,6227,120755,1944,2011,2001,28.4,3166,2256,145,889,168,4225,399
2014,36061000700,"Census Tract 7, New York County, New York",5422,812,4610,3820,6852,113558,1943,2011,2001,29.1,3410,2345,184,986,198,4610,479
2015,36061000700,"Census Tract 7, New York County, New York",5339,761,4578,3665,6727,115819,1943,2012,2857,29,3184,2382,139,886,201,4578,453
2016,36061000700,"Census Tract 7, New York County, New York",5276,765,4511,3614,7061,119063,1939,2012,2941,28.6,3083,2387,117,808,232,4511,527
2017,36061000700,"Census Tract 7, New York County, New York",5425,1103,4322,3384,6803,134794,1939,2013,3048,27,2953,2478,134,536,161,4322,450
2018,36061000700,"Census Tract 7, New York County, New York",5689,1207,4482,3491,6889,171495,1950,2014,3166,23.3,3148,2610,48,585,171,4482,460
2019,36061000700,"Census Tract 7, New York County, New York",5941,1550,4391,3394,6486,185093,0,2015,3308,21.7,3061,2738,28,504,110,4391,300
2020,36061000700,"Census Tract 7, New York County, New York",6130,1559,4571,3818,7000,185911,0,2016,3501,22.5,3516,2990,63,667,84,4571,267
2012,36061000800,"Census Tract 8, New York County, New York",4240,290,3950,3821,10480,31245,1939,1999,854,34.8,628,497,21,3017,189,3950,1258
2013,36061000800,"Census Tract 8, New York County, New York",4150,320,3830,3748,10159,24718,1939,1998,871,39.9,605,394,23,3047,157,3830,1368
2014,36061000800,"Census Tract 8, New York County, New York",3964,379,3585,3506,9160,23973,1939,1999,906,38.9,493,380,14,2861,128,3585,1227
2015,36061000800,"Census Tract 8, New York County, New York",3990,399,3591,3534,9330,NA,1939,1999,929,38.2,518,266,0,2998,146,3591,1148
2016,36061000800,"Census Tract 8, New York County, New York",3913,482,3431,3395,9225,31440,1939,2001,977,38.4,693,388,0,2787,124,3431,930
2017,36061000800,"Census Tract 8, New York County, New York",3940,289,3651,3563,9156,33005,1939,2002,999,38.4,806,446,0,2876,160,3651,1134
2018,36061000800,"Census Tract 8, New York County, New York",3911,279,3632,3544,8791,34951,0,2003,996,39.1,760,430,0,2894,176,3632,1127
2019,36061000800,"Census Tract 8, New York County, New York",3971,265,3706,3586,8998,34178,0,2003,1032,42.8,720,362,0,2979,197,3706,1092
2020,36061000800,"Census Tract 8, New York County, New York",4261,167,4094,3989,8979,32069,0,2005,1038,46.7,896,438,0,3374,169,4094,1369
2012,36061000900,"Census Tract 9, New York County, New York",819,452,367,342,730,144464,1939,2011,2001,24.7,284,269,0,31,27,367,15
2013,36061000900,"Census Tract 9, New York County, New York",939,432,507,460,990,153750,1944,2011,2001,23.3,393,374,0,34,34,507,17
2014,36061000900,"Census Tract 9, New York County, New York",1087,441,646,558,1191,172045,1956,2011,2001,22.1,441,419,23,48,48,646,38
2015,36061000900,"Census Tract 9, New York County, New York",1102,344,758,676,1420,143500,1979,2013,3501,26,568,514,22,84,34,758,35
2016,36061000900,"Census Tract 9, New York County, New York",1106,263,843,754,1538,166250,1947,2013,3501,25.5,650,544,35,90,52,843,34
2017,36061000900,"Census Tract 9, New York County, New York",1094,243,851,735,1488,180625,1939,NA,3501,24.2,654,533,33,99,48,851,43
2018,36061000900,"Census Tract 9, New York County, New York",1106,271,835,690,1412,196250,0,2014,3501,21.6,608,468,37,90,63,835,42
2019,36061000900,"Census Tract 9, New York County, New York",1078,269,809,663,1446,198839,0,2015,3501,21.5,611,481,30,80,57,809,41
2020,36061000900,"Census Tract 9, New York County, New York",1140,257,883,761,1615,174875,0,2015,3501,23.9,710,552,32,74,76,883,59
2012,36061001001,"Census Tract 10.01, New York County, New York",806,67,739,173,599,59917,1956,1996,787,20.2,91,147,0,11,0,739,56
2013,36061001001,"Census Tract 10.01, New York County, New York",837,77,760,166,482,54643,1955,2003,1466,30.3,92,116,0,10,26,760,46
2014,36061001001,"Census Tract 10.01, New York County, New York",849,106,743,165,445,56607,1955,2002,1419,31,89,109,0,0,43,743,62
2015,36061001001,"Census Tract 10.01, New York County, New York",858,89,769,174,304,55966,1953,2004,973,31.1,132,119,0,0,41,769,62
2016,36061001001,"Census Tract 10.01, New York County, New York",856,66,790,222,342,56250,1954,2004,1238,25,125,168,0,5,49,790,68
2017,36061001001,"Census Tract 10.01, New York County, New York",850,51,799,290,446,67000,1954,2004,1274,23.2,167,209,0,6,75,799,59
2018,36061001001,"Census Tract 10.01, New York County, New York",855,46,809,285,434,73750,1955,2003,1136,22.6,158,207,0,24,54,809,60
2019,36061001001,"Census Tract 10.01, New York County, New York",857,15,842,336,552,75250,1955,2004,1171,22.8,177,238,0,41,57,842,37
2020,36061001001,"Census Tract 10.01, New York County, New York",794,9,785,270,407,69500,1955,2002,1211,23.5,125,182,0,38,50,785,16
2012,36061001002,"Census Tract 10.02, New York County, New York",2361,137,2224,2224,5665,15890,1955,1991,431,27.3,78,150,419,228,1419,2224,841
2013,36061001002,"Census Tract 10.02, New York County, New York",2346,131,2215,2215,6106,18270,1954,1993,474,26.7,85,177,516,205,1354,2215,767
2014,36061001002,"Census Tract 10.02, New York County, New York",2405,147,2258,2258,5748,17972,1955,1992,420,26.7,139,178,423,179,1492,2258,631
2015,36061001002,"Census Tract 10.02, New York County, New York",2406,109,2297,2297,5576,17560,1955,1994,396,27.7,175,140,429,271,1489,2297,784
2016,36061001002,"Census Tract 10.02, New York County, New York",2463,74,2389,2389,5420,16464,1955,1999,400,27.2,224,101,514,286,1574,2389,778
2017,36061001002,"Census Tract 10.02, New York County, New York",2561,93,2468,2468,5247,18977,1955,1998,434,27.1,268,87,383,325,1782,2468,700
2018,36061001002,"Census Tract 10.02, New York County, New York",2555,82,2473,2473,4979,17926,1955,2000,393,28.7,292,48,455,355,1682,2473,851
2019,36061001002,"Census Tract 10.02, New York County, New York",2636,157,2479,2479,4836,23230,1956,1995,394,27.6,250,66,508,425,1609,2479,897
2020,36061001002,"Census Tract 10.02, New York County, New York",2467,155,2312,2312,4802,21408,1956,1996,562,29.2,236,37,421,450,1501,2312,850
2012,36061001200,"Census Tract 12, New York County, New York",1849,155,1694,973,2027,26902,1962,2000,681,31.7,301,386,59,205,334,1694,300
2013,36061001200,"Census Tract 12, New York County, New York",1857,117,1740,1026,2126,25800,1959,2001,710,31.1,339,388,48,296,299,1740,322
2014,36061001200,"Census Tract 12, New York County, New York",1897,154,1743,1077,2104,24114,1963,2003,669,29.4,326,334,70,378,302,1743,337
2015,36061001200,"Census Tract 12, New York County, New York",1930,86,1844,1199,2351,28702,1970,2004,908,30.8,383,382,54,372,391,1844,331
2016,36061001200,"Census Tract 12, New York County, New York",1942,72,1870,1187,2331,35042,1960,2005,914,31.7,410,415,36,355,381,1870,341
2017,36061001200,"Census Tract 12, New York County, New York",1956,81,1875,1207,2404,36585,1963,2005,1057,30.9,448,479,26,279,423,1875,404
2018,36061001200,"Census Tract 12, New York County, New York",1963,80,1883,1182,2405,36042,1971,2006,1038,32.3,428,456,53,245,428,1883,408
2019,36061001200,"Census Tract 12, New York County, New York",1972,64,1908,1169,2559,39175,1964,2006,1086,33.5,419,423,32,246,468,1908,406
2020,36061001200,"Census Tract 12, New York County, New York",2045,130,1915,1119,2555,20030,1973,2007,910,31.5,276,311,32,326,450,1915,549
2012,36061001300,"Census Tract 13, New York County, New York",3038,696,2342,2135,3461,115969,1939,2007,2001,26.7,1806,1499,108,313,117,2342,203
2013,36061001300,"Census Tract 13, New York County, New York",3028,718,2310,2136,3492,120833,1939,2010,2001,27,1793,1512,109,281,124,2310,198
2014,36061001300,"Census Tract 13, New York County, New York",3079,662,2417,2291,3959,122210,1939,2011,2001,27.6,1981,1631,88,402,139,2417,209
2015,36061001300,"Census Tract 13, New York County, New York",3148,727,2421,2259,4090,NA,1939,2011,2817,28.5,1987,1536,69,472,140,2421,202
2016,36061001300,"Census Tract 13, New York County, New York",3185,715,2470,2237,4112,123558,1939,2012,2853,29.2,2004,1350,99,521,202,2470,170
2017,36061001300,"Census Tract 13, New York County, New York",3165,592,2573,2323,4335,133287,1939,2012,3018,27.2,2114,1446,60,513,221,2573,125
2018,36061001300,"Census Tract 13, New York County, New York",3240,706,2534,2175,3962,154337,0,2013,3225,25.5,1970,1315,52,511,209,2534,138
2019,36061001300,"Census Tract 13, New York County, New York",3327,749,2578,2110,3588,159861,0,NA,3247,25.2,1811,1345,157,311,194,2578,91
2020,36061001300,"Census Tract 13, New York County, New York",3174,479,2695,2268,3893,179063,0,2016,3364,23.6,2043,1388,222,365,187,2695,130
2012,36061001401,"Census Tract 14.01, New York County, New York",1686,184,1502,333,507,63843,1962,2003,974,28.3,203,240,0,77,16,1502,117
2013,36061001401,"Census Tract 14.01, New York County, New York",1708,131,1577,371,591,65402,1962,2005,986,40.8,251,244,0,109,18,1577,84
2014,36061001401,"Census Tract 14.01, New York County, New York",1717,115,1602,344,475,59500,1961,2008,1972,45.7,229,208,0,118,18,1602,94
2015,36061001401,"Census Tract 14.01, New York County, New York",1754,120,1634,389,553,59297,1961,2009,1647,50,246,230,0,104,26,1634,85
2016,36061001401,"Census Tract 14.01, New York County, New York",1769,93,1676,372,560,62321,1958,2008,NA,41.8,233,204,0,109,18,1676,144
2017,36061001401,"Census Tract 14.01, New York County, New York",1680,73,1607,390,644,70776,1960,2007,1045,34.4,254,232,0,88,29,1607,160
2018,36061001401,"Census Tract 14.01, New York County, New York",1664,69,1595,356,617,73259,1958,2007,1167,27.3,251,244,0,42,31,1595,148
2019,36061001401,"Census Tract 14.01, New York County, New York",1669,99,1570,375,635,73565,1960,2008,1202,23.6,274,270,0,19,46,1570,149
2020,36061001401,"Census Tract 14.01, New York County, New York",1711,142,1569,276,480,70000,1960,2007,1186,21.3,206,219,0,18,32,1569,136
2012,36061001402,"Census Tract 14.02, New York County, New York",1489,153,1336,1255,2951,30250,1962,2000,697,28.1,449,301,29,423,423,1336,461
2013,36061001402,"Census Tract 14.02, New York County, New York",1468,128,1340,1265,2896,30875,1954,2002,860,29.8,538,358,42,410,391,1340,407
2014,36061001402,"Census Tract 14.02, New York County, New York",1456,146,1310,1239,2548,24746,1948,2002,794,31.1,467,335,78,485,304,1310,443
2015,36061001402,"Census Tract 14.02, New York County, New York",1472,102,1370,1317,2857,NA,1958,2002,885,33.8,573,375,109,500,298,1370,434
2016,36061001402,"Census Tract 14.02, New York County, New York",1445,67,1378,1316,2818,25556,1953,2003,1014,32.8,590,433,91,461,282,1378,388
2017,36061001402,"Census Tract 14.02, New York County, New York",1446,53,1393,1342,2784,28015,1949,2004,1090,33.3,563,440,73,472,332,1393,424
2018,36061001402,"Census Tract 14.02, New York County, New York",1465,56,1409,1360,2682,30106,1947,2006,1106,31.5,554,432,90,486,314,1409,431
2019,36061001402,"Census Tract 14.02, New York County, New York",1554,45,1509,1459,2876,25901,1953,2009,1063,32.4,584,480,71,513,347,1509,454
2020,36061001402,"Census Tract 14.02, New York County, New York",1620,144,1476,1399,2575,30417,0,2012,1061,30.5,573,387,67,544,333,1476,429
2012,36061001501,"Census Tract 15.01, New York County, New York",3191,191,3000,1917,3475,61023,1972,2004,844,25.8,1136,1121,83,590,123,3000,305
2013,36061001501,"Census Tract 15.01, New York County, New York",3450,229,3221,2046,3435,50000,1973,2004,863,27.1,1151,1193,43,668,142,3221,346
2014,36061001501,"Census Tract 15.01, New York County, New York",3741,323,3418,1984,3257,74891,1974,2005,1050,26.5,1207,1179,39,558,208,3418,380
2015,36061001501,"Census Tract 15.01, New York County, New York",3979,418,3561,2089,3500,95950,1973,2010,1315,24.2,1449,1241,39,595,233,3561,440
2016,36061001501,"Census Tract 15.01, New York County, New York",4074,381,3693,2105,3264,97841,1973,2011,2379,24.3,1432,1192,28,525,261,3693,514
2017,36061001501,"Census Tract 15.01, New York County, New York",4244,505,3739,2140,3347,97845,1974,2011,2044,24,1435,1172,16,565,272,3739,483
2018,36061001501,"Census Tract 15.01, New York County, New York",4271,609,3662,2060,3325,122553,1974,2012,2744,24.4,1399,1135,80,519,220,3662,450
2019,36061001501,"Census Tract 15.01, New York County, New York",4355,631,3724,2028,3299,108971,1976,2013,2804,25.5,1305,1143,81,531,148,3724,446
2020,36061001501,"Census Tract 15.01, New York County, New York",4266,546,3720,1982,3482,103889,1976,2013,NA,25.3,1213,1023,90,463,225,3720,430
2012,36061001502,"Census Tract 15.02, New York County, New York",3267,487,2780,2176,4036,103519,1971,2009,2001,30.6,1789,1362,102,482,198,2780,194
2013,36061001502,"Census Tract 15.02, New York County, New York",3459,614,2845,2243,4602,103689,1974,2011,2001,31.1,1894,1398,100,497,205,2845,214
2014,36061001502,"Census Tract 15.02, New York County, New York",3727,590,3137,2528,5023,129118,1976,2011,2001,28.2,2103,1584,124,557,209,3137,250
2015,36061001502,"Census Tract 15.02, New York County, New York",3742,652,3090,2476,5014,130811,1978,NA,3075,28,2195,1624,117,540,157,3090,231
2016,36061001502,"Census Tract 15.02, New York County, New York",3772,634,3138,2438,5307,136372,1976,NA,3120,25.9,2191,1617,58,538,194,3138,217
2017,36061001502,"Census Tract 15.02, New York County, New York",3836,701,3135,2485,5754,151832,1972,NA,3223,24.3,2164,1778,65,439,132,3135,276
2018,36061001502,"Census Tract 15.02, New York County, New York",3909,650,3259,2553,5719,158183,1975,2014,3259,23.5,2261,1855,61,420,144,3259,247
2019,36061001502,"Census Tract 15.02, New York County, New York",4186,660,3526,2914,6280,146964,1978,2016,3189,24.2,2658,2133,45,440,159,3526,241
2020,36061001502,"Census Tract 15.02, New York County, New York",4297,726,3571,3082,6229,191591,1979,2017,3308,22,2826,2203,7,498,189,3571,254
2012,36061001600,"Census Tract 16, New York County, New York",3276,258,3018,2707,6770,27217,1939,2002,941,33.6,662,449,20,2122,66,3018,894
2013,36061001600,"Census Tract 16, New York County, New York",3242,231,3011,2800,7657,28375,1939,2002,1015,32.7,688,352,25,2234,118,3011,955
2014,36061001600,"Census Tract 16, New York County, New York",3224,266,2958,2732,7077,26270,1939,2003,972,35.4,707,362,31,2161,143,2958,866
2015,36061001600,"Census Tract 16, New York County, New York",3342,314,3028,2761,6901,NA,1941,2002,993,34.7,883,379,33,2136,171,3028,898
2016,36061001600,"Census Tract 16, New York County, New York",3261,362,2899,2641,6531,40417,1942,2003,1056,34.4,931,482,88,1876,182,2899,793
2017,36061001600,"Census Tract 16, New York County, New York",3268,401,2867,2692,6834,43491,1947,2006,1154,32.7,957,474,102,1947,178,2867,707
2018,36061001600,"Census Tract 16, New York County, New York",3351,328,3023,2820,6678,48733,1946,2007,1316,30.9,1160,656,78,1941,156,3023,617
2019,36061001600,"Census Tract 16, New York County, New York",3282,325,2957,2757,6575,46764,1943,2007,1336,32,1062,683,65,1946,64,2957,608
2020,36061001600,"Census Tract 16, New York County, New York",3448,301,3147,2795,6751,54258,0,2009,1370,29.8,913,741,59,1964,47,3147,503
2012,36061001800,"Census Tract 18, New York County, New York",3448,538,2910,2828,7154,43446,1939,2003,1144,33.8,1190,896,71,1442,337,2910,807
2013,36061001800,"Census Tract 18, New York County, New York",3489,455,3034,2937,7336,46844,1939,2004,1247,32.8,1363,1118,66,1358,342,3034,842
2014,36061001800,"Census Tract 18, New York County, New York",3485,347,3138,2999,7380,47359,1939,2005,1251,32.1,1437,1038,94,1427,403,3138,821
2015,36061001800,"Census Tract 18, New York County, New York",3457,339,3118,2987,7495,57229,1939,2006,1191,29.8,1476,1137,77,1314,449,3118,812
2016,36061001800,"Census Tract 18, New York County, New York",3393,273,3120,2918,6939,55556,1939,2008,1318,29.9,1473,1045,113,1343,377,3120,835
2017,36061001800,"Census Tract 18, New York County, New York",3391,242,3149,2940,6846,59556,1939,2010,1215,29.4,1358,971,80,1419,347,3149,758
2018,36061001800,"Census Tract 18, New York County, New York",3364,259,3105,2846,6398,44806,0,2011,1194,31,1243,816,82,1379,397,3105,852
2019,36061001800,"Census Tract 18, New York County, New York",3251,311,2940,2762,5810,46214,0,2012,1381,32.9,1192,828,75,1254,371,2940,662
2020,36061001800,"Census Tract 18, New York County, New York",3383,288,3095,2914,6056,47328,0,2013,1357,27.8,1507,689,85,1555,347,3095,770
2012,36061002000,"Census Tract 20, New York County, New York",1882,62,1820,1809,4878,18556,1948,1993,407,28.1,152,79,228,285,1254,1820,772
2013,36061002000,"Census Tract 20, New York County, New York",1899,44,1855,1841,4781,17588,1948,1993,380,27.8,103,74,336,291,1189,1855,880
2014,36061002000,"Census Tract 20, New York County, New York",1922,41,1881,1870,4861,17576,1948,1994,400,27.5,120,63,347,274,1254,1881,853
2015,36061002000,"Census Tract 20, New York County, New York",1935,38,1897,1897,4864,16778,1950,1995,415,29.1,99,75,362,360,1161,1897,946
2016,36061002000,"Census Tract 20, New York County, New York",1955,0,1955,1955,4720,15490,1949,1996,398,28.7,117,47,414,266,1292,1955,959
2017,36061002000,"Census Tract 20, New York County, New York",2001,0,2001,2001,4920,14745,1949,1995,421,30.3,138,23,493,283,1282,2001,983
2018,36061002000,"Census Tract 20, New York County, New York",2011,72,1939,1927,4539,16053,1949,2000,443,30.6,131,47,477,243,1223,1939,926
2019,36061002000,"Census Tract 20, New York County, New York",2033,69,1964,1957,4552,16603,1949,2000,449,31.3,137,60,454,280,1166,1964,990
2020,36061002000,"Census Tract 20, New York County, New York",2040,76,1964,1956,4574,18750,1948,2000,491,30.3,205,89,431,249,1174,1964,945
2012,36061002100,"Census Tract 21, New York County, New York",2810,380,2430,1538,3149,202984,1985,2006,2001,18,1352,1187,61,236,54,2430,45
2013,36061002100,"Census Tract 21, New York County, New York",3038,354,2684,1547,3050,198558,1988,2008,2001,18.4,1322,1174,55,272,38,2684,47
2014,36061002100,"Census Tract 21, New York County, New York",3174,353,2821,1524,3041,189464,1992,2010,2001,19.8,1337,1136,67,261,53,2821,58
2015,36061002100,"Census Tract 21, New York County, New York",3204,328,2876,1565,3123,217417,1990,2011,3501,17.2,1413,1207,17,275,57,2876,78
2016,36061002100,"Census Tract 21, New York County, New York",3161,417,2744,1465,2873,204365,1988,2012,3501,18.3,1324,1127,33,276,18,2744,78
2017,36061002100,"Census Tract 21, New York County, New York",3195,413,2782,1459,3086,208507,1989,NA,3363,17.6,1303,1166,17,234,20,2782,76
2018,36061002100,"Census Tract 21, New York County, New York",3235,588,2647,1534,3293,214143,1989,2012,3501,14.9,1454,1314,18,172,16,2647,54
2019,36061002100,"Census Tract 21, New York County, New York",3245,616,2629,1522,3351,216538,1989,2013,3458,15.8,1452,1230,89,171,0,2629,97
2020,36061002100,"Census Tract 21, New York County, New York",3581,684,2897,1681,3520,228523,1993,2015,3501,18.8,1634,1223,72,165,194,2897,63
2012,36061002201,"Census Tract 22.01, New York County, New York",3015,238,2777,2520,6293,41319,1964,1998,876,27.4,757,565,298,531,1007,2777,578
2013,36061002201,"Census Tract 22.01, New York County, New York",3030,212,2818,2555,6190,38750,1964,1997,910,30,624,494,243,595,1088,2818,592
2014,36061002201,"Census Tract 22.01, New York County, New York",3088,196,2892,2616,6158,34847,1965,1997,971,28.3,639,428,310,641,1188,2892,600
2015,36061002201,"Census Tract 22.01, New York County, New York",3102,93,3009,2671,6054,33385,1965,2001,945,28,789,473,371,616,1174,3009,813
2016,36061002201,"Census Tract 22.01, New York County, New York",3092,94,2998,2682,5754,31534,1966,2001,956,29.5,813,430,446,578,1214,2998,867
2017,36061002201,"Census Tract 22.01, New York County, New York",3154,129,3025,2664,5508,24129,1966,2002,939,30.5,774,438,421,583,1235,3025,990
2018,36061002201,"Census Tract 22.01, New York County, New York",3184,120,3064,2781,5758,22479,1965,2005,1005,31.7,934,445,500,527,1306,3064,1049
2019,36061002201,"Census Tract 22.01, New York County, New York",3228,171,3057,2732,5771,26750,1965,2006,951,30.3,884,530,471,452,1255,3057,937
2020,36061002201,"Census Tract 22.01, New York County, New York",3165,177,2988,2661,5541,23451,1967,2010,937,33.8,812,605,541,358,1103,2988,961
2012,36061002202,"Census Tract 22.02, New York County, New York",1052,71,981,880,1942,82353,1952,2005,2001,26.4,646,644,10,138,88,981,132
2013,36061002202,"Census Tract 22.02, New York County, New York",1045,50,995,904,2014,81613,1944,2005,1967,27.4,671,613,2,182,84,995,150
2014,36061002202,"Census Tract 22.02, New York County, New York",1054,68,986,897,1692,73125,1954,2007,2001,32.2,667,560,14,137,167,986,142
2015,36061002202,"Census Tract 22.02, New York County, New York",1079,49,1030,938,1763,67315,1963,2010,2195,34.4,680,608,17,117,168,1030,146
2016,36061002202,"Census Tract 22.02, New York County, New York",1108,31,1077,979,1690,88516,1960,2011,1942,30.7,719,588,18,114,223,1077,169
2017,36061002202,"Census Tract 22.02, New York County, New York",1159,31,1128,1059,1731,91992,1961,2012,2058,30.4,816,616,35,138,219,1128,268
2018,36061002202,"Census Tract 22.02, New York County, New York",1201,70,1131,1059,1660,84276,1991,2013,2017,29.5,773,697,41,109,203,1131,254
2019,36061002202,"Census Tract 22.02, New York County, New York",1195,68,1127,1085,1902,93456,1994,2013,2151,28.1,871,794,43,132,115,1127,249
2020,36061002202,"Census Tract 22.02, New York County, New York",1205,170,1035,975,1903,99250,1978,2014,2506,27,757,667,37,195,78,1035,232
2012,36061002400,"Census Tract 24, New York County, New York",2175,118,2057,2057,5453,26287,1949,1990,588,28,473,187,362,290,1222,2057,717
2013,36061002400,"Census Tract 24, New York County, New York",2175,89,2086,2086,5775,25833,1950,1992,605,28.7,533,219,397,265,1173,2086,743
2014,36061002400,"Census Tract 24, New York County, New York",2210,62,2148,2148,5658,25467,1952,1993,605,29.1,527,241,322,407,1059,2148,714
2015,36061002400,"Census Tract 24, New York County, New York",2183,38,2145,2145,5557,22676,1952,1992,607,31,394,206,402,299,1127,2145,773
2016,36061002400,"Census Tract 24, New York County, New York",2161,39,2122,2122,5126,18354,1951,1993,526,32.5,405,274,402,218,1089,2122,881
2017,36061002400,"Census Tract 24, New York County, New York",1879,0,1879,1861,4195,14159,1949,1993,373,32.5,120,34,485,207,1024,1879,990
2018,36061002400,"Census Tract 24, New York County, New York",1860,23,1837,1820,4076,14825,1948,1991,409,31.4,93,31,411,224,1083,1837,976
2019,36061002400,"Census Tract 24, New York County, New York",1874,24,1850,1835,4124,14015,1948,1995,440,32.4,95,31,428,242,1096,1850,1058
2020,36061002400,"Census Tract 24, New York County, New York",1851,44,1807,1793,4111,12811,1947,1996,419,31.2,127,61,378,265,1054,1807,1125
2012,36061002500,"Census Tract 25, New York County, New York",1919,55,1864,1864,5351,14645,1952,1992,404,30.4,156,70,267,806,709,1864,1050
2013,36061002500,"Census Tract 25, New York County, New York",1917,82,1835,1835,5002,15652,1953,1994,440,29.4,151,64,241,856,648,1835,915
2014,36061002500,"Census Tract 25, New York County, New York",1947,46,1901,1901,5230,16333,1953,1997,436,29.5,182,16,220,904,709,1901,926
2015,36061002500,"Census Tract 25, New York County, New York",2027,41,1986,1986,5035,16527,1954,2001,386,28.9,264,23,265,948,664,1986,963
2016,36061002500,"Census Tract 25, New York County, New York",2064,29,2035,2035,5180,16324,1955,1999,394,29.5,190,9,396,995,716,2035,986
2017,36061002500,"Census Tract 25, New York County, New York",2129,29,2100,2100,5013,17500,1954,1999,420,30.2,145,7,504,1074,597,2100,1000
2018,36061002500,"Census Tract 25, New York County, New York",2134,8,2126,2126,5318,19973,1952,1997,511,31,185,29,460,966,756,2126,972
2019,36061002500,"Census Tract 25, New York County, New York",2140,8,2132,2132,5269,20868,1952,1997,496,30.3,244,40,511,937,686,2132,992
2020,36061002500,"Census Tract 25, New York County, New York",2072,46,2026,2026,5292,21013,1953,2000,481,31,239,40,578,809,634,2026,1000
2012,36061002601,"Census Tract 26.01, New York County, New York",1606,118,1488,1291,2870,31535,1956,2002,847,29.9,528,377,128,210,561,1488,414
2013,36061002601,"Census Tract 26.01, New York County, New York",1593,85,1508,1350,3111,45735,1971,2004,963,28.2,620,471,98,222,528,1508,363
2014,36061002601,"Census Tract 26.01, New York County, New York",1613,57,1556,1390,3335,40526,1973,2004,912,27.9,555,422,90,223,646,1556,364
2015,36061002601,"Census Tract 26.01, New York County, New York",1613,74,1539,1379,3454,37563,1975,2005,955,28.1,515,412,138,178,639,1539,383
2016,36061002601,"Census Tract 26.01, New York County, New York",1648,65,1583,1426,3522,51875,1971,2006,923,24.3,529,472,150,195,584,1583,378
2017,36061002601,"Census Tract 26.01, New York County, New York",1635,72,1563,1395,3350,55125,1973,2006,964,23.1,514,489,173,156,548,1563,330
2018,36061002601,"Census Tract 26.01, New York County, New York",1629,90,1539,1394,3145,45058,1967,2006,933,25.7,503,440,249,168,503,1539,358
2019,36061002601,"Census Tract 26.01, New York County, New York",1612,57,1555,1430,3004,45117,1972,2006,864,27.1,522,461,251,233,437,1555,440
2020,36061002601,"Census Tract 26.01, New York County, New York",1850,53,1797,1654,3300,43661,1951,2007,862,27.2,679,655,197,183,576,1797,521
2012,36061002602,"Census Tract 26.02, New York County, New York",2162,100,2062,1633,3501,45250,1939,2004,1701,28.7,926,890,136,264,219,2062,289
2013,36061002602,"Census Tract 26.02, New York County, New York",2177,118,2059,1590,3315,39929,1939,2004,998,30.5,750,686,168,284,312,2059,296
2014,36061002602,"Census Tract 26.02, New York County, New York",2198,69,2129,1545,3019,41986,1939,2007,1215,28.8,873,757,155,308,223,2129,256
2015,36061002602,"Census Tract 26.02, New York County, New York",2221,85,2136,1671,3266,41694,1950,2010,1235,28.9,883,732,116,289,348,2136,360
2016,36061002602,"Census Tract 26.02, New York County, New York",2200,82,2118,1627,3284,66382,1939,2011,1241,26,916,776,86,318,289,2118,355
2017,36061002602,"Census Tract 26.02, New York County, New York",2167,98,2069,1533,3064,71518,1939,2011,1334,26.9,940,789,76,287,268,2069,352
2018,36061002602,"Census Tract 26.02, New York County, New York",2245,166,2079,1681,3084,64476,0,2012,1454,30.8,1032,869,96,304,327,2079,458
2019,36061002602,"Census Tract 26.02, New York County, New York",2302,254,2048,1685,3265,76653,0,2012,1580,30.7,1008,949,72,194,396,2048,402
2020,36061002602,"Census Tract 26.02, New York County, New York",2141,268,1873,1540,2968,77647,0,2013,1667,29.9,980,990,61,200,267,1873,290
2012,36061002700,"Census Tract 27, New York County, New York",632,97,535,259,593,24526,1939,2003,929,36.4,69,44,0,193,10,535,114
2013,36061002700,"Census Tract 27, New York County, New York",655,120,535,295,702,53011,1939,2003,1123,29.3,92,40,0,237,11,535,111
2014,36061002700,"Census Tract 27, New York County, New York",676,135,541,260,660,32500,1939,2003,1042,36.6,55,33,0,222,0,541,110
2015,36061002700,"Census Tract 27, New York County, New York",694,97,597,259,668,56146,1939,2010,1028,25.7,83,43,0,210,0,597,96
2016,36061002700,"Census Tract 27, New York County, New York",707,80,627,319,747,33583,1939,2009,1027,29,83,32,0,280,0,627,115
2017,36061002700,"Census Tract 27, New York County, New York",714,76,638,295,672,30341,1939,2006,1106,36,81,33,0,262,0,638,96
2018,36061002700,"Census Tract 27, New York County, New York",723,110,613,295,697,28702,0,2010,1121,29.9,73,32,0,263,0,613,117
2019,36061002700,"Census Tract 27, New York County, New York",729,117,612,302,660,16755,0,2011,1105,51,81,36,0,266,0,612,177
2020,36061002700,"Census Tract 27, New York County, New York",702,88,614,236,509,NA,0,2011,1118,51,59,38,0,198,0,614,134
2012,36061002800,"Census Tract 28, New York County, New York",3430,100,3330,2875,6154,32259,1961,2002,959,28.9,934,1053,346,291,1159,3330,863
2013,36061002800,"Census Tract 28, New York County, New York",3341,91,3250,2871,6395,29536,1962,2002,952,28.8,899,861,388,316,1272,3250,1010
2014,36061002800,"Census Tract 28, New York County, New York",3375,98,3277,2926,6628,30412,1964,2002,1032,29.5,1054,990,363,333,1211,3277,883
2015,36061002800,"Census Tract 28, New York County, New York",3474,182,3292,3002,6537,28059,1964,2002,936,29.9,1039,956,420,337,1250,3292,930
2016,36061002800,"Census Tract 28, New York County, New York",3558,178,3380,3050,6592,32053,1968,2003,965,29.7,1205,962,501,332,1227,3380,868
2017,36061002800,"Census Tract 28, New York County, New York",3562,141,3421,3074,6483,34417,1965,2005,1008,29,1326,1146,435,342,1118,3421,877
2018,36061002800,"Census Tract 28, New York County, New York",3547,201,3346,3054,5940,39533,1965,2009,1092,30.1,1402,1200,448,367,1029,3346,664
2019,36061002800,"Census Tract 28, New York County, New York",3616,231,3385,3065,5912,39454,1966,2010,1094,29.1,1322,1151,425,502,987,3385,778
2020,36061002800,"Census Tract 28, New York County, New York",3434,258,3176,2786,5297,44384,1970,2011,1176,27.5,1330,1086,356,461,882,3176,616
2012,36061002900,"Census Tract 29, New York County, New York",2458,314,2144,1972,4622,28000,1939,2002,835,36.2,385,169,12,1791,0,2144,608
2013,36061002900,"Census Tract 29, New York County, New York",2420,349,2071,1856,4037,27600,1939,2001,828,36.6,434,121,16,1674,26,2071,577
2014,36061002900,"Census Tract 29, New York County, New York",2392,324,2068,1865,4094,30998,1939,2002,888,33.9,480,44,20,1720,64,2068,562
2015,36061002900,"Census Tract 29, New York County, New York",2410,245,2165,1979,4367,26391,1939,2002,916,37.4,556,116,20,1735,82,2165,590
2016,36061002900,"Census Tract 29, New York County, New York",2434,153,2281,2115,4368,27539,1939,2004,939,37.5,726,160,22,1827,85,2281,553
2017,36061002900,"Census Tract 29, New York County, New York",2573,167,2406,2235,5108,28229,1939,2002,953,38.4,685,129,0,2022,62,2406,608
2018,36061002900,"Census Tract 29, New York County, New York",2532,324,2208,2037,4597,26510,0,2003,984,39.9,673,144,0,1822,33,2208,588
2019,36061002900,"Census Tract 29, New York County, New York",2561,359,2202,2008,4118,27281,0,2005,1128,42.2,770,250,0,1704,0,2202,648
2020,36061002901,"Census Tract 29.01, New York County, New York",46,0,46,46,68,18906,1987,2013,272,17.2,0,0,0,46,0,46,14
2020,36061002902,"Census Tract 29.02, New York County, New York",2653,443,2210,1980,3721,23082,0,2004,1338,42.7,968,135,0,1816,0,2210,901
2012,36061003001,"Census Tract 30.01, New York County, New York",2498,214,2284,2064,3725,56985,1939,2005,1655,29.9,1296,1283,17,367,381,2284,272
2013,36061003001,"Census Tract 30.01, New York County, New York",2553,253,2300,2104,3877,57759,1939,2005,1763,29.6,1401,1335,55,432,265,2300,248
2014,36061003001,"Census Tract 30.01, New York County, New York",2521,211,2310,2171,3879,70918,1939,2008,1913,29.9,1573,1365,49,372,297,2310,311
2015,36061003001,"Census Tract 30.01, New York County, New York",2539,227,2312,2223,4005,NA,1939,2010,1964,31.4,1639,1397,40,269,332,2312,323
2016,36061003001,"Census Tract 30.01, New York County, New York",2528,206,2322,2253,4031,70739,1939,2011,2056,30.9,1704,1469,39,195,327,2322,365
2017,36061003001,"Census Tract 30.01, New York County, New York",2505,193,2312,2261,4080,70202,1939,2011,2054,30.6,1602,1320,108,250,390,2312,402
2018,36061003001,"Census Tract 30.01, New York County, New York",2449,175,2274,2239,3907,72723,0,2012,2175,31.2,1624,1372,29,312,335,2274,439
2019,36061003001,"Census Tract 30.01, New York County, New York",2442,205,2237,2174,3710,68510,0,2014,2069,31.2,1622,1239,120,250,400,2237,367
2020,36061003001,"Census Tract 30.01, New York County, New York",2318,236,2082,2010,3574,73507,0,2015,1972,30.9,1456,1241,169,232,350,2082,355
2012,36061003002,"Census Tract 30.02, New York County, New York",1875,127,1748,1541,2559,46893,1956,2003,1160,32.7,807,901,92,250,294,1748,250
2013,36061003002,"Census Tract 30.02, New York County, New York",1885,94,1791,1589,2682,53516,1942,2003,1353,31.7,871,944,129,218,282,1791,261
2014,36061003002,"Census Tract 30.02, New York County, New York",1871,98,1773,1626,2692,47708,1943,2004,1247,30.9,936,900,126,252,339,1773,325
2015,36061003002,"Census Tract 30.02, New York County, New York",1883,127,1756,1580,2537,NA,1943,2006,1235,31.6,893,869,152,213,325,1756,323
2016,36061003002,"Census Tract 30.02, New York County, New York",1887,128,1759,1605,2567,52140,1944,2006,1241,32.5,888,943,142,224,284,1759,347
2017,36061003002,"Census Tract 30.02, New York County, New York",1896,134,1762,1589,2646,53365,1939,2006,1180,31.4,882,933,144,173,326,1762,357
2018,36061003002,"Census Tract 30.02, New York County, New York",1871,200,1671,1475,2526,51898,0,2008,1202,30.6,775,923,116,150,275,1671,336
2019,36061003002,"Census Tract 30.02, New York County, New York",1842,184,1658,1487,2532,57083,0,2010,1330,28.9,761,892,84,201,294,1658,370
2020,36061003002,"Census Tract 30.02, New York County, New York",1741,124,1617,1494,2637,68125,0,2011,1384,27.1,767,879,64,241,311,1617,388
2012,36061003100,"Census Tract 31, New York County, New York",817,148,669,516,973,148357,2002,2006,2001,23.6,422,343,16,71,86,669,56
2013,36061003100,"Census Tract 31, New York County, New York",858,120,738,571,1144,161573,2002,2006,2001,21.5,482,342,32,117,80,738,60
2014,36061003100,"Census Tract 31, New York County, New York",868,115,753,564,1040,164265,2000,2008,2001,21.3,458,328,35,123,78,753,69
2015,36061003100,"Census Tract 31, New York County, New York",877,147,730,520,996,188846,1998,2010,2719,18.7,417,304,36,145,35,730,85
2016,36061003100,"Census Tract 31, New York County, New York",848,108,740,528,1045,194000,2000,2011,2826,18.6,442,328,29,142,23,740,63
2017,36061003100,"Census Tract 31, New York County, New York",851,104,747,550,1100,202308,1999,2011,2839,17.3,472,338,31,149,17,747,54
2018,36061003100,"Census Tract 31, New York County, New York",860,126,734,517,1005,195750,1999,2013,2849,18.3,434,343,5,144,9,734,54
2019,36061003100,"Census Tract 31, New York County, New York",897,167,730,512,880,172188,1999,2015,3021,19.8,461,373,7,107,7,730,65
2020,36061003100,"Census Tract 31, New York County, New York",942,202,740,532,989,159722,2001,NA,2998,22.9,493,394,6,94,10,740,46
2012,36061003200,"Census Tract 32, New York County, New York",4911,249,4662,4061,6853,60033,1939,2003,1452,30,2754,2826,238,521,537,4662,643
2013,36061003200,"Census Tract 32, New York County, New York",4888,471,4417,3795,6204,65728,1939,2003,1624,29.3,2790,2736,133,505,455,4417,506
2014,36061003200,"Census Tract 32, New York County, New York",4930,413,4517,3866,6277,70694,1939,2004,1657,27.9,2902,2939,119,449,389,4517,581
2015,36061003200,"Census Tract 32, New York County, New York",4881,410,4471,3879,6430,71276,1939,2006,1607,27.8,2990,2770,217,602,313,4471,627
2016,36061003200,"Census Tract 32, New York County, New York",4927,336,4591,4041,6756,72005,1939,2010,1762,27.9,2827,2875,176,709,300,4591,746
2017,36061003200,"Census Tract 32, New York County, New York",4932,437,4495,3946,6831,64872,1939,2009,1500,26.9,2798,2793,258,554,301,4495,693
2018,36061003200,"Census Tract 32, New York County, New York",4972,272,4700,4214,6831,63616,0,2010,1473,27,3064,2992,318,552,310,4700,853
2019,36061003200,"Census Tract 32, New York County, New York",4995,323,4672,4122,6680,64694,0,2011,1503,26.2,2695,2879,313,560,352,4672,687
2020,36061003200,"Census Tract 32, New York County, New York",4942,336,4606,3753,5875,67482,0,2011,1599,25,2631,2789,219,343,328,4606,748
2012,36061003300,"Census Tract 33, New York County, New York",2667,554,2113,1289,2786,201150,1939,2005,2001,13.2,1205,1080,36,119,40,2113,211
2013,36061003300,"Census Tract 33, New York County, New York",2694,385,2309,1280,2633,172159,1939,2006,2001,19,1189,1080,47,116,26,2309,194
2014,36061003300,"Census Tract 33, New York County, New York",2731,358,2373,1277,2561,164861,1939,2008,2001,17.7,1161,1079,63,60,27,2373,173
2015,36061003300,"Census Tract 33, New York County, New York",2721,423,2298,1183,2295,182344,1963,2010,3374,15.9,1015,1038,0,79,30,2298,124
2016,36061003300,"Census Tract 33, New York County, New York",2826,405,2421,1373,2555,136450,1981,2011,3117,20,1067,1129,0,149,36,2421,174
2017,36061003300,"Census Tract 33, New York County, New York",2874,358,2516,1486,2894,139861,1984,2012,3163,22.3,1206,1280,0,142,0,2516,147
2018,36061003300,"Census Tract 33, New York County, New York",2880,391,2489,1510,2894,143608,1987,2013,3089,21.7,1228,1169,0,260,18,2489,152
2019,36061003300,"Census Tract 33, New York County, New York",2977,549,2428,1521,3044,156146,1986,2015,3060,20.7,1280,1201,0,292,16,2428,105
2020,36061003300,"Census Tract 33, New York County, New York",3029,421,2608,1638,3401,225294,1981,2016,3158,12.3,1398,1355,0,193,73,2608,44
2012,36061003400,"Census Tract 34, New York County, New York",4110,295,3815,3414,6233,64363,1939,2003,1575,29.1,2436,2376,158,316,545,3815,669
2013,36061003400,"Census Tract 34, New York County, New York",4203,326,3877,3521,6111,65421,1939,2003,1657,29.8,2550,2611,106,312,455,3877,659
2014,36061003400,"Census Tract 34, New York County, New York",4172,331,3841,3487,6028,69850,1939,2005,1742,28.7,2505,2413,136,383,483,3841,674
2015,36061003400,"Census Tract 34, New York County, New York",4149,358,3791,3527,6052,NA,1939,2006,1864,28.7,2509,2474,96,408,448,3791,756
2016,36061003400,"Census Tract 34, New York County, New York",4006,301,3705,3459,5768,75867,1939,2011,2047,27.9,2422,2253,166,482,485,3705,800
2017,36061003400,"Census Tract 34, New York County, New York",3969,262,3707,3456,5979,73034,1939,2011,2076,28.9,2469,2286,181,444,511,3707,960
2018,36061003400,"Census Tract 34, New York County, New York",3831,196,3635,3359,5820,78372,0,2012,2132,27.5,2339,2173,181,425,500,3635,1003
2019,36061003400,"Census Tract 34, New York County, New York",3890,190,3700,3449,6057,80652,0,2013,2056,28.8,2456,2360,148,365,501,3700,1037
2020,36061003400,"Census Tract 34, New York County, New York",4038,338,3700,3447,5842,81559,1950,2016,1729,24.4,2660,2368,189,338,397,3700,969
2012,36061003601,"Census Tract 36.01, New York County, New York",1606,204,1402,1225,2593,31477,1977,2003,794,30.5,568,439,122,217,401,1402,399
2013,36061003601,"Census Tract 36.01, New York County, New York",1613,234,1379,1225,2835,32670,1977,2003,950,28.8,558,440,125,238,380,1379,376
2014,36061003601,"Census Tract 36.01, New York County, New York",1625,204,1421,1259,2813,46181,1978,2004,956,27.8,591,456,137,255,367,1421,339
2015,36061003601,"Census Tract 36.01, New York County, New York",1611,173,1438,1306,2941,43810,1977,2005,938,29.7,584,494,145,250,402,1438,455
2016,36061003601,"Census Tract 36.01, New York County, New York",1641,165,1476,1332,3065,47837,1973,2003,1262,30.2,551,468,128,301,457,1476,402
2017,36061003601,"Census Tract 36.01, New York County, New York",1627,155,1472,1334,3211,44318,1971,2003,1115,29.9,539,438,136,297,496,1472,434
2018,36061003601,"Census Tract 36.01, New York County, New York",1602,117,1485,1303,2657,44063,1965,2004,1042,31.4,498,367,144,285,534,1485,344
2019,36061003601,"Census Tract 36.01, New York County, New York",1579,139,1440,1273,2634,37431,1969,2005,986,32.3,453,345,148,287,510,1440,343
2020,36061003601,"Census Tract 36.01, New York County, New York",1632,152,1480,1316,2427,45476,1972,2008,1228,31.6,567,378,101,326,477,1480,293
2012,36061003602,"Census Tract 36.02, New York County, New York",1550,175,1375,1248,1950,50776,1939,2002,1452,33.9,762,842,144,82,138,1375,256
2013,36061003602,"Census Tract 36.02, New York County, New York",1586,192,1394,1237,1951,56403,1939,2003,1536,32.9,743,805,164,126,125,1394,244
2014,36061003602,"Census Tract 36.02, New York County, New York",1561,174,1387,1267,2075,64112,1939,2005,1602,31.1,787,837,88,155,137,1387,194
2015,36061003602,"Census Tract 36.02, New York County, New York",1578,164,1414,1272,2145,74000,1939,2008,1445,26.3,839,804,51,165,184,1414,166
2016,36061003602,"Census Tract 36.02, New York County, New York",1516,208,1308,1216,2001,79167,1939,2010,1585,26.8,841,794,47,168,152,1308,152
2017,36061003602,"Census Tract 36.02, New York County, New York",1499,196,1303,1218,2005,85833,1939,2010,1679,27.8,836,797,23,220,115,1303,179
2018,36061003602,"Census Tract 36.02, New York County, New York",1525,154,1371,1246,2002,90777,0,2012,1980,27,904,850,31,176,105,1371,131
2019,36061003602,"Census Tract 36.02, New York County, New York",1546,125,1421,1242,2015,87604,0,2012,1851,29.1,851,937,29,117,121,1421,228
2020,36061003602,"Census Tract 36.02, New York County, New York",1469,145,1324,1135,1859,91146,1949,2015,2251,29.2,790,951,28,89,45,1324,205
2012,36061003700,"Census Tract 37, New York County, New York",1477,264,1213,733,1266,73480,1939,2003,1753,27.8,543,630,0,50,40,1213,45
2013,36061003700,"Census Tract 37, New York County, New York",1490,220,1270,701,1193,78967,1939,2004,1789,26.1,577,551,0,85,41,1270,68
2014,36061003700,"Census Tract 37, New York County, New York",1550,234,1316,764,1418,84167,1939,2006,1804,25.6,613,575,21,98,37,1316,53
2015,36061003700,"Census Tract 37, New York County, New York",1570,209,1361,753,1342,104659,1939,2009,2211,22.1,618,541,20,110,61,1361,46
2016,36061003700,"Census Tract 37, New York County, New York",1596,248,1348,712,1201,104509,1939,2011,2304,22.2,565,543,18,68,63,1348,68
2017,36061003700,"Census Tract 37, New York County, New York",1601,189,1412,844,1400,106836,1939,2012,2503,23,724,627,30,95,71,1412,61
2018,36061003700,"Census Tract 37, New York County, New York",1659,306,1353,789,1351,108487,0,2012,2547,23.9,646,606,32,66,76,1353,51
2019,36061003700,"Census Tract 37, New York County, New York",1746,361,1385,754,1304,110625,0,2013,2615,26,613,664,10,31,39,1385,63
2020,36061003700,"Census Tract 37, New York County, New York",1916,527,1389,720,1257,108304,0,2015,2423,25.2,603,618,10,51,30,1389,52
2012,36061003800,"Census Tract 38, New York County, New York",5816,731,5085,4765,7776,60949,1939,2003,1622,30.3,3256,3380,126,639,479,5085,795
2013,36061003800,"Census Tract 38, New York County, New York",5795,770,5025,4676,7592,60666,1939,2003,1624,30.1,3219,3220,203,566,480,5025,726
2014,36061003800,"Census Tract 38, New York County, New York",5744,696,5048,4599,7218,62328,1939,2005,1671,29.5,3091,3251,140,543,504,5048,523
2015,36061003800,"Census Tract 38, New York County, New York",5649,631,5018,4613,7505,NA,1939,2008,1748,28.5,3208,3509,48,443,447,5018,554
2016,36061003800,"Census Tract 38, New York County, New York",5693,540,5153,4651,7196,60800,1939,2009,1756,29.9,3362,3493,130,305,616,5153,839
2017,36061003800,"Census Tract 38, New York County, New York",5559,530,5029,4528,7198,58542,1939,2011,1921,30.5,3131,3247,202,412,601,5029,570
2018,36061003800,"Census Tract 38, New York County, New York",5375,511,4864,4509,7772,58984,0,2012,2056,29,3072,3145,406,450,490,4864,508
2019,36061003800,"Census Tract 38, New York County, New York",5343,452,4891,4630,8037,64587,0,2013,2167,29,3385,3246,382,513,468,4891,746
2020,36061003800,"Census Tract 38, New York County, New York",5140,323,4817,4406,7654,66400,0,2015,2214,29.3,3191,3033,353,494,526,4817,607
2012,36061003900,"Census Tract 39, New York County, New York",2905,473,2432,1639,3021,63531,1975,2000,1424,27.7,1082,1310,198,45,86,2432,212
2013,36061003900,"Census Tract 39, New York County, New York",3059,517,2542,1710,3162,67382,1976,1999,1482,28.6,1208,1319,145,79,98,2542,249
2014,36061003900,"Census Tract 39, New York County, New York",3119,604,2515,1693,3079,75717,1976,2001,1664,30,1156,1284,159,50,154,2515,199
2015,36061003900,"Census Tract 39, New York County, New York",3159,631,2528,1668,3067,76000,1976,2000,1690,30.1,1157,1280,124,71,148,2528,189
2016,36061003900,"Census Tract 39, New York County, New York",3157,585,2572,1662,3278,102071,1976,1999,1847,26.7,1218,1351,125,48,92,2572,152
2017,36061003900,"Census Tract 39, New York County, New York",3218,730,2488,1535,2955,100492,1975,2000,1812,25.8,1146,1194,122,67,101,2488,138
2018,36061003900,"Census Tract 39, New York County, New York",3265,606,2659,1700,3333,104444,1975,2007,1865,20.3,1319,1450,106,37,94,2659,142
2019,36061003900,"Census Tract 39, New York County, New York",3419,530,2889,1798,3835,112813,1975,2010,1919,18.9,1475,1567,95,61,69,2889,106
2020,36061003900,"Census Tract 39, New York County, New York",3744,637,3107,2085,4289,187545,1975,2011,2138,15.7,1678,1864,89,30,84,3107,103
2012,36061004000,"Census Tract 40, New York County, New York",4554,556,3998,3302,6391,72708,1939,2003,1841,29.6,2308,2392,149,372,320,3998,658
2013,36061004000,"Census Tract 40, New York County, New York",4546,347,4199,3531,7008,74818,1939,2003,1771,27.9,2550,2655,161,311,368,4199,632
2014,36061004000,"Census Tract 40, New York County, New York",4573,340,4233,3741,7124,84985,1939,2005,1859,27.9,2834,2829,212,340,318,4233,535
2015,36061004000,"Census Tract 40, New York County, New York",4689,542,4147,3852,6795,84060,1939,2009,2054,29.1,2984,2938,233,220,440,4147,507
2016,36061004000,"Census Tract 40, New York County, New York",4695,365,4330,3880,6805,86066,1939,2011,2187,29.9,3102,3053,170,357,277,4330,467
2017,36061004000,"Census Tract 40, New York County, New York",4704,568,4136,3574,6026,89958,1939,2011,2198,28.3,3063,2927,57,302,288,4136,270
2018,36061004000,"Census Tract 40, New York County, New York",4665,733,3932,3405,5663,92365,0,2012,2353,26.9,2931,2648,26,360,371,3932,210
2019,36061004000,"Census Tract 40, New York County, New York",4659,637,4022,3493,5533,82083,0,2014,2238,28.5,2711,2635,96,400,311,4022,315
2020,36061004001,"Census Tract 40.01, New York County, New York",2414,293,2121,1767,2713,82438,0,2012,NA,26.3,1458,1260,0,186,297,2121,97
2020,36061004002,"Census Tract 40.02, New York County, New York",2207,220,1987,1669,3629,143257,0,2016,2799,18.1,1278,1179,83,216,161,1987,190
2012,36061004100,"Census Tract 41, New York County, New York",3781,629,3152,2885,6741,28804,1939,2001,1100,38.9,1072,979,23,1828,44,3152,892
2013,36061004100,"Census Tract 41, New York County, New York",3765,507,3258,2972,6762,37207,1939,2000,1154,35.2,1397,1054,90,1737,60,3258,818
2014,36061004100,"Census Tract 41, New York County, New York",3767,455,3312,2971,6447,50522,1939,2001,1216,30.8,1618,1145,114,1572,153,3312,799
2015,36061004100,"Census Tract 41, New York County, New York",3836,513,3323,3016,6913,56850,1939,2005,1323,28.6,1667,1177,69,1539,223,3323,640
2016,36061004100,"Census Tract 41, New York County, New York",3921,441,3480,3175,7417,71302,1939,2008,1405,26.1,1759,1251,58,1633,197,3480,555
2017,36061004100,"Census Tract 41, New York County, New York",3911,395,3516,3213,7612,75850,1939,2008,1348,25.3,1647,1241,66,1653,187,3516,639
2018,36061004100,"Census Tract 41, New York County, New York",3848,435,3413,3174,7339,78104,0,2010,1408,25.1,1663,1243,43,1646,217,3413,582
2019,36061004100,"Census Tract 41, New York County, New York",3828,448,3380,3184,7271,82042,0,2010,1318,23.7,1745,1262,16,1671,183,3380,592
2020,36061004100,"Census Tract 41, New York County, New York",3751,440,3311,3087,6743,84583,0,2010,1385,26.3,1777,1400,65,1496,138,3311,608
2012,36061004200,"Census Tract 42, New York County, New York",1711,88,1623,1039,2219,121094,1963,2004,2001,24.8,838,718,39,140,107,1623,121
2013,36061004200,"Census Tract 42, New York County, New York",1801,203,1598,1059,2183,105938,1964,2006,2001,24.8,858,698,37,194,103,1598,163
2014,36061004200,"Census Tract 42, New York County, New York",1801,274,1527,934,1906,114545,1964,2009,2001,24.4,741,634,50,197,45,1527,151
2015,36061004200,"Census Tract 42, New York County, New York",1817,275,1542,983,1968,125139,1960,2011,2182,22.4,764,686,41,199,35,1542,164
2016,36061004200,"Census Tract 42, New York County, New York",1847,341,1506,999,1861,115417,1957,2011,2442,23.2,786,673,45,226,45,1506,160
2017,36061004200,"Census Tract 42, New York County, New York",1910,366,1544,1026,1747,103581,1952,2012,2644,24.5,824,688,21,249,57,1544,204
2018,36061004200,"Census Tract 42, New York County, New York",1864,312,1552,1016,1655,101429,1946,2012,2565,26.1,747,698,11,190,92,1552,158
2019,36061004200,"Census Tract 42, New York County, New York",1879,269,1610,1104,1802,120583,1951,2012,2784,25.7,841,728,25,214,104,1610,137
2020,36061004200,"Census Tract 42, New York County, New York",1880,303,1577,1092,1691,93333,1953,2012,2782,35,858,735,30,214,91,1577,208
2012,36061004300,"Census Tract 43, New York County, New York",2578,203,2375,2017,3973,69987,1939,2003,1519,26.4,1493,1301,0,427,184,2375,390
2013,36061004300,"Census Tract 43, New York County, New York",2598,264,2334,2007,3738,69375,1939,2005,1665,27.8,1468,1361,0,373,151,2334,373
2014,36061004300,"Census Tract 43, New York County, New York",2531,184,2347,2107,3865,78274,1939,2007,1784,24.3,1438,1426,0,381,97,2347,381
2015,36061004300,"Census Tract 43, New York County, New York",2478,164,2314,2015,3606,71258,1939,2006,1809,27.5,1375,1322,0,420,91,2314,387
2016,36061004300,"Census Tract 43, New York County, New York",2520,214,2306,2033,3656,69105,1939,2007,2185,30.2,1470,1285,0,518,85,2306,379
2017,36061004300,"Census Tract 43, New York County, New York",2556,241,2315,1974,3404,72071,1939,2011,2096,27,1440,1229,0,477,129,2315,477
2018,36061004300,"Census Tract 43, New York County, New York",2479,390,2089,1777,3182,73662,0,2011,2106,26.4,1318,1100,0,414,164,2089,402
2019,36061004300,"Census Tract 43, New York County, New York",2578,469,2109,1738,3237,73134,0,2012,2012,23,1233,974,56,428,271,2109,326
2020,36061004300,"Census Tract 43, New York County, New York",2805,516,2289,1959,3093,73656,0,2015,2273,23.5,1506,1160,50,348,290,2289,498
2012,36061004400,"Census Tract 44, New York County, New York",8416,291,8125,8076,16894,91205,1946,1998,1760,24.5,6197,6158,384,1001,388,8125,762
2013,36061004400,"Census Tract 44, New York County, New York",8297,297,8000,7965,17675,91912,1946,1998,1774,25.2,6364,6409,230,910,285,8000,751
2014,36061004400,"Census Tract 44, New York County, New York",8281,267,8014,8014,16735,92267,1946,1999,1790,24.5,6480,6333,222,896,387,8014,1035
2015,36061004400,"Census Tract 44, New York County, New York",8345,400,7945,7945,16200,93010,1946,1998,1834,24.7,6472,6314,215,959,334,7945,1002
2016,36061004400,"Census Tract 44, New York County, New York",8460,390,8070,8070,16039,94000,1946,1999,1870,26.8,6648,6582,198,774,364,8070,841
2017,36061004400,"Census Tract 44, New York County, New York",8395,356,8039,8039,17069,98886,1946,2002,2002,27.7,6409,6090,413,906,520,8039,843
2018,36061004400,"Census Tract 44, New York County, New York",8420,275,8145,8145,16684,101736,1946,2004,2293,28.2,6412,5988,469,964,640,8145,821
2019,36061004400,"Census Tract 44, New York County, New York",8383,294,8089,8089,16594,104520,1947,2008,2672,28.5,6357,6147,408,966,552,8089,697
2020,36061004400,"Census Tract 44, New York County, New York",8332,254,8078,8078,16600,106395,1946,2011,3010,25,6763,5785,598,1274,412,8078,1038
2012,36061004500,"Census Tract 45, New York County, New York",615,177,438,268,529,51429,1939,2001,1371,23.5,187,183,0,52,0,438,61
2013,36061004500,"Census Tract 45, New York County, New York",582,174,408,221,435,78854,1939,2002,1625,14.7,171,144,0,47,0,408,49
2014,36061004500,"Census Tract 45, New York County, New York",588,155,433,223,543,137902,1939,2004,1629,13.9,184,138,0,52,0,433,38
2015,36061004500,"Census Tract 45, New York County, New York",571,151,420,235,540,86917,1939,2004,1219,12.4,175,136,0,71,0,420,32
2016,36061004500,"Census Tract 45, New York County, New York",501,106,395,228,493,85313,1939,2003,1161,13,167,120,0,82,0,395,24
2017,36061004500,"Census Tract 45, New York County, New York",466,36,430,202,428,87500,1939,2005,1134,16.1,123,103,0,78,0,430,27
2018,36061004500,"Census Tract 45, New York County, New York",534,103,431,224,453,60588,0,2010,1147,18.6,121,84,4,100,11,431,32
2019,36061004500,"Census Tract 45, New York County, New York",524,119,405,235,515,63068,0,2004,1212,18.1,129,116,5,91,13,405,31
2020,36061004500,"Census Tract 45, New York County, New York",546,82,464,253,477,106033,0,2009,1773,19,180,129,5,91,12,464,40
2012,36061004700,"Census Tract 47, New York County, New York",1519,254,1265,949,1424,74129,1939,2001,1150,25.9,644,860,0,0,74,1265,149
2013,36061004700,"Census Tract 47, New York County, New York",1586,289,1297,984,1401,70938,1939,1999,1450,27.9,689,857,0,29,76,1297,146
2014,36061004700,"Census Tract 47, New York County, New York",1598,257,1341,1001,1556,80642,1939,2000,1593,26.6,759,882,0,26,76,1341,122
2015,36061004700,"Census Tract 47, New York County, New York",1629,321,1308,916,1463,100750,1939,2001,1879,18.6,682,835,0,25,41,1308,143
2016,36061004700,"Census Tract 47, New York County, New York",1725,483,1242,896,1428,121053,1939,2010,2154,21.8,681,774,0,56,53,1242,131
2017,36061004700,"Census Tract 47, New York County, New York",1696,463,1233,832,1389,124038,1939,2011,2242,22.1,650,700,9,52,56,1233,136
2018,36061004700,"Census Tract 47, New York County, New York",1705,433,1272,850,1318,121875,0,2013,2343,23.1,654,680,12,43,83,1272,130
2019,36061004700,"Census Tract 47, New York County, New York",1739,397,1342,894,1461,105885,0,2015,2177,21.3,702,670,10,98,82,1342,124
2020,36061004700,"Census Tract 47, New York County, New York",1785,335,1450,1021,1455,139125,0,2016,2981,27.3,841,798,16,99,75,1450,102
2012,36061004800,"Census Tract 48, New York County, New York",3951,486,3465,2026,4020,86641,1943,2003,1770,26.1,1478,1603,37,267,95,3465,143
2013,36061004800,"Census Tract 48, New York County, New York",3799,295,3504,2047,4237,90375,1942,2004,1829,26.2,1423,1658,53,234,80,3504,80
2014,36061004800,"Census Tract 48, New York County, New York",3781,300,3481,2103,3930,84610,1944,2005,1851,26.9,1501,1576,135,256,129,3481,198
2015,36061004800,"Census Tract 48, New York County, New York",3898,505,3393,2041,3657,91172,1943,2006,1911,27.7,1438,1493,125,255,137,3393,188
2016,36061004800,"Census Tract 48, New York County, New York",3848,478,3370,1955,3419,93347,1939,2006,1802,26.2,1335,1385,87,268,182,3370,201
2017,36061004800,"Census Tract 48, New York County, New York",3788,556,3232,1672,2924,86591,1939,2009,1936,26.7,1184,1217,75,226,139,3232,199
2018,36061004800,"Census Tract 48, New York County, New York",3903,909,2994,1484,2410,89408,0,2010,2002,25.8,1079,1024,64,195,160,2994,245
2019,36061004800,"Census Tract 48, New York County, New York",3862,898,2964,1408,2252,109031,0,2012,2324,24.6,1128,1044,0,189,117,2964,137
2020,36061004800,"Census Tract 48, New York County, New York",3832,1020,2812,1295,2167,123464,0,2015,2547,23.9,1023,981,0,184,96,2812,158
2012,36061004900,"Census Tract 49, New York County, New York",3120,446,2674,1932,3054,92476,1939,2004,1895,23.8,1517,1724,105,27,32,2674,122
2013,36061004900,"Census Tract 49, New York County, New York",3054,369,2685,2014,3278,95571,1939,2006,1922,22.9,1675,1792,88,58,41,2685,102
2014,36061004900,"Census Tract 49, New York County, New York",2964,414,2550,1922,2983,97895,1939,2008,2001,23.5,1612,1588,110,87,114,2550,74
2015,36061004900,"Census Tract 49, New York County, New York",2994,540,2454,1914,2896,93472,1939,2010,2105,25.4,1525,1492,114,145,133,2454,104
2016,36061004900,"Census Tract 49, New York County, New York",2991,539,2452,1911,2941,95417,1939,2011,2038,25.4,1507,1473,102,157,146,2452,168
2017,36061004900,"Census Tract 49, New York County, New York",2978,531,2447,1878,2866,77013,1939,2011,2062,29.4,1479,1428,66,181,174,2447,198
2018,36061004900,"Census Tract 49, New York County, New York",3064,488,2576,1982,3014,83500,0,2011,2213,29.8,1525,1481,76,210,182,2576,212
2019,36061004900,"Census Tract 49, New York County, New York",3086,421,2665,2119,3107,82623,0,2013,2140,26.8,1655,1621,32,258,174,2665,270
2020,36061004900,"Census Tract 49, New York County, New York",3057,432,2625,1985,3049,103640,0,2012,2149,24.1,1759,1547,33,214,176,2625,207
2012,36061005000,"Census Tract 50, New York County, New York",3664,558,3106,1825,2993,104398,1955,2002,1937,24.9,1581,1634,9,128,54,3106,196
2013,36061005000,"Census Tract 50, New York County, New York",3595,628,2967,1739,3001,87479,1954,2002,2001,26.6,1504,1487,0,175,50,2967,245
2014,36061005000,"Census Tract 50, New York County, New York",3605,607,2998,1787,3205,101161,1954,2003,2001,25.3,1494,1446,42,167,149,2998,239
2015,36061005000,"Census Tract 50, New York County, New York",3558,711,2847,1704,3167,100288,1956,2006,2483,25.9,1457,1333,46,232,110,2847,284
2016,36061005000,"Census Tract 50, New York County, New York",3545,790,2755,1520,3022,125500,1954,2009,2686,21.2,1334,1149,51,238,105,2755,263
2017,36061005000,"Census Tract 50, New York County, New York",3534,675,2859,1521,2742,126902,1954,2010,2641,21.3,1380,1189,50,211,95,2859,275
2018,36061005000,"Census Tract 50, New York County, New York",3530,613,2917,1613,2852,165546,1954,2012,2831,20.5,1488,1197,54,315,101,2917,226
2019,36061005000,"Census Tract 50, New York County, New York",3523,686,2837,1527,2447,112250,1954,2013,2698,19.9,1324,1161,52,297,17,2837,199
2020,36061005000,"Census Tract 50, New York County, New York",3357,537,2820,1379,2165,133203,1951,2015,2767,24.2,1235,1055,39,285,0,2820,94
2012,36061005200,"Census Tract 52, New York County, New York",1774,368,1406,769,1591,152204,1947,2003,2001,16.4,631,612,0,78,72,1406,123
2013,36061005200,"Census Tract 52, New York County, New York",1785,305,1480,722,1490,150724,1943,2004,2001,17.6,569,514,0,108,80,1480,138
2014,36061005200,"Census Tract 52, New York County, New York",1773,314,1459,732,1328,152368,1951,2007,2001,18.6,583,492,0,125,90,1459,186
2015,36061005200,"Census Tract 52, New York County, New York",1799,334,1465,731,1329,155708,1949,2009,2620,17.7,601,502,0,118,91,1465,199
2016,36061005200,"Census Tract 52, New York County, New York",1799,289,1510,761,1429,155324,1956,2009,2660,18.5,645,586,0,101,64,1510,180
2017,36061005200,"Census Tract 52, New York County, New York",1791,294,1497,634,1070,135385,1962,2011,2810,21.8,583,543,0,73,9,1497,139
2018,36061005200,"Census Tract 52, New York County, New York",1780,357,1423,617,1002,132330,1955,2011,2736,22.9,568,554,0,53,10,1423,125
2019,36061005200,"Census Tract 52, New York County, New York",1755,386,1369,579,921,154250,1957,2010,2986,22.3,536,516,0,53,10,1369,98
2020,36061005200,"Census Tract 52, New York County, New York",1745,410,1335,524,866,122857,1962,2012,3333,30,485,466,11,34,9,1335,73
2012,36061005400,"Census Tract 54, New York County, New York",2778,369,2409,964,1567,114167,1962,2003,2001,20.8,787,748,0,36,122,2409,233
2013,36061005400,"Census Tract 54, New York County, New York",2837,358,2479,996,1626,105476,1962,2005,2001,24.4,880,792,0,85,93,2479,217
2014,36061005400,"Census Tract 54, New York County, New York",2876,295,2581,1225,1958,124531,1962,2006,2001,22,1079,907,0,178,140,2581,201
2015,36061005400,"Census Tract 54, New York County, New York",2849,332,2517,1163,1828,125049,1961,2007,2573,24.2,1005,808,0,206,129,2517,139
2016,36061005400,"Census Tract 54, New York County, New York",2851,264,2587,1268,2108,126389,1960,2008,2624,22.9,1036,938,16,233,51,2587,101
2017,36061005400,"Census Tract 54, New York County, New York",2874,236,2638,1401,2226,133162,1961,2010,2806,23.4,1176,999,25,330,17,2638,69
2018,36061005400,"Census Tract 54, New York County, New York",2861,313,2548,1344,2276,162866,1961,2010,2673,18.7,1159,993,26,265,29,2548,29
2019,36061005400,"Census Tract 54, New York County, New York",2943,269,2674,1337,2197,164926,1961,2009,2969,19.3,1180,988,30,274,15,2674,66
2020,36061005400,"Census Tract 54, New York County, New York",3181,447,2734,1500,2438,166250,1961,2013,2343,18.2,1362,995,30,381,78,2734,113
2012,36061005501,"Census Tract 55.01, New York County, New York",2528,389,2139,1736,3505,93243,1960,2003,1890,21.2,1584,1449,13,162,30,2139,59
2013,36061005501,"Census Tract 55.01, New York County, New York",2483,293,2190,1710,3643,117308,1960,2003,2001,18.6,1553,1513,25,113,13,2190,63
2014,36061005501,"Census Tract 55.01, New York County, New York",2444,265,2179,1770,3663,111250,1960,2005,2001,20.2,1613,1503,26,198,0,2179,74
2015,36061005501,"Census Tract 55.01, New York County, New York",2454,295,2159,1724,3367,116500,1960,2006,2045,21.2,1658,1335,54,260,0,2159,65
2016,36061005501,"Census Tract 55.01, New York County, New York",2424,360,2064,1563,3157,141875,1959,2009,2100,19.6,1523,1272,49,215,0,2064,60
2017,36061005501,"Census Tract 55.01, New York County, New York",2416,307,2109,1648,3333,160968,1961,2010,2256,18.4,1572,1229,101,239,10,2109,62
2018,36061005501,"Census Tract 55.01, New York County, New York",2407,370,2037,1543,3131,155938,1961,2010,2376,19.7,1429,1100,86,232,10,2037,108
2019,36061005501,"Census Tract 55.01, New York County, New York",2428,315,2113,1578,3239,150111,1962,2010,2673,19,1341,1124,87,211,61,2113,143
2020,36061005501,"Census Tract 55.01, New York County, New York",2358,376,1982,1457,3067,151023,1961,2011,2718,19.4,1220,1007,56,203,77,1982,184
2012,36061005502,"Census Tract 55.02, New York County, New York",1334,203,1131,664,1090,101000,1939,2006,2001,29.6,561,499,39,83,36,1131,126
2013,36061005502,"Census Tract 55.02, New York County, New York",1262,82,1180,753,1459,94292,1939,2007,2001,30.9,613,587,30,39,76,1180,154
2014,36061005502,"Census Tract 55.02, New York County, New York",1283,59,1224,783,1406,103065,1939,2011,2001,24.5,649,591,40,27,120,1224,110
2015,36061005502,"Census Tract 55.02, New York County, New York",1292,125,1167,769,1370,104417,1939,2011,2355,25.1,651,551,38,28,126,1167,86
2016,36061005502,"Census Tract 55.02, New York County, New York",1196,119,1077,787,1426,106992,1939,2011,2349,18.6,637,579,37,27,116,1077,93
2017,36061005502,"Census Tract 55.02, New York County, New York",1156,125,1031,718,1221,125556,1939,2012,2422,22.3,597,578,8,15,102,1031,53
2018,36061005502,"Census Tract 55.02, New York County, New York",1162,155,1007,711,1029,129536,1961,2014,2910,22.3,559,574,9,24,80,1007,47
2019,36061005502,"Census Tract 55.02, New York County, New York",1142,173,969,637,897,124688,1956,2015,3188,24.9,459,514,10,17,56,969,58
2020,36061005502,"Census Tract 55.02, New York County, New York",1132,129,1003,732,1039,117926,0,2017,3047,20.2,473,515,8,45,145,1003,63
2012,36061005600,"Census Tract 56, New York County, New York",2140,356,1784,1060,1686,92125,1956,2006,2001,27.4,763,623,108,110,194,1784,270
2013,36061005600,"Census Tract 56, New York County, New York",2190,565,1625,1019,1571,115320,1961,2008,2001,25.6,706,620,107,114,177,1625,248
2014,36061005600,"Census Tract 56, New York County, New York",2208,563,1645,1010,1517,89563,1957,2010,2001,27,754,548,115,180,184,1645,313
2015,36061005600,"Census Tract 56, New York County, New York",2223,545,1678,1137,1709,89704,1952,2011,2503,24.4,874,776,78,146,137,1678,360
2016,36061005600,"Census Tract 56, New York County, New York",2312,633,1679,1156,1797,96250,1939,2011,1705,22.7,846,754,73,191,138,1679,331
2017,36061005600,"Census Tract 56, New York County, New York",2427,642,1785,1222,1794,60300,1939,2011,1294,22.4,832,804,92,189,137,1785,352
2018,36061005600,"Census Tract 56, New York County, New York",2493,464,2029,1232,1825,59559,0,2011,1486,25.1,902,861,81,214,76,2029,385
2019,36061005600,"Census Tract 56, New York County, New York",2656,410,2246,1386,2179,NA,0,2013,1331,23.8,971,1063,80,144,99,2246,407
2020,36061005600,"Census Tract 56, New York County, New York",2811,482,2329,1577,2451,NA,0,2013,681,24.4,830,944,110,138,385,2329,470
2012,36061005700,"Census Tract 57, New York County, New York",1742,125,1617,996,1749,126855,1972,2005,2001,28.4,870,873,28,84,11,1617,76
2013,36061005700,"Census Tract 57, New York County, New York",1789,137,1652,1023,1812,155625,1973,2007,2001,23.9,905,879,25,119,0,1652,72
2014,36061005700,"Census Tract 57, New York County, New York",1825,175,1650,988,1702,144118,1973,2009,2001,26.3,891,815,62,111,0,1650,78
2015,36061005700,"Census Tract 57, New York County, New York",1864,210,1654,961,1598,150125,1973,2011,3345,25.3,887,747,86,128,0,1654,68
2016,36061005700,"Census Tract 57, New York County, New York",1853,240,1613,911,1477,135104,1971,2011,3501,26.4,871,671,71,129,0,1613,55
2017,36061005700,"Census Tract 57, New York County, New York",1814,285,1529,830,1288,146750,1972,2012,3500,23.5,785,605,75,101,10,1529,57
2018,36061005700,"Census Tract 57, New York County, New York",1801,240,1561,839,1243,157917,1972,2013,3501,23,795,604,76,101,10,1561,36
2019,36061005700,"Census Tract 57, New York County, New York",1785,229,1556,827,1289,180924,1971,2013,3501,21.3,777,656,24,92,7,1556,73
2020,36061005700,"Census Tract 57, New York County, New York",1635,220,1415,820,1641,185357,1971,2015,3501,23.8,781,620,11,137,7,1415,64
2012,36061005800,"Census Tract 58, New York County, New York",2300,313,1987,1923,2940,120917,2001,2006,2001,24.2,1551,1266,63,440,106,1987,213
2013,36061005800,"Census Tract 58, New York County, New York",2306,218,2088,2043,3071,110804,2003,2008,2001,24.4,1631,1392,45,517,47,2088,189
2014,36061005800,"Census Tract 58, New York County, New York",2293,308,1985,1898,2767,145250,2003,2011,2001,23.9,1653,1365,14,451,32,1985,108
2015,36061005800,"Census Tract 58, New York County, New York",2346,353,1993,1866,2895,147039,2003,2011,2947,21.7,1614,1389,13,392,32,1993,109
2016,36061005800,"Census Tract 58, New York County, New York",2376,344,2032,1903,3210,168839,2003,2012,3059,19.7,1630,1422,22,356,71,2032,52
2017,36061005800,"Census Tract 58, New York County, New York",2254,259,1995,1849,2959,181729,2003,2012,2969,17.6,1648,1461,32,316,72,1995,104
2018,36061005800,"Census Tract 58, New York County, New York",2345,220,2125,1886,2891,186204,2002,2013,2691,17,1695,1330,0,406,150,2125,101
2019,36061005800,"Census Tract 58, New York County, New York",2464,57,2407,2174,3697,192019,2002,2015,2194,13,1980,1460,0,413,202,2407,129
2020,36061005800,"Census Tract 58, New York County, New York",2425,89,2336,2173,3770,144563,2001,2015,1474,17.7,1824,1288,72,411,275,2336,213
2012,36061005900,"Census Tract 59, New York County, New York",3338,387,2951,1323,1964,71272,1939,2000,1716,26.7,1103,1043,16,136,103,2951,205
2013,36061005900,"Census Tract 59, New York County, New York",3276,420,2856,1283,2004,64293,1939,2002,1788,26.9,1033,1052,0,119,85,2856,226
2014,36061005900,"Census Tract 59, New York County, New York",3242,355,2887,1091,1627,71268,1939,2000,1827,26.4,899,906,0,98,75,2887,170
2015,36061005900,"Census Tract 59, New York County, New York",3348,367,2981,1195,1698,71009,1939,2004,1868,29.1,960,990,0,131,64,2981,111
2016,36061005900,"Census Tract 59, New York County, New York",3334,404,2930,1228,1787,70822,1939,2001,2081,30.9,946,978,0,147,94,2930,104
2017,36061005900,"Census Tract 59, New York County, New York",3292,398,2894,1113,1621,70843,1939,2004,2127,32.2,797,877,0,157,79,2894,121
2018,36061005900,"Census Tract 59, New York County, New York",3298,486,2812,1003,1460,73930,0,1999,2177,31.5,757,785,0,169,49,2812,104
2019,36061005900,"Census Tract 59, New York County, New York",3354,581,2773,1008,1565,75278,0,2008,2288,32.3,735,775,0,167,66,2773,109
2020,36061005900,"Census Tract 59, New York County, New York",3246,531,2715,1051,1668,54350,0,2010,2217,36.5,894,768,0,154,129,2715,145
2012,36061006000,"Census Tract 60, New York County, New York",2475,119,2356,2356,4905,105321,1946,1998,1844,23.4,1730,1942,76,235,103,2356,144
2013,36061006000,"Census Tract 60, New York County, New York",2459,83,2376,2376,5286,103824,1946,1999,1985,24.2,1725,1886,74,278,123,2376,241
2014,36061006000,"Census Tract 60, New York County, New York",2480,80,2400,2400,5026,107014,NA,2001,2001,24.3,1814,1896,75,289,123,2400,185
2015,36061006000,"Census Tract 60, New York County, New York",2439,105,2334,2334,5063,106310,1946,2005,2337,23.9,1813,1838,30,306,126,2334,205
2016,36061006000,"Census Tract 60, New York County, New York",2470,60,2410,2410,5423,109167,1946,2008,2476,24.8,2008,1921,34,303,124,2410,227
2017,36061006000,"Census Tract 60, New York County, New York",2465,70,2395,2395,5457,123563,NA,2010,2629,23.2,2108,1895,47,290,118,2395,186
2018,36061006000,"Census Tract 60, New York County, New York",2469,61,2408,2408,5348,133889,1946,2011,2395,21.5,2170,1888,36,297,150,2408,110
2019,36061006000,"Census Tract 60, New York County, New York",2523,111,2412,2412,5741,169778,1947,2011,2330,19.2,2138,1903,30,274,142,2412,80
2020,36061006000,"Census Tract 60, New York County, New York",2545,80,2465,2465,5849,170898,1947,2010,2321,19.4,2227,2025,22,231,149,2465,46
2012,36061006100,"Census Tract 61, New York County, New York",2675,427,2248,1184,2009,97955,1951,2005,2001,31.5,984,974,12,113,76,2248,277
2013,36061006100,"Census Tract 61, New York County, New York",2683,478,2205,1154,1822,106944,1951,2007,2001,31.1,965,962,11,107,69,2205,233
2014,36061006100,"Census Tract 61, New York County, New York",2710,435,2275,1136,1790,108846,1954,2010,2001,27.7,935,988,12,74,67,2275,134
2015,36061006100,"Census Tract 61, New York County, New York",2688,337,2351,1214,1900,117813,1961,2011,2718,25.5,1005,1049,0,111,54,2351,98
2016,36061006100,"Census Tract 61, New York County, New York",2672,442,2230,1235,1722,103512,1962,2011,2688,29.7,1011,1030,0,102,73,2230,84
2017,36061006100,"Census Tract 61, New York County, New York",2658,471,2187,1242,1715,147500,1961,2011,2728,21.2,1061,1057,0,85,68,2187,70
2018,36061006100,"Census Tract 61, New York County, New York",2651,477,2174,1169,1673,152917,1961,2011,2636,19.3,1028,1041,0,57,40,2174,74
2019,36061006100,"Census Tract 61, New York County, New York",2680,605,2075,1125,1570,151696,1961,2012,2514,19.7,1021,946,0,92,53,2075,67
2020,36061006100,"Census Tract 61, New York County, New York",2661,721,1940,902,1452,132273,1952,2013,2335,22.3,838,702,0,58,91,1940,60
2012,36061006200,"Census Tract 62, New York County, New York",1385,52,1333,1333,2772,70179,1975,2004,2001,31.5,1168,776,39,276,180,1333,299
2013,36061006200,"Census Tract 62, New York County, New York",1401,54,1347,1347,3019,93750,NA,2005,2001,28.9,1188,764,79,320,142,1347,278
2014,36061006200,"Census Tract 62, New York County, New York",1411,100,1311,1311,2784,100293,1975,2006,2001,29,1165,782,82,292,111,1311,237
2015,36061006200,"Census Tract 62, New York County, New York",1385,86,1299,1295,2682,82330,1975,2009,2338,30.8,1171,732,113,313,84,1299,273
2016,36061006200,"Census Tract 62, New York County, New York",1411,69,1342,1334,2629,103110,1976,2010,2438,28.3,1150,794,115,286,90,1342,190
2017,36061006200,"Census Tract 62, New York County, New York",1711,135,1576,1566,3050,105313,1975,2011,2546,28.5,1344,878,199,349,82,1576,172
2018,36061006200,"Census Tract 62, New York County, New York",1711,257,1454,1448,2633,93367,NA,2011,2713,31.7,1235,839,161,342,50,1454,168
2019,36061006200,"Census Tract 62, New York County, New York",1710,230,1480,1474,2862,88571,1975,2012,2660,31.3,1275,851,180,303,86,1480,186
2020,36061006200,"Census Tract 62, New York County, New York",1636,296,1340,1340,2759,86976,1975,2012,2652,32.5,1133,689,137,272,143,1340,143
2012,36061006300,"Census Tract 63, New York County, New York",4228,546,3682,2233,3718,103995,1939,2003,2001,22.7,1962,1931,14,85,115,3682,274
2013,36061006300,"Census Tract 63, New York County, New York",4277,674,3603,2216,3480,103968,1939,2005,2001,25.8,1919,1867,15,115,132,3603,211
2014,36061006300,"Census Tract 63, New York County, New York",4332,578,3754,2443,3593,103901,1939,2005,2001,28.8,2046,2016,28,163,180,3754,225
2015,36061006300,"Census Tract 63, New York County, New York",4353,617,3736,2322,3389,105473,1939,2005,2207,28.6,1957,1885,15,224,183,3736,210
2016,36061006300,"Census Tract 63, New York County, New York",4380,711,3669,2148,3077,102344,1939,2007,2243,29.1,1707,1766,16,198,152,3669,222
2017,36061006300,"Census Tract 63, New York County, New York",4386,806,3580,1968,3203,107697,1939,2007,2268,27,1572,1643,18,165,142,3580,266
2018,36061006300,"Census Tract 63, New York County, New York",4299,766,3533,1803,2954,112257,0,2010,2360,25.5,1455,1517,19,144,105,3533,269
2019,36061006300,"Census Tract 63, New York County, New York",4191,832,3359,1606,2792,145278,0,2013,2486,19.7,1298,1391,0,108,72,3359,188
2020,36061006300,"Census Tract 63, New York County, New York",4258,905,3353,1824,3180,150463,0,2015,2628,24.8,1520,1510,0,112,169,3353,170
2012,36061006400,"Census Tract 64, New York County, New York",5086,562,4524,3141,5204,86676,1962,2004,1940,26.4,2509,2596,33,274,199,4524,482
2013,36061006400,"Census Tract 64, New York County, New York",5058,594,4464,3160,5165,84167,1964,2005,2001,26.5,2647,2584,56,330,169,4464,474
2014,36061006400,"Census Tract 64, New York County, New York",5077,676,4401,3211,5486,87010,1964,2007,2001,27.2,2788,2557,66,435,114,4401,331
2015,36061006400,"Census Tract 64, New York County, New York",5075,529,4546,3372,5764,90906,1964,2010,2213,27.1,2991,2638,66,429,126,4546,330
2016,36061006400,"Census Tract 64, New York County, New York",5069,642,4427,3136,5404,110485,1963,2011,2361,26.6,2800,2409,38,392,153,4427,286
2017,36061006400,"Census Tract 64, New York County, New York",5097,592,4505,3257,5367,106862,1960,2011,2408,26.5,2819,2540,31,454,91,4505,370
2018,36061006400,"Census Tract 64, New York County, New York",5153,758,4395,3352,5526,116261,1953,2012,2633,25.3,2916,2527,22,374,226,4395,399
2019,36061006400,"Census Tract 64, New York County, New York",5200,797,4403,3066,4601,106161,1954,2012,2706,26.2,2650,2375,0,268,321,4403,459
2020,36061006400,"Census Tract 64, New York County, New York",5445,1237,4208,2836,4277,96849,1941,2013,2705,28.5,2122,2099,153,337,247,4208,797
2012,36061006500,"Census Tract 65, New York County, New York",3629,462,3167,2842,4814,69412,1939,2002,1767,27.6,2229,2295,138,138,136,3167,333
2013,36061006500,"Census Tract 65, New York County, New York",3568,508,3060,2733,4628,79315,1939,2003,1833,27.3,2147,2204,138,143,125,3060,283
2014,36061006500,"Census Tract 65, New York County, New York",3533,519,3014,2699,4573,79341,1939,2009,2001,29,2114,2098,184,119,169,3014,347
2015,36061006500,"Census Tract 65, New York County, New York",3583,542,3041,2760,4785,90478,1939,2010,2100,29.3,2165,2207,175,106,190,3041,374
2016,36061006500,"Census Tract 65, New York County, New York",3572,462,3110,2820,4997,100784,1939,NA,2258,28,2093,2224,146,116,199,3110,364
2017,36061006500,"Census Tract 65, New York County, New York",3600,437,3163,2831,4953,103229,1939,2012,2325,28.6,2100,2160,137,142,259,3163,292
2018,36061006500,"Census Tract 65, New York County, New York",3576,414,3162,2863,5066,105184,0,NA,2329,27.2,2153,2210,113,154,245,3162,288
2019,36061006500,"Census Tract 65, New York County, New York",3569,447,3122,2778,4764,103403,0,2012,2394,26.9,2101,2254,79,180,190,3122,279
2020,36061006500,"Census Tract 65, New York County, New York",3848,504,3344,3067,4708,100818,0,2013,2307,26.7,2432,2414,107,259,215,3344,309
2012,36061006600,"Census Tract 66, New York County, New York",6869,879,5990,4402,8748,62020,1963,2002,1205,23.3,2504,2659,297,482,875,5990,746
2013,36061006600,"Census Tract 66, New York County, New York",6818,918,5900,4376,8926,64070,1963,2002,1218,22.7,2474,2598,286,529,809,5900,731
2014,36061006600,"Census Tract 66, New York County, New York",6962,932,6030,4498,8944,64012,1962,2003,1184,23.6,2395,2561,300,602,883,6030,939
2015,36061006600,"Census Tract 66, New York County, New York",6986,789,6197,4448,8441,62720,1963,2004,1164,24.7,2244,2445,323,587,989,6197,1095
2016,36061006600,"Census Tract 66, New York County, New York",7047,624,6423,4510,8064,64210,1966,2007,1379,26.3,2255,2367,239,573,1199,6423,1151
2017,36061006600,"Census Tract 66, New York County, New York",6969,725,6244,4514,7897,69864,1967,2010,1656,29.4,2496,2345,206,562,1260,6244,1174
2018,36061006600,"Census Tract 66, New York County, New York",6938,528,6410,4428,7199,71144,1969,2011,1597,31.6,2596,2559,157,668,893,6410,1188
2019,36061006600,"Census Tract 66, New York County, New York",6891,439,6452,4395,8266,82489,1967,2013,1391,30.1,2545,2238,291,734,961,6452,944
2020,36061006600,"Census Tract 66, New York County, New York",7209,660,6549,4243,7914,85188,1965,2012,1419,27.6,2404,2260,296,635,966,6549,659
2012,36061006700,"Census Tract 67, New York County, New York",3768,436,3332,2684,4079,76773,1939,2004,2001,28.6,2156,2278,57,152,105,3332,194
2013,36061006700,"Census Tract 67, New York County, New York",3796,570,3226,2559,3733,80528,1939,2006,2001,27.4,2133,2192,71,172,80,3226,163
2014,36061006700,"Census Tract 67, New York County, New York",3906,638,3268,2584,3761,84432,1939,2007,2001,25.3,2126,2254,82,155,82,3268,172
2015,36061006700,"Census Tract 67, New York County, New York",3872,614,3258,2455,3625,83969,1939,2010,2248,25.8,2070,2144,14,180,31,3258,185
2016,36061006700,"Census Tract 67, New York County, New York",3809,559,3250,2501,3953,91784,1939,2011,2341,24.6,2127,2172,34,164,43,3250,180
2017,36061006700,"Census Tract 67, New York County, New York",3875,486,3389,2613,3934,93724,1939,2011,2523,24.3,2214,2303,21,135,70,3389,180
2018,36061006700,"Census Tract 67, New York County, New York",3798,371,3427,2558,3794,97113,0,2012,2459,24.4,2144,2214,25,123,106,3427,115
2019,36061006700,"Census Tract 67, New York County, New York",3756,267,3489,2580,3840,105559,0,2012,2509,24.6,2150,2178,23,89,187,3489,115
2020,36061006700,"Census Tract 67, New York County, New York",3636,332,3304,2730,4182,108313,0,2013,2601,24.7,2276,2267,169,76,204,3304,85
2012,36061006800,"Census Tract 68, New York County, New York",4576,794,3782,2804,4153,92012,1951,2005,2001,26.8,2152,1985,270,237,292,3782,464
2013,36061006800,"Census Tract 68, New York County, New York",4494,548,3946,2863,4096,91438,1957,2006,2001,28.3,2132,1985,295,217,328,3946,488
2014,36061006800,"Census Tract 68, New York County, New York",4397,543,3854,2812,4001,95000,1957,2009,2001,27.7,2121,1988,346,195,259,3854,484
2015,36061006800,"Census Tract 68, New York County, New York",4331,522,3809,2608,3955,95603,1962,2011,2094,28.2,1921,1759,340,261,222,3809,398
2016,36061006800,"Census Tract 68, New York County, New York",4190,575,3615,2380,4103,107384,1959,2011,2273,26.5,1870,1611,253,270,290,3615,287
2017,36061006800,"Census Tract 68, New York County, New York",4252,705,3547,2182,4065,114935,1962,NA,2375,25.7,1759,1418,271,319,231,3547,206
2018,36061006800,"Census Tract 68, New York County, New York",4207,721,3486,2243,4142,102940,1950,2012,2413,28.5,1722,1251,331,382,365,3486,227
2019,36061006800,"Census Tract 68, New York County, New York",4291,700,3591,2172,4095,116543,1950,2013,2599,27.5,1662,1168,288,373,431,3591,247
2020,36061006800,"Census Tract 68, New York County, New York",4419,759,3660,2444,4341,121443,1952,2014,2635,27.4,2043,1465,340,363,334,3660,258
2012,36061006900,"Census Tract 69, New York County, New York",1468,272,1196,748,1403,159419,1939,2006,2001,20.2,671,604,0,53,34,1196,89
2013,36061006900,"Census Tract 69, New York County, New York",1484,263,1221,750,1279,170000,1939,2008,2001,19.5,696,616,0,33,36,1221,95
2014,36061006900,"Census Tract 69, New York County, New York",1474,230,1244,754,1234,171630,1939,2010,2001,19.9,699,575,0,86,37,1244,81
2015,36061006900,"Census Tract 69, New York County, New York",1437,185,1252,785,1221,205469,1939,2011,3471,16.4,746,603,0,105,34,1252,78
2016,36061006900,"Census Tract 69, New York County, New York",1429,217,1212,797,1217,250001,1939,2012,3479,14.9,751,654,0,117,26,1212,78
2017,36061006900,"Census Tract 69, New York County, New York",1403,185,1218,739,1109,201094,1939,2012,3247,14.6,699,599,0,113,27,1218,53
2018,36061006900,"Census Tract 69, New York County, New York",1386,210,1176,696,1100,208611,0,2013,3211,13.4,650,547,0,107,38,1176,29
2019,36061006900,"Census Tract 69, New York County, New York",1359,242,1117,662,1113,250001,0,2015,3164,12.5,618,556,0,69,22,1117,42
2020,36061006900,"Census Tract 69, New York County, New York",1391,346,1045,542,980,212857,0,2016,3298,18.1,505,467,0,40,20,1045,22
2012,36061007000,"Census Tract 70, New York County, New York",5535,688,4847,3855,6465,91981,1966,2005,2001,28.4,3291,3097,106,450,156,4847,347
2013,36061007000,"Census Tract 70, New York County, New York",5669,852,4817,3930,6520,81357,1965,2008,2001,28.7,3102,2814,78,726,194,4817,459
2014,36061007000,"Census Tract 70, New York County, New York",5525,823,4702,3676,6123,70357,1965,2011,2001,29.3,3019,2684,46,720,87,4702,458
2015,36061007000,"Census Tract 70, New York County, New York",5626,794,4832,3765,6304,94476,1966,2011,2322,27.8,3256,2529,142,872,118,4832,408
2016,36061007000,"Census Tract 70, New York County, New York",5744,894,4850,3924,6742,94024,1967,2011,2499,27.1,3343,2643,127,861,163,4850,277
2017,36061007000,"Census Tract 70, New York County, New York",5751,961,4790,3866,6730,90000,1966,2011,2681,28.8,3287,2533,145,764,274,4790,327
2018,36061007000,"Census Tract 70, New York County, New York",5647,1067,4580,3618,6209,110175,1968,2011,2518,28,3226,2517,198,609,236,4580,254
2019,36061007000,"Census Tract 70, New York County, New York",5908,1097,4811,3780,6015,102984,1970,2012,2522,30.2,3083,2555,224,725,276,4811,194
2020,36061007001,"Census Tract 70.01, New York County, New York",3013,911,2102,1507,2320,74028,1965,2011,2352,33.5,1125,1156,0,227,124,2102,122
2020,36061007002,"Census Tract 70.02, New York County, New York",2397,225,2172,1849,3149,118803,1966,2015,3168,26.9,1445,1346,71,316,116,2172,119
2012,36061007100,"Census Tract 71, New York County, New York",3753,391,3362,2300,3487,82438,1939,2003,2001,25.8,1823,1950,12,124,130,3362,268
2013,36061007100,"Census Tract 71, New York County, New York",3844,575,3269,2225,3578,96417,1939,2004,2001,25,1767,1856,12,195,102,3269,212
2014,36061007100,"Census Tract 71, New York County, New York",3835,422,3413,2311,3776,120375,1939,2005,2001,23.8,1844,1902,13,189,134,3413,173
2015,36061007100,"Census Tract 71, New York County, New York",3822,336,3486,2364,3697,115190,1939,2008,2240,24.8,1934,1981,14,176,97,3486,160
2016,36061007100,"Census Tract 71, New York County, New York",3834,476,3358,2237,3641,125036,1939,2011,2117,23,1738,1865,15,146,114,3358,116
2017,36061007100,"Census Tract 71, New York County, New York",3788,534,3254,2079,3521,129729,1939,2011,2153,20.5,1724,1775,0,140,106,3254,101
2018,36061007100,"Census Tract 71, New York County, New York",3754,550,3204,1928,2904,130517,0,2012,1979,20.4,1600,1659,0,111,106,3204,62
2019,36061007100,"Census Tract 71, New York County, New York",3802,691,3111,1797,2732,136604,0,2013,2350,20.4,1561,1594,0,123,32,3111,84
2020,36061007100,"Census Tract 71, New York County, New York",3735,953,2782,1608,2704,153750,0,2016,2638,19.2,1436,1348,0,161,87,2782,44
2012,36061007200,"Census Tract 72, New York County, New York",5295,769,4526,3433,5884,88681,1966,2006,2001,33.7,2975,2609,12,503,257,4526,272
2013,36061007200,"Census Tract 72, New York County, New York",5222,1180,4042,3025,5639,97125,1967,2007,2001,33.1,2525,2201,0,431,293,4042,242
2014,36061007200,"Census Tract 72, New York County, New York",5286,1188,4098,3022,5376,106796,1970,2011,2001,31.2,2505,2067,0,523,297,4098,246
2015,36061007200,"Census Tract 72, New York County, New York",5367,1218,4149,2937,5446,105115,1966,2011,2480,29.3,2434,1855,0,647,318,4149,249
2016,36061007200,"Census Tract 72, New York County, New York",5119,1347,3772,2828,4964,100250,1964,2012,2348,27,2212,1949,0,716,88,3772,328
2017,36061007200,"Census Tract 72, New York County, New York",5036,1174,3862,2881,5268,108750,1964,2012,2359,25.8,2200,1954,0,733,106,3862,314
2018,36061007200,"Census Tract 72, New York County, New York",4858,662,4196,3285,5729,111586,1961,2013,2434,24.5,2482,2422,0,714,95,4196,321
2019,36061007200,"Census Tract 72, New York County, New York",4853,814,4039,3059,5598,114527,1963,2014,2616,23.6,2517,2233,39,582,206,4039,308
2020,36061007200,"Census Tract 72, New York County, New York",4971,761,4210,3386,5732,128006,1967,2016,2823,22.8,2936,2454,39,562,225,4210,124
2012,36061007300,"Census Tract 73, New York County, New York",4538,822,3716,2831,4310,101817,1939,2002,1852,23.3,2263,2353,78,182,193,3716,248
2013,36061007300,"Census Tract 73, New York County, New York",4547,820,3727,2882,4339,104961,1939,2004,1952,22.5,2361,2435,53,198,187,3727,249
2014,36061007300,"Census Tract 73, New York County, New York",4598,783,3815,2923,4437,90794,1939,2006,1900,23.7,2304,2463,22,143,272,3815,251
2015,36061007300,"Census Tract 73, New York County, New York",4596,837,3759,2724,4196,91006,1939,2008,1951,23.9,2190,2281,0,92,313,3759,279
2016,36061007300,"Census Tract 73, New York County, New York",4645,925,3720,2758,4276,89340,1939,2011,2023,28.2,2333,2230,0,158,356,3720,322
2017,36061007300,"Census Tract 73, New York County, New York",4663,851,3812,2929,4475,97444,1939,2011,2092,28.5,2590,2452,0,133,306,3812,302
2018,36061007300,"Census Tract 73, New York County, New York",4573,846,3727,2827,4142,76630,0,2011,2088,32.1,2450,2301,0,143,374,3727,280
2019,36061007300,"Census Tract 73, New York County, New York",4429,868,3561,2759,3964,105963,0,2014,2329,31.4,2474,2386,0,158,257,3561,277
2020,36061007300,"Census Tract 73, New York County, New York",4455,848,3607,2896,4200,142575,0,2016,2415,24.7,2309,2240,0,144,509,3607,345
2012,36061007400,"Census Tract 74, New York County, New York",2663,543,2120,1600,2833,107343,1939,2004,2001,21.9,1313,1201,36,269,41,2120,222
2013,36061007400,"Census Tract 74, New York County, New York",2700,592,2108,1479,2598,112868,1952,2006,2001,22.7,1238,1046,34,243,122,2108,190
2014,36061007400,"Census Tract 74, New York County, New York",2743,659,2084,1489,2263,109159,1948,2008,2001,25.5,1296,1051,53,210,135,2084,285
2015,36061007400,"Census Tract 74, New York County, New York",2836,675,2161,1506,2126,109875,1939,2011,2645,25.9,1347,1198,42,96,105,2161,274
2016,36061007400,"Census Tract 74, New York County, New York",2936,679,2257,1567,2236,110552,1944,2011,2838,26.7,1395,1197,53,130,139,2257,222
2017,36061007400,"Census Tract 74, New York County, New York",2994,814,2180,1432,2058,126810,1962,2012,2900,26.5,1263,1020,32,174,154,2180,178
2018,36061007400,"Census Tract 74, New York County, New York",3087,769,2318,1568,2087,126367,1976,2012,2931,25.6,1376,1198,64,210,55,2318,199
2019,36061007400,"Census Tract 74, New York County, New York",3230,836,2394,1585,2214,128944,1974,2014,2778,21.6,1365,1088,75,266,85,2394,120
2020,36061007400,"Census Tract 74, New York County, New York",3221,816,2405,1712,2447,131765,1983,2016,3034,26.5,1505,1198,115,261,77,2405,100
2012,36061007500,"Census Tract 75, New York County, New York",2596,205,2391,1636,2671,92344,1939,2002,2001,21.7,1226,1335,42,79,202,2391,122
2013,36061007500,"Census Tract 75, New York County, New York",2647,154,2493,1736,2749,90679,1939,2004,2001,25.1,1340,1294,38,137,286,2493,143
2014,36061007500,"Census Tract 75, New York County, New York",2762,170,2592,1530,2349,94375,1942,2007,2001,23.5,1179,1060,19,157,279,2592,136
2015,36061007500,"Census Tract 75, New York County, New York",2751,168,2583,1378,2035,90857,1945,2010,1927,24.6,1028,990,0,107,228,2583,86
2016,36061007500,"Census Tract 75, New York County, New York",2766,267,2499,1326,1880,110735,1945,2011,2483,23.9,1056,1010,0,115,142,2499,92
2017,36061007500,"Census Tract 75, New York County, New York",2759,383,2376,1189,1605,109145,1944,2012,2472,25.9,951,900,0,109,123,2376,87
2018,36061007500,"Census Tract 75, New York County, New York",2763,532,2231,1030,1393,135938,1945,2012,2602,24.8,800,805,0,18,57,2231,133
2019,36061007500,"Census Tract 75, New York County, New York",2800,551,2249,1170,1518,125526,1944,2012,2671,25,946,899,0,19,74,2249,111
2020,36061007500,"Census Tract 75, New York County, New York",2693,473,2220,1357,1748,103043,0,2009,1899,24.5,965,1130,0,38,71,2220,118
2012,36061007600,"Census Tract 76, New York County, New York",1682,483,1199,1036,1703,74853,1939,2005,2001,28.3,715,460,36,433,73,1199,147
2013,36061007600,"Census Tract 76, New York County, New York",1573,413,1160,1008,1842,76500,1939,2007,2001,28.3,740,498,36,420,56,1160,184
2014,36061007600,"Census Tract 76, New York County, New York",1418,321,1097,942,1707,78269,1939,2011,2001,29.1,678,448,43,411,31,1097,201
2015,36061007600,"Census Tract 76, New York County, New York",1384,373,1011,874,1635,100132,1939,2011,2697,28.6,649,392,27,417,29,1011,157
2016,36061007600,"Census Tract 76, New York County, New York",1390,311,1079,947,1693,86563,1939,2012,2656,28.7,706,450,55,407,25,1079,199
2017,36061007600,"Census Tract 76, New York County, New York",1360,296,1064,928,1760,82763,1939,2012,2676,31.7,698,398,53,432,45,1064,204
2018,36061007600,"Census Tract 76, New York County, New York",1394,311,1083,910,1619,95870,0,2013,2885,30.5,690,400,55,408,47,1083,140
2019,36061007600,"Census Tract 76, New York County, New York",1441,260,1181,1008,1740,94375,0,2015,2770,29.4,810,541,42,333,83,1181,179
2020,36061007600,"Census Tract 76, New York County, New York",1482,267,1215,938,1523,94306,0,2015,2591,27.5,764,471,30,258,114,1215,161
2012,36061007700,"Census Tract 77, New York County, New York",4264,572,3692,2611,3790,79076,1939,2003,2001,29.5,2102,2087,14,206,157,3692,227
2013,36061007700,"Census Tract 77, New York County, New York",4254,773,3481,2461,3713,96226,1939,2004,2001,25.7,2035,1908,15,210,178,3481,232
2014,36061007700,"Census Tract 77, New York County, New York",4318,754,3564,2591,3710,103094,1939,2006,2001,25.6,2121,2076,16,212,144,3564,176
2015,36061007700,"Census Tract 77, New York County, New York",4372,855,3517,2553,3953,121235,1939,2009,2248,24.1,2172,2002,40,227,237,3517,136
2016,36061007700,"Census Tract 77, New York County, New York",4331,785,3546,2587,4107,111250,1939,2010,2227,23.8,2178,1984,42,257,264,3546,178
2017,36061007700,"Census Tract 77, New York County, New York",4241,729,3512,2493,4056,123442,1939,2009,2268,23.3,2102,1978,25,181,264,3512,173
2018,36061007700,"Census Tract 77, New York County, New York",4170,535,3635,2648,4236,126733,0,2011,2238,22,2205,2126,25,156,218,3635,296
2019,36061007700,"Census Tract 77, New York County, New York",4115,481,3634,2540,4073,129159,0,2012,2324,20.9,2072,1992,24,97,317,3634,283
2020,36061007700,"Census Tract 77, New York County, New York",3838,528,3310,2229,3624,131612,0,2011,2232,19.6,1799,1821,0,113,181,3310,242
2012,36061007800,"Census Tract 78, New York County, New York",5415,1121,4294,2561,4384,93113,1967,2005,2001,29.3,2211,1878,50,252,305,4294,348
2013,36061007800,"Census Tract 78, New York County, New York",5372,1078,4294,2597,4735,117275,1966,2007,2001,24.9,2242,1858,16,310,338,4294,312
2014,36061007800,"Census Tract 78, New York County, New York",5432,1008,4424,2828,5216,120833,1966,2009,2001,24.8,2259,1797,0,450,476,4424,371
2015,36061007800,"Census Tract 78, New York County, New York",5470,843,4627,2981,5602,121045,1963,NA,2323,24.7,2443,2073,0,466,376,4627,347
2016,36061007800,"Census Tract 78, New York County, New York",5577,1021,4556,3237,6291,101954,1961,2011,2463,27.1,2472,2009,92,658,488,4556,367
2017,36061007800,"Census Tract 78, New York County, New York",5670,985,4685,3314,6793,122734,1959,2011,2647,27.6,2582,1901,94,693,570,4685,424
2018,36061007800,"Census Tract 78, New York County, New York",5696,930,4766,3317,6698,127488,1968,2012,2770,26,2653,1985,49,689,455,4766,370
2019,36061007800,"Census Tract 78, New York County, New York",5631,865,4766,3360,7199,129534,1962,2014,2824,24.7,2825,2192,91,650,347,4766,294
2020,36061007800,"Census Tract 78, New York County, New York",5577,730,4847,3707,7762,119114,1968,2016,3182,31.7,2774,1880,158,773,801,4847,265
2012,36061007900,"Census Tract 79, New York County, New York",2892,298,2594,1758,2633,82313,1939,2003,2001,21.5,1496,1493,12,99,119,2594,140
2013,36061007900,"Census Tract 79, New York County, New York",2904,266,2638,1804,2787,85833,1939,2003,2001,21.3,1542,1526,13,98,124,2638,107
2014,36061007900,"Census Tract 79, New York County, New York",2956,234,2722,1810,2870,79722,1939,2004,2001,22,1512,1578,13,80,97,2722,248
2015,36061007900,"Census Tract 79, New York County, New York",2917,306,2611,1704,2494,78819,1939,2004,2210,23.5,1364,1457,13,88,84,2611,261
2016,36061007900,"Census Tract 79, New York County, New York",2900,272,2628,1619,2495,77591,1939,2004,1829,22.7,1325,1410,13,99,73,2628,319
2017,36061007900,"Census Tract 79, New York County, New York",2852,352,2500,1441,2295,77219,1939,2010,1746,22.1,1184,1309,22,65,35,2500,372
2018,36061007900,"Census Tract 79, New York County, New York",2879,411,2468,1522,2345,75053,0,2008,1364,27.3,1111,1285,24,65,119,2468,435
2019,36061007900,"Census Tract 79, New York County, New York",2893,418,2475,1586,2486,79491,0,2008,1447,25.8,1210,1262,22,77,171,2475,317
2020,36061007900,"Census Tract 79, New York County, New York",3001,595,2406,1681,2716,85166,0,2012,1651,19.8,1406,1351,58,61,193,2406,311
2012,36061008000,"Census Tract 80, New York County, New York",3732,518,3214,1857,2623,79111,1946,2004,2001,27.8,1550,1430,36,234,157,3214,318
2013,36061008000,"Census Tract 80, New York County, New York",3730,691,3039,1748,2405,79518,1946,2006,2001,30,1427,1388,30,232,98,3039,317
2014,36061008000,"Census Tract 80, New York County, New York",3865,707,3158,1826,2429,81481,1945,2008,2001,30.9,1405,1482,62,150,132,3158,404
2015,36061008000,"Census Tract 80, New York County, New York",3773,705,3068,1590,2234,80700,1944,2010,2207,31.7,1248,1289,58,108,126,3068,389
2016,36061008000,"Census Tract 80, New York County, New York",3771,653,3118,1628,2422,84167,1946,2010,2413,32.8,1272,1348,43,147,81,3118,287
2017,36061008000,"Census Tract 80, New York County, New York",3761,753,3008,1461,2204,76653,1944,2011,2580,33.3,1143,1206,46,106,95,3008,282
2018,36061008000,"Census Tract 80, New York County, New York",3784,754,3030,1425,2158,80875,1944,2012,2484,32.1,1107,1095,56,155,110,3030,304
2019,36061008000,"Census Tract 80, New York County, New York",3827,849,2978,1313,2051,105446,1944,2013,2573,31.7,1093,1039,18,164,84,2978,152
2020,36061008000,"Census Tract 80, New York County, New York",3644,842,2802,1448,2330,116096,1949,2016,2731,29.3,1280,1143,0,247,58,2802,136
2012,36061008100,"Census Tract 81, New York County, New York",5400,628,4772,3295,4938,74867,1939,2002,1696,25.2,2489,2328,37,408,495,4772,308
2013,36061008100,"Census Tract 81, New York County, New York",5315,477,4838,3235,5033,89353,1939,2004,1765,24,2595,2594,24,220,369,4838,313
2014,36061008100,"Census Tract 81, New York County, New York",5363,480,4883,3251,5245,89107,1939,2004,1746,24,2482,2609,28,279,319,4883,378
2015,36061008100,"Census Tract 81, New York County, New York",5412,512,4900,3204,5175,90765,1939,2007,1576,23.7,2594,2615,24,259,306,4900,471
2016,36061008100,"Census Tract 81, New York County, New York",5406,814,4592,2969,4880,105734,1939,2009,1719,21.7,2473,2301,39,240,366,4592,530
2017,36061008100,"Census Tract 81, New York County, New York",5396,785,4611,3165,5129,110688,1940,2010,1825,21.5,2529,2450,72,262,360,4611,506
2018,36061008100,"Census Tract 81, New York County, New York",5365,784,4581,3091,5036,118202,1941,2011,1999,21.4,2413,2318,69,218,433,4581,490
2019,36061008100,"Census Tract 81, New York County, New York",5424,873,4551,3068,4746,122344,1941,2013,2163,20.9,2495,2291,66,203,456,4551,391
2020,36061008100,"Census Tract 81, New York County, New York",5364,1008,4356,2648,4052,118819,1943,2015,2399,23,2193,2021,32,149,392,4356,252
2012,36061008200,"Census Tract 82, New York County, New York",2525,556,1969,1177,1945,67454,1955,2004,2001,37.4,892,701,90,201,185,1969,213
2013,36061008200,"Census Tract 82, New York County, New York",2534,616,1918,1003,1752,94595,1956,2004,2001,34.4,775,580,79,142,178,1918,142
2014,36061008200,"Census Tract 82, New York County, New York",2553,647,1906,973,1860,98385,1952,2003,2001,28,793,630,74,158,94,1906,149
2015,36061008200,"Census Tract 82, New York County, New York",2476,598,1878,994,1608,92617,1952,2008,2684,32.6,825,738,36,159,59,1878,108
2016,36061008200,"Census Tract 82, New York County, New York",2523,525,1998,1156,1900,117333,1952,2011,2852,25.9,1020,777,57,203,103,1998,66
2017,36061008200,"Census Tract 82, New York County, New York",2511,364,2147,1177,1833,123578,1956,2011,2958,26.7,1069,783,0,243,85,2147,59
2018,36061008200,"Census Tract 82, New York County, New York",2374,311,2063,1117,1777,126816,1954,2011,3049,26.6,957,800,0,206,56,2063,95
2019,36061008200,"Census Tract 82, New York County, New York",2392,381,2011,1153,1915,110486,1955,2012,3188,27.4,1047,734,41,180,124,2011,108
2020,36061008200,"Census Tract 82, New York County, New York",2495,593,1902,932,1461,117105,1956,2013,3014,25.7,824,559,46,137,134,1902,146
2012,36061008300,"Census Tract 83, New York County, New York",2159,239,1920,1632,3562,44086,1954,2003,890,26.4,837,822,256,195,360,1920,397
2013,36061008300,"Census Tract 83, New York County, New York",2321,348,1973,1681,3655,48059,1952,2004,926,25.3,925,882,265,217,339,1973,345
2014,36061008300,"Census Tract 83, New York County, New York",2315,268,2047,1746,3488,52172,1961,2007,944,25.4,993,1006,227,185,293,2047,402
2015,36061008300,"Census Tract 83, New York County, New York",2346,360,1986,1701,3448,57303,1961,2008,967,26.1,941,889,206,208,405,1986,355
2016,36061008300,"Census Tract 83, New York County, New York",2394,380,2014,1714,3478,51744,1961,2008,938,27,943,841,215,102,576,2014,388
2017,36061008300,"Census Tract 83, New York County, New York",2407,306,2101,1801,3637,53244,1960,2008,922,27.8,929,831,264,104,571,2101,517
2018,36061008300,"Census Tract 83, New York County, New York",2325,260,2065,1742,3304,53125,1958,2010,1022,29.9,930,827,213,138,515,2065,559
2019,36061008300,"Census Tract 83, New York County, New York",2356,302,2054,1713,3100,65787,1955,2011,1596,30.3,1085,850,113,235,497,2054,423
2020,36061008300,"Census Tract 83, New York County, New York",2400,264,2136,1681,2998,47724,1959,2010,1166,31.8,1032,799,98,154,625,2136,460
2012,36061008400,"Census Tract 84, New York County, New York",1015,153,862,686,1374,105792,1993,2008,2001,30.3,516,267,36,357,32,862,95
2013,36061008400,"Census Tract 84, New York County, New York",1041,150,891,724,1437,108827,1994,2010,2001,30.4,585,355,43,301,34,891,95
2014,36061008400,"Census Tract 84, New York County, New York",1134,204,930,788,1642,103750,1995,2011,2001,35.5,610,336,48,341,26,930,136
2015,36061008400,"Census Tract 84, New York County, New York",1171,136,1035,827,1668,101068,1987,NA,3111,37.1,627,365,42,320,44,1035,120
2016,36061008400,"Census Tract 84, New York County, New York",1215,209,1006,821,1658,87813,1991,2012,3216,38.7,618,375,48,329,37,1006,143
2017,36061008400,"Census Tract 84, New York County, New York",1208,235,973,754,1512,105313,1989,2013,3329,37.1,630,339,42,300,28,973,84
2018,36061008400,"Census Tract 84, New York County, New York",1284,295,989,768,1493,117222,1996,2014,3501,31.8,668,277,20,368,47,989,98
2019,36061008400,"Census Tract 84, New York County, New York",1184,300,884,664,1280,148429,1992,2015,3501,27.9,553,291,13,327,39,884,77
2020,36061008400,"Census Tract 84, New York County, New York",1177,358,819,509,1007,154659,2001,2016,3501,26.7,447,246,0,244,11,819,59
2012,36061008601,"Census Tract 86.01, New York County, New York",1548,250,1298,921,1785,158281,1984,2006,2001,26.2,815,747,18,114,18,1298,38
2013,36061008601,"Census Tract 86.01, New York County, New York",1528,296,1232,837,1914,154712,1985,2008,2001,21.8,727,625,16,130,42,1232,44
2014,36061008601,"Census Tract 86.01, New York County, New York",1522,220,1302,980,2181,142109,1984,2011,2001,26.6,818,704,43,154,56,1302,87
2015,36061008601,"Census Tract 86.01, New York County, New York",1540,202,1338,999,2297,141825,1984,2011,3293,27.4,824,706,32,215,46,1338,33
2016,36061008601,"Census Tract 86.01, New York County, New York",1553,227,1326,1006,2338,144659,1984,2012,3391,26.9,861,690,37,205,57,1326,32
2017,36061008601,"Census Tract 86.01, New York County, New York",1525,216,1309,966,2465,147246,1984,2012,3501,24.8,865,613,47,228,64,1309,42
2018,36061008601,"Census Tract 86.01, New York County, New York",1577,245,1332,1001,2463,149659,1984,2014,3501,27.7,894,654,59,234,39,1332,50
2019,36061008601,"Census Tract 86.01, New York County, New York",1655,342,1313,951,2311,161042,1985,2015,3501,22.2,868,626,45,232,37,1313,52
2020,36061008601,"Census Tract 86.01, New York County, New York",1582,318,1264,965,2382,150063,1986,2017,3501,21.9,901,635,47,231,42,1264,145
2012,36061008602,"Census Tract 86.02, New York County, New York",0,0,0,0,0,NA,NA,NA,NA,NA,0,0,0,0,0,0,0
2013,36061008602,"Census Tract 86.02, New York County, New York",0,0,0,0,0,NA,NA,NA,NA,NA,0,0,0,0,0,0,0
2014,36061008602,"Census Tract 86.02, New York County, New York",0,0,0,0,0,NA,NA,NA,NA,NA,0,0,0,0,0,0,0
2015,36061008602,"Census Tract 86.02, New York County, New York",0,0,0,0,0,NA,NA,NA,NA,NA,0,0,0,0,0,0,0
2016,36061008602,"Census Tract 86.02, New York County, New York",0,0,0,0,0,NA,NA,NA,NA,NA,0,0,0,0,0,0,0
2017,36061008602,"Census Tract 86.02, New York County, New York",0,0,0,0,0,NA,NA,NA,NA,NA,0,0,0,0,0,0,0
2018,36061008602,"Census Tract 86.02, New York County, New York",0,0,0,0,0,NA,NA,NA,NA,NA,0,0,0,0,0,0,0
2019,36061008602,"Census Tract 86.02, New York County, New York",0,0,0,0,0,NA,NA,NA,NA,NA,0,0,0,0,0,0,0
2020,36061008602,"Census Tract 86.02, New York County, New York",0,0,0,0,0,NA,NA,NA,NA,NA,0,0,0,0,0,0,0
2012,36061008603,"Census Tract 86.03, New York County, New York",3464,1056,2408,952,2050,114953,1963,2005,2001,23.4,767,792,0,44,90,2408,134
2013,36061008603,"Census Tract 86.03, New York County, New York",3513,1034,2479,921,1979,115906,1962,2006,2001,24,776,752,0,44,97,2479,107
2014,36061008603,"Census Tract 86.03, New York County, New York",3576,1111,2465,820,1700,123500,1972,2009,2001,23.7,685,647,0,47,62,2465,124
2015,36061008603,"Census Tract 86.03, New York County, New York",3553,916,2637,819,1431,115850,1972,2010,2599,26.2,629,633,0,13,88,2637,178
2016,36061008603,"Census Tract 86.03, New York County, New York",3563,1116,2447,763,1354,110078,1972,2010,2628,24.8,599,605,0,21,64,2447,160
2017,36061008603,"Census Tract 86.03, New York County, New York",3561,847,2714,818,1578,113125,1971,2007,2927,25.8,650,660,0,40,48,2714,184
2018,36061008603,"Census Tract 86.03, New York County, New York",3519,1062,2457,736,1448,131838,1972,2008,3047,26.2,580,570,0,41,72,2457,155
2019,36061008603,"Census Tract 86.03, New York County, New York",3355,911,2444,811,1601,150512,1960,2011,3075,22.2,654,632,0,54,110,2444,146
2020,36061008603,"Census Tract 86.03, New York County, New York",3435,985,2450,847,1513,192535,1967,2016,3375,25.5,720,526,0,46,275,2450,92
2012,36061008700,"Census Tract 87, New York County, New York",4323,336,3987,2747,4420,90560,1939,2005,2001,25.2,2074,2022,58,321,319,3987,133
2013,36061008700,"Census Tract 87, New York County, New York",4249,356,3893,2655,4530,91792,1939,2006,2001,25.9,2045,1979,43,308,307,3893,162
2014,36061008700,"Census Tract 87, New York County, New York",4350,415,3935,2804,5228,92656,1944,2008,2001,26.4,2039,2048,37,403,252,3935,166
2015,36061008700,"Census Tract 87, New York County, New York",4315,394,3921,2770,4724,96634,1945,2010,2243,25.8,2032,2253,22,290,205,3921,303
2016,36061008700,"Census Tract 87, New York County, New York",4160,344,3816,2612,4367,96786,1947,2011,2341,26.4,1938,2153,39,226,194,3816,309
2017,36061008700,"Census Tract 87, New York County, New York",4117,280,3837,2529,4102,130282,1948,2012,2613,25.3,1954,2105,55,102,238,3837,338
2018,36061008700,"Census Tract 87, New York County, New York",4241,112,4129,2865,4511,136573,1942,2013,2461,24.5,2279,2352,87,80,317,4129,342
2019,36061008700,"Census Tract 87, New York County, New York",4148,161,3987,2619,3873,163131,0,2015,2902,23.5,2297,2277,82,18,183,3987,332
2020,36061008700,"Census Tract 87, New York County, New York",4208,257,3951,2560,3891,162917,0,2016,2868,23.4,2317,2034,60,63,337,3951,418
2012,36061008800,"Census Tract 88, New York County, New York",5457,1024,4433,2639,3991,89816,1939,2005,1927,25.7,2249,2013,40,384,149,4433,274
2013,36061008800,"Census Tract 88, New York County, New York",5507,1066,4441,2612,3930,90714,1939,2006,1919,26.2,2241,1840,29,528,159,4441,270
2014,36061008800,"Census Tract 88, New York County, New York",5543,1069,4474,2580,3877,94048,1939,2008,1941,27.1,2275,1718,106,560,91,4474,349
2015,36061008800,"Census Tract 88, New York County, New York",5645,1090,4555,2396,3481,96371,1939,2009,1995,27.8,2102,1622,108,501,69,4555,366
2016,36061008800,"Census Tract 88, New York County, New York",5719,1245,4474,2309,3510,89002,1939,2010,2139,30.2,1956,1447,136,571,105,4474,322
2017,36061008800,"Census Tract 88, New York County, New York",5642,1248,4394,2094,3497,89908,1939,2011,2043,31.3,1791,1361,97,499,54,4394,256
2018,36061008800,"Census Tract 88, New York County, New York",5656,1283,4373,2053,3411,102056,0,2011,2105,29.2,1824,1357,103,449,62,4373,202
2019,36061008800,"Census Tract 88, New York County, New York",5752,1357,4395,2226,3776,112813,0,2013,2343,29,1998,1558,104,433,55,4395,114
2020,36061008800,"Census Tract 88, New York County, New York",5681,1174,4507,2735,4566,123125,1962,2015,2350,31.1,2552,1673,233,468,55,4507,77
2012,36061008900,"Census Tract 89, New York County, New York",3442,168,3274,2508,3836,73263,1939,2002,1569,25.7,1771,1712,180,141,395,3274,173
2013,36061008900,"Census Tract 89, New York County, New York",3511,369,3142,2382,3814,76065,1939,2004,1656,26.6,1802,1687,183,141,268,3142,222
2014,36061008900,"Census Tract 89, New York County, New York",3542,484,3058,2154,3697,68750,1939,2005,1685,29.1,1576,1612,173,118,209,3058,274
2015,36061008900,"Census Tract 89, New York County, New York",3582,556,3026,2091,3583,68776,1939,2007,1792,27.8,1508,1588,174,39,269,3026,280
2016,36061008900,"Census Tract 89, New York County, New York",3524,708,2816,1936,3342,81168,1939,2007,1757,25.4,1251,1417,196,52,242,2816,351
2017,36061008900,"Census Tract 89, New York County, New York",3501,781,2720,1861,3459,95208,1939,2008,1920,24.5,1267,1273,137,104,227,2720,321
2018,36061008900,"Census Tract 89, New York County, New York",3439,610,2829,1934,3448,86136,0,2011,2048,25,1252,1399,123,76,264,2829,334
2019,36061008900,"Census Tract 89, New York County, New York",3508,630,2878,1999,3416,86830,0,2011,1801,25.2,1217,1276,70,145,411,2878,427
2020,36061008900,"Census Tract 89, New York County, New York",3626,641,2985,2045,3445,84580,0,2010,1833,24.2,1448,1506,18,145,262,2985,356
2012,36061009000,"Census Tract 90, New York County, New York",5895,1439,4456,2967,4545,108976,1965,2005,2001,26.6,2279,2086,36,551,267,4456,226
2013,36061009000,"Census Tract 90, New York County, New York",5832,1624,4208,2892,4636,87217,1964,2006,2001,27.7,2256,1989,22,595,267,4208,289
2014,36061009000,"Census Tract 90, New York County, New York",5735,1519,4216,3044,4847,106419,1965,2008,2001,27.3,2395,1892,19,810,297,4216,309
2015,36061009000,"Census Tract 90, New York County, New York",5815,1596,4219,3035,4933,113340,1965,2011,2381,28.3,2548,1876,0,821,304,4219,330
2016,36061009000,"Census Tract 90, New York County, New York",5788,1413,4375,3014,5261,122244,1965,2011,2304,24.4,2555,2078,0,668,238,4375,166
2017,36061009000,"Census Tract 90, New York County, New York",5802,1285,4517,2982,4888,129375,1967,2012,2337,24.7,2462,2049,0,540,355,4517,240
2018,36061009000,"Census Tract 90, New York County, New York",5673,1041,4632,3041,4725,134739,1968,2013,2407,26.3,2479,2135,0,452,350,4632,208
2019,36061009000,"Census Tract 90, New York County, New York",5698,1106,4592,3001,4727,129476,1969,2014,2622,26.3,2443,2205,28,395,317,4592,285
2020,36061009000,"Census Tract 90, New York County, New York",6049,1367,4682,3238,5045,128680,1966,2015,2510,26.2,2545,2563,71,265,249,4682,403
2012,36061009100,"Census Tract 91, New York County, New York",4210,532,3678,2622,3804,88227,1939,2004,1842,26.7,2049,1845,85,345,194,3678,366
2013,36061009100,"Census Tract 91, New York County, New York",4386,492,3894,2691,4113,88009,1939,2004,1789,27.5,2065,1910,76,298,231,3894,468
2014,36061009100,"Census Tract 91, New York County, New York",4431,413,4018,2887,4391,92716,1939,2006,1828,26.7,2142,2044,43,413,217,4018,462
2015,36061009100,"Census Tract 91, New York County, New York",4489,358,4131,3089,4599,100861,1939,2008,1990,24.9,2258,1960,174,574,237,4131,493
2016,36061009100,"Census Tract 91, New York County, New York",4398,493,3905,2842,4207,83231,1943,2011,1938,24.4,2044,1885,210,420,222,3905,535
2017,36061009100,"Census Tract 91, New York County, New York",4420,515,3905,2650,4252,76583,1948,2011,2132,25.3,1853,1715,323,406,251,3905,542
2018,36061009100,"Census Tract 91, New York County, New York",4434,670,3764,2580,4018,101316,1961,2013,2097,23,1856,1706,321,304,276,3764,471
2019,36061009100,"Census Tract 91, New York County, New York",4576,756,3820,2626,4072,122698,1953,2015,2088,20.6,2118,1772,299,286,306,3820,561
2020,36061009100,"Census Tract 91, New York County, New York",4145,621,3524,2417,3981,152863,1960,NA,2227,21.9,2052,1612,124,278,417,3524,574
2012,36061009200,"Census Tract 92, New York County, New York",1405,327,1078,938,1392,134444,1939,2005,2001,23.2,673,578,46,182,116,1078,86
2013,36061009200,"Census Tract 92, New York County, New York",1461,312,1149,1018,1467,134737,1939,2007,2001,25.6,719,679,36,127,153,1149,83
2014,36061009200,"Census Tract 92, New York County, New York",1422,322,1100,1024,1555,120000,1939,2011,2001,26,788,688,45,185,107,1100,69
2015,36061009200,"Census Tract 92, New York County, New York",1405,252,1153,1033,1547,NA,1956,2011,2685,24.8,860,771,34,175,53,1153,78
2016,36061009200,"Census Tract 92, New York County, New York",1409,281,1128,999,1542,131146,1950,NA,2601,24.3,828,701,42,195,42,1128,92
2017,36061009200,"Census Tract 92, New York County, New York",1411,311,1100,960,1521,123882,1939,2011,2532,23.5,773,737,17,165,26,1100,54
2018,36061009200,"Census Tract 92, New York County, New York",1400,313,1087,937,1388,127656,0,2012,2599,22.6,753,697,16,175,23,1087,53
2019,36061009200,"Census Tract 92, New York County, New York",1384,372,1012,851,1222,139632,1955,2013,2583,21.3,663,615,9,151,28,1012,47
2020,36061009200,"Census Tract 92, New York County, New York",1265,327,938,787,1222,142083,1947,2015,2341,19.2,598,502,15,181,35,938,29
2012,36061009300,"Census Tract 93, New York County, New York",5683,609,5074,2937,5299,70313,1939,2000,1471,25.2,1714,1977,347,83,510,5074,741
2013,36061009300,"Census Tract 93, New York County, New York",5585,541,5044,2860,5782,80671,1939,2002,1619,25.4,1798,1913,399,90,414,5044,592
2014,36061009300,"Census Tract 93, New York County, New York",5699,585,5114,2845,6477,79897,1939,2003,1599,24.2,1816,1920,379,124,374,5114,504
2015,36061009300,"Census Tract 93, New York County, New York",5787,589,5198,2885,6942,62339,1939,2005,1554,24.3,1688,1826,394,189,461,5198,653
2016,36061009300,"Census Tract 93, New York County, New York",5794,605,5189,3003,6330,72188,1939,2010,1834,27.4,1888,1926,344,298,435,5189,498
2017,36061009300,"Census Tract 93, New York County, New York",5777,522,5255,2837,5912,64473,1939,2010,1831,28.9,1868,1823,291,311,412,5255,483
2018,36061009300,"Census Tract 93, New York County, New York",5895,678,5217,2951,5395,64047,1940,2008,1583,27.7,1747,1824,207,417,519,5217,634
2019,36061009300,"Census Tract 93, New York County, New York",5852,626,5226,3094,5454,58750,0,2008,1449,27.7,1793,1899,213,414,587,5226,728
2020,36061009300,"Census Tract 93, New York County, New York",6122,756,5366,3116,5509,77206,0,2011,1832,26.4,1994,2049,185,348,532,5366,543
2012,36061009400,"Census Tract 94, New York County, New York",19,0,19,19,28,38281,1958,NA,666,26.9,4,8,0,0,0,19,7
2013,36061009400,"Census Tract 94, New York County, New York",16,0,16,16,29,41250,1975,2003,725,25,4,12,0,0,0,16,0
2014,36061009400,"Census Tract 94, New York County, New York",24,4,20,20,33,41667,1973,2005,763,23.9,7,16,0,0,0,20,0
2015,36061009400,"Census Tract 94, New York County, New York",15,4,11,11,15,NA,1955,2004,2107,28.1,7,7,0,0,0,11,0
2016,36061009400,"Census Tract 94, New York County, New York",32,4,28,28,44,199167,1946,2012,3088,19.4,20,24,0,0,0,28,0
2017,36061009400,"Census Tract 94, New York County, New York",42,4,38,38,56,NA,1961,2016,2833,30.8,30,38,0,0,0,38,0
2018,36061009400,"Census Tract 94, New York County, New York",54,16,38,34,46,NA,1957,2016,3028,25,30,34,0,0,0,38,0
2019,36061009400,"Census Tract 94, New York County, New York",66,12,54,49,62,151339,1948,2016,2446,18.7,44,49,0,0,0,54,0
2020,36061009400,"Census Tract 94, New York County, New York",60,11,49,45,56,153750,1948,2016,2404,18.7,41,45,0,0,0,49,0
2012,36061009500,"Census Tract 95, New York County, New York",1327,284,1043,589,1044,106512,1977,2008,2001,25.9,515,420,46,88,9,1043,37
2013,36061009500,"Census Tract 95, New York County, New York",1416,262,1154,694,1412,120313,2000,2009,1941,23.5,608,465,34,140,21,1154,52
2014,36061009500,"Census Tract 95, New York County, New York",1444,279,1165,741,1454,134083,1990,2011,2001,19.9,652,464,55,164,24,1165,92
2015,36061009500,"Census Tract 95, New York County, New York",1512,289,1223,753,1445,111993,2002,2011,2280,20,627,478,63,161,16,1223,120
2016,36061009500,"Census Tract 95, New York County, New York",1517,293,1224,746,1535,128393,2001,2012,2231,18,580,463,27,203,47,1224,153
2017,36061009500,"Census Tract 95, New York County, New York",1453,199,1254,805,1725,127784,1991,2012,1967,20,631,514,28,189,48,1254,178
2018,36061009500,"Census Tract 95, New York County, New York",1429,233,1196,793,1514,127969,1993,2013,2750,23.6,609,541,24,153,54,1196,182
2019,36061009500,"Census Tract 95, New York County, New York",1442,213,1229,759,1349,130469,1999,2014,3031,24.9,619,550,19,133,41,1229,114
2020,36061009500,"Census Tract 95, New York County, New York",1393,245,1148,731,1368,128393,1968,2013,2232,23.1,598,499,20,102,99,1148,96
2012,36061009600,"Census Tract 96, New York County, New York",226,107,119,115,135,98594,1939,2007,1270,13.9,68,87,0,28,0,119,0
2013,36061009600,"Census Tract 96, New York County, New York",268,138,130,113,126,104063,1996,2008,1493,13.3,75,85,0,28,0,130,9
2014,36061009600,"Census Tract 96, New York County, New York",282,154,128,109,120,101406,1969,2008,1470,13.6,70,78,0,31,0,128,11
2015,36061009600,"Census Tract 96, New York County, New York",299,179,120,97,119,136719,2000,2011,1967,16.4,89,61,0,36,0,120,12
2016,36061009600,"Census Tract 96, New York County, New York",257,160,97,77,99,143472,1939,2010,2371,18.1,72,52,0,25,0,97,13
2017,36061009600,"Census Tract 96, New York County, New York",260,157,103,81,102,139219,1939,2013,2646,25.2,81,68,0,13,0,103,14
2018,36061009600,"Census Tract 96, New York County, New York",233,135,98,88,119,144688,0,2014,2879,19.4,88,74,0,14,0,98,0
2019,36061009600,"Census Tract 96, New York County, New York",252,124,128,112,148,145313,0,2013,2860,25.6,92,94,0,14,4,128,0
2020,36061009600,"Census Tract 96, New York County, New York",223,82,141,123,147,202750,1962,2015,2978,17.7,97,103,0,9,11,141,0
2012,36061009700,"Census Tract 97, New York County, New York",2820,189,2631,1733,3080,36740,1952,2000,799,27.7,844,931,128,217,436,2631,372
2013,36061009700,"Census Tract 97, New York County, New York",2827,180,2647,1746,3099,41755,1950,2000,855,27.8,881,956,113,198,437,2647,307
2014,36061009700,"Census Tract 97, New York County, New York",2852,116,2736,1794,3321,38033,1952,2001,863,28.2,823,967,124,104,559,2736,393
2015,36061009700,"Census Tract 97, New York County, New York",2890,177,2713,1709,3315,37191,1951,2000,830,25.5,866,991,94,226,397,2713,335
2016,36061009700,"Census Tract 97, New York County, New York",2904,137,2767,1671,3215,38018,1952,2001,972,28.4,852,935,60,312,340,2767,441
2017,36061009700,"Census Tract 97, New York County, New York",2936,138,2798,1503,3000,36012,1957,2004,892,27.9,702,620,134,417,308,2798,512
2018,36061009700,"Census Tract 97, New York County, New York",2965,106,2859,1343,2400,40210,1956,2005,934,27.9,616,564,110,440,218,2859,523
2019,36061009700,"Census Tract 97, New York County, New York",2929,96,2833,1334,2308,38150,1957,2005,889,27.1,571,509,173,430,210,2833,546
2020,36061009700,"Census Tract 97, New York County, New York",2974,103,2871,1311,1868,39103,1957,2005,909,28.1,581,465,170,304,335,2871,509
2012,36061009800,"Census Tract 98, New York County, New York",5243,946,4297,2932,4789,85602,1947,2004,2001,28.8,2255,2221,49,521,100,4297,243
2013,36061009800,"Census Tract 98, New York County, New York",5244,988,4256,2830,4683,84688,1947,2003,1957,29.2,2258,2166,43,510,82,4256,231
2014,36061009800,"Census Tract 98, New York County, New York",5314,1113,4201,2557,4373,86605,1950,2003,1919,28.1,1945,2133,32,309,49,4201,170
2015,36061009800,"Census Tract 98, New York County, New York",5403,1111,4292,2628,4681,96371,1948,2006,2076,26.9,2101,2164,41,374,24,4292,173
2016,36061009800,"Census Tract 98, New York County, New York",5228,944,4284,2450,4186,102330,1952,2010,2366,26.7,1865,1974,34,365,44,4284,210
2017,36061009800,"Census Tract 98, New York County, New York",5203,1013,4190,2136,3674,118348,1950,2011,2527,25.6,1773,1809,0,198,100,4190,135
2018,36061009800,"Census Tract 98, New York County, New York",5261,1039,4222,2329,3697,103059,1959,2012,2436,29,1885,1828,0,356,120,4222,198
2019,36061009800,"Census Tract 98, New York County, New York",5239,997,4242,2607,4215,108719,1960,2013,2409,26.3,2035,1968,0,359,254,4242,197
2020,36061009800,"Census Tract 98, New York County, New York",5399,1052,4347,2735,4325,93305,1963,2015,2209,27.9,2175,2123,0,378,209,4347,417
2012,36061009900,"Census Tract 99, New York County, New York",1989,372,1617,1252,2111,126458,2006,2011,2001,25.2,1010,795,110,209,95,1617,111
2013,36061009900,"Census Tract 99, New York County, New York",2438,390,2048,1653,2757,130981,2006,2011,2001,25,1366,1081,98,317,105,2048,131
2014,36061009900,"Census Tract 99, New York County, New York",2808,425,2383,2029,3303,120917,2008,2011,2001,27.3,1711,1247,130,460,136,2383,125
2015,36061009900,"Census Tract 99, New York County, New York",3386,495,2891,2563,4239,122986,2008,NA,2901,27.3,2090,1655,151,512,160,2891,146
2016,36061009900,"Census Tract 99, New York County, New York",3664,532,3132,2808,4641,125641,2009,NA,2942,26.3,2243,1732,153,591,245,3132,180
2017,36061009900,"Census Tract 99, New York County, New York",3810,408,3402,3091,5071,115656,2010,2013,3127,26.2,2446,1857,190,607,331,3402,207
2018,36061009900,"Census Tract 99, New York County, New York",3846,344,3502,3184,5087,118125,2011,2013,3345,27.6,2456,1879,233,582,396,3502,190
2019,36061009900,"Census Tract 99, New York County, New York",3956,383,3573,3269,5315,137009,2011,2014,3392,26.6,2532,1999,235,499,448,3573,212
2020,36061009901,"Census Tract 99.01, New York County, New York",1315,301,1014,799,1458,250001,2004,2015,3442,12.5,687,551,42,104,102,1014,35
2020,36061009902,"Census Tract 99.02, New York County, New York",2041,207,1834,1650,2483,132167,2014,2016,3132,24.6,1345,1164,103,183,178,1834,71
2020,36061009903,"Census Tract 99.03, New York County, New York",640,45,595,595,1098,159276,2011,2013,3501,26.6,460,209,63,201,105,595,42
2012,36061010000,"Census Tract 100, New York County, New York",1378,187,1191,837,1177,85543,1952,2004,2001,29.9,599,590,50,97,67,1191,106
2013,36061010000,"Census Tract 100, New York County, New York",1399,185,1214,929,1426,85497,1951,2006,2001,31.1,669,666,42,85,92,1214,87
2014,36061010000,"Census Tract 100, New York County, New York",1393,176,1217,978,1458,107824,1952,2009,2001,31.1,785,765,19,60,88,1217,121
2015,36061010000,"Census Tract 100, New York County, New York",1388,209,1179,886,1256,117679,1953,2011,2391,28.3,784,710,16,38,84,1179,108
2016,36061010000,"Census Tract 100, New York County, New York",1375,195,1180,942,1393,91635,1953,2011,2372,30.6,832,781,14,74,58,1180,117
2017,36061010000,"Census Tract 100, New York County, New York",1362,202,1160,913,1405,106534,1953,2011,2449,29.6,807,732,10,104,45,1160,85
2018,36061010000,"Census Tract 100, New York County, New York",1335,181,1154,883,1328,96250,1955,2012,2698,29.6,770,649,9,169,41,1154,104
2019,36061010000,"Census Tract 100, New York County, New York",1333,188,1145,876,1328,96445,1953,2012,2683,28.3,757,596,0,211,35,1145,65
2020,36061010000,"Census Tract 100, New York County, New York",1391,205,1186,965,1386,81086,1953,2016,2401,36.5,831,546,4,167,220,1186,61
2012,36061010100,"Census Tract 101, New York County, New York",749,189,560,560,993,137614,2005,2007,2001,30.7,378,301,44,150,50,560,33
2013,36061010100,"Census Tract 101, New York County, New York",828,194,634,634,1046,142167,2007,2009,2001,27.9,472,313,45,215,50,634,20
2014,36061010100,"Census Tract 101, New York County, New York",917,208,709,703,1119,150250,2007,2011,2001,26.5,523,359,23,243,59,709,36
2015,36061010100,"Census Tract 101, New York County, New York",963,204,759,752,1172,160556,2008,2012,3362,25.1,580,388,11,289,51,759,41
2016,36061010100,"Census Tract 101, New York County, New York",995,188,807,799,1100,146615,2008,NA,3501,27.2,625,403,12,295,73,807,46
2017,36061010100,"Census Tract 101, New York County, New York",1054,231,823,814,1137,148750,2009,NA,3446,24.6,636,420,22,274,74,823,46
2018,36061010100,"Census Tract 101, New York County, New York",1130,300,830,818,1170,135652,2008,2014,3355,27.2,645,413,41,237,89,830,78
2019,36061010100,"Census Tract 101, New York County, New York",1172,348,824,814,1244,134545,2010,2015,3415,25,663,402,42,234,103,824,76
2020,36061010100,"Census Tract 101, New York County, New York",1235,287,948,944,1333,96667,2012,2017,3165,29.3,758,470,82,273,90,948,74
2012,36061010200,"Census Tract 102, New York County, New York",265,136,129,54,88,15900,1963,2011,2001,50,29,54,0,0,0,129,18
2013,36061010200,"Census Tract 102, New York County, New York",268,117,151,105,192,161563,2001,2008,2001,10,79,105,0,0,0,151,19
2014,36061010200,"Census Tract 102, New York County, New York",269,145,124,88,154,16471,1971,2011,2001,50,54,88,0,0,0,124,27
2015,36061010200,"Census Tract 102, New York County, New York",313,188,125,86,157,NA,1972,2011,3501,42.5,51,86,0,0,0,125,19
2016,36061010200,"Census Tract 102, New York County, New York",309,220,89,59,93,NA,1979,2009,2972,31.8,52,53,0,0,0,89,19
2017,36061010200,"Census Tract 102, New York County, New York",305,249,56,36,62,170167,1973,2009,3501,32.7,30,31,0,0,0,56,4
2018,36061010200,"Census Tract 102, New York County, New York",305,256,49,22,33,NA,1972,2013,3250,37.5,15,16,0,0,0,49,7
2019,36061010200,"Census Tract 102, New York County, New York",315,249,66,31,50,NA,1969,2015,2875,45,19,27,0,0,0,66,10
2020,36061010200,"Census Tract 102, New York County, New York",318,187,131,100,117,80970,1946,2013,3501,51,88,96,0,0,0,131,11
2012,36061010300,"Census Tract 103, New York County, New York",1402,215,1187,1066,1800,90714,1976,2005,2001,27.8,787,631,66,310,33,1187,79
2013,36061010300,"Census Tract 103, New York County, New York",1351,204,1147,1029,1713,90684,1979,2006,2001,28.2,779,657,58,226,41,1147,100
2014,36061010300,"Census Tract 103, New York County, New York",1396,177,1219,1071,1833,86723,1970,2009,2001,29.1,777,619,66,251,30,1219,121
2015,36061010300,"Census Tract 103, New York County, New York",1371,220,1151,1021,1703,NA,1971,2010,2455,28,807,612,100,223,30,1151,91
2016,36061010300,"Census Tract 103, New York County, New York",1357,245,1112,984,1658,92578,1973,2011,2523,29.6,811,622,73,199,37,1112,78
2017,36061010300,"Census Tract 103, New York County, New York",1321,250,1071,933,1506,98112,1976,2011,2637,29.1,773,531,58,192,89,1071,100
2018,36061010300,"Census Tract 103, New York County, New York",1497,289,1208,1061,1769,100566,1980,2012,2841,30.2,881,541,84,308,71,1208,116
2019,36061010300,"Census Tract 103, New York County, New York",1632,364,1268,1140,1869,92308,1983,2014,2895,30.7,1023,685,82,260,94,1268,110
2020,36061010300,"Census Tract 103, New York County, New York",1744,425,1319,1170,2006,104394,1996,NA,2994,27.8,1021,741,20,275,112,1319,88
2012,36061010400,"Census Tract 104, New York County, New York",1033,329,704,362,508,58636,1939,2003,1788,27.8,234,255,23,31,70,704,84
2013,36061010400,"Census Tract 104, New York County, New York",1033,366,667,315,476,60893,1939,2003,1899,27.1,240,199,6,45,65,667,90
2014,36061010400,"Census Tract 104, New York County, New York",1043,370,673,363,542,62788,1940,2003,1895,29.2,256,235,5,66,57,673,58
2015,36061010400,"Census Tract 104, New York County, New York",1063,436,627,347,524,80804,1945,2005,2276,28.9,218,229,5,94,19,627,46
2016,36061010400,"Census Tract 104, New York County, New York",1064,486,578,284,444,81563,1953,2010,2375,28.5,203,192,0,77,15,578,60
2017,36061010400,"Census Tract 104, New York County, New York",1046,454,592,287,463,83672,1954,2012,2661,28.2,206,210,0,61,16,592,44
2018,36061010400,"Census Tract 104, New York County, New York",1028,457,571,286,469,101500,1954,2012,2829,28.7,220,206,5,49,26,571,30
2019,36061010400,"Census Tract 104, New York County, New York",993,471,522,240,354,116333,1951,2013,2691,24.8,202,184,5,44,7,522,28
2020,36061010400,"Census Tract 104, New York County, New York",982,430,552,271,386,118958,0,2016,2179,22,247,219,5,40,7,552,31
2012,36061010601,"Census Tract 106.01, New York County, New York",5142,764,4378,1753,2642,92196,1954,2003,2001,29.4,1315,1530,80,89,31,4378,83
2013,36061010601,"Census Tract 106.01, New York County, New York",5146,870,4276,1693,2619,94952,1953,2003,2001,29.1,1257,1476,55,92,45,4276,130
2014,36061010601,"Census Tract 106.01, New York County, New York",5230,892,4338,1524,2289,93987,1951,2005,2001,29.6,1150,1278,53,102,66,4338,158
2015,36061010601,"Census Tract 106.01, New York County, New York",5256,806,4450,1548,2261,92740,1953,2005,2368,36.2,1141,1357,53,67,48,4450,223
2016,36061010601,"Census Tract 106.01, New York County, New York",5341,989,4352,1269,1743,84020,1955,2010,2694,38,893,1098,23,103,45,4352,201
2017,36061010601,"Census Tract 106.01, New York County, New York",5395,1154,4241,1120,1583,66800,1951,2011,2690,35.2,733,972,0,66,82,4241,246
2018,36061010601,"Census Tract 106.01, New York County, New York",5411,1012,4399,1085,1497,69856,1943,2011,2748,32.2,717,896,0,103,86,4399,159
2019,36061010601,"Census Tract 106.01, New York County, New York",5616,1284,4332,1305,1730,100656,1951,2012,2818,32.7,974,1119,0,136,50,4332,219
2020,36061010601,"Census Tract 106.01, New York County, New York",5395,1268,4127,1181,1589,100257,1952,2013,2959,30.8,892,970,0,110,101,4127,206
2012,36061010602,"Census Tract 106.02, New York County, New York",2981,312,2669,2036,3772,90217,1958,2003,2001,25.2,1819,1683,0,209,132,2669,97
2013,36061010602,"Census Tract 106.02, New York County, New York",2963,402,2561,1913,3458,99659,1960,2005,2001,24.5,1692,1557,70,128,149,2561,90
2014,36061010602,"Census Tract 106.02, New York County, New York",2975,539,2436,1800,3277,108667,1961,2007,2001,26,1621,1419,49,158,164,2436,118
2015,36061010602,"Census Tract 106.02, New York County, New York",2946,580,2366,1706,3288,111951,1966,2011,2393,25.2,1575,1359,59,201,87,2366,132
2016,36061010602,"Census Tract 106.02, New York County, New York",2956,633,2323,1701,3252,119740,1970,2011,2585,26,1570,1319,58,168,156,2323,103
2017,36061010602,"Census Tract 106.02, New York County, New York",2926,664,2262,1735,3688,134517,1969,2011,2872,26.1,1559,1367,60,140,154,2262,96
2018,36061010602,"Census Tract 106.02, New York County, New York",2925,758,2167,1704,3694,148750,1967,2012,2920,25.9,1575,1322,15,209,143,2167,55
2019,36061010602,"Census Tract 106.02, New York County, New York",2964,697,2267,1905,4081,149866,1976,2013,3029,24.4,1728,1416,20,292,160,2267,78
2020,36061010602,"Census Tract 106.02, New York County, New York",2666,575,2091,1775,3936,155972,1980,2015,3142,23.8,1593,1316,0,266,162,2091,59
2012,36061010800,"Census Tract 108, New York County, New York",6282,1355,4927,2830,4612,84167,1956,2003,2001,25.6,2292,2245,68,352,114,4927,183
2013,36061010800,"Census Tract 108, New York County, New York",6272,1392,4880,2790,4524,92554,1957,2005,2001,24.6,2380,2174,30,364,165,4880,217
2014,36061010800,"Census Tract 108, New York County, New York",6291,1336,4955,2909,4777,95791,1958,2008,2001,24.7,2546,2321,26,346,160,4955,239
2015,36061010800,"Census Tract 108, New York County, New York",6284,1465,4819,2814,4971,104000,1958,2011,2196,23.7,2527,2333,11,321,119,4819,195
2016,36061010800,"Census Tract 108, New York County, New York",6166,1419,4747,2902,5219,111541,1959,2012,2248,21.8,2627,2385,0,368,122,4747,211
2017,36061010800,"Census Tract 108, New York County, New York",6147,1303,4844,3023,5234,132127,1954,2012,2272,19.3,2792,2500,0,373,101,4844,168
2018,36061010800,"Census Tract 108, New York County, New York",6222,1231,4991,2940,5054,127308,1954,2012,2203,18.7,2630,2552,0,250,95,4991,172
2019,36061010800,"Census Tract 108, New York County, New York",6288,1334,4954,2942,4956,151992,1955,2013,2364,18.3,2559,2413,0,249,200,4954,247
2020,36061010801,"Census Tract 108.01, New York County, New York",2112,346,1766,1168,1830,163358,1954,2015,2291,17.1,1070,928,0,173,67,1766,67
2020,36061010802,"Census Tract 108.02, New York County, New York",2572,287,2285,1323,2365,95511,1954,2015,3062,29.8,1089,1090,0,27,100,2285,170
2020,36061010803,"Census Tract 108.03, New York County, New York",1482,387,1095,442,704,152222,1956,2016,2208,18.6,442,319,0,0,96,1095,47
2012,36061010900,"Census Tract 109, New York County, New York",62,0,62,28,50,64167,1944,2011,1893,33.3,25,14,0,9,0,62,5
2013,36061010900,"Census Tract 109, New York County, New York",92,16,76,47,101,64659,1939,2011,2001,35.3,41,28,0,14,0,76,11
2014,36061010900,"Census Tract 109, New York County, New York",131,23,108,66,131,101731,1939,2011,2001,30,60,35,0,26,0,108,11
2015,36061010900,"Census Tract 109, New York County, New York",125,34,91,61,119,NA,1939,NA,3050,22,56,24,0,31,0,91,12
2016,36061010900,"Census Tract 109, New York County, New York",108,34,74,48,95,104722,1939,NA,3020,23,42,24,0,24,0,74,8
2017,36061010900,"Census Tract 109, New York County, New York",123,32,91,64,113,160769,1939,2014,2792,18.8,61,36,0,28,0,91,7
2018,36061010900,"Census Tract 109, New York County, New York",110,17,93,64,99,166429,0,2015,2719,18.7,64,34,0,30,0,93,3
2019,36061010900,"Census Tract 109, New York County, New York",96,18,78,53,69,141250,0,2017,2866,25.8,53,29,0,24,0,78,3
2020,36061010900,"Census Tract 109, New York County, New York",108,21,87,56,81,131667,0,2017,2976,26.5,53,35,0,18,0,87,2
2012,36061011000,"Census Tract 110, New York County, New York",5320,960,4360,3470,5636,100054,1955,2004,1940,24.3,2681,3084,94,190,82,4360,258
2013,36061011000,"Census Tract 110, New York County, New York",5237,1036,4201,3473,6001,101498,1955,2005,1966,23.4,2698,3028,65,246,113,4201,183
2014,36061011000,"Census Tract 110, New York County, New York",5098,913,4185,3568,6429,92778,1960,2007,1961,26.4,2818,2983,145,175,260,4185,156
2015,36061011000,"Census Tract 110, New York County, New York",5040,863,4177,3394,6024,98971,1955,2009,1977,23.9,2665,2706,205,268,208,4177,243
2016,36061011000,"Census Tract 110, New York County, New York",5068,864,4204,3292,5849,105556,1956,2010,2140,23.1,2512,2677,235,176,227,4204,281
2017,36061011000,"Census Tract 110, New York County, New York",5043,970,4073,3246,5941,114083,1961,2011,2439,22.6,2603,2706,138,178,249,4073,281
2018,36061011000,"Census Tract 110, New York County, New York",5045,1106,3939,2929,4951,114495,1962,2012,2569,24.3,2409,2362,131,144,319,3939,347
2019,36061011000,"Census Tract 110, New York County, New York",5123,1128,3995,3031,5358,143490,1964,2013,2764,21.8,2504,2463,122,266,180,3995,320
2020,36061011000,"Census Tract 110, New York County, New York",5038,1096,3942,3264,6030,146350,1961,2014,2885,21.6,2811,2644,72,246,302,3942,204
2012,36061011100,"Census Tract 111, New York County, New York",2367,467,1900,1674,2952,72544,1960,2006,1840,27.8,1118,761,150,362,369,1900,228
2013,36061011100,"Census Tract 111, New York County, New York",2576,480,2096,1839,3388,90245,1993,2008,1995,25.8,1247,835,197,398,382,2096,213
2014,36061011100,"Census Tract 111, New York County, New York",2761,508,2253,2025,3915,94375,1994,2011,2001,26,1402,982,201,462,343,2253,248
2015,36061011100,"Census Tract 111, New York County, New York",2961,497,2464,2190,4204,104667,1999,NA,2390,26.3,1566,1066,261,482,334,2464,264
2016,36061011100,"Census Tract 111, New York County, New York",3122,454,2668,2367,4519,107270,2001,2011,2373,25,1534,1257,176,427,470,2668,279
2017,36061011100,"Census Tract 111, New York County, New York",3125,441,2684,2389,4491,104659,2001,2012,2398,24.2,1451,1188,167,547,451,2684,322
2018,36061011100,"Census Tract 111, New York County, New York",3108,362,2746,2490,4411,97609,2002,2012,2676,26.8,1612,1339,194,526,389,2746,380
2019,36061011100,"Census Tract 111, New York County, New York",3141,324,2817,2475,4147,111098,2003,2013,3048,27.2,1758,1347,166,527,413,2817,306
2020,36061011100,"Census Tract 111, New York County, New York",2999,320,2679,2382,4173,112767,2002,2014,3041,26.6,1708,1198,61,623,502,2679,247
2012,36061011201,"Census Tract 112.01, New York County, New York",920,324,596,458,669,113750,1950,2003,2001,24.9,317,391,13,26,28,596,6
2013,36061011201,"Census Tract 112.01, New York County, New York",964,391,573,500,713,150417,1954,2004,2001,23.4,377,430,11,32,27,573,10
2014,36061011201,"Census Tract 112.01, New York County, New York",1012,423,589,485,647,164712,1957,2006,2001,20.1,366,421,11,41,3,589,17
2015,36061011201,"Census Tract 112.01, New York County, New York",1016,467,549,453,619,126964,1955,2007,2435,23.3,343,415,0,26,5,549,36
2016,36061011201,"Census Tract 112.01, New York County, New York",1020,489,531,450,655,128333,1955,2008,2484,22.8,339,402,6,27,11,531,32
2017,36061011201,"Census Tract 112.01, New York County, New York",1012,520,492,407,621,133542,1954,2009,2571,22.3,311,355,7,26,13,492,29
2018,36061011201,"Census Tract 112.01, New York County, New York",996,516,480,376,600,130625,1952,2011,2447,22.5,265,305,19,29,17,480,24
2019,36061011201,"Census Tract 112.01, New York County, New York",1001,503,498,390,649,119750,1958,2011,2449,19.8,306,300,21,46,23,498,44
2020,36061011201,"Census Tract 112.01, New York County, New York",948,431,517,350,690,191786,1958,2013,2603,17.7,286,240,19,65,26,517,25
2012,36061011202,"Census Tract 112.02, New York County, New York",496,285,211,22,33,250001,1965,NA,2001,NA,22,22,0,0,0,211,5
2013,36061011202,"Census Tract 112.02, New York County, New York",487,294,193,49,59,191696,1946,2003,2001,18,44,49,0,0,0,193,5
2014,36061011202,"Census Tract 112.02, New York County, New York",466,283,183,38,52,193125,1943,2003,2001,18.4,34,38,0,0,0,183,5
2015,36061011202,"Census Tract 112.02, New York County, New York",455,265,190,63,90,193661,1944,2010,2760,17.7,58,55,0,8,0,190,9
2016,36061011202,"Census Tract 112.02, New York County, New York",473,309,164,64,91,196333,1944,2010,2778,17.8,60,56,0,8,0,164,10
2017,36061011202,"Census Tract 112.02, New York County, New York",510,348,162,56,75,200893,1981,2012,2738,16.8,52,43,0,13,0,162,4
2018,36061011202,"Census Tract 112.02, New York County, New York",540,349,191,47,90,NA,1985,2016,3117,26.8,47,36,0,11,0,191,7
2019,36061011202,"Census Tract 112.02, New York County, New York",561,339,222,60,107,158611,1983,2016,3100,28.1,60,47,0,13,0,222,11
2020,36061011202,"Census Tract 112.02, New York County, New York",601,367,234,42,73,NA,1983,2016,3500,35.5,35,36,0,6,0,234,5
2012,36061011203,"Census Tract 112.03, New York County, New York",1150,522,628,364,570,71818,1966,2004,2001,41.2,251,311,0,37,1,628,154
2013,36061011203,"Census Tract 112.03, New York County, New York",1160,465,695,388,673,78295,1965,2005,2001,36.8,293,317,15,47,9,695,147
2014,36061011203,"Census Tract 112.03, New York County, New York",1174,436,738,418,811,94722,1965,2009,2001,34,329,343,16,50,9,738,135
2015,36061011203,"Census Tract 112.03, New York County, New York",1172,483,689,395,719,127583,1967,2011,3041,32,331,302,13,74,6,689,76
2016,36061011203,"Census Tract 112.03, New York County, New York",1208,530,678,401,804,118229,1967,2011,2778,23.7,332,298,12,78,13,678,57
2017,36061011203,"Census Tract 112.03, New York County, New York",1214,549,665,410,848,123571,1968,2011,2701,21.3,350,313,12,72,13,665,55
2018,36061011203,"Census Tract 112.03, New York County, New York",1204,556,648,371,722,122981,1967,2012,2853,23.4,317,300,0,64,7,648,40
2019,36061011203,"Census Tract 112.03, New York County, New York",1202,609,593,301,583,114583,1969,2012,2797,22.9,257,241,0,54,6,593,28
2020,36061011203,"Census Tract 112.03, New York County, New York",1145,532,613,309,627,147596,1969,2013,2605,22,242,281,0,21,7,613,25
2012,36061011300,"Census Tract 113, New York County, New York",96,8,88,81,112,122188,1939,2006,2001,21.4,47,34,0,41,0,88,6
2013,36061011300,"Census Tract 113, New York County, New York",107,5,102,85,113,142542,1939,2006,1783,19.3,55,44,0,41,0,102,0
2014,36061011300,"Census Tract 113, New York County, New York",71,5,66,39,60,134063,2001,2011,2001,21.9,39,13,0,26,0,66,0
2015,36061011300,"Census Tract 113, New York County, New York",74,7,67,39,61,134250,2003,2012,2732,20.6,39,14,0,25,0,67,0
2016,36061011300,"Census Tract 113, New York County, New York",79,16,63,37,57,137188,2003,NA,2750,25.9,34,12,0,22,0,63,3
2017,36061011300,"Census Tract 113, New York County, New York",78,16,62,33,48,152750,1982,2012,3021,22.5,30,11,0,19,0,62,3
2018,36061011300,"Census Tract 113, New York County, New York",69,12,57,28,41,130000,2001,2013,3200,27.2,23,3,0,20,0,57,9
2019,36061011300,"Census Tract 113, New York County, New York",87,34,53,28,28,96875,1983,2013,3042,28.8,21,3,0,18,0,53,11
2020,36061011300,"Census Tract 113, New York County, New York",77,27,50,25,25,133125,1968,2013,2406,28.9,19,9,0,10,0,50,10
2012,36061011401,"Census Tract 114.01, New York County, New York",1261,628,633,387,681,83875,1939,2003,1547,21.1,246,366,9,12,0,633,77
2013,36061011401,"Census Tract 114.01, New York County, New York",1256,597,659,356,642,112000,1939,2004,1869,21.3,246,317,8,31,0,659,55
2014,36061011401,"Census Tract 114.01, New York County, New York",1289,627,662,373,701,102250,1939,2005,1930,22.2,254,318,0,50,5,662,42
2015,36061011401,"Census Tract 114.01, New York County, New York",1284,662,622,307,577,148250,1942,2008,2213,18.2,231,271,0,24,4,622,29
2016,36061011401,"Census Tract 114.01, New York County, New York",1313,664,649,321,591,152250,1946,2008,2135,17.5,247,291,0,21,4,649,36
2017,36061011401,"Census Tract 114.01, New York County, New York",1351,697,654,290,564,232813,1946,2007,2188,16.9,235,257,0,22,5,654,30
2018,36061011401,"Census Tract 114.01, New York County, New York",1350,729,621,238,433,210000,1944,2007,2070,15.3,184,221,0,0,13,621,32
2019,36061011401,"Census Tract 114.01, New York County, New York",1370,727,643,241,416,250001,0,2008,2000,9,203,210,0,7,22,643,41
2020,36061011401,"Census Tract 114.01, New York County, New York",1384,708,676,312,430,250001,0,2013,2435,15.3,273,283,0,7,22,676,34
2012,36061011402,"Census Tract 114.02, New York County, New York",1954,601,1353,533,836,95881,1939,2004,1900,24.3,421,403,23,84,23,1353,96
2013,36061011402,"Census Tract 114.02, New York County, New York",2000,608,1392,516,871,76563,1939,2004,2001,35.4,422,398,19,84,15,1392,74
2014,36061011402,"Census Tract 114.02, New York County, New York",1967,662,1305,476,779,81111,1939,2007,2001,27.2,420,387,11,61,17,1305,86
2015,36061011402,"Census Tract 114.02, New York County, New York",1902,638,1264,430,707,82727,1939,2008,2045,22.5,375,362,11,52,5,1264,67
2016,36061011402,"Census Tract 114.02, New York County, New York",1886,743,1143,314,488,82037,1939,2006,2112,22.7,263,278,0,36,0,1143,67
2017,36061011402,"Census Tract 114.02, New York County, New York",1873,738,1135,313,382,84491,1939,2010,2073,20.1,232,307,0,6,0,1135,70
2018,36061011402,"Census Tract 114.02, New York County, New York",1876,837,1039,274,383,84200,0,2011,2116,19.9,194,242,9,8,8,1039,87
2019,36061011402,"Census Tract 114.02, New York County, New York",1894,832,1062,293,418,101964,1941,2012,2250,19.8,202,247,11,7,20,1062,81
2020,36061011402,"Census Tract 114.02, New York County, New York",1918,853,1065,350,611,NA,1955,2017,2731,22.4,269,304,10,9,19,1065,74
2012,36061011500,"Census Tract 115, New York County, New York",1537,411,1126,872,1761,61500,1989,2005,1718,28.9,538,364,63,179,215,1126,179
2013,36061011500,"Census Tract 115, New York County, New York",1678,489,1189,959,1851,71426,2000,2008,1998,25,649,422,74,173,248,1189,164
2014,36061011500,"Census Tract 115, New York County, New York",1848,536,1312,1076,2006,71250,2001,2011,2001,26,760,482,55,248,268,1312,221
2015,36061011500,"Census Tract 115, New York County, New York",2025,533,1492,1225,2258,84861,2003,2011,2280,26.7,899,575,76,287,294,1492,232
2016,36061011500,"Census Tract 115, New York County, New York",2250,595,1655,1368,2459,88417,2004,NA,2407,27.9,997,633,76,404,275,1655,246
2017,36061011500,"Census Tract 115, New York County, New York",2315,541,1774,1464,2637,113750,2004,2012,2446,24.5,1099,704,88,424,284,1774,220
2018,36061011500,"Census Tract 115, New York County, New York",2337,499,1838,1501,2873,124219,2005,NA,2625,25.3,1111,719,62,502,219,1838,279
2019,36061011500,"Census Tract 115, New York County, New York",2361,475,1886,1563,2821,107337,2006,2014,2440,27.6,1151,691,87,553,256,1886,234
2020,36061011500,"Census Tract 115, New York County, New York",2295,516,1779,1509,2850,121406,2005,2014,2463,27.8,1151,675,86,514,242,1779,207
2012,36061011600,"Census Tract 116, New York County, New York",2757,603,2154,1788,2858,65726,1939,2001,1222,25.5,1381,1205,144,285,96,2154,73
2013,36061011600,"Census Tract 116, New York County, New York",2737,568,2169,1790,2867,66029,1939,2002,1184,26.2,1343,1237,168,230,87,2169,85
2014,36061011600,"Census Tract 116, New York County, New York",2770,722,2048,1700,2678,66684,1946,2003,1277,26.9,1212,1217,178,130,99,2048,154
2015,36061011600,"Census Tract 116, New York County, New York",2553,732,1821,1474,2300,70615,1952,2007,1465,28.2,1152,1035,165,165,78,1821,140
2016,36061011600,"Census Tract 116, New York County, New York",2418,507,1911,1523,2457,72845,1957,2010,1514,28.1,1161,1065,169,130,150,1911,131
2017,36061011600,"Census Tract 116, New York County, New York",2297,459,1838,1444,2655,82596,1963,2012,1669,26.9,1101,1121,70,131,103,1838,116
2018,36061011600,"Census Tract 116, New York County, New York",2173,456,1717,1345,2587,84519,1963,2012,1728,26.6,1062,994,30,164,136,1717,137
2019,36061011600,"Census Tract 116, New York County, New York",2187,436,1751,1379,2684,91838,1949,2014,1739,26.1,1120,970,16,194,191,1751,65
2020,36061011600,"Census Tract 116, New York County, New York",2566,464,2102,1766,2938,79583,0,2016,1857,26.4,1210,1221,15,347,175,2102,270
2012,36061011700,"Census Tract 117, New York County, New York",1950,504,1446,1446,2441,103015,2004,2007,2001,26.8,1153,822,163,164,248,1446,158
2013,36061011700,"Census Tract 117, New York County, New York",2304,568,1736,1736,2935,106423,NA,2009,2001,29.3,1335,958,198,262,270,1736,173
2014,36061011700,"Census Tract 117, New York County, New York",2580,553,2027,2027,3531,106226,2005,2011,2001,29.4,1509,1049,235,324,343,2027,174
2015,36061011700,"Census Tract 117, New York County, New York",2908,545,2363,2363,3865,107125,2004,2011,2880,29.3,1744,1305,293,317,378,2363,208
2016,36061011700,"Census Tract 117, New York County, New York",2988,683,2305,2305,3949,119927,2004,2011,2816,26.8,1670,1222,261,341,462,2305,195
2017,36061011700,"Census Tract 117, New York County, New York",2934,516,2418,2418,3937,124964,2004,2013,2933,27.6,1836,1310,216,514,351,2418,158
2018,36061011700,"Census Tract 117, New York County, New York",2849,390,2459,2459,4237,134606,2004,2013,3005,25.2,1939,1328,262,427,438,2459,132
2019,36061011700,"Census Tract 117, New York County, New York",3195,472,2723,2723,4186,159671,2004,2015,3149,24.3,2303,1546,344,485,379,2723,159
2020,36061011700,"Census Tract 117, New York County, New York",3435,563,2872,2872,4308,139797,2005,2015,3413,25.1,2526,1648,287,603,302,2872,183
2012,36061011800,"Census Tract 118, New York County, New York",6726,1435,5291,3854,7175,121024,1961,2003,2001,22.5,3163,3336,34,343,43,5291,348
2013,36061011800,"Census Tract 118, New York County, New York",6523,1209,5314,3977,7169,105363,1962,2004,2001,21.9,3381,3403,33,305,171,5314,285
2014,36061011800,"Census Tract 118, New York County, New York",6370,1140,5230,3732,6737,95490,1961,2005,2001,25.8,3008,3129,35,351,150,5230,360
2015,36061011800,"Census Tract 118, New York County, New York",6124,988,5136,3591,6216,95359,1961,2008,2276,25.8,3018,2939,35,326,177,5136,284
2016,36061011800,"Census Tract 118, New York County, New York",5983,1046,4937,3397,5911,102087,1959,2010,2437,24,2795,2907,0,225,144,4937,194
2017,36061011800,"Census Tract 118, New York County, New York",6019,1135,4884,3267,5476,103148,1957,2010,2450,28,2617,2741,0,314,186,4884,293
2018,36061011800,"Census Tract 118, New York County, New York",6022,1310,4712,2988,5325,106955,1955,2012,2525,28.2,2459,2511,0,326,141,4712,364
2019,36061011800,"Census Tract 118, New York County, New York",6020,1182,4838,3243,5768,128966,1956,2013,2507,25.3,2814,2689,0,392,150,4838,271
2020,36061011800,"Census Tract 118, New York County, New York",6371,1439,4932,3305,5765,131474,1949,2014,2494,25.4,2874,2704,0,472,129,4932,233
2012,36061011900,"Census Tract 119, New York County, New York",1122,96,1026,1026,1108,11270,1939,2004,383,30.8,276,442,401,20,189,1026,578
2013,36061011900,"Census Tract 119, New York County, New York",1121,108,1013,1013,1079,11981,1939,2003,330,29.9,172,374,398,10,227,1013,520
2014,36061011900,"Census Tract 119, New York County, New York",1110,81,1029,1029,1071,12479,1939,2004,313,30.5,197,386,436,8,247,1029,507
2015,36061011900,"Census Tract 119, New York County, New York",1088,52,1036,1036,1068,11671,1939,2004,332,30.8,269,379,443,15,244,1036,593
2016,36061011900,"Census Tract 119, New York County, New York",1113,151,962,962,996,12903,1939,2004,535,31.7,243,289,388,24,276,962,500
2017,36061011900,"Census Tract 119, New York County, New York",1132,175,957,957,1027,16394,1939,2006,517,32.4,200,246,475,19,260,957,418
2018,36061011900,"Census Tract 119, New York County, New York",1147,157,990,990,1097,19803,0,2007,612,32.4,279,261,522,42,243,990,406
2019,36061011900,"Census Tract 119, New York County, New York",1130,197,933,933,1071,17568,0,2008,711,35.1,347,299,429,76,148,933,411
2020,36061011900,"Census Tract 119, New York County, New York",1174,255,919,919,1024,18750,0,2009,538,30.8,260,262,408,19,247,919,398
2012,36061012000,"Census Tract 120, New York County, New York",2675,750,1925,726,1343,124211,1960,2005,2001,27,617,533,0,58,121,1925,119
2013,36061012000,"Census Tract 120, New York County, New York",2637,775,1862,661,1175,109811,1957,2005,2001,28.1,586,504,0,53,87,1862,110
2014,36061012000,"Census Tract 120, New York County, New York",2624,867,1757,593,1110,134688,1957,2006,2001,27,518,448,0,58,69,1757,114
2015,36061012000,"Census Tract 120, New York County, New York",2534,818,1716,510,877,110714,1939,2010,2374,30.2,461,456,0,41,13,1716,64
2016,36061012000,"Census Tract 120, New York County, New York",2549,728,1821,490,841,94878,1939,2010,2220,31,430,399,41,36,14,1821,92
2017,36061012000,"Census Tract 120, New York County, New York",2594,825,1769,371,513,82083,1939,2011,1996,19.3,288,319,38,0,14,1769,42
2018,36061012000,"Census Tract 120, New York County, New York",2613,960,1653,465,728,98220,0,2013,2439,21.9,314,370,83,0,12,1653,90
2019,36061012000,"Census Tract 120, New York County, New York",2586,929,1657,495,866,102250,0,2014,2256,19.1,352,384,86,12,13,1657,85
2020,36061012000,"Census Tract 120, New York County, New York",2542,916,1626,505,1095,154104,1954,2016,2440,15.4,385,399,83,11,12,1626,92
2012,36061012100,"Census Tract 121, New York County, New York",5752,493,5259,4923,7700,58539,1967,2002,1332,27.3,2930,3180,384,549,639,5259,604
2013,36061012100,"Census Tract 121, New York County, New York",5744,668,5076,4801,7812,60369,1969,2002,1514,27.8,2819,3121,349,488,719,5076,475
2014,36061012100,"Census Tract 121, New York County, New York",5753,725,5028,4735,7655,61408,1965,2003,1435,27.8,2700,3081,307,519,720,5028,443
2015,36061012100,"Census Tract 121, New York County, New York",5627,663,4964,4658,7627,61108,1966,2004,1457,28.5,2826,3139,193,430,865,4964,477
2016,36061012100,"Census Tract 121, New York County, New York",5670,802,4868,4546,7300,63000,1965,2006,1476,27.9,3088,3278,286,404,588,4868,451
2017,36061012100,"Census Tract 121, New York County, New York",5633,901,4732,4471,7974,67947,1958,2008,1488,26.7,3007,3115,219,379,758,4732,613
2018,36061012100,"Census Tract 121, New York County, New York",5625,835,4790,4539,7405,53956,1954,2010,1366,29.9,2871,3096,220,555,646,4790,852
2019,36061012100,"Census Tract 121, New York County, New York",5619,920,4699,4552,7441,61634,1968,2009,1366,29.6,2930,3144,229,427,702,4699,721
2020,36061012101,"Census Tract 121.01, New York County, New York",2187,540,1647,1542,2649,68534,1965,2015,1164,29.8,990,948,0,282,275,1647,449
2020,36061012102,"Census Tract 121.02, New York County, New York",3371,253,3118,3118,4706,51419,1971,2006,1158,30.8,1767,1931,122,314,705,3118,382
2012,36061012200,"Census Tract 122, New York County, New York",2860,1225,1635,657,1160,96222,1939,2003,2001,25.7,497,607,0,0,50,1635,67
2013,36061012200,"Census Tract 122, New York County, New York",2873,1134,1739,617,1159,113563,1939,2007,2001,25,486,601,0,0,16,1739,53
2014,36061012200,"Census Tract 122, New York County, New York",2971,1121,1850,621,1106,100486,1939,2011,2001,27.8,524,606,0,0,15,1850,106
2015,36061012200,"Census Tract 122, New York County, New York",2977,1125,1852,617,932,87563,1939,2011,2572,27.8,507,603,0,0,14,1852,101
2016,36061012200,"Census Tract 122, New York County, New York",2963,1167,1796,616,908,90571,1939,2011,2376,26.7,531,616,0,0,0,1796,108
2017,36061012200,"Census Tract 122, New York County, New York",2963,1209,1754,513,709,90104,1939,2010,2449,27.8,442,513,0,0,0,1754,124
2018,36061012200,"Census Tract 122, New York County, New York",2880,1435,1445,415,614,81993,0,2008,2198,29,346,415,0,0,0,1445,76
2019,36061012200,"Census Tract 122, New York County, New York",2803,1392,1411,373,536,87188,0,2003,1991,29.7,300,373,0,0,0,1411,55
2020,36061012200,"Census Tract 122, New York County, New York",2514,1188,1326,336,465,117885,0,2001,1705,24.7,302,321,0,15,0,1326,51
2012,36061012400,"Census Tract 124, New York County, New York",6578,1275,5303,4375,8064,91426,1971,2005,1977,25.6,3424,3311,239,579,253,5303,311
2013,36061012400,"Census Tract 124, New York County, New York",6548,1467,5081,4103,7588,105336,1968,2006,2001,24.7,3243,3072,194,624,226,5081,274
2014,36061012400,"Census Tract 124, New York County, New York",6584,1332,5252,4109,7419,106439,1968,2008,2001,23.6,3214,3115,196,638,169,5252,346
2015,36061012400,"Census Tract 124, New York County, New York",6593,1268,5325,4038,7146,107560,1968,2011,2147,23.7,2982,2907,142,664,224,5325,385
2016,36061012400,"Census Tract 124, New York County, New York",6482,1101,5381,4003,6865,88634,1966,2011,2233,25.9,3138,2786,98,613,414,5381,452
2017,36061012400,"Census Tract 124, New York County, New York",6428,973,5455,3923,6330,114359,1964,2012,2334,25.2,3265,2857,73,545,360,5455,470
2018,36061012400,"Census Tract 124, New York County, New York",6422,1219,5203,3980,6655,116907,1970,2013,2431,25.5,3350,2919,37,524,428,5203,397
2019,36061012400,"Census Tract 124, New York County, New York",6510,1378,5132,4217,7121,126512,1966,2015,2461,25.1,3481,3089,20,580,432,5132,330
2020,36061012400,"Census Tract 124, New York County, New York",6374,1199,5175,3921,6670,121599,1965,2016,2555,26,3458,2873,16,564,415,5175,237
2012,36061012500,"Census Tract 125, New York County, New York",2034,571,1463,1434,2299,129700,1996,2005,2001,23,1194,800,89,433,81,1463,217
2013,36061012500,"Census Tract 125, New York County, New York",2096,648,1448,1380,2344,138750,1996,2007,2001,24.7,1101,686,83,525,62,1448,220
2014,36061012500,"Census Tract 125, New York County, New York",2132,711,1421,1341,2362,142461,1995,2010,2001,24.7,1111,690,58,470,67,1421,137
2015,36061012500,"Census Tract 125, New York County, New York",2128,656,1472,1363,2345,NA,1994,2011,3452,24.7,1136,713,54,441,115,1472,108
2016,36061012500,"Census Tract 125, New York County, New York",2128,685,1443,1364,2388,146458,1993,2011,3413,24.3,1181,717,32,443,136,1443,116
2017,36061012500,"Census Tract 125, New York County, New York",2109,651,1458,1375,2358,136964,1993,2013,3501,25.1,1106,732,8,457,137,1458,171
2018,36061012500,"Census Tract 125, New York County, New York",2102,591,1511,1439,2289,126309,1994,2013,3302,26,1150,739,46,381,201,1511,227
2019,36061012500,"Census Tract 125, New York County, New York",2092,559,1533,1430,2137,121538,1992,2015,3326,28.4,1094,826,59,329,195,1533,280
2020,36061012500,"Census Tract 125, New York County, New York",2045,570,1475,1367,2067,112121,1991,NA,3335,23.1,984,712,126,292,211,1475,255
2012,36061012600,"Census Tract 126, New York County, New York",8693,1648,7045,4529,7381,77587,1958,2002,1826,28.3,3489,3763,117,260,376,7045,410
2013,36061012600,"Census Tract 126, New York County, New York",8654,1662,6992,4387,6628,74365,1959,2002,1748,28.1,3397,3711,115,271,275,6992,348
2014,36061012600,"Census Tract 126, New York County, New York",8685,1772,6913,4338,6601,76092,1960,2004,1746,26.8,3179,3729,138,275,185,6913,373
2015,36061012600,"Census Tract 126, New York County, New York",8588,1513,7075,4673,7793,81662,1959,2006,1840,27.1,3371,3834,125,323,378,7075,263
2016,36061012600,"Census Tract 126, New York County, New York",8494,1246,7248,4658,7827,89345,1958,2010,1896,25.4,3365,3674,156,441,387,7248,431
2017,36061012600,"Census Tract 126, New York County, New York",8654,1312,7342,4522,7779,103198,1955,2011,2085,24,3507,3481,120,561,360,7342,267
2018,36061012600,"Census Tract 126, New York County, New York",8377,1020,7357,4529,8114,91840,1958,2011,2133,25.6,3323,3607,86,379,381,7357,369
2019,36061012600,"Census Tract 126, New York County, New York",8160,1180,6980,4057,7416,91314,1959,2011,2228,28.1,2997,3188,0,358,366,6980,476
2020,36061012601,"Census Tract 126.01, New York County, New York",4654,849,3805,1603,2609,85920,1955,2011,2213,30.7,1261,1292,0,106,127,3805,445
2020,36061012602,"Census Tract 126.02, New York County, New York",3465,807,2658,1659,3453,171406,1969,2014,3501,25.2,1303,1458,0,201,0,2658,188
2012,36061012700,"Census Tract 127, New York County, New York",4353,539,3814,3199,5292,58445,1939,2002,1642,29.5,2117,2283,168,242,486,3814,446
2013,36061012700,"Census Tract 127, New York County, New York",4434,683,3751,3157,5122,59656,1939,2003,1708,30.6,2171,2226,128,332,484,3751,441
2014,36061012700,"Census Tract 127, New York County, New York",4509,608,3901,3269,5231,60894,1939,2004,1730,33.3,2291,2258,129,319,525,3901,375
2015,36061012700,"Census Tract 127, New York County, New York",4491,594,3897,3281,5593,65212,1939,2006,1838,35.1,2421,2253,50,391,518,3897,358
2016,36061012700,"Census Tract 127, New York County, New York",4615,682,3933,3269,5479,67083,1939,2008,1914,35.1,2339,2106,78,409,673,3933,264
2017,36061012700,"Census Tract 127, New York County, New York",4884,1173,3711,2869,4851,69142,1939,2010,1915,33.4,1900,1518,195,352,805,3711,418
2018,36061012700,"Census Tract 127, New York County, New York",4787,841,3946,2936,4581,58724,0,2010,2121,34.7,1942,1482,155,337,853,3946,500
2019,36061012700,"Census Tract 127, New York County, New York",4580,651,3929,2986,4900,82551,0,2012,2182,29.1,2137,1484,91,309,828,3929,523
2020,36061012700,"Census Tract 127, New York County, New York",4668,598,4070,3134,4933,113488,0,2015,2300,23,2380,1537,121,439,513,4070,551
2012,36061012800,"Census Tract 128, New York County, New York",3798,741,3057,944,1737,106346,1950,2002,1921,20.6,764,891,0,23,30,3057,148
2013,36061012800,"Census Tract 128, New York County, New York",3828,801,3027,1009,1793,99750,1951,2002,1992,20.3,796,965,0,15,29,3027,163
2014,36061012800,"Census Tract 128, New York County, New York",3768,757,3011,903,1596,102422,1950,2003,2001,19.9,728,847,0,15,41,3011,202
2015,36061012800,"Census Tract 128, New York County, New York",3792,688,3104,778,1495,111250,1945,2004,2075,18.7,576,763,0,15,0,3104,119
2016,36061012800,"Census Tract 128, New York County, New York",3707,848,2859,597,1082,81806,1944,2001,2014,23,430,580,0,17,0,2859,193
2017,36061012800,"Census Tract 128, New York County, New York",3657,841,2816,473,752,81750,1944,1999,2077,30.2,309,473,0,0,0,2816,177
2018,36061012800,"Census Tract 128, New York County, New York",3618,937,2681,416,649,127262,1941,2010,2060,18.5,294,416,0,0,0,2681,156
2019,36061012800,"Census Tract 128, New York County, New York",3644,1156,2488,354,631,109250,0,2007,2094,19.5,267,336,0,18,0,2488,167
2020,36061012800,"Census Tract 128, New York County, New York",3553,1211,2342,452,910,NA,1944,2016,2304,40,342,406,0,15,31,2342,228
2012,36061012900,"Census Tract 129, New York County, New York",3582,555,3027,2214,3968,67794,1984,2005,2001,30.2,1598,1410,199,321,200,3027,291
2013,36061012900,"Census Tract 129, New York County, New York",3621,663,2958,2218,3918,64375,1983,2006,2001,32.6,1564,1433,199,329,188,2958,272
2014,36061012900,"Census Tract 129, New York County, New York",3601,686,2915,2222,3934,88904,1984,2008,2001,27.8,1579,1472,175,343,179,2915,224
2015,36061012900,"Census Tract 129, New York County, New York",3921,757,3164,2403,4264,96932,1988,2010,2293,26.7,1756,1541,136,433,239,3164,259
2016,36061012900,"Census Tract 129, New York County, New York",4303,887,3416,2756,4410,93304,1989,2012,2417,27.7,2134,1909,92,396,273,3416,385
2017,36061012900,"Census Tract 129, New York County, New York",4742,1001,3741,3078,4918,100098,1995,2013,2476,27.4,2410,2158,118,474,260,3741,559
2018,36061012900,"Census Tract 129, New York County, New York",5270,1145,4125,3525,5838,103960,1998,2014,2642,26.9,2725,2458,115,501,336,4125,560
2019,36061012900,"Census Tract 129, New York County, New York",6031,996,5035,4381,7012,91868,1999,2015,2422,28.6,3510,2814,135,730,576,5035,576
2020,36061012901,"Census Tract 129.01, New York County, New York",4683,941,3742,3195,4753,103478,2009,2016,2708,29.2,2718,2165,138,625,154,3742,338
2020,36061012902,"Census Tract 129.02, New York County, New York",1594,308,1286,988,1687,80035,0,2011,1747,29.4,666,674,0,117,127,1286,206
2012,36061013000,"Census Tract 130, New York County, New York",2787,833,1954,602,983,56438,1939,2001,1649,29.7,479,546,16,27,0,1954,68
2013,36061013000,"Census Tract 130, New York County, New York",2754,826,1928,593,888,56750,1939,2002,1598,29.4,479,550,0,26,0,1928,92
2014,36061013000,"Census Tract 130, New York County, New York",2747,846,1901,602,914,64917,1942,2004,1671,27.5,495,541,0,35,0,1901,163
2015,36061013000,"Census Tract 130, New York County, New York",2635,937,1698,568,849,75682,1941,2008,1667,22.6,447,517,0,51,0,1698,125
2016,36061013000,"Census Tract 130, New York County, New York",2704,858,1846,653,903,69614,1939,2011,1736,26.7,547,620,0,33,0,1846,165
2017,36061013000,"Census Tract 130, New York County, New York",2714,907,1807,597,863,77891,1939,2011,1797,25.9,505,548,0,30,19,1807,154
2018,36061013000,"Census Tract 130, New York County, New York",2707,851,1856,574,774,71473,0,2012,1836,27.6,484,524,0,30,20,1856,139
2019,36061013000,"Census Tract 130, New York County, New York",2760,971,1789,555,794,81458,0,2013,1775,28,463,474,0,20,61,1789,24
2020,36061013000,"Census Tract 130, New York County, New York",2853,1176,1677,438,852,76307,1945,2015,1775,30.1,374,382,0,0,56,1677,25
2012,36061013100,"Census Tract 131, New York County, New York",2278,658,1620,1449,2174,102471,1966,2005,2001,26.1,1056,883,87,138,285,1620,241
2013,36061013100,"Census Tract 131, New York County, New York",2283,614,1669,1502,2227,100878,1965,2006,2001,27.3,1161,974,72,158,262,1669,250
2014,36061013100,"Census Tract 131, New York County, New York",2300,547,1753,1578,2403,85000,1964,2007,2001,28.6,1225,1009,60,216,279,1753,289
2015,36061013100,"Census Tract 131, New York County, New York",2299,576,1723,1569,2537,81532,1963,2008,2582,29.1,1140,958,64,227,318,1723,346
2016,36061013100,"Census Tract 131, New York County, New York",2278,548,1730,1581,2604,85859,1965,2010,2642,28.1,1168,1005,51,239,284,1730,275
2017,36061013100,"Census Tract 131, New York County, New York",2313,552,1761,1514,2334,100300,1966,2011,2808,28.1,1192,1032,31,229,229,1761,223
2018,36061013100,"Census Tract 131, New York County, New York",2319,554,1765,1569,2418,115434,1967,2012,2830,26,1191,956,57,305,260,1765,202
2019,36061013100,"Census Tract 131, New York County, New York",2330,553,1777,1552,2449,102813,1968,2013,2889,26.1,1157,985,30,259,278,1777,259
2020,36061013100,"Census Tract 131, New York County, New York",2359,520,1839,1589,2191,81193,1972,2016,2744,28.7,1141,857,22,365,345,1839,248
2012,36061013200,"Census Tract 132, New York County, New York",6840,788,6052,4773,7494,74399,1946,2004,1788,24.5,3576,3768,40,472,345,6052,433
2013,36061013200,"Census Tract 132, New York County, New York",6822,820,6002,4694,7316,71910,1944,2005,1793,27,3652,3774,35,419,358,6002,595
2014,36061013200,"Census Tract 132, New York County, New York",6778,829,5949,4652,7490,78673,1941,2008,1872,25.4,3520,3718,9,380,417,5949,554
2015,36061013200,"Census Tract 132, New York County, New York",6733,673,6060,4691,7576,NA,1946,2010,1884,25.8,3517,3838,0,327,370,6060,541
2016,36061013200,"Census Tract 132, New York County, New York",6637,784,5853,4616,7955,81596,1944,2011,1924,28.1,3503,3598,0,301,543,5853,492
2017,36061013200,"Census Tract 132, New York County, New York",6403,736,5667,4331,8609,88650,1951,2011,2024,31.3,3351,2938,0,341,856,5667,483
2018,36061013200,"Census Tract 132, New York County, New York",6492,1009,5483,4282,8877,94158,1961,2012,2120,29.6,3288,2731,0,318,974,5483,245
2019,36061013200,"Census Tract 132, New York County, New York",6484,907,5577,4373,8885,98393,1959,2012,2115,30.7,3075,2659,0,354,1086,5577,215
2020,36061013201,"Census Tract 132.01, New York County, New York",1801,325,1476,1115,2097,103589,1965,2014,2172,28.2,798,665,0,191,125,1476,114
2020,36061013202,"Census Tract 132.02, New York County, New York",1761,120,1641,1555,2989,62443,0,2015,2159,47.3,1109,1212,0,68,255,1641,186
2020,36061013203,"Census Tract 132.03, New York County, New York",3192,261,2931,2527,3983,105939,1954,2015,2212,36.7,1552,1363,0,278,886,2931,173
2012,36061013300,"Census Tract 133, New York County, New York",3893,831,3062,2841,5750,75102,1955,2004,1844,28.2,1929,1871,172,311,481,3062,423
2013,36061013300,"Census Tract 133, New York County, New York",3909,1063,2846,2605,4952,79018,1953,2005,1925,28.3,1919,1786,140,219,481,2846,408
2014,36061013300,"Census Tract 133, New York County, New York",4003,1116,2887,2612,4745,84265,1951,2005,2001,28.3,1817,1693,120,284,567,2887,397
2015,36061013300,"Census Tract 133, New York County, New York",4086,1300,2786,2540,4362,87321,1954,2006,2055,28.4,1783,1511,190,339,538,2786,386
2016,36061013300,"Census Tract 133, New York County, New York",4206,1395,2811,2495,4284,93049,1954,2007,2177,27.5,1826,1458,151,332,530,2811,386
2017,36061013300,"Census Tract 133, New York County, New York",4230,1250,2980,2590,4340,84059,1953,2009,2253,27.3,1842,1420,113,367,679,2980,354
2018,36061013300,"Census Tract 133, New York County, New York",4275,1064,3211,2758,4893,79028,1953,2011,2088,27.7,1868,1338,139,556,682,3211,414
2019,36061013300,"Census Tract 133, New York County, New York",4262,866,3396,2818,5220,80126,1957,2013,2107,26.1,1926,1206,132,673,677,3396,442
2020,36061013300,"Census Tract 133, New York County, New York",4275,550,3725,3006,5103,81871,1965,2015,2280,24.8,2084,1277,33,770,779,3725,469
2012,36061013400,"Census Tract 134, New York County, New York",7520,1110,6410,3716,6341,90365,1956,2004,1772,24.3,3054,3251,54,192,219,6410,902
2013,36061013400,"Census Tract 134, New York County, New York",7542,1222,6320,3915,6219,90022,1960,2005,1788,24.7,3309,3393,44,244,234,6320,944
2014,36061013400,"Census Tract 134, New York County, New York",7569,1057,6512,4197,7067,88325,1963,2007,1824,25.8,3329,3574,36,348,239,6512,961
2015,36061013400,"Census Tract 134, New York County, New York",7693,854,6839,4422,7112,81520,1962,2010,1789,28.8,3394,3588,145,341,292,6839,810
2016,36061013400,"Census Tract 134, New York County, New York",7750,473,7277,4701,7826,91180,1962,2011,1872,30.4,3702,3897,160,356,229,7277,720
2017,36061013400,"Census Tract 134, New York County, New York",7682,962,6720,4252,6877,84388,1963,2011,1961,31.2,3355,3532,155,450,59,6720,631
2018,36061013400,"Census Tract 134, New York County, New York",7684,751,6933,3820,6082,76938,1959,2011,1894,31.2,2744,3185,201,377,0,6933,540
2019,36061013400,"Census Tract 134, New York County, New York",7697,949,6748,4121,6200,79552,1952,2012,1939,31.7,3210,3195,244,367,250,6748,755
2020,36061013400,"Census Tract 134, New York County, New York",7888,1772,6116,3777,6301,90325,1946,2015,2091,28.6,3019,2943,67,419,290,6116,840
2012,36061013500,"Census Tract 135, New York County, New York",3695,374,3321,3293,5937,45573,1995,2004,1088,29,1665,1279,566,526,1063,3321,675
2013,36061013500,"Census Tract 135, New York County, New York",3935,495,3440,3411,5937,56058,2000,2005,1259,28.5,1764,1335,527,475,1198,3440,609
2014,36061013500,"Census Tract 135, New York County, New York",4152,623,3529,3487,5864,61380,1996,2005,1323,28.2,1757,1520,545,352,1196,3529,687
2015,36061013500,"Census Tract 135, New York County, New York",4323,576,3747,3676,6126,62153,2001,2006,1299,27.7,1987,1672,493,432,1179,3747,683
2016,36061013500,"Census Tract 135, New York County, New York",4561,658,3903,3825,6647,71865,2001,2007,1347,26,2089,1819,478,477,1135,3903,644
2017,36061013500,"Census Tract 135, New York County, New York",4889,532,4357,4270,7537,64544,2000,2009,1207,26.5,2184,1949,518,500,1278,4357,686
2018,36061013500,"Census Tract 135, New York County, New York",5040,567,4473,4230,7580,63046,2001,2011,1177,26.7,2214,1980,425,559,1201,4473,947
2019,36061013500,"Census Tract 135, New York County, New York",5497,537,4960,4710,9005,76232,2003,2013,1186,24.7,2791,2181,412,682,1355,4960,894
2020,36061013501,"Census Tract 135.01, New York County, New York",2673,230,2443,2332,4418,90139,2003,2015,1197,23.7,1409,991,121,381,874,2443,357
2020,36061013502,"Census Tract 135.02, New York County, New York",3206,313,2893,2785,4794,NA,2000,2015,1172,29.4,1540,1358,288,299,769,2893,756
2012,36061013600,"Census Tract 136, New York County, New York",9843,1043,8800,6046,10173,83317,1960,2004,1863,29.8,4547,4816,155,501,413,8800,492
2013,36061013600,"Census Tract 136, New York County, New York",9813,1398,8415,5911,10025,74432,1960,2006,1853,31.5,4525,4787,150,480,428,8415,459
2014,36061013600,"Census Tract 136, New York County, New York",9911,1300,8611,6220,10547,87185,1960,2008,1950,30.3,4827,5021,143,605,310,8611,528
2015,36061013600,"Census Tract 136, New York County, New York",9748,1074,8674,6282,11091,96265,1962,2010,2040,30.6,4980,5299,143,444,373,8674,427
2016,36061013600,"Census Tract 136, New York County, New York",9532,1216,8316,5903,10583,95128,1962,2011,2203,30.7,4739,4723,190,586,381,8316,445
2017,36061013600,"Census Tract 136, New York County, New York",9493,1185,8308,5468,10792,102078,1962,2011,2267,29.9,4346,4736,117,266,402,8308,507
2018,36061013600,"Census Tract 136, New York County, New York",9413,1178,8235,5522,11026,115525,1962,2012,2358,25.5,4538,4549,66,534,439,8235,504
2019,36061013600,"Census Tract 136, New York County, New York",9198,1064,8134,5485,10747,108972,1960,2013,2351,26.6,4434,4627,67,444,414,8134,380
2020,36061013601,"Census Tract 136.01, New York County, New York",814,0,814,200,632,NA,1950,NA,3501,35.1,135,200,0,0,0,814,74
2020,36061013602,"Census Tract 136.02, New York County, New York",2993,0,2993,1953,4592,105035,1970,2015,2334,23.7,1382,1407,173,120,426,2993,45
2020,36061013603,"Census Tract 136.03, New York County, New York",2273,393,1880,1741,3346,98250,1964,2012,2273,29,1234,1682,0,59,0,1880,0
2020,36061013604,"Census Tract 136.04, New York County, New York",2595,337,2258,1510,2509,105370,0,2016,2222,29,1476,1218,0,208,84,2258,213
2012,36061013700,"Census Tract 137, New York County, New York",5409,1266,4143,2857,4546,108806,1950,2005,2001,22.5,2383,2169,27,433,114,4143,329
2013,36061013700,"Census Tract 137, New York County, New York",5442,1554,3888,2695,4459,105814,1961,2006,2001,23.9,2178,1952,29,424,140,3888,356
2014,36061013700,"Census Tract 137, New York County, New York",5377,1512,3865,2759,5031,120197,1963,2008,2001,21.8,2383,1934,32,498,228,3865,287
2015,36061013700,"Census Tract 137, New York County, New York",5473,1895,3578,2539,4896,142292,1962,2010,2842,23.4,2159,1863,0,439,170,3578,324
2016,36061013700,"Census Tract 137, New York County, New York",5517,2142,3375,2347,4604,128177,1962,2011,2848,26.2,1986,1643,23,403,173,3375,308
2017,36061013700,"Census Tract 137, New York County, New York",5605,2235,3370,2271,4241,130913,1952,2011,2956,25.3,1974,1610,29,339,198,3370,276
2018,36061013700,"Census Tract 137, New York County, New York",5679,2195,3484,2353,4422,163679,1955,2012,3061,22.4,2010,1779,28,292,211,3484,254
2019,36061013700,"Census Tract 137, New York County, New York",5642,2378,3264,2107,3994,170966,1949,2013,3016,20.8,1740,1548,24,333,107,3264,255
2020,36061013700,"Census Tract 137, New York County, New York",5486,2103,3383,2016,3987,182589,1945,2014,2803,19.6,1712,1351,58,407,124,3383,293
2012,36061013800,"Census Tract 138, New York County, New York",8137,758,7379,5369,8313,85033,1951,2004,1870,25,4380,4578,28,389,321,7379,525
2013,36061013800,"Census Tract 138, New York County, New York",8173,824,7349,5269,8033,84901,1944,2005,1959,24.5,4301,4482,27,337,381,7349,497
2014,36061013800,"Census Tract 138, New York County, New York",8193,728,7465,5372,8465,87196,1943,2007,2001,24.4,4365,4575,0,292,405,7465,483
2015,36061013800,"Census Tract 138, New York County, New York",7970,708,7262,5092,8920,110898,1948,2010,2157,24.5,4115,4314,13,328,364,7262,408
2016,36061013800,"Census Tract 138, New York County, New York",7785,587,7198,5291,8993,117421,1948,2011,2146,24.8,4351,4072,46,734,363,7198,418
2017,36061013800,"Census Tract 138, New York County, New York",7669,424,7245,5415,9613,131484,1948,2012,2261,24.7,4807,4286,60,753,289,7245,367
2018,36061013800,"Census Tract 138, New York County, New York",7668,828,6840,5088,8640,132564,1954,2014,2378,26.4,4490,3950,59,772,310,6840,337
2019,36061013800,"Census Tract 138, New York County, New York",7414,805,6609,4986,8412,135870,1961,2015,2402,25.3,4327,3869,88,766,261,6609,372
2020,36061013800,"Census Tract 138, New York County, New York",7526,757,6769,4784,7937,136741,1964,2016,2489,26.6,4187,3800,50,660,360,6769,361
2012,36061013900,"Census Tract 139, New York County, New York",7182,1530,5652,4074,5941,69463,1952,2004,1860,32.2,2780,3084,240,383,336,5652,334
2013,36061013900,"Census Tract 139, New York County, New York",7359,1789,5570,3871,5437,76955,1952,2005,1937,32.6,2805,2935,251,323,333,5570,366
2014,36061013900,"Census Tract 139, New York County, New York",7447,1924,5523,3967,5656,80348,1951,2006,1963,32.7,2881,3062,249,260,311,5523,364
2015,36061013900,"Census Tract 139, New York County, New York",7485,1932,5553,3995,5893,NA,1949,2007,2000,31.6,3013,2935,266,298,306,5553,402
2016,36061013900,"Census Tract 139, New York County, New York",7535,1673,5862,4382,6293,95486,1947,2008,2063,30.6,3153,3056,222,409,459,5862,527
2017,36061013900,"Census Tract 139, New York County, New York",7119,984,6135,4691,7108,97977,1950,2010,2040,28.3,3458,3309,153,516,450,6135,639
2018,36061013900,"Census Tract 139, New York County, New York",7127,825,6302,4802,7704,89960,1943,2010,1762,25.2,3303,3214,178,493,698,6302,561
2019,36061013900,"Census Tract 139, New York County, New York",7096,489,6607,4760,7435,101515,1940,2012,2053,24.4,3216,3340,127,531,605,6607,762
2020,36061013900,"Census Tract 139, New York County, New York",7278,204,7074,5034,7412,99701,1951,2015,1939,27.3,3727,3600,303,522,694,7074,660
2012,36061014000,"Census Tract 140, New York County, New York",4549,660,3889,1893,3773,110195,1949,2003,1989,22.4,1357,1515,31,171,159,3889,184
2013,36061014000,"Census Tract 140, New York County, New York",4469,679,3790,1799,3656,106165,1948,2004,2001,24.9,1326,1427,33,175,151,3790,200
2014,36061014000,"Census Tract 140, New York County, New York",4431,689,3742,1857,3678,115442,1947,2008,2001,24.2,1470,1463,39,243,95,3742,195
2015,36061014000,"Census Tract 140, New York County, New York",4457,705,3752,1893,3663,112096,1941,2009,2193,25,1511,1565,64,201,46,3752,203
2016,36061014000,"Census Tract 140, New York County, New York",4513,548,3965,2148,4307,114118,1942,2010,2356,25.3,1613,1639,65,273,145,3965,179
2017,36061014000,"Census Tract 140, New York County, New York",4449,564,3885,2007,3797,116250,1939,2010,2464,25.7,1630,1678,50,158,121,3885,74
2018,36061014000,"Census Tract 140, New York County, New York",4447,476,3971,1965,3463,112765,0,2011,2381,26.5,1528,1631,50,146,109,3971,85
2019,36061014000,"Census Tract 140, New York County, New York",4446,635,3811,1852,3217,91500,0,2012,2370,27.8,1450,1547,52,108,100,3811,111
2020,36061014000,"Census Tract 140, New York County, New York",4569,519,4050,1878,3053,87560,0,2012,2321,32.7,1267,1524,16,150,92,4050,212
2012,36061014200,"Census Tract 142, New York County, New York",2821,974,1847,641,1354,190417,1939,2004,1981,16.6,448,534,0,77,15,1847,121
2013,36061014200,"Census Tract 142, New York County, New York",2867,905,1962,749,1531,175966,1947,2007,1907,18.4,480,622,0,84,14,1962,131
2014,36061014200,"Census Tract 142, New York County, New York",2842,873,1969,671,1353,99766,1942,2009,2001,18.3,468,573,0,74,15,1969,171
2015,36061014200,"Census Tract 142, New York County, New York",2885,813,2072,741,1460,NA,1939,2010,1803,14.8,520,659,0,71,0,2072,147
2016,36061014200,"Census Tract 142, New York County, New York",2879,835,2044,804,1448,116100,1951,2010,2390,16,508,731,0,65,0,2044,140
2017,36061014200,"Census Tract 142, New York County, New York",2875,670,2205,876,1636,117989,1951,2008,2461,19,577,785,0,81,0,2205,94
2018,36061014200,"Census Tract 142, New York County, New York",2879,655,2224,752,1481,102423,0,2007,2197,23.8,457,676,0,76,0,2224,173
2019,36061014200,"Census Tract 142, New York County, New York",2852,653,2199,747,1521,123542,0,2008,2201,18.2,429,685,0,62,0,2199,115
2020,36061014200,"Census Tract 142, New York County, New York",2985,824,2161,774,1673,107366,1951,2012,2547,28.9,542,601,0,101,72,2161,164
2012,36061014300,"Census Tract 143, New York County, New York",0,0,0,0,0,NA,NA,NA,NA,NA,0,0,0,0,0,0,0
2013,36061014300,"Census Tract 143, New York County, New York",0,0,0,0,0,NA,NA,NA,NA,NA,0,0,0,0,0,0,0
2014,36061014300,"Census Tract 143, New York County, New York",0,0,0,0,0,NA,NA,NA,NA,NA,0,0,0,0,0,0,0
2015,36061014300,"Census Tract 143, New York County, New York",0,0,0,0,0,NA,NA,NA,NA,NA,0,0,0,0,0,0,0
2016,36061014300,"Census Tract 143, New York County, New York",0,0,0,0,0,NA,NA,NA,NA,NA,0,0,0,0,0,0,0
2017,36061014300,"Census Tract 143, New York County, New York",0,0,0,0,0,NA,NA,NA,NA,NA,0,0,0,0,0,0,0
2018,36061014300,"Census Tract 143, New York County, New York",0,0,0,0,0,NA,NA,NA,NA,NA,0,0,0,0,0,0,0
2019,36061014300,"Census Tract 143, New York County, New York",0,0,0,0,0,NA,NA,NA,NA,NA,0,0,0,0,0,0,0
2020,36061014300,"Census Tract 143, New York County, New York",0,0,0,0,0,NA,NA,NA,NA,NA,0,0,0,0,0,0,0
2012,36061014401,"Census Tract 144.01, New York County, New York",2903,371,2532,1360,2659,101983,1945,2003,2001,24.2,1119,1190,0,62,108,2532,101
2013,36061014401,"Census Tract 144.01, New York County, New York",2963,370,2593,1398,2567,88973,1951,2004,2001,28.7,1180,1225,0,63,110,2593,142
2014,36061014401,"Census Tract 144.01, New York County, New York",2956,345,2611,1431,2631,92879,1950,2006,2001,28.1,1083,1230,0,45,138,2611,110
2015,36061014401,"Census Tract 144.01, New York County, New York",2935,259,2676,1446,2709,83971,1939,2009,2202,28.3,1068,1271,0,31,128,2676,140
2016,36061014401,"Census Tract 144.01, New York County, New York",2887,178,2709,1472,2774,84063,1950,2010,2249,28.9,1101,1277,0,29,148,2709,182
2017,36061014401,"Census Tract 144.01, New York County, New York",2878,103,2775,1520,2783,82896,1945,2011,2330,27.4,1202,1284,0,89,129,2775,175
2018,36061014401,"Census Tract 144.01, New York County, New York",2849,296,2553,1348,2379,83701,0,2011,2383,28.2,1019,1114,13,85,130,2553,156
2019,36061014401,"Census Tract 144.01, New York County, New York",2893,418,2475,1322,2204,85582,0,2011,2215,26.5,1028,1091,33,74,138,2475,146
2020,36061014401,"Census Tract 144.01, New York County, New York",2885,468,2417,1122,1874,93750,1947,2011,2365,28.6,882,906,34,98,101,2417,89
2012,36061014402,"Census Tract 144.02, New York County, New York",4278,381,3897,2731,4033,70168,1963,2004,1813,26.1,2204,2126,118,277,260,3897,181
2013,36061014402,"Census Tract 144.02, New York County, New York",4267,354,3913,2710,4264,76328,1962,2004,1854,26.9,2217,2143,126,255,237,3913,262
2014,36061014402,"Census Tract 144.02, New York County, New York",4297,306,3991,2893,5014,99313,1963,2006,1973,25.1,2419,2230,171,337,170,3991,318
2015,36061014402,"Census Tract 144.02, New York County, New York",4288,266,4022,2831,4853,96675,1961,2010,2110,26.7,2374,2226,168,247,118,4022,302
2016,36061014402,"Census Tract 144.02, New York County, New York",4276,313,3963,2753,4706,104489,1948,2011,2159,26.3,2407,2248,98,226,73,3963,252
2017,36061014402,"Census Tract 144.02, New York County, New York",4241,337,3904,2706,4905,99706,1949,2011,2271,27.6,2427,2223,83,220,54,3904,210
2018,36061014402,"Census Tract 144.02, New York County, New York",4216,429,3787,2629,4550,99042,1947,2012,2268,27.8,2374,2257,18,174,66,3787,158
2019,36061014402,"Census Tract 144.02, New York County, New York",4207,442,3765,2545,4235,98341,1948,2013,2329,28.6,2254,2106,18,196,140,3765,96
2020,36061014402,"Census Tract 144.02, New York County, New York",4246,674,3572,2366,4120,109118,1950,2012,2302,25.5,2105,1908,50,190,204,3572,53
2012,36061014500,"Census Tract 145, New York County, New York",3315,868,2447,1630,2829,179537,1991,2005,2001,19.6,1376,1191,37,271,168,2447,151
2013,36061014500,"Census Tract 145, New York County, New York",3462,958,2504,1659,2686,180809,1990,2006,2001,21.5,1444,1298,48,225,100,2504,138
2014,36061014500,"Census Tract 145, New York County, New York",3559,1035,2524,1731,2727,182750,1990,2008,2001,21.4,1543,1390,34,175,119,2524,157
2015,36061014500,"Census Tract 145, New York County, New York",3594,989,2605,1732,2754,182724,1990,2010,3334,22,1532,1391,35,150,138,2605,154
2016,36061014500,"Census Tract 145, New York County, New York",3744,987,2757,1883,2978,162734,1990,2011,3397,22.2,1579,1422,101,202,140,2757,207
2017,36061014500,"Census Tract 145, New York County, New York",3809,908,2901,1918,3263,169758,1989,2011,3501,21.9,1605,1307,114,240,228,2901,218
2018,36061014500,"Census Tract 145, New York County, New York",3923,994,2929,1868,3325,176833,1991,2012,3501,18.9,1540,1202,85,348,199,2929,225
2019,36061014500,"Census Tract 145, New York County, New York",4088,1136,2952,1933,3546,181563,1989,2014,3474,17.9,1610,1130,87,481,219,2952,245
2020,36061014500,"Census Tract 145, New York County, New York",4059,1121,2938,2093,3986,172019,1989,2015,3501,26.6,1758,1233,106,546,185,2938,238
2012,36061014601,"Census Tract 146.01, New York County, New York",2679,415,2264,1997,3151,101904,1960,NA,1924,25.1,1720,1605,72,212,66,2264,147
2013,36061014601,"Census Tract 146.01, New York County, New York",2743,330,2413,2125,3290,105185,1962,2006,1994,24,1766,1687,66,274,50,2413,153
2014,36061014601,"Census Tract 146.01, New York County, New York",2839,289,2550,2278,3711,107279,1967,2007,2001,24.7,1868,1885,28,216,75,2550,145
2015,36061014601,"Census Tract 146.01, New York County, New York",2882,233,2649,2327,3685,110288,1965,2011,2115,24.3,1900,1835,31,309,63,2649,95
2016,36061014601,"Census Tract 146.01, New York County, New York",2863,232,2631,2397,3746,105583,1960,2011,2254,26.5,1921,1832,15,366,129,2631,153
2017,36061014601,"Census Tract 146.01, New York County, New York",2854,251,2603,2361,3858,104975,1959,2012,2303,27.8,1929,1670,0,436,213,2603,172
2018,36061014601,"Census Tract 146.01, New York County, New York",2838,379,2459,2274,3844,107338,1959,NA,2345,26.7,1925,1513,0,429,311,2459,136
2019,36061014601,"Census Tract 146.01, New York County, New York",2880,555,2325,2164,3792,134583,1964,2014,2390,21.4,1862,1468,32,415,235,2325,98
2020,36061014601,"Census Tract 146.01, New York County, New York",3169,633,2536,2427,3957,112925,1952,2015,2281,25.5,1898,1788,31,354,254,2536,361
2012,36061014602,"Census Tract 146.02, New York County, New York",5348,683,4665,3608,5812,80592,1957,2005,1963,25.7,2995,2947,70,341,187,4665,332
2013,36061014602,"Census Tract 146.02, New York County, New York",5352,636,4716,3627,5697,80994,1956,2006,1971,26.4,3084,2934,55,388,185,4716,331
2014,36061014602,"Census Tract 146.02, New York County, New York",5296,641,4655,3577,5661,87035,1957,2011,2001,25.4,3109,2943,59,325,212,4655,319
2015,36061014602,"Census Tract 146.02, New York County, New York",5238,554,4684,3452,5534,91290,1957,2011,2169,26.3,2973,2993,55,254,133,4684,221
2016,36061014602,"Census Tract 146.02, New York County, New York",5373,536,4837,3466,5385,87164,1957,2010,2093,27.9,3006,2993,82,198,180,4837,198
2017,36061014602,"Census Tract 146.02, New York County, New York",5244,702,4542,3211,4985,89159,1956,2011,2173,27.1,2894,2764,0,257,173,4542,182
2018,36061014602,"Census Tract 146.02, New York County, New York",5191,709,4482,3266,5462,96231,1953,2012,2226,24.7,2809,2731,0,317,156,4482,133
2019,36061014602,"Census Tract 146.02, New York County, New York",5099,630,4469,3223,5528,97420,1952,2012,2302,24.7,2746,2749,0,267,158,4469,96
2020,36061014602,"Census Tract 146.02, New York County, New York",5445,857,4588,3631,6202,103594,1953,2011,2238,26,3011,3221,0,177,170,4588,279
2012,36061014700,"Census Tract 147, New York County, New York",1539,270,1269,1064,1802,69167,1984,2007,2001,26.5,914,553,51,335,104,1269,72
2013,36061014700,"Census Tract 147, New York County, New York",1743,380,1363,1120,1973,86786,1989,2008,2001,25.3,968,588,67,357,80,1363,68
2014,36061014700,"Census Tract 147, New York County, New York",1887,422,1465,1217,2195,108281,1999,2011,2001,25.2,1073,753,40,328,75,1465,66
2015,36061014700,"Census Tract 147, New York County, New York",1965,453,1512,1278,2556,122031,2001,2011,3164,23.9,1113,703,62,382,103,1512,66
2016,36061014700,"Census Tract 147, New York County, New York",1972,365,1607,1388,2823,168015,2002,NA,3288,21.7,1245,796,49,397,106,1607,74
2017,36061014700,"Census Tract 147, New York County, New York",1975,401,1574,1398,3009,184938,2001,2013,3337,19.2,1315,813,40,375,106,1574,120
2018,36061014700,"Census Tract 147, New York County, New York",1956,358,1598,1427,2857,182679,2000,2014,3112,19.8,1366,793,29,401,148,1598,127
2019,36061014700,"Census Tract 147, New York County, New York",1973,307,1666,1451,2899,191925,2000,2015,2967,19,1385,780,27,431,160,1666,93
2020,36061014700,"Census Tract 147, New York County, New York",1951,388,1563,1347,2588,195868,1994,NA,2956,22,1283,707,72,411,172,1563,94
2012,36061014801,"Census Tract 148.01, New York County, New York",1657,348,1309,867,1599,135568,1964,2002,2001,20.1,744,740,0,61,55,1309,57
2013,36061014801,"Census Tract 148.01, New York County, New York",1708,363,1345,894,1707,121467,1966,2003,2001,24.1,758,764,0,57,53,1345,62
2014,36061014801,"Census Tract 148.01, New York County, New York",1710,289,1421,935,1754,120970,1965,2004,2001,23.2,767,757,0,76,66,1421,59
2015,36061014801,"Census Tract 148.01, New York County, New York",1732,276,1456,959,1853,117292,1965,2006,2262,21.1,804,771,11,75,64,1456,70
2016,36061014801,"Census Tract 148.01, New York County, New York",1731,251,1480,952,1814,116563,1965,2009,2313,20.7,756,766,11,88,51,1480,60
2017,36061014801,"Census Tract 148.01, New York County, New York",1737,184,1553,943,1707,105875,1964,2011,2351,25,708,771,11,83,67,1553,78
2018,36061014801,"Census Tract 148.01, New York County, New York",1738,222,1516,899,1680,111719,1964,2011,2416,23.4,690,734,11,78,66,1516,76
2019,36061014801,"Census Tract 148.01, New York County, New York",1741,327,1414,823,1476,110469,1964,2012,2605,26.7,607,673,10,57,45,1414,67
2020,36061014801,"Census Tract 148.01, New York County, New York",1583,279,1304,768,1537,109444,1963,2013,2521,26.6,575,630,0,38,68,1304,69
2012,36061014802,"Census Tract 148.02, New York County, New York",4008,495,3513,2211,3836,88266,1939,2003,1877,25.2,1747,1919,113,107,72,3513,169
2013,36061014802,"Census Tract 148.02, New York County, New York",3993,598,3395,2121,3834,83125,1939,2004,1944,28.1,1646,1927,57,84,53,3395,199
2014,36061014802,"Census Tract 148.02, New York County, New York",4024,648,3376,1954,3434,81389,1942,2008,1984,28.5,1609,1706,42,84,98,3376,211
2015,36061014802,"Census Tract 148.02, New York County, New York",3984,705,3279,2113,3813,89132,1939,2010,1975,26.6,1734,1758,51,150,117,3279,157
2016,36061014802,"Census Tract 148.02, New York County, New York",4014,626,3388,2156,3975,101742,1939,NA,2308,25.5,1781,1701,45,136,186,3388,148
2017,36061014802,"Census Tract 148.02, New York County, New York",3984,575,3409,2020,3773,104347,1939,2011,2175,24.1,1682,1565,0,192,178,3409,177
2018,36061014802,"Census Tract 148.02, New York County, New York",3885,503,3382,2094,3847,105242,0,2012,2449,23.5,1740,1587,0,227,190,3382,126
2019,36061014802,"Census Tract 148.02, New York County, New York",3907,676,3231,2005,3885,111116,0,2012,2539,22.6,1631,1547,17,194,171,3231,157
2020,36061014802,"Census Tract 148.02, New York County, New York",3866,593,3273,1924,4030,105612,0,2015,2702,24,1513,1348,51,113,368,3273,140
2012,36061014900,"Census Tract 149, New York County, New York",3963,1068,2895,1795,2781,104315,1971,2004,2001,24.8,1571,1593,25,118,32,2895,219
2013,36061014900,"Census Tract 149, New York County, New York",4006,954,3052,1879,3076,103036,1971,2005,2001,24.9,1549,1640,28,101,110,3052,184
2014,36061014900,"Census Tract 149, New York County, New York",4040,957,3083,1889,3160,126203,1971,2006,2001,22.5,1526,1564,28,171,126,3083,145
2015,36061014900,"Census Tract 149, New York County, New York",4100,1061,3039,1917,3278,130399,1972,2008,3027,22.3,1571,1586,11,144,176,3039,131
2016,36061014900,"Census Tract 149, New York County, New York",4160,1100,3060,1889,3081,125208,1972,2010,2968,23.1,1577,1544,7,119,219,3060,118
2017,36061014900,"Census Tract 149, New York County, New York",4113,1083,3030,1776,2844,126607,1973,2010,2452,23.6,1445,1406,20,150,200,3030,143
2018,36061014900,"Census Tract 149, New York County, New York",4095,1217,2878,1788,2734,129821,1974,2012,2665,21,1515,1405,28,167,188,2878,232
2019,36061014900,"Census Tract 149, New York County, New York",4044,1159,2885,1810,2738,129821,1975,2012,2723,19.8,1585,1499,30,100,181,2885,298
2020,36061014900,"Census Tract 149, New York County, New York",4088,1105,2983,1832,2770,141350,1975,2015,2909,21.4,1514,1519,31,142,140,2983,400
2012,36061015001,"Census Tract 150.01, New York County, New York",1311,188,1123,383,624,142813,1939,1996,2001,23.1,333,361,0,11,11,1123,99
2013,36061015001,"Census Tract 150.01, New York County, New York",1318,253,1065,354,646,134722,1939,1998,2001,22.4,313,336,0,18,0,1065,79
2014,36061015001,"Census Tract 150.01, New York County, New York",1332,220,1112,439,847,157277,1939,2000,2001,20.4,394,404,0,35,0,1112,98
2015,36061015001,"Census Tract 150.01, New York County, New York",1295,270,1025,353,677,166250,1939,2003,2273,17,306,319,0,34,0,1025,111
2016,36061015001,"Census Tract 150.01, New York County, New York",1294,246,1048,415,905,148523,1939,2007,2125,19.8,363,370,0,34,11,1048,85
2017,36061015001,"Census Tract 150.01, New York County, New York",1279,199,1080,427,917,147396,1939,2005,2217,19.8,372,381,0,23,23,1080,107
2018,36061015001,"Census Tract 150.01, New York County, New York",1256,185,1071,421,788,136131,0,2008,2268,21.5,380,364,0,30,27,1071,103
2019,36061015001,"Census Tract 150.01, New York County, New York",1227,180,1047,451,964,128625,0,2011,2301,23,363,409,0,22,20,1047,91
2020,36061015001,"Census Tract 150.01, New York County, New York",1283,318,965,414,861,131923,0,2012,2475,24.4,349,374,0,15,25,965,94
2012,36061015002,"Census Tract 150.02, New York County, New York",2941,391,2550,582,1108,135500,1949,1995,1765,22.9,488,501,0,0,64,2550,106
2013,36061015002,"Census Tract 150.02, New York County, New York",2901,521,2380,700,1643,135408,1951,1997,2001,23,580,563,0,0,119,2380,142
2014,36061015002,"Census Tract 150.02, New York County, New York",2933,525,2408,663,1643,138417,1955,2003,2001,21.5,582,536,0,0,112,2408,70
2015,36061015002,"Census Tract 150.02, New York County, New York",2921,517,2404,774,1909,137553,1956,2004,2260,18.7,719,619,0,0,139,2404,125
2016,36061015002,"Census Tract 150.02, New York County, New York",2945,633,2312,617,1547,138724,1958,2004,2494,19.2,557,470,0,0,147,2312,120
2017,36061015002,"Census Tract 150.02, New York County, New York",2926,611,2315,537,1385,136676,1961,2005,2852,22.4,479,415,0,0,122,2315,117
2018,36061015002,"Census Tract 150.02, New York County, New York",2929,596,2333,380,784,146250,1962,2004,2664,18.8,347,299,0,0,81,2333,118
2019,36061015002,"Census Tract 150.02, New York County, New York",2929,699,2230,410,820,120156,1962,2007,2705,21.6,380,334,0,10,66,2230,139
2020,36061015002,"Census Tract 150.02, New York County, New York",2846,760,2086,395,701,118813,1964,2005,3137,30.2,320,388,0,7,0,2086,79
2012,36061015100,"Census Tract 151, New York County, New York",4717,655,4062,3738,7989,55682,1992,2004,1802,27.5,2101,1876,511,697,848,4062,731
2013,36061015100,"Census Tract 151, New York County, New York",4856,781,4075,3664,7262,56204,1991,2004,1644,27.1,1922,1750,573,668,788,4075,739
2014,36061015100,"Census Tract 151, New York County, New York",5007,1010,3997,3555,6523,52136,1990,2005,1643,27.6,2060,1673,471,549,928,3997,640
2015,36061015100,"Census Tract 151, New York County, New York",5126,962,4164,3724,6611,NA,1990,2007,1729,28.4,2238,1772,476,622,901,4164,723
2016,36061015100,"Census Tract 151, New York County, New York",5049,834,4215,3779,6843,50715,1984,2008,1095,27.3,2188,1425,629,632,1139,4215,827
2017,36061015100,"Census Tract 151, New York County, New York",5161,832,4329,3812,7223,51943,1982,2009,1072,25.2,2091,1372,642,598,1052,4329,884
2018,36061015100,"Census Tract 151, New York County, New York",5266,711,4555,4108,8218,52942,1982,2010,1029,26.7,2312,1440,755,584,1197,4555,883
2019,36061015100,"Census Tract 151, New York County, New York",5554,460,5094,4525,9108,65905,1992,2012,935,22.9,2651,2011,886,522,959,5094,916
2020,36061015101,"Census Tract 151.01, New York County, New York",1766,107,1659,1623,3715,41540,0,2011,874,27.1,669,199,751,45,522,1659,233
2020,36061015102,"Census Tract 151.02, New York County, New York",3670,421,3249,2697,5704,120343,2003,NA,1234,20.1,1990,1547,328,363,395,3249,594
2012,36061015200,"Census Tract 152, New York County, New York",3946,362,3584,2846,5491,60000,1969,2003,1150,24.9,1568,1356,375,469,744,3584,602
2013,36061015200,"Census Tract 152, New York County, New York",3980,370,3610,2893,5507,60914,1968,2004,1186,23.3,1583,1290,427,427,875,3610,596
2014,36061015200,"Census Tract 152, New York County, New York",3988,407,3581,2949,5864,47188,1967,2004,1102,23.6,1623,1350,453,329,1003,3581,624
2015,36061015200,"Census Tract 152, New York County, New York",3984,260,3724,2993,6077,65284,1968,2005,1094,23.8,1605,1468,500,226,1036,3724,518
2016,36061015200,"Census Tract 152, New York County, New York",4035,257,3778,3099,6121,60934,1967,2007,1172,26.1,1675,1486,456,230,1146,3778,654
2017,36061015200,"Census Tract 152, New York County, New York",4074,216,3858,3157,6352,67775,1968,2010,1456,25.5,1755,1471,426,270,1106,3858,656
2018,36061015200,"Census Tract 152, New York County, New York",4078,278,3800,3107,6007,64449,1967,2011,1272,26.3,1695,1410,518,215,1044,3800,680
2019,36061015200,"Census Tract 152, New York County, New York",4037,221,3816,3140,6296,70183,1967,2012,1586,25,1844,1506,444,264,976,3816,616
2020,36061015200,"Census Tract 152, New York County, New York",4020,441,3579,2998,6177,72706,1966,2011,1767,23.6,1759,1382,424,211,952,3579,584
2012,36061015300,"Census Tract 153, New York County, New York",6290,1142,5148,3171,5624,104702,1941,2004,2001,23.2,2570,2387,150,259,349,5148,396
2013,36061015300,"Census Tract 153, New York County, New York",6234,1349,4885,2987,5365,101052,1945,2004,2001,24.1,2416,2236,145,251,352,4885,345
2014,36061015300,"Census Tract 153, New York County, New York",6280,1507,4773,2813,5133,99671,1939,2005,2001,24.6,2213,2184,157,174,290,4773,327
2015,36061015300,"Census Tract 153, New York County, New York",6326,1517,4809,2761,5437,116109,1948,2007,2477,20.7,2250,2156,81,255,241,4809,194
2016,36061015300,"Census Tract 153, New York County, New York",6339,1523,4816,2597,4851,127850,1950,2011,2605,21.8,2146,2081,27,295,181,4816,100
2017,36061015300,"Census Tract 153, New York County, New York",6560,1476,5084,2905,5068,129190,1939,2011,2655,22,2442,2333,30,331,174,5084,202
2018,36061015300,"Census Tract 153, New York County, New York",6569,1233,5336,3053,5127,143209,0,2012,2761,20.8,2602,2585,30,275,139,5336,260
2019,36061015300,"Census Tract 153, New York County, New York",6230,1009,5221,3080,5084,145194,0,2013,2823,20.9,2704,2602,30,207,210,5221,260
2020,36061015301,"Census Tract 153.01, New York County, New York",2722,411,2311,1457,2392,126602,0,2012,2714,23.7,1289,1005,86,67,74,2311,108
2020,36061015302,"Census Tract 153.02, New York County, New York",3862,902,2960,1879,3335,121215,1960,2015,2824,23.4,1593,1596,0,211,64,2960,162
2012,36061015400,"Census Tract 154, New York County, New York",8300,724,7576,5370,9193,73178,1973,2004,1690,29,3827,3459,326,712,790,7576,616
2013,36061015400,"Census Tract 154, New York County, New York",8304,683,7621,5426,9689,71393,1972,2005,1739,29.5,3883,3492,380,694,870,7621,565
2014,36061015400,"Census Tract 154, New York County, New York",8369,555,7814,5557,10502,75990,1972,2006,1770,29.7,4039,3684,331,755,718,7814,650
2015,36061015400,"Census Tract 154, New York County, New York",8418,442,7976,5372,10005,71613,1972,2008,1832,31,3957,3419,553,629,723,7976,781
2016,36061015400,"Census Tract 154, New York County, New York",8433,576,7857,5190,10526,72045,1965,2010,1910,28.6,3892,3346,547,510,595,7857,605
2017,36061015400,"Census Tract 154, New York County, New York",8416,679,7737,5251,10673,83013,1964,2011,2035,27.3,4201,3483,533,451,604,7737,464
2018,36061015400,"Census Tract 154, New York County, New York",8137,939,7198,4835,9322,77116,1964,2012,2080,27.4,3653,3427,378,336,412,7198,537
2019,36061015400,"Census Tract 154, New York County, New York",8299,1035,7264,4781,9347,85651,1969,2013,2240,26.1,3623,3343,414,270,479,7264,396
2020,36061015401,"Census Tract 154.01, New York County, New York",3312,327,2985,2207,3612,100021,1950,2012,1855,25.2,1756,1887,85,0,138,2985,95
2020,36061015402,"Census Tract 154.02, New York County, New York",2559,427,2132,1324,2523,98209,0,NA,2662,29.7,1098,747,104,164,148,2132,0
2020,36061015403,"Census Tract 154.03, New York County, New York",2493,297,2196,1405,2740,77775,1976,2004,1213,21.9,708,933,254,113,70,2196,473
2012,36061015500,"Census Tract 155, New York County, New York",6402,774,5628,2507,4663,130198,1992,2003,2001,24.3,2179,1923,27,338,169,5628,311
2013,36061015500,"Census Tract 155, New York County, New York",6503,1178,5325,2203,4346,132739,1991,2004,2001,22.6,1914,1703,28,327,82,5325,223
2014,36061015500,"Census Tract 155, New York County, New York",6616,1153,5463,2112,4399,138906,1993,2005,2001,21.1,1852,1665,27,311,46,5463,261
2015,36061015500,"Census Tract 155, New York County, New York",6623,1166,5457,2011,4224,138042,1993,2007,2561,23,1738,1520,24,347,0,5457,275
2016,36061015500,"Census Tract 155, New York County, New York",6584,1018,5566,1941,3870,141850,1994,2011,2754,21.9,1756,1497,24,362,31,5566,297
2017,36061015500,"Census Tract 155, New York County, New York",6559,1046,5513,1736,3380,136579,1996,2013,2962,23.4,1606,1296,0,297,49,5513,405
2018,36061015500,"Census Tract 155, New York County, New York",6575,744,5831,2054,3691,133036,1994,2013,3150,23.9,1842,1511,27,374,53,5831,364
2019,36061015500,"Census Tract 155, New York County, New York",6932,787,6145,2697,4600,151217,1996,2015,2968,20.8,2423,2002,130,387,192,6145,400
2020,36061015501,"Census Tract 155.01, New York County, New York",3375,371,3004,1167,2054,183472,2000,2016,2148,12.7,1115,937,24,113,84,3004,206
2020,36061015502,"Census Tract 155.02, New York County, New York",3330,429,2901,1219,2131,131285,1997,2015,3116,28.8,1083,826,208,185,92,2901,243
2012,36061015601,"Census Tract 156.01, New York County, New York",3133,217,2916,2825,5309,85954,1976,2005,2001,30.3,2346,1796,221,361,406,2916,111
2013,36061015601,"Census Tract 156.01, New York County, New York",3142,288,2854,2792,5424,86992,1979,2006,2001,30.5,2250,1821,207,333,409,2854,142
2014,36061015601,"Census Tract 156.01, New York County, New York",3163,250,2913,2870,5628,86523,1980,2008,2001,29.6,2337,1834,228,397,398,2913,158
2015,36061015601,"Census Tract 156.01, New York County, New York",3053,314,2739,2707,5290,87786,1980,2011,2007,28.9,2056,1794,208,349,344,2739,183
2016,36061015601,"Census Tract 156.01, New York County, New York",3046,290,2756,2721,5434,87083,1981,2011,2130,28.9,2009,1871,160,374,305,2756,209
2017,36061015601,"Census Tract 156.01, New York County, New York",2990,335,2655,2601,5412,89145,1983,2012,2214,28.2,1883,1835,121,339,305,2655,284
2018,36061015601,"Census Tract 156.01, New York County, New York",2965,325,2640,2579,5165,98638,1984,NA,2425,24.7,1934,1773,133,391,273,2640,206
2019,36061015601,"Census Tract 156.01, New York County, New York",3055,473,2582,2496,4925,99026,1983,2015,2386,28.3,1802,1655,143,328,375,2582,262
2020,36061015601,"Census Tract 156.01, New York County, New York",3091,470,2621,2516,4883,94363,1983,NA,2360,28.6,1790,1575,147,319,467,2621,337
2012,36061015602,"Census Tract 156.02, New York County, New York",1071,99,972,963,1960,44375,1957,2003,996,26.2,463,325,171,146,421,972,215
2013,36061015602,"Census Tract 156.02, New York County, New York",1116,118,998,973,2089,43750,1956,2003,961,27.6,402,273,201,160,458,998,262
2014,36061015602,"Census Tract 156.02, New York County, New York",1110,164,946,896,2039,44539,1956,2004,950,27,341,180,163,207,387,946,211
2015,36061015602,"Census Tract 156.02, New York County, New York",1107,157,950,872,1949,45870,1957,2005,979,28.3,342,191,165,149,392,950,217
2016,36061015602,"Census Tract 156.02, New York County, New York",1109,75,1034,930,2084,52667,1962,2006,963,27.5,386,232,155,139,399,1034,226
2017,36061015602,"Census Tract 156.02, New York County, New York",1105,64,1041,911,2219,49213,1959,2008,987,25.9,350,226,181,119,347,1041,273
2018,36061015602,"Census Tract 156.02, New York County, New York",1110,55,1055,953,2157,56199,1959,2008,1013,26.6,354,243,185,121,366,1055,328
2019,36061015602,"Census Tract 156.02, New York County, New York",1134,64,1070,991,2226,61369,1960,2010,861,26.3,359,252,214,92,431,1070,331
2020,36061015602,"Census Tract 156.02, New York County, New York",1189,130,1059,988,2129,64310,1960,2012,725,19.9,378,261,215,104,424,1059,313
2012,36061015700,"Census Tract 157, New York County, New York",7129,1299,5830,4043,6821,83657,1939,2001,1552,26.6,3127,3539,64,179,247,5830,504
2013,36061015700,"Census Tract 157, New York County, New York",7047,1296,5751,3886,6328,97653,1939,2004,1734,24.4,3040,3383,28,265,213,5751,428
2014,36061015700,"Census Tract 157, New York County, New York",7165,1532,5633,3653,6073,101738,1939,2007,1893,27.6,2994,3034,10,422,180,5633,520
2015,36061015700,"Census Tract 157, New York County, New York",7203,1718,5485,3762,6280,102105,1939,2011,2025,27.2,3350,3033,43,514,149,5485,469
2016,36061015700,"Census Tract 157, New York County, New York",7196,1913,5283,3368,5407,109309,1939,2011,2072,24.5,2970,2657,37,517,174,5283,414
2017,36061015700,"Census Tract 157, New York County, New York",7121,1890,5231,3124,5513,115417,1939,2011,2166,23.6,2992,2405,41,446,117,5231,537
2018,36061015700,"Census Tract 157, New York County, New York",7194,1836,5358,3286,5921,117584,0,2011,2176,23.3,2953,2556,45,462,102,5358,535
2019,36061015700,"Census Tract 157, New York County, New York",7215,1890,5325,3565,5891,106972,0,2011,2109,24.4,3164,2866,92,282,210,5325,456
2020,36061015700,"Census Tract 157, New York County, New York",8138,2351,5787,3649,5710,118983,0,2012,2239,23.6,2925,3129,42,278,113,5787,429
2012,36061015801,"Census Tract 158.01, New York County, New York",2951,586,2365,1174,2350,96000,1939,2005,1951,30.5,914,930,13,48,141,2365,91
2013,36061015801,"Census Tract 158.01, New York County, New York",2983,530,2453,1251,2414,95750,1939,2006,2001,29.5,948,996,72,25,138,2453,109
2014,36061015801,"Census Tract 158.01, New York County, New York",2998,431,2567,1307,2382,103594,1944,2007,2001,26.6,991,1015,58,62,142,2567,102
2015,36061015801,"Census Tract 158.01, New York County, New York",3013,343,2670,1386,2572,105112,1945,2009,2172,27.5,1080,961,70,155,179,2670,96
2016,36061015801,"Census Tract 158.01, New York County, New York",2983,168,2815,1462,2434,109569,1943,2010,2404,25.6,1209,1040,48,204,159,2815,106
2017,36061015801,"Census Tract 158.01, New York County, New York",2930,260,2670,1249,2093,117279,1944,2012,2395,24,1104,864,47,234,93,2670,100
2018,36061015801,"Census Tract 158.01, New York County, New York",2940,462,2478,1178,2028,127756,1948,2013,2553,23.3,1086,801,0,260,109,2478,54
2019,36061015801,"Census Tract 158.01, New York County, New York",2962,433,2529,1182,2050,127500,1960,2014,2536,23.8,1102,810,0,215,157,2529,108
2020,36061015801,"Census Tract 158.01, New York County, New York",2925,569,2356,1263,1963,132614,1942,2014,2313,21.7,1177,916,0,138,209,2356,92
2012,36061015802,"Census Tract 158.02, New York County, New York",2013,245,1768,1713,3212,78950,1988,2006,2001,28.4,1383,938,61,418,266,1768,115
2013,36061015802,"Census Tract 158.02, New York County, New York",2058,211,1847,1786,3351,96154,1988,2008,2001,28.4,1499,910,78,529,224,1847,132
2014,36061015802,"Census Tract 158.02, New York County, New York",2081,218,1863,1795,3511,98036,1991,2011,2001,27,1530,941,119,450,229,1863,133
2015,36061015802,"Census Tract 158.02, New York County, New York",2093,124,1969,1898,3623,NA,1991,NA,2394,27.3,1588,1014,119,435,280,1969,150
2016,36061015802,"Census Tract 158.02, New York County, New York",2051,105,1946,1905,3691,97625,1989,2011,2391,27.6,1568,1066,108,404,258,1946,177
2017,36061015802,"Census Tract 158.02, New York County, New York",2075,141,1934,1909,3830,97279,1989,2012,2388,26.2,1545,1008,174,411,244,1934,199
2018,36061015802,"Census Tract 158.02, New York County, New York",2070,313,1757,1715,3361,94766,1990,2012,2299,25.1,1352,927,138,370,223,1757,151
2019,36061015802,"Census Tract 158.02, New York County, New York",2055,312,1743,1690,3140,98672,1991,2013,2365,24.6,1319,856,132,413,238,1743,126
2020,36061015802,"Census Tract 158.02, New York County, New York",2312,414,1898,1863,3320,92008,1991,2014,2835,25.3,1301,1029,120,441,222,1898,153
2012,36061015900,"Census Tract 159, New York County, New York",6273,1383,4890,2042,3195,92880,1939,2002,1994,25.3,1838,1640,67,188,83,4890,579
2013,36061015900,"Census Tract 159, New York County, New York",6351,1222,5129,2472,3710,91625,1939,2005,1941,24.7,2202,2017,50,229,106,5129,646
2014,36061015900,"Census Tract 159, New York County, New York",6366,1493,4873,2153,3279,97278,1939,2007,2001,26.6,1979,1721,60,162,143,4873,552
2015,36061015900,"Census Tract 159, New York County, New York",6454,1145,5309,2610,3785,96719,1939,2010,1958,26.3,2284,2051,58,242,199,5309,692
2016,36061015900,"Census Tract 159, New York County, New York",6413,1062,5351,2685,3888,94801,1939,2011,2122,27.5,2378,2095,22,269,247,5351,509
2017,36061015900,"Census Tract 159, New York County, New York",6336,1175,5161,2584,4046,104115,1939,2011,2399,24.4,2255,2038,31,289,236,5161,406
2018,36061015900,"Census Tract 159, New York County, New York",6293,1078,5215,2443,3749,104485,0,2011,2427,26.4,2097,1879,70,269,218,5215,378
2019,36061015900,"Census Tract 159, New York County, New York",6342,837,5505,2568,4005,107601,0,2011,2010,22.2,2122,1809,55,307,336,5505,549
2020,36061015900,"Census Tract 159, New York County, New York",6149,1061,5088,2273,3662,127139,0,2012,2412,21.1,1983,1652,82,187,334,5088,323
2012,36061016001,"Census Tract 160.01, New York County, New York",1970,372,1598,491,846,118083,1939,2004,2001,30.2,388,383,33,39,36,1598,132
2013,36061016001,"Census Tract 160.01, New York County, New York",1925,308,1617,522,957,100347,1939,2006,2001,31.5,414,430,38,18,36,1617,131
2014,36061016001,"Census Tract 160.01, New York County, New York",1944,280,1664,481,938,103669,1939,2008,2001,29.9,419,420,0,19,42,1664,75
2015,36061016001,"Census Tract 160.01, New York County, New York",1922,260,1662,427,850,127679,1939,2010,2566,24.8,377,362,0,24,41,1662,49
2016,36061016001,"Census Tract 160.01, New York County, New York",1871,183,1688,369,781,170721,1939,2011,2565,18.1,328,311,0,17,41,1688,42
2017,36061016001,"Census Tract 160.01, New York County, New York",1848,136,1712,318,690,175600,1939,2012,2560,18.6,307,296,0,10,12,1712,51
2018,36061016001,"Census Tract 160.01, New York County, New York",1862,191,1671,275,477,136477,0,2014,2655,22.4,245,235,0,7,33,1671,72
2019,36061016001,"Census Tract 160.01, New York County, New York",1851,297,1554,276,482,138750,0,2015,2680,26.3,240,219,0,21,36,1554,87
2020,36061016001,"Census Tract 160.01, New York County, New York",1894,358,1536,239,395,NA,0,2015,2883,47.7,203,195,0,19,25,1536,71
2012,36061016002,"Census Tract 160.02, New York County, New York",1429,260,1169,826,2178,56522,1939,2001,1515,30.4,613,495,11,90,200,1169,138
2013,36061016002,"Census Tract 160.02, New York County, New York",1373,253,1120,721,1540,58068,1939,2002,1518,29.8,472,441,23,118,139,1120,85
2014,36061016002,"Census Tract 160.02, New York County, New York",1334,198,1136,731,1626,64583,1939,2003,1497,28.5,480,437,22,117,136,1136,102
2015,36061016002,"Census Tract 160.02, New York County, New York",1303,101,1202,747,1796,58466,1939,2010,1577,33.3,548,422,34,134,126,1202,123
2016,36061016002,"Census Tract 160.02, New York County, New York",1305,62,1243,739,1686,55625,1939,2011,1665,31.9,566,461,20,125,104,1243,93
2017,36061016002,"Census Tract 160.02, New York County, New York",1309,62,1247,692,1559,61576,1939,2011,1695,29.2,523,435,19,92,121,1247,92
2018,36061016002,"Census Tract 160.02, New York County, New York",1340,70,1270,689,1546,63493,0,2012,1729,30.2,546,406,8,75,175,1270,106
2019,36061016002,"Census Tract 160.02, New York County, New York",1350,94,1256,738,1519,71935,0,2014,1785,29.5,595,460,8,98,163,1256,90
2020,36061016002,"Census Tract 160.02, New York County, New York",1396,172,1224,784,1854,71979,0,2015,1792,27.9,554,466,0,85,228,1224,69
2012,36061016100,"Census Tract 161, New York County, New York",4180,543,3637,2956,4798,105480,1939,2004,1902,24.8,2450,2552,32,124,208,3637,284
2013,36061016100,"Census Tract 161, New York County, New York",4262,557,3705,2935,4940,98412,1939,2004,1876,23.6,2348,2423,16,256,215,3705,226
2014,36061016100,"Census Tract 161, New York County, New York",4338,638,3700,2902,4873,109385,1939,2007,2001,25.3,2366,2492,38,150,187,3700,224
2015,36061016100,"Census Tract 161, New York County, New York",4357,747,3610,2802,4425,101959,1939,2010,2236,25.8,2366,2271,82,216,191,3610,142
2016,36061016100,"Census Tract 161, New York County, New York",4409,763,3646,2743,4269,98090,1939,NA,2310,26.3,2229,2136,95,182,293,3646,182
2017,36061016100,"Census Tract 161, New York County, New York",4322,863,3459,2462,3880,97643,1939,2012,2361,27.6,2007,1771,79,279,296,3459,245
2018,36061016100,"Census Tract 161, New York County, New York",4249,806,3443,2405,3855,100125,0,2012,2371,28.4,1955,1789,95,212,277,3443,272
2019,36061016100,"Census Tract 161, New York County, New York",4288,777,3511,2394,3806,106739,0,2014,2371,24.9,1939,1746,142,212,305,3511,168
2020,36061016100,"Census Tract 161, New York County, New York",4439,697,3742,2585,4002,109639,0,2016,2593,27,2148,2011,134,132,309,3742,140
2012,36061016200,"Census Tract 162, New York County, New York",4228,271,3957,3639,9038,25163,1971,2001,672,30,712,279,1824,136,1495,3957,1188
2013,36061016200,"Census Tract 162, New York County, New York",4165,321,3844,3574,8471,24349,1972,2001,736,31.3,647,297,1756,120,1505,3844,1190
2014,36061016200,"Census Tract 162, New York County, New York",4123,348,3775,3509,8386,22482,1971,2001,748,33.1,641,275,1610,182,1523,3775,1313
2015,36061016200,"Census Tract 162, New York County, New York",4143,253,3890,3596,8601,21051,1970,2002,641,33,727,291,1513,192,1695,3890,1457
2016,36061016200,"Census Tract 162, New York County, New York",4124,259,3865,3518,8670,26210,1968,2002,788,31.2,861,298,1505,247,1579,3865,1306
2017,36061016200,"Census Tract 162, New York County, New York",4262,293,3969,3587,9006,29911,1970,2001,870,30.9,876,309,1700,284,1450,3969,1189
2018,36061016200,"Census Tract 162, New York County, New York",4365,242,4123,3691,8972,37250,1970,2003,934,30,934,293,1658,336,1629,4123,1052
2019,36061016200,"Census Tract 162, New York County, New York",4416,221,4195,3771,8449,30341,1970,2005,833,30.2,850,309,1660,301,1682,4195,1198
2020,36061016200,"Census Tract 162, New York County, New York",4801,240,4561,4195,8430,23764,1970,2009,763,31.8,817,328,1512,340,1549,4561,1671
2012,36061016300,"Census Tract 163, New York County, New York",4393,495,3898,2554,4133,77389,1939,2003,1759,26.1,1993,1892,46,406,156,3898,395
2013,36061016300,"Census Tract 163, New York County, New York",4392,371,4021,2737,4735,71174,1939,2005,1867,28.2,1998,2097,80,395,150,4021,448
2014,36061016300,"Census Tract 163, New York County, New York",4394,569,3825,2540,4456,82222,1939,2006,1916,28.5,1917,1995,90,335,120,3825,456
2015,36061016300,"Census Tract 163, New York County, New York",4402,576,3826,2506,4227,82244,1939,2007,1917,27.4,1871,2037,80,245,145,3826,500
2016,36061016300,"Census Tract 163, New York County, New York",4453,580,3873,2491,4230,86208,1939,2010,2077,28.2,1746,2107,85,163,164,3873,408
2017,36061016300,"Census Tract 163, New York County, New York",4458,717,3741,2251,3760,93558,1939,2011,2187,28.3,1553,1903,77,98,212,3741,376
2018,36061016300,"Census Tract 163, New York County, New York",4528,1006,3522,2046,3278,100345,0,2011,2203,28,1465,1721,31,135,190,3522,281
2019,36061016300,"Census Tract 163, New York County, New York",4592,876,3716,2278,3750,95435,0,2012,2312,31.2,1620,1940,31,125,213,3716,335
2020,36061016300,"Census Tract 163, New York County, New York",4296,890,3406,1902,3376,99484,0,2014,2437,32.2,1416,1531,31,123,248,3406,200
2012,36061016400,"Census Tract 164, New York County, New York",2534,116,2418,2418,6565,33845,1970,2002,728,25.7,820,456,416,294,1228,2418,457
2013,36061016400,"Census Tract 164, New York County, New York",2538,152,2386,2386,6575,34267,1968,2003,818,26.2,873,395,575,243,1175,2386,422
2014,36061016400,"Census Tract 164, New York County, New York",2642,119,2523,2523,6717,33792,1970,2004,888,28.1,848,362,656,248,1239,2523,587
2015,36061016400,"Census Tract 164, New York County, New York",2734,132,2602,2597,6886,33408,1968,2005,861,27.2,932,378,771,306,1144,2602,700
2016,36061016400,"Census Tract 164, New York County, New York",2849,57,2792,2782,7235,32092,1970,2006,875,29.3,993,378,789,400,1339,2792,885
2017,36061016400,"Census Tract 164, New York County, New York",3047,50,2997,2986,7670,27039,1969,2006,741,30.2,893,324,985,403,1508,2997,1230
2018,36061016400,"Census Tract 164, New York County, New York",3111,64,3047,3033,7256,27714,1971,2008,714,31,801,404,917,423,1469,3047,1316
2019,36061016400,"Census Tract 164, New York County, New York",3188,105,3083,3072,7447,28660,1969,2008,720,30.6,805,411,996,445,1425,3083,1213
2020,36061016400,"Census Tract 164, New York County, New York",3364,181,3183,3181,7487,28046,1972,2010,834,31.6,827,423,919,405,1559,3183,1385
2012,36061016500,"Census Tract 165, New York County, New York",4006,576,3430,1954,4106,93377,1939,2002,1939,23.8,1603,1628,109,63,121,3430,163
2013,36061016500,"Census Tract 165, New York County, New York",4038,575,3463,1984,3931,95255,1939,2002,1944,23.5,1589,1657,112,77,91,3463,136
2014,36061016500,"Census Tract 165, New York County, New York",3996,649,3347,1942,4057,95809,1939,2002,1850,23,1518,1591,116,73,112,3347,124
2015,36061016500,"Census Tract 165, New York County, New York",3993,695,3298,2100,4319,96085,1939,2004,1853,23.3,1591,1611,167,98,229,3298,142
2016,36061016500,"Census Tract 165, New York County, New York",3977,737,3240,2007,3802,116798,1939,2008,1912,22.2,1468,1477,156,189,208,3240,141
2017,36061016500,"Census Tract 165, New York County, New York",3879,606,3273,2050,4061,129013,1939,2011,2050,21.5,1504,1528,156,175,239,3273,192
2018,36061016500,"Census Tract 165, New York County, New York",3853,658,3195,1999,4016,158220,0,2011,2276,20.1,1578,1506,98,210,226,3195,191
2019,36061016500,"Census Tract 165, New York County, New York",3811,655,3156,1951,3937,156838,0,2012,2386,21.8,1551,1407,76,262,248,3156,203
2020,36061016500,"Census Tract 165, New York County, New York",3841,665,3176,1784,3825,159891,0,2013,2588,21.1,1456,1310,18,249,178,3176,188
2012,36061016600,"Census Tract 166, New York County, New York",3107,243,2864,2819,7484,33825,1942,2002,1010,32.4,880,671,537,263,1363,2864,678
2013,36061016600,"Census Tract 166, New York County, New York",3084,293,2791,2684,6950,34643,1946,2003,1034,32,890,663,519,224,1315,2791,695
2014,36061016600,"Census Tract 166, New York County, New York",3116,241,2875,2752,6845,37157,1945,2004,1149,31.7,913,683,526,169,1325,2875,564
2015,36061016600,"Census Tract 166, New York County, New York",3075,221,2854,2713,6373,34484,1942,2004,1100,31.5,908,647,473,179,1357,2854,589
2016,36061016600,"Census Tract 166, New York County, New York",3124,257,2867,2745,6672,36133,1939,2004,1056,30.5,909,731,481,153,1344,2867,589
2017,36061016600,"Census Tract 166, New York County, New York",3205,311,2894,2759,6087,40328,1939,2003,1086,30.7,998,722,422,154,1476,2894,697
2018,36061016600,"Census Tract 166, New York County, New York",3257,353,2904,2777,5938,44085,0,2004,1176,31.2,960,731,462,136,1476,2904,678
2019,36061016600,"Census Tract 166, New York County, New York",3238,419,2819,2685,5636,34321,1947,2005,1172,31.8,853,700,394,170,1490,2819,836
2020,36061016600,"Census Tract 166, New York County, New York",3279,483,2796,2631,5279,42708,1951,2010,1201,31.8,906,567,403,212,1508,2796,838
2012,36061016700,"Census Tract 167, New York County, New York",3687,505,3182,2065,3835,79353,1939,2003,2001,31.3,1504,1652,63,106,215,3182,204
2013,36061016700,"Census Tract 167, New York County, New York",3737,471,3266,2021,3802,84840,1939,2004,2001,28.2,1441,1707,61,117,152,3266,258
2014,36061016700,"Census Tract 167, New York County, New York",3709,537,3172,1911,3359,73443,1939,2005,2001,32.9,1320,1543,110,86,238,3172,250
2015,36061016700,"Census Tract 167, New York County, New York",3704,498,3206,1958,3538,85270,1939,2006,2114,27.8,1363,1650,94,93,189,3206,259
2016,36061016700,"Census Tract 167, New York County, New York",3730,549,3181,1900,3444,105104,1939,2008,2149,23.2,1409,1553,73,123,200,3181,204
2017,36061016700,"Census Tract 167, New York County, New York",3715,538,3177,1729,3130,126250,1939,2010,2203,20.4,1341,1426,67,105,176,3177,156
2018,36061016700,"Census Tract 167, New York County, New York",3695,574,3121,1768,3247,125781,0,2009,2279,21.1,1370,1395,68,119,235,3121,245
2019,36061016700,"Census Tract 167, New York County, New York",3674,607,3067,1821,3348,129004,0,2010,2261,21.2,1476,1500,21,151,149,3067,257
2020,36061016700,"Census Tract 167, New York County, New York",3804,835,2969,1801,3429,128949,0,2011,2332,23.6,1441,1517,21,100,163,2969,222
2012,36061016800,"Census Tract 168, New York County, New York",1748,160,1588,1442,4167,24492,1954,2002,556,25.9,300,144,458,57,812,1588,519
2013,36061016800,"Census Tract 168, New York County, New York",1757,199,1558,1429,3962,24885,1955,2002,618,25.9,356,177,417,83,789,1558,471
2014,36061016800,"Census Tract 168, New York County, New York",1828,249,1579,1483,4072,24356,1954,2001,615,26.9,382,165,496,102,750,1579,566
2015,36061016800,"Census Tract 168, New York County, New York",1874,188,1686,1586,3849,24755,1956,2000,613,27.8,435,208,513,108,809,1686,615
2016,36061016800,"Census Tract 168, New York County, New York",1929,159,1770,1641,3686,22898,1957,2001,632,27.6,525,286,493,139,781,1770,638
2017,36061016800,"Census Tract 168, New York County, New York",2000,203,1797,1714,3928,22318,1957,2001,686,30,413,260,580,167,763,1797,759
2018,36061016800,"Census Tract 168, New York County, New York",2037,194,1843,1725,4080,22962,1958,2005,645,30.3,408,244,567,150,817,1843,733
2019,36061016800,"Census Tract 168, New York County, New York",2044,218,1826,1697,4188,21052,1960,2006,631,32.3,334,254,562,111,822,1826,749
2020,36061016800,"Census Tract 168, New York County, New York",2102,328,1774,1647,4193,22938,1960,2010,635,32.1,327,285,616,134,666,1774,692
2012,36061016900,"Census Tract 169, New York County, New York",4983,753,4230,2995,5010,88016,1939,2003,1990,26.7,2259,2556,43,201,187,4230,409
2013,36061016900,"Census Tract 169, New York County, New York",4942,915,4027,2963,5214,86679,1939,2003,1995,28.2,2199,2531,80,212,129,4027,400
2014,36061016900,"Census Tract 169, New York County, New York",4953,946,4007,2860,5254,75081,1939,2006,1993,30.8,2048,2383,139,192,136,4007,515
2015,36061016900,"Census Tract 169, New York County, New York",4974,929,4045,2712,5018,87536,1939,2008,2071,25,2184,2409,55,186,62,4045,390
2016,36061016900,"Census Tract 169, New York County, New York",4959,740,4219,2974,5863,88295,1939,2009,2050,25.7,2317,2557,90,198,116,4219,427
2017,36061016900,"Census Tract 169, New York County, New York",4915,799,4116,2759,5496,102946,1939,2011,2166,23.1,2191,2307,86,200,145,4116,331
2018,36061016900,"Census Tract 169, New York County, New York",4945,861,4084,2652,5099,113261,0,2011,2342,23.1,2105,2196,52,239,143,4084,363
2019,36061016900,"Census Tract 169, New York County, New York",4943,892,4051,2631,5018,123912,0,2013,2599,22.3,2230,2226,0,196,180,4051,246
2020,36061016900,"Census Tract 169, New York County, New York",5016,1067,3949,2823,5701,121444,0,2015,2833,23.7,2421,2395,48,204,148,3949,374
2012,36061017000,"Census Tract 170, New York County, New York",3341,193,3148,2828,6762,33796,1962,1999,934,29.8,694,365,717,404,1463,3148,622
2013,36061017000,"Census Tract 170, New York County, New York",3333,172,3161,2847,6896,32344,1963,2001,987,31.7,729,378,622,425,1453,3161,813
2014,36061017000,"Census Tract 170, New York County, New York",3376,143,3233,3056,7069,31698,1963,2002,1040,29.9,759,312,787,483,1531,3233,838
2015,36061017000,"Census Tract 170, New York County, New York",3416,153,3263,3081,7245,30453,1962,2003,1067,31.1,806,274,817,501,1473,3263,952
2016,36061017000,"Census Tract 170, New York County, New York",3498,189,3309,3160,6949,28864,1962,2004,1063,29.6,774,344,824,533,1502,3309,930
2017,36061017000,"Census Tract 170, New York County, New York",3666,182,3484,3405,7187,30434,1962,2005,1067,29.5,794,274,832,518,1773,3484,869
2018,36061017000,"Census Tract 170, New York County, New York",3733,145,3588,3388,6955,30051,1962,2004,1073,30.6,957,443,913,501,1550,3588,873
2019,36061017000,"Census Tract 170, New York County, New York",3708,305,3403,3154,7001,34361,1962,2005,1062,31,914,440,764,464,1505,3403,714
2020,36061017000,"Census Tract 170, New York County, New York",3670,222,3448,3170,7165,35204,1963,2008,1112,32.1,877,408,646,596,1611,3448,751
2012,36061017100,"Census Tract 171, New York County, New York",5244,650,4594,2912,5383,81667,1939,2001,1763,25.6,2165,2256,333,32,241,4594,411
2013,36061017100,"Census Tract 171, New York County, New York",5101,459,4642,2786,4813,73790,1939,2002,1913,28.5,2159,2214,331,65,200,4642,367
2014,36061017100,"Census Tract 171, New York County, New York",5018,301,4717,2814,4732,65334,1939,2004,1904,30.2,2251,2253,253,80,255,4717,404
2015,36061017100,"Census Tract 171, New York County, New York",4960,439,4521,2665,4708,66574,1939,2004,1931,28.7,2032,2041,187,92,340,4521,383
2016,36061017100,"Census Tract 171, New York County, New York",4948,425,4523,2769,4555,66580,1939,2006,1835,29.6,2158,2258,123,104,277,4523,477
2017,36061017100,"Census Tract 171, New York County, New York",4887,581,4306,2395,3927,78080,1939,2010,1885,27.2,1889,1964,36,133,230,4306,533
2018,36061017100,"Census Tract 171, New York County, New York",4820,527,4293,2254,3589,71488,0,2010,1862,26.9,1706,1834,28,138,224,4293,560
2019,36061017100,"Census Tract 171, New York County, New York",4825,808,4017,2080,3468,84417,0,2010,1933,25.1,1559,1709,26,105,209,4017,486
2020,36061017100,"Census Tract 171, New York County, New York",4947,672,4275,2367,3966,120420,0,2013,2690,32.3,2026,2077,23,181,86,4275,473
2012,36061017200,"Census Tract 172, New York County, New York",2356,183,2173,2044,5070,31054,1963,2003,851,28.5,596,226,564,153,1184,2173,455
2013,36061017200,"Census Tract 172, New York County, New York",2369,215,2154,2032,5375,33472,1967,2003,976,29.9,706,298,651,111,1040,2154,419
2014,36061017200,"Census Tract 172, New York County, New York",2443,257,2186,2083,5436,34202,1967,2003,1016,32,655,250,538,141,1214,2186,489
2015,36061017200,"Census Tract 172, New York County, New York",2467,316,2151,2049,5430,NA,1966,2004,1002,33,742,254,510,124,1202,2151,496
2016,36061017200,"Census Tract 172, New York County, New York",2470,186,2284,2172,5440,37361,1968,2005,1057,31.3,845,303,542,114,1259,2284,504
2017,36061017200,"Census Tract 172, New York County, New York",2490,246,2244,2148,5651,43552,1970,2005,1115,30.3,784,317,621,149,1233,2244,514
2018,36061017200,"Census Tract 172, New York County, New York",2477,254,2223,2118,5609,31055,1967,2007,1069,33,631,255,680,170,1128,2223,611
2019,36061017200,"Census Tract 172, New York County, New York",2551,350,2201,2087,4846,29929,1963,2008,965,29.3,652,250,795,115,1100,2201,588
2020,36061017200,"Census Tract 172, New York County, New York",2416,325,2091,2018,4963,27054,1965,2009,976,28.2,629,192,950,142,942,2091,566
2012,36061017300,"Census Tract 173, New York County, New York",5144,716,4428,3301,6005,81523,1939,2002,1722,28.8,2510,2144,303,437,469,4428,499
2013,36061017300,"Census Tract 173, New York County, New York",5198,932,4266,3103,5835,92386,1939,2003,1790,28.3,2434,2019,288,437,396,4266,375
2014,36061017300,"Census Tract 173, New York County, New York",5119,810,4309,3299,6379,82336,1939,2003,1560,26.7,2542,2083,350,522,397,4309,322
2015,36061017300,"Census Tract 173, New York County, New York",5023,828,4195,3159,6041,81513,1939,2005,1505,26.9,2363,1927,296,481,474,4195,294
2016,36061017300,"Census Tract 173, New York County, New York",5049,909,4140,2979,5684,102625,1939,2010,1760,26.4,2238,1943,321,384,389,4140,201
2017,36061017300,"Census Tract 173, New York County, New York",5113,852,4261,2954,5297,106727,1939,2010,1962,25.5,2260,2111,203,243,386,4261,195
2018,36061017300,"Census Tract 173, New York County, New York",5070,551,4519,3227,6041,109623,0,2011,2160,24.6,2568,2394,184,229,401,4519,207
2019,36061017300,"Census Tract 173, New York County, New York",5116,1118,3998,2659,4441,110328,0,2012,2296,26.4,2095,2048,193,145,270,3998,350
2020,36061017300,"Census Tract 173, New York County, New York",5371,1021,4350,3371,5557,79688,0,2011,2337,26.5,2788,2882,64,197,232,4350,371
2012,36061017401,"Census Tract 174.01, New York County, New York",2226,270,1956,1714,4336,23607,1964,1999,758,30.7,263,144,743,104,793,1956,562
2013,36061017401,"Census Tract 174.01, New York County, New York",2199,278,1921,1666,4010,22308,1964,2001,782,33,294,175,759,93,745,1921,541
2014,36061017401,"Census Tract 174.01, New York County, New York",2257,291,1966,1718,3746,17325,1965,2001,813,40.3,332,171,776,76,789,1966,680
2015,36061017401,"Census Tract 174.01, New York County, New York",2202,273,1929,1671,3518,NA,1965,2002,825,38.2,389,139,773,41,810,1929,724
2016,36061017401,"Census Tract 174.01, New York County, New York",2271,249,2022,1749,3902,16313,1962,2002,855,39.8,495,217,796,29,800,2022,832
2017,36061017401,"Census Tract 174.01, New York County, New York",2307,258,2049,1765,3959,16541,1963,2003,693,38.3,461,143,801,101,812,2049,902
2018,36061017401,"Census Tract 174.01, New York County, New York",2306,282,2024,1774,4034,19398,1961,2003,593,35.6,409,182,748,105,828,2024,869
2019,36061017401,"Census Tract 174.01, New York County, New York",2340,292,2048,1762,4084,20089,1962,2004,594,36.2,467,230,806,50,721,2048,829
2020,36061017401,"Census Tract 174.01, New York County, New York",2230,189,2041,1720,3870,23538,1961,2004,649,36.5,426,314,652,77,757,2041,643
2012,36061017402,"Census Tract 174.02, New York County, New York",881,20,861,861,2519,42125,1976,2003,1134,30.7,220,72,565,25,266,861,283
2013,36061017402,"Census Tract 174.02, New York County, New York",871,15,856,856,2662,44766,1977,2003,1288,34.7,251,103,493,45,250,856,273
2014,36061017402,"Census Tract 174.02, New York County, New York",872,17,855,855,2562,45516,1977,2003,1446,32.3,335,143,459,64,220,855,273
2015,36061017402,"Census Tract 174.02, New York County, New York",917,30,887,870,2283,36176,1976,2002,1384,32.3,305,136,477,40,219,887,278
2016,36061017402,"Census Tract 174.02, New York County, New York",964,39,925,881,2286,28750,1976,2001,1422,36.5,289,148,472,54,237,925,306
2017,36061017402,"Census Tract 174.02, New York County, New York",1021,45,976,903,2436,35461,1975,2002,1358,36.1,329,176,421,63,258,976,306
2018,36061017402,"Census Tract 174.02, New York County, New York",1040,61,979,870,2218,39483,1976,2003,1602,33.9,343,166,409,60,253,979,261
2019,36061017402,"Census Tract 174.02, New York County, New York",1094,79,1015,884,2134,41563,1977,2005,1641,34,345,156,423,73,255,1015,247
2020,36061017402,"Census Tract 174.02, New York County, New York",1229,111,1118,981,2396,50365,1976,2010,2007,33.8,405,187,392,113,287,1118,244
2012,36061017500,"Census Tract 175, New York County, New York",5741,635,5106,2705,4976,92668,1939,2001,1884,24.3,2139,2179,127,92,251,5106,245
2013,36061017500,"Census Tract 175, New York County, New York",5859,936,4923,2541,5030,94399,1939,2002,2001,23.4,2058,2060,116,69,242,4923,236
2014,36061017500,"Census Tract 175, New York County, New York",5882,1152,4730,2494,5369,99149,1939,2007,1929,21.8,1943,1967,70,40,355,4730,142
2015,36061017500,"Census Tract 175, New York County, New York",5937,1166,4771,2424,5037,81574,1939,2009,1792,19.2,1907,1942,25,129,311,4771,107
2016,36061017500,"Census Tract 175, New York County, New York",5937,1260,4677,2395,4582,84427,1939,2010,2079,21.8,2048,2038,22,132,187,4677,104
2017,36061017500,"Census Tract 175, New York County, New York",5885,1217,4668,2442,4787,102598,1939,2011,1894,18.6,1998,1916,96,160,253,4668,111
2018,36061017500,"Census Tract 175, New York County, New York",5872,959,4913,2598,4895,100417,0,2011,2066,18.5,2139,1950,114,252,260,4913,171
2019,36061017500,"Census Tract 175, New York County, New York",5710,763,4947,2469,4463,104181,0,2011,1994,18.3,2035,1877,140,235,189,4947,205
2020,36061017500,"Census Tract 175, New York County, New York",5531,762,4769,2521,5236,98877,0,2011,2009,22,1930,1685,171,200,417,4769,176
2012,36061017700,"Census Tract 177, New York County, New York",5019,467,4552,3175,6301,35656,1962,1997,960,28.5,1157,1132,1179,178,994,4552,858
2013,36061017700,"Census Tract 177, New York County, New York",4984,407,4577,3065,5927,40428,1962,2000,942,28.3,1332,1209,1084,228,806,4577,809
2014,36061017700,"Census Tract 177, New York County, New York",5060,240,4820,3384,6842,47292,1963,2000,990,27.8,1336,1198,972,352,1001,4820,792
2015,36061017700,"Census Tract 177, New York County, New York",5078,238,4840,3320,6876,50650,1965,2001,979,26.3,1238,990,1068,354,1106,4840,884
2016,36061017700,"Census Tract 177, New York County, New York",5081,265,4816,3253,6832,52946,1965,2002,1087,26.8,1292,1066,859,370,1070,4816,853
2017,36061017700,"Census Tract 177, New York County, New York",5150,432,4718,3046,6444,49368,1966,2003,1100,26.1,1378,1018,743,294,999,4718,626
2018,36061017700,"Census Tract 177, New York County, New York",5209,527,4682,2902,5937,54912,1965,2005,1151,26.2,1309,1079,685,136,1003,4682,669
2019,36061017700,"Census Tract 177, New York County, New York",5265,645,4620,2811,5851,44023,1963,2007,1132,25.4,1416,992,806,103,1066,4620,767
2020,36061017700,"Census Tract 177, New York County, New York",5208,794,4414,2572,5801,56900,1964,2010,1759,35.6,1648,1315,331,108,742,4414,722
2012,36061017800,"Census Tract 178, New York County, New York",1874,235,1639,1578,4233,28333,1939,2004,1085,37.9,364,456,328,84,694,1639,480
2013,36061017800,"Census Tract 178, New York County, New York",1830,205,1625,1556,3671,26684,1939,2004,1069,34.4,374,435,362,100,659,1625,510
2014,36061017800,"Census Tract 178, New York County, New York",1878,173,1705,1645,3640,27172,1939,2005,1118,34.8,405,413,466,121,680,1705,539
2015,36061017800,"Census Tract 178, New York County, New York",1848,221,1627,1565,3606,32254,1939,2006,1093,29.8,430,392,444,122,688,1627,457
2016,36061017800,"Census Tract 178, New York County, New York",1860,232,1628,1554,3467,40789,1939,2008,1116,27.9,568,416,423,142,647,1628,391
2017,36061017800,"Census Tract 178, New York County, New York",1926,259,1667,1573,3460,40625,1939,2010,1253,28.8,646,416,421,121,677,1667,419
2018,36061017800,"Census Tract 178, New York County, New York",2000,236,1764,1696,3426,43438,0,2011,1384,29.3,760,453,482,94,717,1764,462
2019,36061017800,"Census Tract 178, New York County, New York",2040,262,1778,1719,3737,48980,1942,2011,1466,27.8,764,477,463,56,717,1778,390
2020,36061017800,"Census Tract 178, New York County, New York",2174,266,1908,1761,3856,52225,1951,2013,1635,27.2,825,480,549,121,602,1908,417
2012,36061017900,"Census Tract 179, New York County, New York",5277,488,4789,3487,6340,56205,1939,2001,1406,25,2400,2349,353,346,489,4789,595
2013,36061017900,"Census Tract 179, New York County, New York",5263,430,4833,3541,6372,64448,1939,2002,1600,27.4,2532,2551,275,283,390,4833,670
2014,36061017900,"Census Tract 179, New York County, New York",5275,513,4762,3651,6828,63279,1939,2003,1460,29.7,2481,2466,369,163,644,4762,743
2015,36061017900,"Census Tract 179, New York County, New York",5210,639,4571,3496,6688,60625,1939,2005,1453,31.4,2299,2296,211,192,718,4571,602
2016,36061017900,"Census Tract 179, New York County, New York",5209,673,4536,3351,6772,68928,1939,2007,1527,32,2302,2158,175,94,832,4536,652
2017,36061017900,"Census Tract 179, New York County, New York",5174,615,4559,3338,6584,59856,1939,2010,1692,33,2292,2072,183,115,911,4559,577
2018,36061017900,"Census Tract 179, New York County, New York",5236,790,4446,3114,6134,70664,0,2010,1810,27.5,2127,1937,181,103,893,4446,406
2019,36061017900,"Census Tract 179, New York County, New York",5227,967,4260,2976,5820,76842,0,2011,1777,24.7,2114,1911,69,130,846,4260,435
2020,36061017900,"Census Tract 179, New York County, New York",5185,980,4205,2775,5446,100655,0,2013,1855,20.5,2032,1798,122,116,718,4205,430
2012,36061018000,"Census Tract 180, New York County, New York",2900,201,2699,2613,7431,24491,1955,2001,623,30,445,248,928,81,1527,2699,966
2013,36061018000,"Census Tract 180, New York County, New York",2927,245,2682,2525,6864,23134,1955,2000,618,30.7,424,256,877,88,1433,2682,1050
2014,36061018000,"Census Tract 180, New York County, New York",2980,178,2802,2622,7138,25503,1956,2002,690,31.1,454,194,898,79,1559,2802,939
2015,36061018000,"Census Tract 180, New York County, New York",3072,158,2914,2747,7584,30266,1955,2003,753,29.2,580,212,804,111,1711,2914,901
2016,36061018000,"Census Tract 180, New York County, New York",3056,134,2922,2753,7842,31672,1954,2005,815,29.8,613,301,837,81,1635,2922,927
2017,36061018000,"Census Tract 180, New York County, New York",3154,147,3007,2881,7565,33750,1953,2007,864,29.4,683,353,910,97,1658,3007,991
2018,36061018000,"Census Tract 180, New York County, New York",3262,158,3104,3066,8131,35357,1951,2008,871,27.1,828,402,1121,84,1684,3104,981
2019,36061018000,"Census Tract 180, New York County, New York",3305,279,3026,3002,7356,31861,1951,2008,933,30.3,704,357,1113,77,1682,3026,1136
2020,36061018000,"Census Tract 180, New York County, New York",3359,365,2994,2885,5937,21315,1953,2011,909,34,619,313,1115,67,1582,2994,1306
2012,36061018100,"Census Tract 181, New York County, New York",4752,318,4434,3625,7408,66721,1964,1996,1092,23,2566,2093,799,272,636,4434,521
2013,36061018100,"Census Tract 181, New York County, New York",4632,378,4254,3464,6785,65383,1964,1995,1130,23.8,2457,1976,793,276,593,4254,543
2014,36061018100,"Census Tract 181, New York County, New York",4699,391,4308,3404,6820,66384,1965,1994,1002,23.3,2225,1870,790,262,686,4308,521
2015,36061018100,"Census Tract 181, New York County, New York",4701,347,4354,3473,6771,65845,1965,1997,1072,24.5,2298,1968,781,263,606,4354,475
2016,36061018100,"Census Tract 181, New York County, New York",4694,253,4441,3472,6611,67832,1966,2002,1167,23.7,2304,1907,641,258,800,4441,537
2017,36061018100,"Census Tract 181, New York County, New York",4810,366,4444,3140,6182,65556,1966,1997,1129,25.8,2077,1683,805,176,719,4444,504
2018,36061018100,"Census Tract 181, New York County, New York",4845,384,4461,2989,6141,62437,1964,1999,1139,23.7,1963,1687,785,61,678,4461,404
2019,36061018100,"Census Tract 181, New York County, New York",4773,509,4264,2862,5062,83083,1965,2000,1391,23.9,1928,1715,546,106,474,4264,413
2020,36061018100,"Census Tract 181, New York County, New York",4790,526,4264,2889,5363,87231,1967,1994,1189,19.9,1983,1805,506,116,479,4264,402
2012,36061018200,"Census Tract 182, New York County, New York",2747,196,2551,2535,6765,27770,1950,2001,582,26.9,488,249,770,36,1556,2551,915
2013,36061018200,"Census Tract 182, New York County, New York",2691,215,2476,2457,5941,23401,1954,2002,579,28.2,581,296,737,78,1354,2476,893
2014,36061018200,"Census Tract 182, New York County, New York",2778,171,2607,2589,6510,22619,1952,2001,576,29.4,578,306,808,43,1486,2607,1058
2015,36061018200,"Census Tract 182, New York County, New York",2845,178,2667,2613,7097,22747,1950,2002,575,29.4,536,267,742,129,1517,2667,1100
2016,36061018200,"Census Tract 182, New York County, New York",2888,80,2808,2725,7012,18757,1949,2003,566,32,627,298,732,130,1578,2808,1186
2017,36061018200,"Census Tract 182, New York County, New York",3001,40,2961,2847,7855,21736,1949,2004,640,29.4,769,252,900,129,1624,2961,1204
2018,36061018200,"Census Tract 182, New York County, New York",3058,30,3028,2924,8050,26845,1949,2006,705,29.3,854,278,968,151,1553,3028,1093
2019,36061018200,"Census Tract 182, New York County, New York",3102,30,3072,2954,7555,23013,1950,2008,722,30,846,245,1084,146,1512,3072,1110
2020,36061018200,"Census Tract 182, New York County, New York",3072,79,2993,2933,7172,29716,1950,2006,762,28.9,966,230,1140,80,1495,2993,1001
2012,36061018300,"Census Tract 183, New York County, New York",5258,769,4489,3493,6552,71997,1939,2002,1761,25.6,2418,2458,359,337,412,4489,525
2013,36061018300,"Census Tract 183, New York County, New York",5149,760,4389,3504,7280,72000,1939,2003,1852,26.8,2581,2282,329,515,486,4389,425
2014,36061018300,"Census Tract 183, New York County, New York",5118,779,4339,3394,6356,68779,1939,2004,1828,28.4,2534,2235,372,484,437,4339,331
2015,36061018300,"Census Tract 183, New York County, New York",5204,827,4377,3129,5442,74875,1939,2008,1861,28.6,2483,2357,149,400,316,4377,353
2016,36061018300,"Census Tract 183, New York County, New York",5173,1142,4031,2724,4611,86912,1939,2010,1998,28.7,2395,2179,67,241,237,4031,177
2017,36061018300,"Census Tract 183, New York County, New York",5065,1183,3882,2716,4551,84944,1939,2011,2069,30,2314,2081,92,226,329,3882,231
2018,36061018300,"Census Tract 183, New York County, New York",5036,1115,3921,2731,4312,82153,0,2011,2321,32.4,2145,2149,87,95,394,3921,389
2019,36061018300,"Census Tract 183, New York County, New York",5101,1181,3920,2744,4859,87821,0,2011,2360,26.1,2001,1999,116,75,508,3920,432
2020,36061018300,"Census Tract 183, New York County, New York",4753,1109,3644,2407,4556,99179,0,2011,2348,21.1,1791,1704,101,82,464,3644,343
2012,36061018400,"Census Tract 184, New York County, New York",3204,290,2914,2640,7712,24784,1968,2001,679,29.7,442,111,1125,138,1426,2914,903
2013,36061018400,"Census Tract 184, New York County, New York",3251,418,2833,2530,7281,21731,1968,2003,642,29.6,568,140,943,257,1295,2833,924
2014,36061018400,"Census Tract 184, New York County, New York",3278,492,2786,2473,7430,21420,1968,2003,639,30.8,580,122,1082,236,1147,2786,939
2015,36061018400,"Census Tract 184, New York County, New York",3330,450,2880,2612,7075,22414,1966,2004,647,30.6,785,183,1004,203,1255,2880,927
2016,36061018400,"Census Tract 184, New York County, New York",3308,364,2944,2663,6507,22223,1962,2003,634,30.3,684,191,1050,205,1206,2944,1034
2017,36061018400,"Census Tract 184, New York County, New York",3402,287,3115,2878,6974,25864,1963,2005,600,29.6,835,247,1190,279,1155,3115,1105
2018,36061018400,"Census Tract 184, New York County, New York",3340,223,3117,2901,6888,22850,1965,2005,639,32.2,636,182,1231,184,1406,3117,1252
2019,36061018400,"Census Tract 184, New York County, New York",3485,205,3280,3060,6810,20909,1966,2008,756,31.9,721,316,1212,162,1465,3280,1280
2020,36061018400,"Census Tract 184, New York County, New York",3552,275,3277,2946,6893,22240,1968,2008,800,31.7,542,264,1429,132,1296,3277,1220
2012,36061018500,"Census Tract 185, New York County, New York",2859,267,2592,1983,3473,87883,1962,1994,1426,19.8,1556,1316,326,185,144,2592,131
2013,36061018500,"Census Tract 185, New York County, New York",2932,201,2731,2045,3845,101597,1966,2002,1686,21.3,1686,1379,244,213,169,2731,221
2014,36061018500,"Census Tract 185, New York County, New York",3125,249,2876,2219,4359,107750,1966,2002,1701,20,1808,1406,376,228,174,2876,308
2015,36061018500,"Census Tract 185, New York County, New York",3159,338,2821,2106,4135,105333,1966,1998,1733,24,1711,1263,383,221,212,2821,283
2016,36061018500,"Census Tract 185, New York County, New York",3281,538,2743,2033,4188,125531,1967,2009,2010,23.2,1692,1192,348,265,225,2743,272
2017,36061018500,"Census Tract 185, New York County, New York",3286,605,2681,1916,3896,123071,1967,2010,2071,24.2,1665,1161,398,139,244,2681,254
2018,36061018500,"Census Tract 185, New York County, New York",3286,753,2533,1705,3417,122054,1965,2011,2307,24.5,1465,1105,314,131,176,2533,248
2019,36061018500,"Census Tract 185, New York County, New York",3270,673,2597,1755,3530,130481,1965,2013,2106,22.1,1565,1150,316,153,159,2597,229
2020,36061018500,"Census Tract 185, New York County, New York",3363,758,2605,1597,3176,146131,1965,2016,2648,20.5,1474,1058,222,296,46,2605,191
2012,36061018600,"Census Tract 186, New York County, New York",2020,39,1981,1964,5585,20599,1955,1994,518,27.1,313,100,1373,26,515,1981,893
2013,36061018600,"Census Tract 186, New York County, New York",2036,67,1969,1954,6175,20883,1955,1995,511,27.3,285,87,1287,39,576,1969,885
2014,36061018600,"Census Tract 186, New York County, New York",2069,68,2001,1985,6592,23004,1957,1996,464,24.9,360,87,1203,111,606,2001,828
2015,36061018600,"Census Tract 186, New York County, New York",2081,77,2004,1973,6628,NA,1956,1999,561,26.4,338,68,1060,121,703,2004,863
2016,36061018600,"Census Tract 186, New York County, New York",2114,71,2043,2020,7055,30551,1956,2000,570,25.5,285,105,1091,132,697,2043,818
2017,36061018600,"Census Tract 186, New York County, New York",2146,59,2087,1997,6968,33386,1956,2003,602,21.8,300,121,875,136,875,2087,715
2018,36061018600,"Census Tract 186, New York County, New York",2170,36,2134,2063,6489,31811,1956,2001,524,26.4,211,125,1041,104,829,2134,804
2019,36061018600,"Census Tract 186, New York County, New York",2167,31,2136,2058,5967,34550,1955,2002,706,30,271,162,1027,51,824,2136,745
2020,36061018600,"Census Tract 186, New York County, New York",1984,31,1953,1902,5494,36682,1954,2003,744,31.1,291,157,1155,41,617,1953,670
2012,36061018700,"Census Tract 187, New York County, New York",4510,338,4172,3182,6405,60986,1939,2002,1811,29,2434,2208,122,291,573,4172,373
2013,36061018700,"Census Tract 187, New York County, New York",4536,511,4025,2925,5855,63142,1939,2002,1863,28.8,2326,2004,176,357,442,4025,364
2014,36061018700,"Census Tract 187, New York County, New York",4552,523,4029,2980,5926,73750,1939,2003,1855,30.5,2342,1997,295,278,510,4029,460
2015,36061018700,"Census Tract 187, New York County, New York",4551,565,3986,2889,5352,84019,1939,2002,1721,26,2235,2122,229,208,347,3986,397
2016,36061018700,"Census Tract 187, New York County, New York",4616,750,3866,2667,4795,90597,1939,2003,1763,24.2,2040,1992,275,189,240,3866,296
2017,36061018700,"Census Tract 187, New York County, New York",4615,637,3978,2696,5165,93426,1939,2004,1838,24.7,2083,1921,308,222,283,3978,314
2018,36061018700,"Census Tract 187, New York County, New York",4630,689,3941,2808,5461,101023,0,2006,1891,23.1,2224,2038,296,241,231,3941,328
2019,36061018700,"Census Tract 187, New York County, New York",4695,649,4046,2887,5507,103188,0,2008,1975,22.7,2400,2165,209,332,156,4046,230
2020,36061018700,"Census Tract 187, New York County, New York",4164,492,3672,2420,5070,108095,0,2011,2147,24,2012,1707,122,282,245,3672,345
2012,36061018800,"Census Tract 188, New York County, New York",2562,327,2235,2123,5320,26170,1964,2004,993,38.5,470,383,615,70,1090,2235,808
2013,36061018800,"Census Tract 188, New York County, New York",2510,346,2164,2055,5198,27910,1962,2005,1036,37.8,473,405,522,108,1112,2164,676
2014,36061018800,"Census Tract 188, New York County, New York",2574,227,2347,2219,5193,27615,1961,2007,1038,37.8,564,484,649,88,1072,2347,764
2015,36061018800,"Census Tract 188, New York County, New York",2588,290,2298,2196,5134,27975,1962,2009,1044,34.3,615,510,666,86,981,2298,637
2016,36061018800,"Census Tract 188, New York County, New York",2595,340,2255,2142,4939,30068,1965,2009,1014,31.2,758,501,638,125,915,2255,644
2017,36061018800,"Census Tract 188, New York County, New York",2676,305,2371,2236,5647,29884,1965,2010,1009,30.9,737,444,708,84,1013,2371,725
2018,36061018800,"Census Tract 188, New York County, New York",2660,364,2296,2121,5240,38224,1967,2011,1067,29.4,767,416,668,61,926,2296,569
2019,36061018800,"Census Tract 188, New York County, New York",2602,397,2205,2089,5058,40236,1966,2012,1200,30.9,768,351,728,99,900,2205,657
2020,36061018800,"Census Tract 188, New York County, New York",2646,492,2154,2064,4617,29222,1967,2014,1301,34.4,549,269,745,85,949,2154,956
2012,36061018900,"Census Tract 189, New York County, New York",5227,201,5026,4429,10164,25862,1950,1997,791,29.6,1537,1094,1686,319,1596,5026,1401
2013,36061018900,"Census Tract 189, New York County, New York",5230,255,4975,4282,9954,24424,1947,1998,782,30.1,1495,850,1744,306,1677,4975,1435
2014,36061018900,"Census Tract 189, New York County, New York",5266,261,5005,4301,9969,25623,1947,2000,827,31.8,1473,749,1819,285,1861,5005,1473
2015,36061018900,"Census Tract 189, New York County, New York",5336,299,5037,4314,10574,25625,1951,2001,799,33.1,1435,744,1544,281,1938,5037,1535
2016,36061018900,"Census Tract 189, New York County, New York",5447,367,5080,4426,10631,25293,1952,2002,780,32.1,1487,649,1541,369,1990,5080,1634
2017,36061018900,"Census Tract 189, New York County, New York",5487,545,4942,4288,10153,21288,1955,2004,677,32.3,1441,636,1322,361,2194,4942,1886
2018,36061018900,"Census Tract 189, New York County, New York",5413,654,4759,4117,9792,27392,1957,2008,791,28.9,1256,740,1170,261,2224,4759,1524
2019,36061018900,"Census Tract 189, New York County, New York",5386,696,4690,4063,9793,27355,1958,2011,820,29,1279,800,952,277,2125,4690,1474
2020,36061018900,"Census Tract 189, New York County, New York",5207,623,4584,4049,9262,25951,1956,2011,810,32.3,1127,689,854,407,2399,4584,1674
2012,36061019000,"Census Tract 190, New York County, New York",1617,349,1268,798,1722,26337,1973,2004,803,29.9,267,50,574,31,122,1268,263
2013,36061019000,"Census Tract 190, New York County, New York",1653,326,1327,819,1663,22480,1974,2004,696,30.9,214,39,654,34,103,1327,275
2014,36061019000,"Census Tract 190, New York County, New York",1657,298,1359,836,1796,21308,1971,2004,700,33.3,187,37,668,33,111,1359,290
2015,36061019000,"Census Tract 190, New York County, New York",1632,258,1374,824,1847,21657,1972,2006,764,32.3,222,29,663,35,123,1374,284
2016,36061019000,"Census Tract 190, New York County, New York",1686,233,1453,879,1823,31250,1973,2007,789,26.9,284,54,685,25,142,1453,296
2017,36061019000,"Census Tract 190, New York County, New York",1764,187,1577,949,2010,29013,1976,2007,816,27.3,339,73,757,25,132,1577,362
2018,36061019000,"Census Tract 190, New York County, New York",1792,237,1555,978,2162,40549,1978,2010,973,25.5,408,96,726,28,144,1555,296
2019,36061019000,"Census Tract 190, New York County, New York",1852,182,1670,1037,2181,33750,1977,2011,1086,28.1,387,91,728,37,231,1670,377
2020,36061019000,"Census Tract 190, New York County, New York",1834,146,1688,1024,2134,46667,1979,2012,1135,26,434,94,664,37,216,1688,335
2012,36061019100,"Census Tract 191, New York County, New York",4878,496,4382,3155,6015,74247,1939,2001,1698,26.6,2418,2172,406,231,299,4382,542
2013,36061019100,"Census Tract 191, New York County, New York",4897,345,4552,3219,6212,71599,1939,2000,1685,26.5,2334,2115,397,257,401,4552,403
2014,36061019100,"Census Tract 191, New York County, New York",4922,386,4536,3136,5858,72988,1939,2001,1731,27.8,2351,2042,350,244,410,4536,387
2015,36061019100,"Census Tract 191, New York County, New York",4899,247,4652,3115,5868,72569,1939,2003,1725,27.9,2164,2086,322,234,344,4652,509
2016,36061019100,"Census Tract 191, New York County, New York",4947,283,4664,2981,5477,72584,1939,2003,1668,28.6,2037,1883,298,336,353,4664,483
2017,36061019100,"Census Tract 191, New York County, New York",4991,191,4800,2891,5372,66450,1939,2004,1618,29.6,1805,1776,279,412,473,4800,504
2018,36061019100,"Census Tract 191, New York County, New York",4919,340,4579,2701,5379,69450,0,2009,1813,28.5,1660,1699,462,166,464,4579,625
2019,36061019100,"Census Tract 191, New York County, New York",4825,380,4445,2662,6012,83229,0,2011,1993,24.7,1628,1682,426,184,526,4445,498
2020,36061019100,"Census Tract 191, New York County, New York",4925,467,4458,2502,5349,104276,0,2012,2188,27.5,1597,1569,385,173,522,4458,391
2012,36061019200,"Census Tract 192, New York County, New York",1340,33,1307,1307,3947,17768,1955,1999,443,29.7,157,30,437,60,829,1307,683
2013,36061019200,"Census Tract 192, New York County, New York",1322,31,1291,1282,3875,16348,1955,1999,437,30.1,178,17,528,37,755,1291,708
2014,36061019200,"Census Tract 192, New York County, New York",1365,35,1330,1320,3988,16748,1955,2000,438,29.2,234,20,635,34,691,1330,770
2015,36061019200,"Census Tract 192, New York County, New York",1378,52,1326,1313,4003,16093,1955,2001,421,30.5,228,23,635,34,702,1326,742
2016,36061019200,"Census Tract 192, New York County, New York",1399,62,1337,1327,3949,16208,1956,2003,419,31.8,224,19,612,54,719,1337,730
2017,36061019200,"Census Tract 192, New York County, New York",1427,53,1374,1354,3897,17154,1956,2001,473,31.1,221,36,638,46,709,1374,694
2018,36061019200,"Census Tract 192, New York County, New York",1442,64,1378,1372,3988,19846,1956,2005,446,28.6,200,50,641,76,626,1378,612
2019,36061019200,"Census Tract 192, New York County, New York",1433,46,1387,1369,3730,19395,1957,2003,480,30.1,176,57,660,56,640,1387,582
2020,36061019200,"Census Tract 192, New York County, New York",1566,53,1513,1497,3962,16452,1959,2003,454,29.2,140,75,751,38,688,1513,762
2012,36061019300,"Census Tract 193, New York County, New York",4234,332,3902,3184,7453,33851,1939,2001,1113,31.9,1336,1177,785,231,1385,3902,1121
2013,36061019300,"Census Tract 193, New York County, New York",4229,285,3944,3269,8259,32470,1939,2002,1111,33.1,1389,1135,688,237,1501,3944,1185
2014,36061019300,"Census Tract 193, New York County, New York",4240,343,3897,3203,7533,29427,1939,2004,1144,33.5,1411,1158,772,157,1384,3897,1230
2015,36061019300,"Census Tract 193, New York County, New York",4235,368,3867,3313,7844,30596,1939,2006,1149,32.6,1568,1050,802,205,1482,3867,1287
2016,36061019300,"Census Tract 193, New York County, New York",4259,433,3826,3243,7522,32252,1939,2008,1351,32.6,1602,1144,583,292,1256,3826,1225
2017,36061019300,"Census Tract 193, New York County, New York",4435,512,3923,3221,7330,34654,1951,2006,1247,32.5,1469,989,695,243,1277,3923,1212
2018,36061019300,"Census Tract 193, New York County, New York",4379,410,3969,3318,7933,31938,1947,2008,1260,32.6,1402,876,819,336,1302,3969,1018
2019,36061019300,"Census Tract 193, New York County, New York",4406,416,3990,3361,8673,45840,1943,2009,1521,28.7,1542,1052,583,324,1423,3990,956
2020,36061019300,"Census Tract 193, New York County, New York",4282,365,3917,3253,8179,46231,1950,2011,1401,29.2,1654,909,584,361,1317,3917,959
2012,36061019400,"Census Tract 194, New York County, New York",2483,263,2220,2142,5572,16853,1961,1998,569,28.3,249,106,620,142,1336,2220,985
2013,36061019400,"Census Tract 194, New York County, New York",2557,331,2226,2138,5591,14695,1966,1997,509,28.9,203,112,966,79,1104,2226,1125
2014,36061019400,"Census Tract 194, New York County, New York",2672,316,2356,2230,6177,19692,1958,1999,605,30.1,200,115,967,79,1161,2356,1160
2015,36061019400,"Census Tract 194, New York County, New York",2737,251,2486,2381,6452,22334,1957,2001,620,29.3,208,133,956,74,1311,2486,1204
2016,36061019400,"Census Tract 194, New York County, New York",2781,239,2542,2422,6215,19988,1958,2003,627,29.5,335,142,968,66,1276,2542,1155
2017,36061019400,"Census Tract 194, New York County, New York",2864,192,2672,2525,6131,18999,1959,2004,561,29.8,321,199,910,55,1409,2672,1194
2018,36061019400,"Census Tract 194, New York County, New York",2868,266,2602,2513,6058,20420,1959,2005,610,29.8,390,145,868,28,1523,2602,1080
2019,36061019400,"Census Tract 194, New York County, New York",2880,272,2608,2526,5752,19455,1969,2007,539,29,463,173,835,20,1622,2608,1144
2020,36061019400,"Census Tract 194, New York County, New York",2871,226,2645,2478,5383,18134,1971,2007,656,31.3,434,129,903,15,1536,2645,1122
2012,36061019500,"Census Tract 195, New York County, New York",3757,325,3432,2502,5511,64268,1939,2000,1785,27.6,1788,1528,193,299,562,3432,549
2013,36061019500,"Census Tract 195, New York County, New York",3740,383,3357,2513,5540,65208,1939,2002,1847,26.4,1794,1527,149,358,560,3357,496
2014,36061019500,"Census Tract 195, New York County, New York",3832,429,3403,2568,6056,76121,1939,2004,2000,26.2,1847,1487,165,422,591,3403,425
2015,36061019500,"Census Tract 195, New York County, New York",3783,451,3332,2404,5483,85921,1939,2006,2045,27.5,1774,1539,118,349,464,3332,478
2016,36061019500,"Census Tract 195, New York County, New York",3833,568,3265,2276,5160,90574,1939,2007,2144,28.1,1673,1552,64,274,399,3265,463
2017,36061019500,"Census Tract 195, New York County, New York",3779,555,3224,2169,4833,78463,1939,2007,1874,27.7,1533,1339,115,314,435,3224,432
2018,36061019500,"Census Tract 195, New York County, New York",3715,486,3229,2131,4724,74548,0,2005,1882,29.5,1390,1249,114,332,482,3229,460
2019,36061019500,"Census Tract 195, New York County, New York",3757,416,3341,2234,4706,67265,0,2003,1455,29.5,1364,1184,154,345,601,3341,562
2020,36061019500,"Census Tract 195, New York County, New York",3752,498,3254,2140,4818,68879,0,1999,1476,32.6,1306,1071,303,304,589,3254,496
2012,36061019600,"Census Tract 196, New York County, New York",1537,133,1404,1385,3849,18183,1974,2002,509,30.7,158,41,451,48,873,1404,567
2013,36061019600,"Census Tract 196, New York County, New York",1573,140,1433,1425,3962,16843,1975,2002,524,30.6,140,35,453,73,912,1433,588
2014,36061019600,"Census Tract 196, New York County, New York",1655,109,1546,1521,3740,16813,1977,2004,581,31.5,200,81,500,118,898,1546,640
2015,36061019600,"Census Tract 196, New York County, New York",1675,99,1576,1557,3808,18614,1977,2005,572,31.2,247,111,583,104,783,1576,682
2016,36061019600,"Census Tract 196, New York County, New York",1722,99,1623,1602,3774,20278,1977,2006,575,29.6,273,131,617,101,820,1623,738
2017,36061019600,"Census Tract 196, New York County, New York",1718,83,1635,1615,3579,16660,1976,2006,518,30.4,271,149,629,88,811,1635,822
2018,36061019600,"Census Tract 196, New York County, New York",1711,82,1629,1613,3406,15948,1977,2008,624,32,314,154,628,100,780,1629,884
2019,36061019600,"Census Tract 196, New York County, New York",1732,63,1669,1669,3896,17455,1975,2009,626,29.8,350,151,695,53,833,1669,790
2020,36061019600,"Census Tract 196, New York County, New York",1802,50,1752,1752,3889,18066,1974,2011,737,28,381,200,706,41,809,1752,757
2012,36061019701,"Census Tract 197.01, New York County, New York",400,48,352,352,677,71250,2003,2007,2001,27.8,266,218,30,66,29,352,131
2013,36061019701,"Census Tract 197.01, New York County, New York",497,55,442,442,928,84500,2004,2008,2001,28.8,365,265,30,95,44,442,149
2014,36061019701,"Census Tract 197.01, New York County, New York",499,54,445,445,855,72708,2004,2011,2001,29.8,338,245,30,101,69,445,155
2015,36061019701,"Census Tract 197.01, New York County, New York",437,5,432,432,888,72000,2004,2011,3402,30,321,223,32,118,47,432,131
2016,36061019701,"Census Tract 197.01, New York County, New York",376,15,361,361,704,68092,2005,2012,3501,40.1,269,160,14,124,52,361,113
2017,36061019701,"Census Tract 197.01, New York County, New York",409,95,314,314,553,69375,2005,2014,3501,39.6,222,143,6,104,50,314,79
2018,36061019701,"Census Tract 197.01, New York County, New York",456,127,329,329,480,63173,2006,2015,3464,31.9,210,154,25,91,51,329,58
2019,36061019701,"Census Tract 197.01, New York County, New York",519,154,365,365,613,52656,2005,2016,3042,32.5,265,148,46,109,52,365,78
2020,36061019701,"Census Tract 197.01, New York County, New York",538,166,372,372,635,31111,2008,2016,2200,33.9,275,150,58,119,51,372,121
2012,36061019702,"Census Tract 197.02, New York County, New York",1177,196,981,766,1570,54412,1968,2001,1086,26.1,338,243,329,13,227,981,170
2013,36061019702,"Census Tract 197.02, New York County, New York",1209,189,1020,753,1595,43417,1956,2000,1051,28.6,284,238,379,13,198,1020,198
2014,36061019702,"Census Tract 197.02, New York County, New York",1172,179,993,758,1697,42955,1957,2003,1190,28.8,320,311,316,27,170,993,231
2015,36061019702,"Census Tract 197.02, New York County, New York",1191,230,961,758,1690,46250,1956,2005,1211,28.4,351,271,327,56,141,961,263
2016,36061019702,"Census Tract 197.02, New York County, New York",1197,196,1001,771,1755,50531,1956,2007,1228,29.8,373,254,354,87,115,1001,262
2017,36061019702,"Census Tract 197.02, New York County, New York",1239,144,1095,808,1768,52262,1955,2010,1605,29.9,406,233,347,119,87,1095,287
2018,36061019702,"Census Tract 197.02, New York County, New York",1265,146,1119,873,1968,54297,1950,2011,1973,28.4,433,236,357,110,127,1119,378
2019,36061019702,"Census Tract 197.02, New York County, New York",1304,179,1125,850,1822,54389,1944,2014,1921,30.3,406,217,301,89,187,1125,356
2020,36061019702,"Census Tract 197.02, New York County, New York",1230,125,1105,814,2040,85658,0,2015,2033,30.6,378,248,320,52,163,1105,226
2012,36061019800,"Census Tract 198, New York County, New York",1141,148,993,575,995,59716,1951,2004,1128,28.6,379,202,284,25,75,993,87
2013,36061019800,"Census Tract 198, New York County, New York",1179,93,1086,743,1113,51979,1948,2004,1128,30.3,433,211,417,25,82,1086,85
2014,36061019800,"Census Tract 198, New York County, New York",1262,98,1164,836,1530,59500,1956,2006,1186,28.5,496,206,527,26,69,1164,91
2015,36061019800,"Census Tract 198, New York County, New York",1274,99,1175,768,1544,45833,1962,2008,1226,32,422,153,484,24,99,1175,128
2016,36061019800,"Census Tract 198, New York County, New York",1304,71,1233,791,1681,70233,1949,2010,1304,23.2,444,129,435,62,143,1233,142
2017,36061019800,"Census Tract 198, New York County, New York",1308,21,1287,838,1819,60288,1948,2010,1359,24.4,427,142,451,51,170,1287,147
2018,36061019800,"Census Tract 198, New York County, New York",1327,45,1282,787,1734,60335,1941,2009,1629,27.1,402,152,408,36,148,1282,181
2019,36061019800,"Census Tract 198, New York County, New York",1244,66,1178,675,1496,60552,1943,2010,1690,25.5,339,168,278,26,146,1178,175
2020,36061019800,"Census Tract 198, New York County, New York",1024,105,919,506,1100,63409,0,2008,1506,18.9,201,81,289,0,119,919,90
2012,36061019900,"Census Tract 199, New York County, New York",3672,317,3355,2665,5395,32293,1939,2004,1578,36.5,1898,1521,163,571,337,3355,905
2013,36061019900,"Census Tract 199, New York County, New York",3705,306,3399,2577,5392,32319,1939,2006,1642,35.7,1884,1449,178,474,390,3399,844
2014,36061019900,"Census Tract 199, New York County, New York",3727,383,3344,2505,5175,33084,1939,2009,1605,35.2,1824,1463,128,429,397,3344,822
2015,36061019900,"Census Tract 199, New York County, New York",3804,474,3330,2477,5046,55848,1939,2011,1705,34.6,1897,1409,125,395,429,3330,622
2016,36061019900,"Census Tract 199, New York County, New York",3862,657,3205,2337,4819,64491,1939,2011,1711,32.8,1697,1304,91,342,468,3205,600
2017,36061019900,"Census Tract 199, New York County, New York",3877,735,3142,2212,4611,61930,1939,2012,1774,33.6,1634,1223,65,377,481,3142,572
2018,36061019900,"Census Tract 199, New York County, New York",3724,651,3073,2171,4485,61424,0,2013,1821,37.6,1609,1128,126,397,407,3073,544
2019,36061019900,"Census Tract 199, New York County, New York",3643,627,3016,2075,4406,70513,0,2015,1983,37.3,1581,1097,131,411,353,3016,458
2020,36061019900,"Census Tract 199, New York County, New York",3779,826,2953,1901,3762,46989,0,2016,1790,36,1482,976,109,462,296,2953,490
2012,36061020000,"Census Tract 200, New York County, New York",1730,353,1377,1012,1877,52931,1939,2004,989,26.2,444,161,687,41,123,1377,202
2013,36061020000,"Census Tract 200, New York County, New York",1636,308,1328,956,1800,56210,1939,2005,1078,24.6,467,194,606,41,111,1328,201
2014,36061020000,"Census Tract 200, New York County, New York",1571,283,1288,912,1891,57823,1939,2006,1111,26.8,467,229,544,26,117,1288,191
2015,36061020000,"Census Tract 200, New York County, New York",1571,231,1340,996,2179,55329,1939,2006,1130,25.5,521,301,565,6,110,1340,207
2016,36061020000,"Census Tract 200, New York County, New York",1557,260,1297,906,2144,53684,1939,2008,1364,27.7,522,338,461,0,95,1297,166
2017,36061020000,"Census Tract 200, New York County, New York",1604,319,1285,937,2174,52313,1939,2007,1268,29.4,433,247,519,0,162,1285,204
2018,36061020000,"Census Tract 200, New York County, New York",1622,303,1319,1025,2536,57737,0,2007,1254,28,407,247,547,2,196,1319,194
2019,36061020000,"Census Tract 200, New York County, New York",1662,306,1356,1105,2618,60505,0,2007,1332,24.3,492,248,596,41,169,1356,162
2020,36061020000,"Census Tract 200, New York County, New York",1841,347,1494,1185,2308,47531,0,2008,1149,28.7,445,179,759,40,120,1494,194
2012,36061020101,"Census Tract 201.01, New York County, New York",332,12,320,268,655,72321,1939,2005,1652,23,203,173,30,49,16,320,56
2013,36061020101,"Census Tract 201.01, New York County, New York",323,14,309,250,589,71538,1939,2006,1733,25.5,210,194,22,22,12,309,47
2014,36061020101,"Census Tract 201.01, New York County, New York",310,13,297,237,535,81641,1939,2005,1872,24,212,192,7,21,13,297,49
2015,36061020101,"Census Tract 201.01, New York County, New York",300,14,286,230,511,80625,1939,2007,1879,24.6,210,173,4,32,13,286,45
2016,36061020101,"Census Tract 201.01, New York County, New York",289,14,275,215,488,74271,1939,2010,1869,25.8,202,161,9,25,13,275,49
2017,36061020101,"Census Tract 201.01, New York County, New York",288,19,269,211,455,86563,1939,2011,2163,24.4,197,162,5,26,10,269,51
2018,36061020101,"Census Tract 201.01, New York County, New York",290,19,271,196,429,101250,0,2012,2325,22,183,146,4,27,11,271,44
2019,36061020101,"Census Tract 201.01, New York County, New York",302,18,284,203,486,86875,0,2014,2332,23.1,199,137,6,36,18,284,39
2020,36061020101,"Census Tract 201.01, New York County, New York",262,25,237,180,485,130625,0,2015,2338,22.1,169,126,6,24,24,237,35
2012,36061020102,"Census Tract 201.02, New York County, New York",1892,144,1748,1571,3754,41449,1939,2003,934,28.7,646,362,937,27,309,1748,330
2013,36061020102,"Census Tract 201.02, New York County, New York",1883,144,1739,1501,3582,41775,1939,2004,1081,29,693,349,851,41,301,1739,325
2014,36061020102,"Census Tract 201.02, New York County, New York",1888,111,1777,1579,3622,53650,1939,2004,1017,27.5,793,307,956,32,332,1777,328
2015,36061020102,"Census Tract 201.02, New York County, New York",1918,119,1799,1559,3614,44744,1946,2006,1016,29,770,291,919,50,346,1799,359
2016,36061020102,"Census Tract 201.02, New York County, New York",1923,131,1792,1510,3649,52407,1948,2007,1213,30.5,717,341,837,64,303,1792,355
2017,36061020102,"Census Tract 201.02, New York County, New York",1921,104,1817,1499,3637,55474,1945,2007,1308,29.7,755,366,827,35,303,1817,355
2018,36061020102,"Census Tract 201.02, New York County, New York",1919,145,1774,1402,3539,60217,1943,2009,1357,28.6,645,330,742,52,298,1774,358
2019,36061020102,"Census Tract 201.02, New York County, New York",1880,202,1678,1327,3305,62773,0,2010,1493,28.3,576,346,659,72,262,1678,348
2020,36061020102,"Census Tract 201.02, New York County, New York",1795,221,1574,1249,3330,75078,0,2011,1567,21.8,580,286,633,86,239,1574,278
2012,36061020300,"Census Tract 203, New York County, New York",572,28,544,530,999,25313,1939,2005,1471,50,426,266,101,66,75,544,142
2013,36061020300,"Census Tract 203, New York County, New York",564,47,517,492,998,25714,1939,2009,1517,47.4,455,241,96,86,44,517,176
2014,36061020300,"Census Tract 203, New York County, New York",537,54,483,454,946,30833,1939,2011,1516,48.7,414,181,104,80,53,483,147
2015,36061020300,"Census Tract 203, New York County, New York",463,75,388,366,782,33571,1939,2012,1446,46.3,327,171,70,45,41,388,123
2016,36061020300,"Census Tract 203, New York County, New York",449,85,364,348,750,36250,1939,2012,1467,39,307,155,40,49,59,364,129
2017,36061020300,"Census Tract 203, New York County, New York",438,80,358,333,771,34306,1939,2013,1612,39.3,289,117,41,59,81,358,129
2018,36061020300,"Census Tract 203, New York County, New York",421,77,344,314,754,32917,0,2015,1678,39.6,255,120,26,64,91,344,119
2019,36061020300,"Census Tract 203, New York County, New York",401,58,343,320,791,46111,0,NA,1788,33.6,252,119,12,94,85,343,103
2020,36061020300,"Census Tract 203, New York County, New York",494,41,453,404,859,55781,0,2016,2062,42.2,345,200,9,121,74,453,106
2012,36061020500,"Census Tract 205, New York County, New York",1342,121,1221,1072,2084,95694,1939,2001,1856,21.8,976,790,44,139,85,1221,36
2013,36061020500,"Census Tract 205, New York County, New York",1296,93,1203,1004,2023,106346,1939,2001,1898,22.1,933,793,26,122,49,1203,43
2014,36061020500,"Census Tract 205, New York County, New York",1307,89,1218,955,2008,99856,1939,2001,1872,22.1,891,786,21,109,32,1218,26
2015,36061020500,"Census Tract 205, New York County, New York",1259,107,1152,896,1879,93250,1939,2002,1895,23.9,862,714,20,111,35,1152,18
2016,36061020500,"Census Tract 205, New York County, New York",1265,77,1188,928,1987,96875,1939,2005,1968,22.6,868,734,28,76,70,1188,31
2017,36061020500,"Census Tract 205, New York County, New York",1259,112,1147,896,1818,94306,1939,1998,1981,21.7,831,693,18,85,82,1147,29
2018,36061020500,"Census Tract 205, New York County, New York",1247,122,1125,917,1846,106125,0,2004,2020,21.4,852,690,16,65,113,1125,49
2019,36061020500,"Census Tract 205, New York County, New York",1304,85,1219,1017,2089,110188,0,2007,2232,22.8,944,750,18,87,127,1219,61
2020,36061020500,"Census Tract 205, New York County, New York",1284,85,1199,1001,2213,133199,0,2009,2549,20.7,920,798,9,55,125,1199,70
2012,36061020600,"Census Tract 206, New York County, New York",1461,259,1202,977,2029,28787,1939,2004,819,30.5,210,169,690,5,100,1202,341
2013,36061020600,"Census Tract 206, New York County, New York",1520,307,1213,1036,2011,28704,1939,2004,881,34.6,261,139,740,11,170,1213,303
2014,36061020600,"Census Tract 206, New York County, New York",1656,327,1329,1135,2310,31042,1939,2004,894,29.1,282,144,824,14,162,1329,295
2015,36061020600,"Census Tract 206, New York County, New York",1684,320,1364,1174,2281,33372,1939,2007,986,28.8,392,168,817,27,187,1364,314
2016,36061020600,"Census Tract 206, New York County, New York",1728,309,1419,1244,2477,30606,1941,2010,1002,28.8,451,140,843,25,298,1419,331
2017,36061020600,"Census Tract 206, New York County, New York",1760,221,1539,1338,2633,32316,1963,2011,1005,29.1,423,116,941,25,279,1539,348
2018,36061020600,"Census Tract 206, New York County, New York",1814,240,1574,1377,2872,31991,1967,2012,1066,29.8,414,153,933,41,258,1574,407
2019,36061020600,"Census Tract 206, New York County, New York",1815,255,1560,1378,2753,29536,1967,2013,1161,37.3,439,119,926,33,325,1560,445
2020,36061020600,"Census Tract 206, New York County, New York",1839,272,1567,1401,2780,40018,1964,2014,1191,35,475,193,897,29,324,1567,393
2012,36061020701,"Census Tract 207.01, New York County, New York",1440,45,1395,1364,2704,46371,1939,2005,1523,33.8,1288,822,56,340,47,1395,425
2013,36061020701,"Census Tract 207.01, New York County, New York",1414,54,1360,1325,2597,48125,1939,2005,1614,33.1,1261,794,26,372,61,1360,410
2014,36061020701,"Census Tract 207.01, New York County, New York",1374,53,1321,1293,2579,53324,1939,2006,1676,31.5,1177,747,30,341,97,1321,360
2015,36061020701,"Census Tract 207.01, New York County, New York",1366,54,1312,1264,2631,59706,1939,2010,1713,30.3,1140,698,75,321,131,1312,307
2016,36061020701,"Census Tract 207.01, New York County, New York",1386,88,1298,1246,2603,67143,1939,2010,1807,28.8,1096,704,64,304,127,1298,236
2017,36061020701,"Census Tract 207.01, New York County, New York",1367,117,1250,1215,2460,62037,1939,2011,1805,31.2,1024,632,101,323,148,1250,298
2018,36061020701,"Census Tract 207.01, New York County, New York",1359,170,1189,1152,2333,58667,0,2012,1853,34.5,946,560,140,251,196,1189,389
2019,36061020701,"Census Tract 207.01, New York County, New York",1364,173,1191,1152,2322,56250,0,2014,1932,35.4,952,574,133,243,204,1191,368
2020,36061020701,"Census Tract 207.01, New York County, New York",1427,284,1143,1118,2142,62083,0,NA,1945,35.7,906,547,79,247,177,1143,309
2012,36061020800,"Census Tract 208, New York County, New York",2617,523,2094,1828,4282,30988,1942,2004,796,34.8,630,285,1205,154,155,2094,582
2013,36061020800,"Census Tract 208, New York County, New York",2602,549,2053,1688,4096,28397,1943,2004,882,35.4,543,212,1114,187,145,2053,558
2014,36061020800,"Census Tract 208, New York County, New York",2608,480,2128,1718,4371,32096,1940,2006,996,33,545,295,1079,166,165,2128,446
2015,36061020800,"Census Tract 208, New York County, New York",2539,462,2077,1618,4113,33873,1939,2007,1008,28.4,562,310,1095,103,101,2077,374
2016,36061020800,"Census Tract 208, New York County, New York",2522,444,2078,1670,4356,47100,1941,2008,1094,27.5,709,346,1119,92,144,2078,293
2017,36061020800,"Census Tract 208, New York County, New York",2655,457,2198,1711,4132,51474,1939,2009,1221,27.1,758,311,1147,72,230,2198,340
2018,36061020800,"Census Tract 208, New York County, New York",2707,436,2271,1811,4391,72383,0,2011,1245,23.9,847,264,1289,31,250,2271,330
2019,36061020800,"Census Tract 208, New York County, New York",2718,457,2261,1779,4227,75299,0,2011,1582,23.3,1024,280,1186,32,235,2261,438
2020,36061020800,"Census Tract 208, New York County, New York",2643,380,2263,1884,4616,77130,0,2012,1668,23.8,1120,362,1152,33,358,2263,436
2012,36061020901,"Census Tract 209.01, New York County, New York",1567,172,1395,1364,3960,23568,1955,1998,510,25.8,236,104,791,8,488,1395,481
2013,36061020901,"Census Tract 209.01, New York County, New York",1558,120,1438,1396,3957,23581,1957,1999,504,24.6,271,63,844,13,491,1438,475
2014,36061020901,"Census Tract 209.01, New York County, New York",1589,111,1478,1430,3862,27609,1956,1999,655,25.5,277,97,824,19,486,1478,489
2015,36061020901,"Census Tract 209.01, New York County, New York",1593,48,1545,1498,3941,NA,1958,2000,734,25,265,80,822,59,515,1545,511
2016,36061020901,"Census Tract 209.01, New York County, New York",1596,97,1499,1455,3510,21827,1957,2002,805,29.5,251,82,647,70,658,1499,530
2017,36061020901,"Census Tract 209.01, New York County, New York",1652,87,1565,1491,3601,22171,1958,2003,813,27.9,268,86,687,55,681,1565,539
2018,36061020901,"Census Tract 209.01, New York County, New York",1649,119,1530,1461,3368,29196,1955,2004,881,30.1,264,75,747,74,611,1530,509
2019,36061020901,"Census Tract 209.01, New York County, New York",1636,164,1472,1392,3361,26250,1955,2005,912,33.3,263,49,659,62,670,1472,495
2020,36061020901,"Census Tract 209.01, New York County, New York",1506,138,1368,1291,3353,24637,1954,2008,853,29.6,231,57,631,32,653,1368,491
2012,36061021000,"Census Tract 210, New York County, New York",3189,200,2989,2634,6543,31648,1953,1994,793,25.7,872,173,2110,47,401,2989,627
2013,36061021000,"Census Tract 210, New York County, New York",3163,232,2931,2546,6698,28611,1952,1996,713,26.8,838,170,2007,35,417,2931,772
2014,36061021000,"Census Tract 210, New York County, New York",3228,140,3088,2687,6316,26399,1951,1995,796,28.7,757,186,2137,50,418,3088,890
2015,36061021000,"Census Tract 210, New York County, New York",3204,137,3067,2780,6460,26274,1949,1998,831,28.2,821,142,2144,55,460,3067,920
2016,36061021000,"Census Tract 210, New York County, New York",3251,188,3063,2795,6699,27541,1948,1999,928,28.4,753,150,2099,88,485,3063,979
2017,36061021000,"Census Tract 210, New York County, New York",3308,192,3116,2800,7017,25592,1948,2002,911,28.5,771,77,2198,44,534,3116,1093
2018,36061021000,"Census Tract 210, New York County, New York",3327,166,3161,2951,7225,30777,1949,2003,1002,27.9,732,44,2311,68,487,3161,991
2019,36061021000,"Census Tract 210, New York County, New York",3313,238,3075,2826,7056,31568,1952,2003,970,28,742,13,2114,80,558,3075,931
2020,36061021000,"Census Tract 210, New York County, New York",3625,207,3418,3125,6352,30779,1954,2007,980,31.6,963,80,2183,206,717,3418,1185
2012,36061021100,"Census Tract 211, New York County, New York",4592,342,4250,3226,6804,34144,1951,2001,1072,27,1428,919,925,436,916,4250,859
2013,36061021100,"Census Tract 211, New York County, New York",4609,353,4256,3281,7387,45817,1951,2002,1194,26.2,1597,1031,855,509,878,4256,816
2014,36061021100,"Census Tract 211, New York County, New York",4583,596,3987,3001,6816,35880,1950,2004,1099,25.6,1469,831,717,503,869,3987,933
2015,36061021100,"Census Tract 211, New York County, New York",4586,474,4112,3007,7072,33969,1949,2008,1223,27.2,1646,902,635,676,707,4112,1165
2016,36061021100,"Census Tract 211, New York County, New York",4616,578,4038,2960,6751,29115,1950,2005,1119,26.8,1553,826,671,512,857,4038,1214
2017,36061021100,"Census Tract 211, New York County, New York",4637,516,4121,2878,6483,35737,1950,2010,1187,30.5,1899,1062,702,503,540,4121,1004
2018,36061021100,"Census Tract 211, New York County, New York",4568,441,4127,3042,7048,34231,1943,2008,1245,34.4,1960,905,536,551,848,4127,1111
2019,36061021100,"Census Tract 211, New York County, New York",4656,278,4378,3246,7771,40813,1942,2010,1289,36.1,2041,1133,542,537,853,4378,957
2020,36061021100,"Census Tract 211, New York County, New York",4842,400,4442,3417,7826,42173,1947,2010,1286,32,2124,1176,748,429,955,4442,798
2012,36061021200,"Census Tract 212, New York County, New York",2716,420,2296,2196,3400,50052,1958,2002,1083,28.5,920,160,1712,92,218,2296,216
2013,36061021200,"Census Tract 212, New York County, New York",2704,348,2356,2300,3645,51138,1959,2004,1216,30.8,1014,136,1777,123,312,2356,198
2014,36061021200,"Census Tract 212, New York County, New York",2787,247,2540,2475,3848,51559,1960,2005,1311,31.2,1044,151,1901,74,425,2540,218
2015,36061021200,"Census Tract 212, New York County, New York",2773,281,2492,2459,4143,52162,1959,2007,1456,33,1246,201,1880,89,444,2492,295
2016,36061021200,"Census Tract 212, New York County, New York",2795,268,2527,2483,4261,53199,1959,2006,1503,32.1,1297,191,1911,71,384,2527,294
2017,36061021200,"Census Tract 212, New York County, New York",2840,215,2625,2577,4310,53027,1960,2007,1460,33.2,1347,274,1839,83,410,2625,329
2018,36061021200,"Census Tract 212, New York County, New York",2867,319,2548,2470,3952,58399,1961,2007,1414,28.5,1358,231,1784,67,390,2548,308
2019,36061021200,"Census Tract 212, New York County, New York",2867,458,2409,2310,3743,50985,1962,2008,1463,30.5,1276,240,1617,86,360,2409,377
2020,36061021200,"Census Tract 212, New York County, New York",2764,413,2351,2266,3808,66767,1963,2007,1696,24.3,1268,233,1591,67,317,2351,317
2012,36061021303,"Census Tract 213.03, New York County, New York",2447,230,2217,2117,5211,35347,1939,2000,1044,36.9,584,302,1190,70,543,2217,505
2013,36061021303,"Census Tract 213.03, New York County, New York",2428,248,2180,2084,5250,33594,1939,2001,1011,33.4,653,294,1137,73,579,2180,624
2014,36061021303,"Census Tract 213.03, New York County, New York",2418,245,2173,2102,5164,35833,1939,2002,1148,33.9,701,328,1093,28,658,2173,563
2015,36061021303,"Census Tract 213.03, New York County, New York",2443,255,2188,2099,5608,NA,1940,2002,1161,36.9,725,271,1283,40,533,2188,661
2016,36061021303,"Census Tract 213.03, New York County, New York",2452,308,2144,2079,5420,35787,1939,2005,1234,38.5,842,356,1059,43,656,2144,628
2017,36061021303,"Census Tract 213.03, New York County, New York",2492,313,2179,2117,5472,43170,1939,2005,1236,30.9,998,472,973,59,625,2179,496
2018,36061021303,"Census Tract 213.03, New York County, New York",2573,239,2334,2261,5614,45688,0,2008,1292,32.8,1084,466,1147,63,560,2334,413
2019,36061021303,"Census Tract 213.03, New York County, New York",2550,221,2329,2240,5902,43733,0,2009,1338,35.1,1033,514,969,63,697,2329,504
2020,36061021303,"Census Tract 213.03, New York County, New York",2517,184,2333,2246,5905,55641,0,2010,1366,29.3,1018,607,995,87,568,2333,372
2012,36061021400,"Census Tract 214, New York County, New York",2010,164,1846,1825,2959,37214,1962,2001,1017,29.1,683,183,1546,20,38,1846,302
2013,36061021400,"Census Tract 214, New York County, New York",1985,176,1809,1790,2812,37879,1961,2001,1044,30.2,693,183,1505,24,47,1809,412
2014,36061021400,"Census Tract 214, New York County, New York",2007,148,1859,1835,2847,42981,1959,2003,1098,30.2,773,131,1478,46,132,1859,444
2015,36061021400,"Census Tract 214, New York County, New York",2026,134,1892,1871,2986,44504,1959,2003,1112,30.5,809,108,1530,30,128,1892,472
2016,36061021400,"Census Tract 214, New York County, New York",2048,156,1892,1860,3169,51314,1959,2005,1164,28.5,872,164,1399,72,175,1892,405
2017,36061021400,"Census Tract 214, New York County, New York",2092,162,1930,1896,3256,52935,1959,2006,1219,28.9,966,171,1398,88,181,1930,371
2018,36061021400,"Census Tract 214, New York County, New York",2104,127,1977,1943,3418,58616,1961,2009,1306,27.8,1002,152,1432,94,223,1977,260
2019,36061021400,"Census Tract 214, New York County, New York",2108,159,1949,1930,3251,60619,1962,2010,1390,28.9,1006,181,1458,79,183,1949,194
2020,36061021400,"Census Tract 214, New York County, New York",2233,185,2048,2048,3143,60335,1959,2011,1464,29.1,1128,183,1544,79,215,2048,205
2012,36061021500,"Census Tract 215, New York County, New York",1342,192,1150,1092,2717,25625,1973,1998,843,34,333,90,746,0,256,1150,300
2013,36061021500,"Census Tract 215, New York County, New York",1374,197,1177,1149,3158,31354,1972,2002,834,32.1,338,119,760,11,238,1177,361
2014,36061021500,"Census Tract 215, New York County, New York",1424,131,1293,1259,3465,32261,1972,2003,925,32.2,390,150,821,23,266,1293,404
2015,36061021500,"Census Tract 215, New York County, New York",1459,130,1329,1310,3688,32734,1974,2004,1065,32.7,408,161,877,26,223,1329,388
2016,36061021500,"Census Tract 215, New York County, New York",1558,93,1465,1443,4056,30927,1973,2007,1097,32.9,436,186,985,27,252,1465,495
2017,36061021500,"Census Tract 215, New York County, New York",1655,29,1626,1601,4449,32656,1974,2007,1104,31.8,412,215,1005,51,329,1626,495
2018,36061021500,"Census Tract 215, New York County, New York",1691,30,1661,1627,4383,41083,1976,2010,1297,32.7,508,196,1098,35,324,1661,487
2019,36061021500,"Census Tract 215, New York County, New York",1731,30,1701,1675,4325,51198,1976,2009,1338,30,578,166,1076,69,432,1701,383
2020,36061021500,"Census Tract 215, New York County, New York",1829,69,1760,1720,4187,46897,1976,2009,1250,30.1,570,155,1180,78,363,1760,364
2012,36061021600,"Census Tract 216, New York County, New York",3878,629,3249,2802,7306,37361,1939,2002,942,29.8,1083,558,1690,141,377,3249,771
2013,36061021600,"Census Tract 216, New York County, New York",3799,593,3206,2659,6987,40090,1939,2002,1019,31.5,1019,545,1647,102,365,3206,743
2014,36061021600,"Census Tract 216, New York County, New York",3819,528,3291,2785,7207,38997,1939,2003,1008,32.1,1042,618,1745,10,471,3291,745
2015,36061021600,"Census Tract 216, New York County, New York",3771,428,3343,2769,7030,40903,1939,2003,1080,29.9,1110,683,1591,111,410,3343,733
2016,36061021600,"Census Tract 216, New York County, New York",3841,418,3423,2802,6822,49733,1939,2004,1177,27.4,1256,727,1546,153,432,3423,679
2017,36061021600,"Census Tract 216, New York County, New York",3894,433,3461,2878,6906,49728,1939,2006,1269,28,1378,728,1439,161,566,3461,691
2018,36061021600,"Census Tract 216, New York County, New York",3917,374,3543,3104,7434,51379,0,2009,1358,27.3,1660,798,1558,188,561,3543,727
2019,36061021600,"Census Tract 216, New York County, New York",3857,386,3471,2916,7124,60238,0,2010,1482,25.9,1618,706,1387,234,560,3471,600
2020,36061021600,"Census Tract 216, New York County, New York",3849,400,3449,2993,7794,57382,0,2009,1405,26.2,1636,605,1560,211,517,3449,583
2012,36061021703,"Census Tract 217.03, New York County, New York",0,0,0,0,0,NA,NA,NA,NA,NA,0,0,0,0,0,0,0
2013,36061021703,"Census Tract 217.03, New York County, New York",0,0,0,0,0,NA,NA,NA,NA,NA,0,0,0,0,0,0,0
2014,36061021703,"Census Tract 217.03, New York County, New York",0,0,0,0,0,NA,NA,NA,NA,NA,0,0,0,0,0,0,0
2015,36061021703,"Census Tract 217.03, New York County, New York",4,0,4,0,0,NA,NA,NA,NA,NA,0,0,0,0,0,4,0
2016,36061021703,"Census Tract 217.03, New York County, New York",4,0,4,0,0,NA,NA,NA,NA,NA,0,0,0,0,0,4,0
2017,36061021703,"Census Tract 217.03, New York County, New York",4,0,4,0,0,NA,NA,NA,NA,NA,0,0,0,0,0,4,0
2018,36061021703,"Census Tract 217.03, New York County, New York",4,0,4,0,0,NA,NA,NA,NA,NA,0,0,0,0,0,4,0
2019,36061021703,"Census Tract 217.03, New York County, New York",6,0,6,0,0,NA,NA,NA,NA,NA,0,0,0,0,0,6,0
2020,36061021703,"Census Tract 217.03, New York County, New York",6,0,6,0,0,NA,NA,NA,NA,NA,0,0,0,0,0,6,0
2012,36061021800,"Census Tract 218, New York County, New York",2864,287,2577,2283,5921,39635,1939,2003,1084,30.2,920,558,1483,29,247,2577,720
2013,36061021800,"Census Tract 218, New York County, New York",2920,253,2667,2243,6089,40718,1939,2003,1089,31.1,831,611,1422,9,235,2667,736
2014,36061021800,"Census Tract 218, New York County, New York",2987,294,2693,2352,6618,41207,1939,2004,1071,28.9,883,487,1563,41,290,2693,830
2015,36061021800,"Census Tract 218, New York County, New York",3042,260,2782,2521,7003,45323,1939,2006,1102,28.4,1024,544,1637,65,335,2782,878
2016,36061021800,"Census Tract 218, New York County, New York",3125,249,2876,2574,6514,46940,1939,2007,1184,30.9,1073,527,1731,69,336,2876,955
2017,36061021800,"Census Tract 218, New York County, New York",3177,275,2902,2623,6723,42112,1943,2008,1154,30.5,1047,502,1818,58,308,2902,1011
2018,36061021800,"Census Tract 218, New York County, New York",3211,237,2974,2841,6566,49233,0,2009,1231,29.7,1268,476,1997,124,322,2974,882
2019,36061021800,"Census Tract 218, New York County, New York",3158,281,2877,2702,5800,47702,0,2010,1238,29.3,1167,529,1833,103,321,2877,871
2020,36061021800,"Census Tract 218, New York County, New York",3108,307,2801,2386,5153,46250,1942,2011,1335,31.7,961,443,1554,92,395,2801,680
2012,36061021900,"Census Tract 219, New York County, New York",2290,189,2101,2063,5792,15687,1955,1994,570,43.3,285,68,952,66,970,2101,1041
2013,36061021900,"Census Tract 219, New York County, New York",2241,237,2004,1974,5727,16575,1951,1995,543,40.3,170,43,756,57,1096,2004,959
2014,36061021900,"Census Tract 219, New York County, New York",2252,238,2014,1993,5876,16838,1953,1995,578,38.6,148,45,864,20,1077,2014,934
2015,36061021900,"Census Tract 219, New York County, New York",2195,176,2019,1968,6193,19505,1944,1996,541,33,211,77,963,12,1059,2019,931
2016,36061021900,"Census Tract 219, New York County, New York",2209,126,2083,2025,6122,21712,1939,1996,528,32.3,280,93,1002,11,1056,2083,883
2017,36061021900,"Census Tract 219, New York County, New York",2300,146,2154,2106,6236,19829,1951,2002,499,34.5,217,78,996,0,1176,2154,1061
2018,36061021900,"Census Tract 219, New York County, New York",2281,95,2186,2101,5872,17476,1944,2002,560,35.7,270,124,1091,19,1022,2186,1142
2019,36061021900,"Census Tract 219, New York County, New York",2276,83,2193,2110,5782,20848,1945,2003,498,31.7,317,117,1115,14,1024,2193,1078
2020,36061021900,"Census Tract 219, New York County, New York",2142,79,2063,2040,5953,23371,1949,2003,613,31.9,261,99,1003,14,1008,2063,953
2012,36061022000,"Census Tract 220, New York County, New York",2934,450,2484,2059,4483,27599,1939,2002,986,33.7,740,343,1420,35,299,2484,740
2013,36061022000,"Census Tract 220, New York County, New York",2897,360,2537,2084,4804,28093,1939,2002,950,33.8,567,252,1571,10,279,2537,800
2014,36061022000,"Census Tract 220, New York County, New York",2891,318,2573,2181,4472,34890,1939,2004,1005,30.5,790,335,1507,23,331,2573,637
2015,36061022000,"Census Tract 220, New York County, New York",2864,380,2484,2077,4345,38707,1939,2005,1075,28.9,755,350,1421,29,281,2484,626
2016,36061022000,"Census Tract 220, New York County, New York",2880,371,2509,2145,4997,42712,1939,2006,1051,27.4,770,417,1406,55,292,2509,596
2017,36061022000,"Census Tract 220, New York County, New York",2987,423,2564,2283,5627,55825,1939,2009,1148,24.5,985,491,1451,79,337,2564,583
2018,36061022000,"Census Tract 220, New York County, New York",2982,451,2531,2294,5467,59574,0,2011,1228,23.5,1182,607,1329,86,368,2531,484
2019,36061022000,"Census Tract 220, New York County, New York",2976,457,2519,2198,5190,59020,1950,2012,1254,25.3,1213,594,1161,90,427,2519,423
2020,36061022000,"Census Tract 220, New York County, New York",3141,426,2715,2358,5573,76389,0,2012,1525,23.4,1505,568,1093,92,505,2715,406
2012,36061022102,"Census Tract 221.02, New York County, New York",1342,114,1228,760,1208,29643,1939,2004,992,31.3,328,130,468,42,135,1228,252
2013,36061022102,"Census Tract 221.02, New York County, New York",1335,164,1171,697,1232,31141,1939,2004,1097,33.2,318,140,435,38,97,1171,158
2014,36061022102,"Census Tract 221.02, New York County, New York",1353,126,1227,792,1385,30625,1939,2003,1171,34.5,351,202,451,14,57,1227,189
2015,36061022102,"Census Tract 221.02, New York County, New York",1301,139,1162,791,1453,34365,1939,2004,1157,31.8,354,241,452,14,51,1162,143
2016,36061022102,"Census Tract 221.02, New York County, New York",1263,146,1117,847,1721,33989,1939,2006,1196,33.6,400,261,496,0,57,1117,154
2017,36061022102,"Census Tract 221.02, New York County, New York",1275,174,1101,661,1322,31464,1939,2007,1285,36.7,266,188,386,0,31,1101,147
2018,36061022102,"Census Tract 221.02, New York County, New York",1326,146,1180,762,1511,52581,0,2010,1450,31,361,181,390,15,38,1180,142
2019,36061022102,"Census Tract 221.02, New York County, New York",1309,143,1166,725,1465,81205,0,2011,1526,24.2,378,158,413,41,75,1166,96
2020,36061022102,"Census Tract 221.02, New York County, New York",1254,115,1139,669,1320,67083,0,2012,1389,26,319,137,350,45,107,1139,70
2012,36061022200,"Census Tract 222, New York County, New York",1529,345,1184,997,2277,27528,1951,2003,976,34.5,326,174,686,25,126,1184,406
2013,36061022200,"Census Tract 222, New York County, New York",1502,322,1180,972,2384,32031,1952,2005,1045,33,415,204,656,39,87,1180,360
2014,36061022200,"Census Tract 222, New York County, New York",1523,266,1257,980,2296,27734,1953,2006,1059,34,405,199,631,31,105,1257,428
2015,36061022200,"Census Tract 222, New York County, New York",1531,254,1277,959,2280,17750,1968,2010,898,35.8,370,194,602,40,99,1277,506
2016,36061022200,"Census Tract 222, New York County, New York",1532,224,1308,1016,2229,28462,1963,2011,1067,34.5,366,203,626,46,98,1308,466
2017,36061022200,"Census Tract 222, New York County, New York",1600,218,1382,1084,2452,37717,1966,2011,1250,30.9,482,251,608,73,97,1382,387
2018,36061022200,"Census Tract 222, New York County, New York",1657,202,1455,1176,2536,34429,1963,2011,1194,30,456,261,681,71,109,1455,419
2019,36061022200,"Census Tract 222, New York County, New York",1646,187,1459,1204,2548,35263,1964,2012,1165,28.6,500,276,685,76,135,1459,434
2020,36061022200,"Census Tract 222, New York County, New York",1593,135,1458,1176,2589,38958,1956,2012,1341,26.7,572,296,677,57,95,1458,330
2012,36061022301,"Census Tract 223.01, New York County, New York",2533,218,2315,2231,8131,29554,1939,2001,997,35.3,473,225,409,74,1702,2315,733
2013,36061022301,"Census Tract 223.01, New York County, New York",2509,187,2322,2217,7939,30191,1939,2000,1022,35.4,404,240,385,69,1684,2322,777
2014,36061022301,"Census Tract 223.01, New York County, New York",2509,143,2366,2228,7453,34447,1939,2001,944,34.2,395,238,430,52,1660,2366,822
2015,36061022301,"Census Tract 223.01, New York County, New York",2518,138,2380,2205,7408,35988,1939,2001,1045,33.9,415,285,440,19,1618,2380,753
2016,36061022301,"Census Tract 223.01, New York County, New York",2562,82,2480,2265,7347,35536,1939,2001,965,33,445,296,444,26,1660,2480,681
2017,36061022301,"Census Tract 223.01, New York County, New York",2615,70,2545,2272,7492,40968,1939,2000,1003,33.1,544,388,304,23,1639,2545,609
2018,36061022301,"Census Tract 223.01, New York County, New York",2550,102,2448,2140,6989,43969,0,2003,1146,31.9,651,412,223,63,1548,2448,481
2019,36061022301,"Census Tract 223.01, New York County, New York",2571,99,2472,2238,7606,51929,0,2007,1220,31,819,593,266,82,1479,2472,521
2020,36061022301,"Census Tract 223.01, New York County, New York",2714,53,2661,2441,7509,49904,0,2009,1324,31.5,764,601,387,78,1539,2661,553
2012,36061022302,"Census Tract 223.02, New York County, New York",1540,43,1497,1480,3463,20471,1972,2000,742,35,298,88,653,76,834,1497,625
2013,36061022302,"Census Tract 223.02, New York County, New York",1515,33,1482,1472,3389,22972,1972,2001,937,36.4,390,137,579,65,841,1482,603
2014,36061022302,"Census Tract 223.02, New York County, New York",1543,14,1529,1529,3425,25608,1973,2000,956,35.9,403,180,561,62,793,1529,543
2015,36061022302,"Census Tract 223.02, New York County, New York",1562,0,1562,1562,3432,24241,1973,2002,1081,41.8,470,195,559,82,787,1562,622
2016,36061022302,"Census Tract 223.02, New York County, New York",1548,18,1530,1530,3426,25309,1973,2002,1117,39,521,187,502,120,779,1530,609
2017,36061022302,"Census Tract 223.02, New York County, New York",1564,18,1546,1546,3405,26007,1973,2003,1209,39.8,463,166,498,147,804,1546,579
2018,36061022302,"Census Tract 223.02, New York County, New York",1545,19,1526,1495,3364,26642,1972,2004,1301,37.8,409,131,462,171,805,1526,609
2019,36061022302,"Census Tract 223.02, New York County, New York",1530,18,1512,1475,3126,22701,1972,2007,1491,39.1,431,136,417,193,846,1512,615
2020,36061022302,"Census Tract 223.02, New York County, New York",1495,103,1392,1355,3018,24684,1972,2007,1589,38.6,402,138,352,132,784,1392,511
2012,36061022400,"Census Tract 224, New York County, New York",2803,271,2532,2353,5886,18662,1955,2000,606,29.3,263,27,1640,61,589,2532,1060
2013,36061022400,"Census Tract 224, New York County, New York",2835,248,2587,2423,6278,22207,1955,2001,632,28.4,392,80,1566,71,670,2587,933
2014,36061022400,"Census Tract 224, New York County, New York",2930,266,2664,2536,6856,21312,1955,2002,634,29.3,397,89,1822,44,592,2664,1025
2015,36061022400,"Census Tract 224, New York County, New York",2988,246,2742,2620,7486,NA,1955,2003,701,30.5,446,174,1741,44,666,2742,1005
2016,36061022400,"Census Tract 224, New York County, New York",2972,266,2706,2662,7455,30051,1952,2005,809,30.1,649,348,1632,33,618,2706,1067
2017,36061022400,"Census Tract 224, New York County, New York",3122,198,2924,2808,7927,30850,1954,2005,820,28.2,766,382,1742,17,676,2924,1134
2018,36061022400,"Census Tract 224, New York County, New York",3153,281,2872,2748,7324,30769,1953,2008,866,28.3,750,375,1739,38,605,2872,1228
2019,36061022400,"Census Tract 224, New York County, New York",3138,305,2833,2664,6959,32013,1953,2009,951,28,651,341,1661,40,642,2833,1104
2020,36061022400,"Census Tract 224, New York County, New York",2956,268,2688,2522,6696,45729,1953,2010,1060,27.2,657,282,1588,45,567,2688,960
2012,36061022500,"Census Tract 225, New York County, New York",3915,465,3450,2988,8848,35266,1939,1995,935,26.3,661,429,792,12,1832,3450,1067
2013,36061022500,"Census Tract 225, New York County, New York",3858,416,3442,2940,8918,36640,1939,1997,980,26.7,898,616,730,8,1679,3442,949
2014,36061022500,"Census Tract 225, New York County, New York",3900,400,3500,2999,9424,36263,1939,1997,1041,25.9,671,525,941,29,1739,3500,1060
2015,36061022500,"Census Tract 225, New York County, New York",3844,377,3467,3002,9059,37254,1939,2000,1098,27.9,767,614,840,64,1681,3467,989
2016,36061022500,"Census Tract 225, New York County, New York",3873,367,3506,2898,8892,36437,1939,2003,1127,30.6,799,730,856,56,1459,3506,928
2017,36061022500,"Census Tract 225, New York County, New York",3959,377,3582,3008,9342,51004,1939,2004,1195,30.3,932,735,884,100,1486,3582,887
2018,36061022500,"Census Tract 225, New York County, New York",4036,428,3608,2927,8407,44963,0,2006,1411,31.5,893,637,865,145,1509,3608,937
2019,36061022500,"Census Tract 225, New York County, New York",4063,440,3623,2807,7702,53043,0,2009,1442,32.9,1036,622,713,153,1492,3623,888
2020,36061022500,"Census Tract 225, New York County, New York",4022,331,3691,2819,8320,44228,0,2008,1525,34.5,973,589,884,108,1422,3691,1017
2012,36061022600,"Census Tract 226, New York County, New York",2423,577,1846,1428,2962,29038,1939,2004,914,35,428,72,1136,74,135,1846,521
2013,36061022600,"Census Tract 226, New York County, New York",2316,617,1699,1311,2854,29608,1939,2004,941,34.5,335,58,1006,69,191,1699,594
2014,36061022600,"Census Tract 226, New York County, New York",2334,603,1731,1491,3176,30625,1947,2006,987,33.5,401,131,1089,30,265,1731,615
2015,36061022600,"Census Tract 226, New York County, New York",2321,526,1795,1577,3498,24769,1947,2006,995,33.1,411,104,1146,40,332,1795,701
2016,36061022600,"Census Tract 226, New York County, New York",2344,425,1919,1716,3901,36731,1939,2008,1015,31.9,482,171,1214,71,288,1919,724
2017,36061022600,"Census Tract 226, New York County, New York",2389,365,2024,1830,3976,38663,1943,2009,1084,31.5,567,234,1252,77,320,2024,725
2018,36061022600,"Census Tract 226, New York County, New York",2476,373,2103,1854,3891,41000,0,2010,1116,30.5,641,334,1102,83,347,2103,655
2019,36061022600,"Census Tract 226, New York County, New York",2432,408,2024,1781,3950,45579,0,2011,1133,28.7,646,321,1101,84,277,2024,579
2020,36061022600,"Census Tract 226, New York County, New York",2320,384,1936,1652,3474,49545,0,2012,1203,29.6,638,312,924,116,249,1936,524
2012,36061022700,"Census Tract 227, New York County, New York",2620,332,2288,1758,4319,31925,1939,2003,1166,34.1,717,174,1161,37,367,2288,565
2013,36061022700,"Census Tract 227, New York County, New York",2537,303,2234,1705,4317,32428,1939,2004,1142,33.2,736,264,1075,32,334,2234,518
2014,36061022700,"Census Tract 227, New York County, New York",2496,259,2237,1806,4588,34208,1939,2005,1182,35,732,282,1138,0,397,2237,611
2015,36061022700,"Census Tract 227, New York County, New York",2448,261,2187,1764,4356,42172,1939,2007,1265,33.1,778,457,911,0,399,2187,500
2016,36061022700,"Census Tract 227, New York County, New York",2446,239,2207,1814,4760,43714,1939,2007,1327,32.6,811,558,874,8,357,2207,500
2017,36061022700,"Census Tract 227, New York County, New York",2492,271,2221,1976,5245,49286,1939,2008,1346,30.9,933,581,882,16,549,2221,536
2018,36061022700,"Census Tract 227, New York County, New York",2516,259,2257,1937,4262,45313,0,2007,1404,32.6,901,423,894,15,709,2257,531
2019,36061022700,"Census Tract 227, New York County, New York",2490,308,2182,1876,4163,50688,0,2010,1481,30.8,908,435,796,45,670,2182,504
2020,36061022700,"Census Tract 227, New York County, New York",2425,284,2141,1668,3841,51635,0,2011,1540,30,842,364,776,41,492,2141,462
2012,36061022800,"Census Tract 228, New York County, New York",2789,414,2375,1909,3820,31563,1939,2004,1004,32.4,591,174,1422,45,278,2375,512
2013,36061022800,"Census Tract 228, New York County, New York",2729,403,2326,1903,3848,29953,1939,2005,957,33.5,622,242,1391,46,225,2326,506
2014,36061022800,"Census Tract 228, New York County, New York",2790,351,2439,2113,4664,29987,1939,2005,973,37,696,242,1529,36,240,2439,626
2015,36061022800,"Census Tract 228, New York County, New York",2747,288,2459,2013,4244,28358,1939,2006,970,38.3,662,285,1401,59,255,2459,626
2016,36061022800,"Census Tract 228, New York County, New York",2767,327,2440,2055,4748,28700,1939,2006,1037,38.5,663,299,1383,84,247,2440,680
2017,36061022800,"Census Tract 228, New York County, New York",2894,283,2611,2068,4545,29127,1939,2006,1105,37.2,682,368,1371,58,241,2611,602
2018,36061022800,"Census Tract 228, New York County, New York",2845,199,2646,2090,4189,40000,0,2009,1231,31.9,814,415,1308,91,205,2646,522
2019,36061022800,"Census Tract 228, New York County, New York",2822,173,2649,2118,4490,43750,0,2010,1210,31.7,712,405,1344,119,288,2649,491
2020,36061022800,"Census Tract 228, New York County, New York",3069,267,2802,2225,4331,55331,0,2009,1270,29.4,997,302,1465,126,249,2802,568
2012,36061022900,"Census Tract 229, New York County, New York",3109,306,2803,2586,8264,31750,1939,2001,1108,43.4,613,294,886,23,1597,2803,790
2013,36061022900,"Census Tract 229, New York County, New York",3091,310,2781,2524,7688,30923,1939,2001,1091,42.9,690,361,973,56,1358,2781,756
2014,36061022900,"Census Tract 229, New York County, New York",3202,329,2873,2651,7589,30805,1939,2003,1152,43.2,757,424,1074,81,1279,2873,829
2015,36061022900,"Census Tract 229, New York County, New York",3222,328,2894,2647,7661,32114,1939,2003,1204,37.4,678,439,1005,112,1259,2894,833
2016,36061022900,"Census Tract 229, New York County, New York",3237,238,2999,2707,7428,39896,1939,2004,1189,33.1,739,509,886,114,1220,2999,831
2017,36061022900,"Census Tract 229, New York County, New York",3343,197,3146,2777,7399,45109,1939,2005,1255,32.3,737,533,836,100,1304,3146,739
2018,36061022900,"Census Tract 229, New York County, New York",3340,171,3169,2915,8054,51045,0,2006,1317,29.2,833,619,827,75,1342,3169,713
2019,36061022900,"Census Tract 229, New York County, New York",3383,177,3206,2947,8289,49602,0,2007,1492,30.8,877,707,724,43,1404,3206,705
2020,36061022900,"Census Tract 229, New York County, New York",3255,138,3117,2777,8035,49454,0,2008,1601,31.1,833,648,599,53,1433,3117,662
2012,36061023000,"Census Tract 230, New York County, New York",4133,406,3727,3469,8259,26152,1943,2003,758,28.5,733,265,2492,44,659,3727,1158
2013,36061023000,"Census Tract 230, New York County, New York",4026,377,3649,3446,8934,33039,1939,2004,820,27.8,884,251,2401,69,775,3649,1013
2014,36061023000,"Census Tract 230, New York County, New York",3952,307,3645,3524,8716,33107,1939,2004,851,28.1,983,252,2548,37,727,3645,1140
2015,36061023000,"Census Tract 230, New York County, New York",3903,350,3553,3485,9001,NA,1945,2005,799,27.1,859,334,2460,40,741,3553,1090
2016,36061023000,"Census Tract 230, New York County, New York",3966,360,3606,3522,9132,33528,1943,2006,778,27.7,797,304,2527,45,753,3606,1144
2017,36061023000,"Census Tract 230, New York County, New York",4059,387,3672,3560,8781,33967,1949,2007,807,27.4,859,311,2621,59,691,3672,1229
2018,36061023000,"Census Tract 230, New York County, New York",4169,453,3716,3565,7925,25667,1952,2007,808,31.5,744,294,2705,69,544,3716,1348
2019,36061023000,"Census Tract 230, New York County, New York",4156,460,3696,3511,8196,33470,1952,2008,864,30.8,793,347,2525,65,593,3696,1072
2020,36061023000,"Census Tract 230, New York County, New York",4223,430,3793,3563,7855,32474,1951,2008,985,32.9,1082,265,2622,68,662,3793,1053
2012,36061023100,"Census Tract 231, New York County, New York",2957,237,2720,2190,4751,31680,1939,2003,1053,33.6,888,473,1068,49,614,2720,597
2013,36061023100,"Census Tract 231, New York County, New York",2894,235,2659,2286,4989,31667,1939,2004,1123,35.8,925,463,1172,47,714,2659,620
2014,36061023100,"Census Tract 231, New York County, New York",2924,293,2631,2311,5573,35332,1939,2005,1269,33.4,1039,522,1107,23,749,2631,692
2015,36061023100,"Census Tract 231, New York County, New York",2942,293,2649,2372,6203,37288,1939,2008,1268,33.4,1013,521,1049,41,931,2649,627
2016,36061023100,"Census Tract 231, New York County, New York",2987,327,2660,2410,6149,36655,1939,2009,1311,35.8,988,518,1112,39,799,2660,617
2017,36061023100,"Census Tract 231, New York County, New York",3072,408,2664,2384,6049,37339,1939,2009,1297,38,849,426,1242,35,824,2664,607
2018,36061023100,"Census Tract 231, New York County, New York",3063,403,2660,2376,6125,43763,0,2011,1389,34.5,873,516,931,34,975,2660,555
2019,36061023100,"Census Tract 231, New York County, New York",3098,456,2642,2319,5980,46240,0,2011,1244,31.9,709,457,969,37,839,2642,499
2020,36061023100,"Census Tract 231, New York County, New York",2926,451,2475,2100,5844,50370,0,2011,1359,34.3,597,459,723,0,864,2475,535
2012,36061023200,"Census Tract 232, New York County, New York",3484,309,3175,3059,8859,25880,1955,2001,652,29.1,467,35,2381,20,901,3175,1102
2013,36061023200,"Census Tract 232, New York County, New York",3302,269,3033,2965,8016,27363,1957,2001,721,28.9,593,40,2335,8,813,3033,1033
2014,36061023200,"Census Tract 232, New York County, New York",3338,215,3123,2997,7921,28205,1960,2003,772,30.2,683,38,2289,36,813,3123,917
2015,36061023200,"Census Tract 232, New York County, New York",3331,141,3190,3055,7643,28119,1963,2006,799,31.4,745,96,2259,31,842,3190,972
2016,36061023200,"Census Tract 232, New York County, New York",3317,159,3158,3026,8062,31009,1962,2008,818,29.4,764,164,2124,40,1033,3158,941
2017,36061023200,"Census Tract 232, New York County, New York",3386,208,3178,3053,7799,32900,1965,2009,921,28.5,879,151,2159,40,983,3178,739
2018,36061023200,"Census Tract 232, New York County, New York",3499,201,3298,3224,8743,35083,1964,2009,989,29.1,721,166,2221,60,937,3298,731
2019,36061023200,"Census Tract 232, New York County, New York",3453,231,3222,3152,8738,37022,1962,2008,1036,28.5,784,216,2191,66,851,3222,816
2020,36061023200,"Census Tract 232, New York County, New York",3491,245,3246,3191,9214,39474,1956,2008,1049,27.9,832,265,1901,75,1140,3246,785
2012,36061023300,"Census Tract 233, New York County, New York",2709,291,2418,2241,5582,31641,1939,2002,1096,39.5,801,538,1097,42,686,2418,359
2013,36061023300,"Census Tract 233, New York County, New York",2669,211,2458,2220,5665,33333,1939,2001,1131,38.1,766,548,1084,30,630,2458,399
2014,36061023300,"Census Tract 233, New York County, New York",2713,182,2531,2268,5900,36492,1939,2001,1178,38.3,801,509,1081,60,725,2531,569
2015,36061023300,"Census Tract 233, New York County, New York",2699,143,2556,2288,5920,38750,1939,2002,1202,38.2,826,548,1032,52,752,2556,567
2016,36061023300,"Census Tract 233, New York County, New York",2700,123,2577,2225,6025,48161,1939,2003,1306,35.6,990,602,854,62,784,2577,550
2017,36061023300,"Census Tract 233, New York County, New York",2705,184,2521,2075,5864,49228,1939,2008,1404,37.5,1007,581,665,48,879,2521,556
2018,36061023300,"Census Tract 233, New York County, New York",2710,189,2521,2067,5743,51343,0,2008,1457,36,1062,596,697,54,824,2521,561
2019,36061023300,"Census Tract 233, New York County, New York",2723,239,2484,2026,5739,54623,0,2010,1486,35.6,974,638,638,15,818,2484,479
2020,36061023300,"Census Tract 233, New York County, New York",2786,245,2541,2145,5668,63776,0,2010,1648,33.3,906,588,710,155,759,2541,480
2012,36061023400,"Census Tract 234, New York County, New York",2276,218,2058,1970,4907,37931,1939,2004,995,30.3,644,173,1272,6,478,2058,387
2013,36061023400,"Census Tract 234, New York County, New York",2279,189,2090,1981,4881,31368,1939,2004,1035,34.3,720,193,1242,24,427,2090,502
2014,36061023400,"Census Tract 234, New York County, New York",2366,201,2165,2010,4762,30739,1939,2006,1097,37.7,833,233,1275,23,454,2165,540
2015,36061023400,"Census Tract 234, New York County, New York",2390,172,2218,2049,4727,31581,1939,2008,1228,38.6,828,169,1381,15,494,2218,527
2016,36061023400,"Census Tract 234, New York County, New York",2436,121,2315,2154,4942,31266,1939,2008,1152,36.6,811,182,1456,24,523,2315,516
2017,36061023400,"Census Tract 234, New York County, New York",2460,111,2349,2170,4819,32017,1941,2009,1210,36.7,756,237,1471,40,513,2349,527
2018,36061023400,"Census Tract 234, New York County, New York",2449,137,2312,2119,4514,39188,0,2011,1202,34.6,784,268,1439,7,522,2312,458
2019,36061023400,"Census Tract 234, New York County, New York",2511,98,2413,2190,4647,44500,1941,2011,1294,33,849,246,1436,7,486,2413,446
2020,36061023400,"Census Tract 234, New York County, New York",2597,114,2483,2258,4583,52775,1946,2012,1499,33.5,885,447,1313,9,473,2483,406
2012,36061023501,"Census Tract 235.01, New York County, New York",2628,124,2504,2142,5885,35362,1939,2002,918,29,360,168,1334,43,640,2504,702
2013,36061023501,"Census Tract 235.01, New York County, New York",2577,134,2443,2066,5735,33250,1939,2004,946,28.9,425,243,1092,48,680,2443,704
2014,36061023501,"Census Tract 235.01, New York County, New York",2606,111,2495,2124,5554,30357,1939,2004,930,32.8,487,253,1028,64,803,2495,766
2015,36061023501,"Census Tract 235.01, New York County, New York",2622,117,2505,2122,5786,30159,1939,2006,960,33.8,499,196,1027,87,894,2505,822
2016,36061023501,"Census Tract 235.01, New York County, New York",2666,141,2525,2103,5249,30913,1939,2007,990,36.3,544,295,942,60,825,2525,673
2017,36061023501,"Census Tract 235.01, New York County, New York",2706,162,2544,2155,5973,37955,1939,2010,1095,33.8,512,357,860,51,859,2544,595
2018,36061023501,"Census Tract 235.01, New York County, New York",2694,189,2505,2159,5976,41653,0,2011,1260,31.9,648,336,878,78,905,2505,497
2019,36061023501,"Census Tract 235.01, New York County, New York",2782,186,2596,2226,6316,46250,0,2012,1369,29,743,335,1085,59,820,2596,436
2020,36061023501,"Census Tract 235.01, New York County, New York",2775,163,2612,2260,6044,68472,0,2013,1761,30.8,872,457,896,37,885,2612,341
2012,36061023502,"Census Tract 235.02, New York County, New York",964,232,732,732,1763,25357,1940,2004,929,33.7,180,34,484,0,199,732,294
2013,36061023502,"Census Tract 235.02, New York County, New York",954,176,778,774,2008,30096,1939,2006,1021,31.6,229,58,563,0,150,778,238
2014,36061023502,"Census Tract 235.02, New York County, New York",940,168,772,751,1672,30142,1941,2007,1048,31,189,48,558,0,143,772,218
2015,36061023502,"Census Tract 235.02, New York County, New York",904,123,781,769,1827,28641,1941,2009,1046,32.1,175,80,582,0,123,781,211
2016,36061023502,"Census Tract 235.02, New York County, New York",941,103,838,817,1898,31815,1939,2010,1190,32.3,214,78,613,5,147,838,191
2017,36061023502,"Census Tract 235.02, New York County, New York",984,113,871,838,1933,29470,1939,2011,1173,31.5,221,70,636,7,174,871,225
2018,36061023502,"Census Tract 235.02, New York County, New York",998,135,863,817,1881,28523,1945,2010,1263,35.4,250,82,586,9,214,863,226
2019,36061023502,"Census Tract 235.02, New York County, New York",1001,146,855,813,1888,38125,1945,2010,1319,33.8,295,93,562,43,195,855,224
2020,36061023502,"Census Tract 235.02, New York County, New York",957,178,779,724,1729,41667,1942,2012,1503,34,307,83,497,50,174,779,222
2012,36061023600,"Census Tract 236, New York County, New York",3280,197,3083,2159,4541,37469,1963,1997,801,23.5,598,68,1884,43,270,3083,481
2013,36061023600,"Census Tract 236, New York County, New York",3184,89,3095,2317,5205,36268,1963,1997,809,25.4,506,32,1908,58,419,3095,635
2014,36061023600,"Census Tract 236, New York County, New York",3135,156,2979,2295,5460,35428,1963,1997,829,26.8,394,21,1889,33,442,2979,615
2015,36061023600,"Census Tract 236, New York County, New York",3159,191,2968,2441,5909,35281,1965,2003,811,27.4,396,22,1898,18,513,2968,600
2016,36061023600,"Census Tract 236, New York County, New York",3243,239,3004,2532,6043,32339,1964,2003,874,31.3,415,22,1883,15,587,3004,664
2017,36061023600,"Census Tract 236, New York County, New York",3327,215,3112,2583,6037,37703,1963,2005,893,29.6,702,68,1759,20,550,3112,706
2018,36061023600,"Census Tract 236, New York County, New York",3323,199,3124,2596,6340,43057,1963,2006,935,27.2,878,81,1822,35,444,3124,566
2019,36061023600,"Census Tract 236, New York County, New York",3439,189,3250,2546,6188,43291,1963,2007,936,27.8,757,69,1853,24,468,3250,645
2020,36061023600,"Census Tract 236, New York County, New York",3477,88,3389,2533,5698,36860,1962,2008,913,30.2,665,57,1908,20,549,3389,658
2012,36061023700,"Census Tract 237, New York County, New York",2789,294,2495,2373,7247,34171,1939,2002,1051,31.3,649,360,992,39,1198,2495,739
2013,36061023700,"Census Tract 237, New York County, New York",2727,253,2474,2366,7498,36629,1939,2002,1095,29.5,656,397,828,16,1303,2474,737
2014,36061023700,"Census Tract 237, New York County, New York",2754,260,2494,2376,7267,37713,1939,2002,1120,28.6,689,330,787,55,1232,2494,690
2015,36061023700,"Census Tract 237, New York County, New York",2795,180,2615,2437,7068,NA,1939,2004,1142,29.2,656,361,834,54,1261,2615,570
2016,36061023700,"Census Tract 237, New York County, New York",2858,106,2752,2529,7482,46098,1939,2009,1180,28.5,742,351,844,90,1242,2752,571
2017,36061023700,"Census Tract 237, New York County, New York",2920,77,2843,2616,7236,42351,1939,2010,1186,28.5,818,458,763,91,1189,2843,620
2018,36061023700,"Census Tract 237, New York County, New York",2893,141,2752,2455,6653,43936,0,2010,1261,29.4,787,412,799,92,1071,2752,684
2019,36061023700,"Census Tract 237, New York County, New York",2887,229,2658,2402,6167,46500,0,2008,1324,32.1,793,486,662,56,1167,2658,658
2020,36061023700,"Census Tract 237, New York County, New York",2869,283,2586,2374,6071,52090,0,2010,1375,31.9,844,495,794,50,970,2586,687
2012,36061023801,"Census Tract 238.01, New York County, New York",4196,433,3763,3367,8486,69440,1979,2004,1883,27.6,2163,1473,405,878,492,3763,572
2013,36061023801,"Census Tract 238.01, New York County, New York",4286,349,3937,3435,8246,71480,1979,2005,1845,28.2,2221,1429,512,858,511,3937,552
2014,36061023801,"Census Tract 238.01, New York County, New York",4464,409,4055,3530,8079,78011,1979,2007,1928,26.7,2488,1454,290,1110,521,4055,444
2015,36061023801,"Census Tract 238.01, New York County, New York",4436,488,3948,3421,7839,79443,1979,2008,2015,27,2428,1386,343,1068,482,3948,333
2016,36061023801,"Census Tract 238.01, New York County, New York",4568,450,4118,3393,7600,77630,1979,2010,1988,28.2,2421,1462,333,1043,410,4118,415
2017,36061023801,"Census Tract 238.01, New York County, New York",4713,488,4225,3291,7245,81721,1979,2011,2138,31.2,2353,1270,421,1119,401,4225,380
2018,36061023801,"Census Tract 238.01, New York County, New York",4489,545,3944,3014,6527,90990,1978,2012,2354,28.5,2253,1302,295,1080,262,3944,215
2019,36061023801,"Census Tract 238.01, New York County, New York",3412,414,2998,1987,4262,83892,1979,2014,2398,30,1418,788,201,798,183,2998,172
2012,36061023802,"Census Tract 238.02, New York County, New York",547,79,468,468,985,103409,2003,2007,2001,26.8,348,302,17,83,72,468,107
2013,36061023802,"Census Tract 238.02, New York County, New York",668,86,582,582,1197,120682,2003,2011,2001,23.5,435,397,6,96,76,582,116
2014,36061023802,"Census Tract 238.02, New York County, New York",739,82,657,657,1242,117292,2003,2011,2001,24,511,439,5,133,74,657,102
2015,36061023802,"Census Tract 238.02, New York County, New York",827,153,674,635,1218,NA,2003,2012,2676,26.3,517,430,5,147,48,674,100
2016,36061023802,"Census Tract 238.02, New York County, New York",798,126,672,620,1166,104643,2003,2012,2815,28.1,541,393,10,176,34,672,92
2017,36061023802,"Census Tract 238.02, New York County, New York",716,121,595,587,1241,119750,2004,NA,2879,27.1,527,351,5,186,45,595,70
2018,36061023802,"Census Tract 238.02, New York County, New York",938,134,804,798,1692,100435,2002,2013,2912,29.6,616,365,6,301,126,804,197
2019,36061023802,"Census Tract 238.02, New York County, New York",1995,219,1776,1688,4297,105865,1981,2013,2796,29.5,1285,740,210,480,179,1776,247
2020,36061023802,"Census Tract 238.02, New York County, New York",2062,155,1907,1826,4569,102303,1982,2013,3007,30.3,1442,859,222,488,182,1907,201
2020,36061023803,"Census Tract 238.03, New York County, New York",1845,328,1517,717,1186,49289,1973,2006,2063,39.3,482,313,56,259,70,1517,80
2020,36061023804,"Census Tract 238.04, New York County, New York",1821,198,1623,1211,2672,151406,2006,2017,2831,19.7,1126,541,107,553,71,1623,97
2012,36061023900,"Census Tract 239, New York County, New York",999,8,991,827,1854,26058,1939,2001,895,28.7,252,104,413,0,292,991,275
2013,36061023900,"Census Tract 239, New York County, New York",1020,44,976,854,1943,32361,1939,2002,857,29.1,248,110,456,0,322,976,287
2014,36061023900,"Census Tract 239, New York County, New York",1043,42,1001,914,2298,34825,1939,2002,897,29.2,324,145,426,0,393,1001,259
2015,36061023900,"Census Tract 239, New York County, New York",1085,36,1049,962,2609,NA,1939,2003,1074,28.3,343,131,449,0,435,1049,253
2016,36061023900,"Census Tract 239, New York County, New York",1125,38,1087,1017,2421,32518,1943,2005,1117,32,375,154,395,0,467,1087,317
2017,36061023900,"Census Tract 239, New York County, New York",1182,31,1151,1065,2917,33355,1943,2007,1261,34.1,359,175,412,30,490,1151,338
2018,36061023900,"Census Tract 239, New York County, New York",1233,18,1215,1113,2932,37071,1950,2008,1282,31.9,400,136,437,34,548,1215,300
2019,36061023900,"Census Tract 239, New York County, New York",1151,72,1079,907,2383,35740,1945,2009,1339,31.6,271,157,313,42,420,1079,243
2020,36061023900,"Census Tract 239, New York County, New York",1275,69,1206,1066,2806,32188,1956,2011,1134,31.8,354,182,422,27,502,1206,250
2012,36061024000,"Census Tract 240, New York County, New York",0,0,0,0,0,NA,NA,NA,NA,NA,0,0,0,0,0,0,0
2013,36061024000,"Census Tract 240, New York County, New York",0,0,0,0,0,NA,NA,NA,NA,NA,0,0,0,0,0,0,0
2014,36061024000,"Census Tract 240, New York County, New York",0,0,0,0,0,NA,NA,NA,NA,NA,0,0,0,0,0,0,0
2015,36061024000,"Census Tract 240, New York County, New York",0,0,0,0,0,NA,NA,NA,NA,NA,0,0,0,0,0,0,0
2016,36061024000,"Census Tract 240, New York County, New York",0,0,0,0,0,NA,NA,NA,NA,NA,0,0,0,0,0,0,0
2017,36061024000,"Census Tract 240, New York County, New York",0,0,0,0,0,NA,NA,NA,NA,NA,0,0,0,0,0,0,0
2018,36061024000,"Census Tract 240, New York County, New York",0,0,0,0,0,NA,NA,NA,NA,NA,0,0,0,0,0,0,0
2019,36061024000,"Census Tract 240, New York County, New York",0,0,0,0,0,NA,NA,NA,NA,NA,0,0,0,0,0,0,0
2020,36061024000,"Census Tract 240, New York County, New York",0,0,0,0,0,NA,NA,NA,NA,NA,0,0,0,0,0,0,0
2012,36061024100,"Census Tract 241, New York County, New York",3492,286,3206,2530,7088,35000,1939,1997,946,28.6,806,260,1005,104,1230,3206,781
2013,36061024100,"Census Tract 241, New York County, New York",3460,365,3095,2505,6734,34250,1939,1995,1009,27.7,788,256,851,115,1326,3095,746
2014,36061024100,"Census Tract 241, New York County, New York",3490,312,3178,2512,6143,36994,1939,1997,1095,29,799,278,672,126,1479,3178,762
2015,36061024100,"Census Tract 241, New York County, New York",3496,349,3147,2598,6612,37413,1939,2000,1167,28.4,798,279,719,130,1570,3147,730
2016,36061024100,"Census Tract 241, New York County, New York",3509,428,3081,2417,6503,39276,1939,2000,1171,29.3,806,339,720,90,1384,3081,908
2017,36061024100,"Census Tract 241, New York County, New York",3601,308,3293,2486,6872,43137,1939,2001,1223,28.6,798,400,754,155,1323,3293,849
2018,36061024100,"Census Tract 241, New York County, New York",3652,287,3365,2442,6281,40515,0,2001,1145,32.4,745,408,782,78,1339,3365,783
2019,36061024100,"Census Tract 241, New York County, New York",3671,239,3432,2453,6652,45546,0,2005,1191,32.5,707,437,740,122,1305,3432,734
2020,36061024100,"Census Tract 241, New York County, New York",3527,166,3361,2342,6152,45940,0,2005,1190,33.5,848,461,685,125,1184,3361,605
2012,36061024200,"Census Tract 242, New York County, New York",1306,74,1232,1225,3454,17449,1976,2000,406,27.8,144,28,706,51,519,1232,558
2013,36061024200,"Census Tract 242, New York County, New York",1372,73,1299,1295,3357,18859,1977,2002,399,27.8,195,47,750,62,521,1299,594
2014,36061024200,"Census Tract 242, New York County, New York",1438,58,1380,1366,3476,17375,1977,2003,463,29.2,240,34,769,72,647,1380,686
2015,36061024200,"Census Tract 242, New York County, New York",1537,66,1471,1446,3745,18386,1976,2005,484,29.8,312,61,853,66,582,1471,718
2016,36061024200,"Census Tract 242, New York County, New York",1632,74,1558,1547,3990,19703,1978,2006,474,28.6,308,66,860,110,624,1558,699
2017,36061024200,"Census Tract 242, New York County, New York",1812,76,1736,1726,4219,25443,1978,2009,527,28.5,396,96,923,106,727,1736,645
2018,36061024200,"Census Tract 242, New York County, New York",1905,94,1811,1802,4419,25402,1980,2010,587,29.3,386,88,940,104,793,1811,646
2019,36061024200,"Census Tract 242, New York County, New York",1984,81,1903,1891,4739,25900,1979,2011,810,29.9,374,74,1046,77,777,1903,618
2020,36061024200,"Census Tract 242, New York County, New York",1853,101,1752,1752,4882,34795,1979,2011,877,29.5,324,63,974,50,728,1752,482
2012,36061024301,"Census Tract 243.01, New York County, New York",1467,132,1335,1246,3814,29904,1939,2002,1067,33.9,304,107,689,0,501,1335,420
2013,36061024301,"Census Tract 243.01, New York County, New York",1506,167,1339,1258,3713,31483,1939,2003,1122,34.7,387,182,661,0,454,1339,462
2014,36061024301,"Census Tract 243.01, New York County, New York",1491,157,1334,1258,3839,34828,1940,2005,1138,33.9,489,246,668,0,443,1334,419
2015,36061024301,"Census Tract 243.01, New York County, New York",1525,151,1374,1303,3574,NA,1939,2004,1064,33.7,496,216,620,58,474,1374,429
2016,36061024301,"Census Tract 243.01, New York County, New York",1551,112,1439,1396,4174,47396,1939,2006,1173,31.5,634,303,568,60,511,1439,355
2017,36061024301,"Census Tract 243.01, New York County, New York",1579,121,1458,1439,4179,42056,1939,2004,1161,32.4,578,236,677,50,517,1458,403
2018,36061024301,"Census Tract 243.01, New York County, New York",1596,99,1497,1465,4684,50474,0,2006,1211,31.3,549,181,614,82,627,1497,361
2019,36061024301,"Census Tract 243.01, New York County, New York",1613,95,1518,1491,4374,57146,0,2006,1326,29.3,593,225,626,79,597,1518,303
2020,36061024301,"Census Tract 243.01, New York County, New York",1719,77,1642,1581,4802,64949,0,2011,1356,27.2,635,223,580,67,728,1642,240
2012,36061024302,"Census Tract 243.02, New York County, New York",2494,79,2415,2415,6785,20456,1963,1996,363,27.7,194,0,1481,19,998,2415,1010
2013,36061024302,"Census Tract 243.02, New York County, New York",2460,89,2371,2371,6601,19955,1962,1995,416,28.4,180,0,1520,5,965,2371,1110
2014,36061024302,"Census Tract 243.02, New York County, New York",2510,123,2387,2387,6416,18153,1962,1997,429,28.4,170,0,1424,17,1103,2387,1173
2015,36061024302,"Census Tract 243.02, New York County, New York",2566,80,2486,2486,7025,20371,1961,1997,469,26.3,301,0,1518,0,1018,2486,1102
2016,36061024302,"Census Tract 243.02, New York County, New York",2689,99,2590,2590,7396,18345,1961,2000,478,28.4,212,0,1611,54,1082,2590,1322
2017,36061024302,"Census Tract 243.02, New York County, New York",2779,92,2687,2673,7423,20792,1961,2001,566,30.8,111,0,1552,55,1203,2687,1307
2018,36061024302,"Census Tract 243.02, New York County, New York",2783,82,2701,2686,7547,21423,1961,2002,537,30.1,216,0,1414,59,1450,2701,1311
2019,36061024302,"Census Tract 243.02, New York County, New York",2795,107,2688,2662,7495,23954,1962,2003,598,30.1,213,0,1403,62,1410,2688,1216
2020,36061024302,"Census Tract 243.02, New York County, New York",2765,97,2668,2642,6971,23110,1961,2004,620,31.6,234,59,1484,84,1228,2668,1237
2012,36061024500,"Census Tract 245, New York County, New York",5025,147,4878,4791,16156,34248,1939,1999,955,30.3,873,330,981,110,3547,4878,1418
2013,36061024500,"Census Tract 245, New York County, New York",4915,191,4724,4604,15577,32826,1939,1996,969,31.9,1022,389,911,127,3266,4724,1501
2014,36061024500,"Census Tract 245, New York County, New York",4952,225,4727,4594,15412,34518,1939,1999,1023,34.8,1042,486,840,152,3156,4727,1375
2015,36061024500,"Census Tract 245, New York County, New York",5064,239,4825,4701,15750,NA,1939,2000,1045,35.7,1041,426,781,117,3396,4825,1346
2016,36061024500,"Census Tract 245, New York County, New York",5123,345,4778,4606,15048,38478,1939,1999,1067,34,1042,453,787,127,3330,4778,1287
2017,36061024500,"Census Tract 245, New York County, New York",5170,369,4801,4604,14502,38713,1939,2000,1045,31.3,1047,481,788,150,3249,4801,1206
2018,36061024500,"Census Tract 245, New York County, New York",5258,386,4872,4738,15137,44413,0,2004,1144,30.8,1160,586,814,96,3341,4872,1083
2019,36061024500,"Census Tract 245, New York County, New York",5297,337,4960,4820,14399,48088,0,2006,1207,30.4,1328,530,1037,79,3281,4960,1265
2020,36061024500,"Census Tract 245, New York County, New York",5907,410,5497,5333,13701,42972,0,2011,1275,33.8,1985,1178,1150,85,2873,5497,1313
2012,36061024700,"Census Tract 247, New York County, New York",2633,206,2427,2059,7469,29642,1939,1997,1012,40.7,465,445,255,100,1329,2427,723
2013,36061024700,"Census Tract 247, New York County, New York",2617,223,2394,2030,7063,28493,1939,2001,1113,49.3,532,353,373,75,1294,2394,744
2014,36061024700,"Census Tract 247, New York County, New York",2657,250,2407,2137,7220,30629,1939,2001,1195,44.9,611,392,411,56,1344,2407,545
2015,36061024700,"Census Tract 247, New York County, New York",2683,239,2444,2088,7187,32969,1939,2000,1184,38.9,671,383,382,38,1377,2444,607
2016,36061024700,"Census Tract 247, New York County, New York",2695,228,2467,2165,6951,34147,1939,1999,1186,35.6,703,382,449,86,1429,2467,514
2017,36061024700,"Census Tract 247, New York County, New York",2748,195,2553,2243,6692,43280,1939,2000,1222,34.1,803,426,597,64,1424,2553,453
2018,36061024700,"Census Tract 247, New York County, New York",2737,101,2636,2271,6877,47046,0,2001,1307,32.2,774,497,527,90,1428,2636,337
2019,36061024700,"Census Tract 247, New York County, New York",2798,195,2603,2162,6181,49500,0,2004,1222,29.8,719,395,525,102,1424,2603,404
2020,36061024700,"Census Tract 247, New York County, New York",2977,281,2696,2270,6208,55846,0,2005,1159,27.5,689,322,443,101,1629,2696,538
2012,36061024900,"Census Tract 249, New York County, New York",368,6,362,324,1018,32500,1939,2001,862,29.3,34,36,97,2,185,362,115
2013,36061024900,"Census Tract 249, New York County, New York",350,7,343,307,971,36563,1939,2002,853,26.1,43,39,54,5,187,343,95
2014,36061024900,"Census Tract 249, New York County, New York",387,6,381,346,1129,36000,1939,2003,910,28.3,49,28,100,4,209,381,109
2015,36061024900,"Census Tract 249, New York County, New York",387,6,381,360,1229,37250,1939,2005,895,27.8,80,31,104,3,230,381,115
2016,36061024900,"Census Tract 249, New York County, New York",419,0,419,399,1215,40139,1939,2007,947,28.2,123,44,98,0,292,419,117
2017,36061024900,"Census Tract 249, New York County, New York",426,0,426,405,1108,41875,1939,2011,1037,31.5,134,48,127,0,277,426,124
2018,36061024900,"Census Tract 249, New York County, New York",464,21,443,408,962,33676,0,2012,1064,37.2,134,46,132,8,264,443,112
2019,36061024900,"Census Tract 249, New York County, New York",472,38,434,391,900,41339,0,2012,1337,36.3,150,59,95,10,249,434,107
2020,36061024900,"Census Tract 249, New York County, New York",526,87,439,398,842,51974,1941,2015,1554,35.6,175,98,62,17,238,439,88
2012,36061025100,"Census Tract 251, New York County, New York",868,94,774,770,2587,41667,1939,1988,837,26,116,16,212,19,546,774,153
2013,36061025100,"Census Tract 251, New York County, New York",840,100,740,728,2338,34621,1939,1989,875,30.1,132,54,164,19,502,740,149
2014,36061025100,"Census Tract 251, New York County, New York",856,93,763,745,2285,29647,1939,1994,924,32.9,148,45,180,24,542,763,176
2015,36061025100,"Census Tract 251, New York County, New York",853,129,724,700,2265,28000,1939,2002,956,35.9,135,44,160,25,510,724,212
2016,36061025100,"Census Tract 251, New York County, New York",866,132,734,711,2442,29844,1939,2003,977,34.6,112,47,157,30,529,734,223
2017,36061025100,"Census Tract 251, New York County, New York",905,102,803,779,2384,31215,1939,2001,986,33.9,160,68,137,44,578,803,252
2018,36061025100,"Census Tract 251, New York County, New York",911,115,796,778,2325,39868,0,2004,1075,31.2,167,83,129,46,572,796,253
2019,36061025100,"Census Tract 251, New York County, New York",915,95,820,808,2430,41863,0,2006,1103,30.6,249,103,134,42,573,820,207
2020,36061025100,"Census Tract 251, New York County, New York",907,60,847,839,2410,38482,0,2010,1011,31.4,267,86,133,47,623,847,250
2012,36061025300,"Census Tract 253, New York County, New York",3972,179,3793,3675,10884,33036,1939,1997,1045,34.9,941,538,630,182,2566,3793,1188
2013,36061025300,"Census Tract 253, New York County, New York",3889,194,3695,3597,10779,33877,1939,1997,1083,35.1,1064,561,614,182,2464,3695,1160
2014,36061025300,"Census Tract 253, New York County, New York",3934,150,3784,3720,11207,35552,1939,1997,1135,34.3,1212,602,661,123,2540,3784,1107
2015,36061025300,"Census Tract 253, New York County, New York",3938,98,3840,3795,12085,NA,1939,1998,1150,34.8,1248,799,550,109,2565,3840,1017
2016,36061025300,"Census Tract 253, New York County, New York",3991,165,3826,3785,13791,47218,1939,1999,1153,30.8,1271,783,435,119,2691,3826,1031
2017,36061025300,"Census Tract 253, New York County, New York",4082,189,3893,3840,13276,50406,1939,2000,1240,32.1,1417,822,469,133,2631,3893,935
2018,36061025300,"Census Tract 253, New York County, New York",4082,181,3901,3840,13234,53336,0,2002,1306,30.2,1397,856,412,152,2644,3901,919
2019,36061025300,"Census Tract 253, New York County, New York",4153,231,3922,3832,13294,56129,0,2001,1235,29.9,1351,823,374,130,2706,3922,817
2020,36061025300,"Census Tract 253, New York County, New York",4331,234,4097,4005,12227,60595,0,2008,1511,33.1,1410,688,348,182,2620,4097,736
2012,36061025500,"Census Tract 255, New York County, New York",2380,283,2097,1969,4651,43925,1939,2002,1386,32.2,1203,669,167,278,898,2097,403
2013,36061025500,"Census Tract 255, New York County, New York",2281,197,2084,1936,4622,45000,1939,2002,1459,33.1,1025,638,168,204,992,2084,425
2014,36061025500,"Census Tract 255, New York County, New York",2264,107,2157,1972,4428,46714,1939,2003,1457,32.5,1114,758,182,227,859,2157,453
2015,36061025500,"Census Tract 255, New York County, New York",2189,138,2051,1961,4638,45625,1939,2003,1463,36.1,1075,579,100,230,1050,2051,452
2016,36061025500,"Census Tract 255, New York County, New York",2189,92,2097,2003,4977,41016,1939,2005,1477,37,1127,633,128,212,1034,2097,611
2017,36061025500,"Census Tract 255, New York County, New York",2231,101,2130,2080,5086,34364,1939,2004,1448,38.3,1124,660,170,211,1029,2130,702
2018,36061025500,"Census Tract 255, New York County, New York",2297,86,2211,2161,5429,55403,0,2006,1541,34.3,1222,681,181,293,984,2211,651
2019,36061025500,"Census Tract 255, New York County, New York",2220,190,2030,1971,5280,65496,0,2005,1645,33.2,1028,629,124,225,1000,2030,542
2020,36061025500,"Census Tract 255, New York County, New York",2428,230,2198,2007,5199,69926,0,2004,1638,27.6,951,505,120,227,1156,2198,568
2012,36061025700,"Census Tract 257, New York County, New York",1919,262,1657,1170,3015,48520,1939,2003,1009,26.8,545,273,672,51,187,1657,310
2013,36061025700,"Census Tract 257, New York County, New York",1975,245,1730,1150,2906,49087,1939,2004,1103,27,484,254,602,70,241,1730,286
2014,36061025700,"Census Tract 257, New York County, New York",2001,259,1742,1176,3089,61500,1965,2004,1297,27.3,580,292,589,80,225,1742,229
2015,36061025700,"Census Tract 257, New York County, New York",1964,244,1720,1170,3052,64074,1982,2005,1470,26.4,645,315,564,79,228,1720,165
2016,36061025700,"Census Tract 257, New York County, New York",1984,181,1803,1209,2985,60284,1972,2007,1624,27.8,720,372,586,69,208,1803,164
2017,36061025700,"Census Tract 257, New York County, New York",2029,170,1859,1249,3148,66902,1976,2008,1620,27,756,374,557,67,277,1859,171
2018,36061025700,"Census Tract 257, New York County, New York",2030,166,1864,1327,3381,69792,1977,2008,1663,27.4,862,438,596,71,247,1864,261
2019,36061025700,"Census Tract 257, New York County, New York",1989,137,1852,1380,3604,69250,1976,2009,1646,24.8,837,501,598,71,215,1852,240
2020,36061025700,"Census Tract 257, New York County, New York",2159,190,1969,1493,3604,72083,1957,2010,1662,24.6,947,555,732,43,164,1969,260
2012,36061025900,"Census Tract 259, New York County, New York",1637,193,1444,986,2819,34709,1960,2004,938,33.4,302,71,662,7,328,1444,319
2013,36061025900,"Census Tract 259, New York County, New York",1665,162,1503,930,2634,30965,1968,2006,1017,37.2,288,82,559,20,330,1503,364
2014,36061025900,"Census Tract 259, New York County, New York",1737,122,1615,986,3108,35305,1974,2007,1055,36.7,328,98,564,18,341,1615,414
2015,36061025900,"Census Tract 259, New York County, New York",1761,96,1665,1008,2881,31981,1974,2008,1111,38.3,359,96,551,13,346,1665,392
2016,36061025900,"Census Tract 259, New York County, New York",1800,119,1681,1014,2818,32183,1979,2010,1113,38.5,362,84,538,6,376,1681,399
2017,36061025900,"Census Tract 259, New York County, New York",1833,135,1698,1034,2345,36573,1991,2010,1205,37.4,467,120,576,6,306,1698,353
2018,36061025900,"Census Tract 259, New York County, New York",1871,122,1749,1047,2258,45196,1988,2011,1206,34.4,452,164,586,7,277,1749,250
2019,36061025900,"Census Tract 259, New York County, New York",1902,143,1759,1133,2350,39432,1985,2011,1185,33.4,437,176,589,7,329,1759,248
2020,36061025900,"Census Tract 259, New York County, New York",1845,135,1710,1018,2114,53194,1988,2011,1133,29,422,172,499,29,287,1710,201
2012,36061026100,"Census Tract 261, New York County, New York",3753,103,3650,3639,12678,30774,1939,1999,906,33.7,319,127,640,33,3126,3650,1271
2013,36061026100,"Census Tract 261, New York County, New York",3717,131,3586,3566,13246,28750,1939,2000,936,35.1,334,94,521,66,3154,3586,1367
2014,36061026100,"Census Tract 261, New York County, New York",3820,155,3665,3655,13634,30045,1939,2000,988,37.2,369,113,470,91,3230,3665,1335
2015,36061026100,"Census Tract 261, New York County, New York",3833,147,3686,3645,13371,NA,1939,2001,994,39.6,377,142,498,66,3164,3686,1429
2016,36061026100,"Census Tract 261, New York County, New York",3877,177,3700,3625,13250,31470,1939,2000,1074,40.3,451,174,498,79,3129,3700,1392
2017,36061026100,"Census Tract 261, New York County, New York",4044,176,3868,3775,13537,35516,1939,1998,1115,33.7,478,181,584,46,3235,3868,1230
2018,36061026100,"Census Tract 261, New York County, New York",4062,248,3814,3731,12983,43047,0,1997,1194,31.1,495,231,669,59,3094,3814,995
2019,36061026100,"Census Tract 261, New York County, New York",4135,272,3863,3756,12855,44375,1940,1997,1291,31.7,527,242,700,34,3153,3863,1034
2020,36061026100,"Census Tract 261, New York County, New York",3952,318,3634,3560,11770,50854,0,1998,1319,30.7,618,196,517,102,3012,3634,934
2012,36061026300,"Census Tract 263, New York County, New York",2964,111,2853,2811,8888,27628,1939,1997,1075,40.8,563,282,358,46,2199,2853,1012
2013,36061026300,"Census Tract 263, New York County, New York",2928,89,2839,2794,8873,27962,1939,1998,1097,41.7,610,311,307,74,2143,2839,933
2014,36061026300,"Census Tract 263, New York County, New York",2937,69,2868,2842,9317,28986,1939,1998,1153,37.9,583,348,334,85,2180,2868,951
2015,36061026300,"Census Tract 263, New York County, New York",2966,85,2881,2866,9677,29237,1939,2001,1173,38.8,756,336,277,92,2228,2881,1018
2016,36061026300,"Census Tract 263, New York County, New York",2968,75,2893,2893,9033,28630,1939,2001,1240,39.4,785,331,273,71,2273,2893,910
2017,36061026300,"Census Tract 263, New York County, New York",3044,37,3007,3007,9255,30961,1939,2001,1317,35,1030,352,308,92,2428,3007,848
2018,36061026300,"Census Tract 263, New York County, New York",3091,38,3053,3004,9438,36184,0,2003,1411,33.8,911,311,408,111,2430,3053,952
2019,36061026300,"Census Tract 263, New York County, New York",3130,46,3084,3037,9130,43750,0,2004,1467,33.9,1097,341,363,97,2411,3084,787
2020,36061026300,"Census Tract 263, New York County, New York",3035,43,2992,2950,9074,50451,0,2006,1551,32.3,1096,416,317,118,2305,2992,651
2012,36061026500,"Census Tract 265, New York County, New York",3015,98,2917,2397,6108,41781,1939,1998,1219,38.4,956,571,184,52,1589,2917,550
2013,36061026500,"Census Tract 265, New York County, New York",2986,223,2763,2249,6152,42017,1939,1997,1233,38.5,927,468,156,70,1508,2763,412
2014,36061026500,"Census Tract 265, New York County, New York",2976,213,2763,2307,6714,45134,1939,2000,1317,34,1008,525,254,67,1499,2763,344
2015,36061026500,"Census Tract 265, New York County, New York",2997,222,2775,2412,7426,60171,1939,2001,1349,29.2,1047,650,326,65,1448,2775,315
2016,36061026500,"Census Tract 265, New York County, New York",3013,239,2774,2319,6818,57435,1939,2000,1325,29,975,728,296,50,1371,2774,388
2017,36061026500,"Census Tract 265, New York County, New York",3034,295,2739,2309,7291,65951,1939,2000,1348,24.9,981,816,336,50,1252,2739,399
2018,36061026500,"Census Tract 265, New York County, New York",3041,255,2786,2356,7323,76012,0,2003,1432,24.3,1109,899,396,76,1187,2786,361
2019,36061026500,"Census Tract 265, New York County, New York",3044,273,2771,2282,7019,80811,0,2006,1429,23,1006,925,261,113,1189,2771,367
2020,36061026500,"Census Tract 265, New York County, New York",3005,241,2764,2043,6422,79141,0,2011,1494,23.5,966,727,222,153,1148,2764,249
2012,36061026700,"Census Tract 267, New York County, New York",624,96,528,524,1525,35673,1939,1998,1118,36.4,153,265,47,0,242,528,206
2013,36061026700,"Census Tract 267, New York County, New York",604,93,511,507,1550,34635,1940,2001,1264,38.9,158,258,44,0,237,511,186
2014,36061026700,"Census Tract 267, New York County, New York",634,73,561,556,1743,41765,1939,2003,1308,33.1,237,284,35,0,238,561,128
2015,36061026700,"Census Tract 267, New York County, New York",639,68,571,567,1795,38939,1939,2004,1251,33.7,211,261,45,0,270,571,99
2016,36061026700,"Census Tract 267, New York County, New York",634,62,572,572,1657,36935,1939,2007,1263,40.8,256,287,51,0,237,572,111
2017,36061026700,"Census Tract 267, New York County, New York",626,49,577,577,1643,38911,1939,2009,1275,39.2,259,288,32,0,259,577,79
2018,36061026700,"Census Tract 267, New York County, New York",628,79,549,549,1540,39638,0,2010,1379,40.1,266,288,28,3,232,549,90
2019,36061026700,"Census Tract 267, New York County, New York",632,94,538,538,1495,43542,1941,2011,1520,36,278,290,22,3,239,538,90
2020,36061026700,"Census Tract 267, New York County, New York",616,85,531,531,1474,57847,1941,2013,1570,29.8,282,281,15,10,225,531,100
2012,36061026900,"Census Tract 269, New York County, New York",2835,247,2588,2416,8247,26352,1939,1995,951,44.8,403,108,237,93,2142,2588,940
2013,36061026900,"Census Tract 269, New York County, New York",2787,239,2548,2382,8285,28209,1939,1993,970,44.4,335,112,260,56,2127,2548,942
2014,36061026900,"Census Tract 269, New York County, New York",2791,261,2530,2387,8538,33603,1939,1997,1085,38.5,336,120,290,45,2122,2530,770
2015,36061026900,"Census Tract 269, New York County, New York",2807,239,2568,2408,7971,NA,1939,2000,1101,35.9,436,143,263,27,2123,2568,668
2016,36061026900,"Census Tract 269, New York County, New York",2875,145,2730,2589,8830,33006,1939,2001,1126,37.5,449,118,370,31,2283,2730,780
2017,36061026900,"Census Tract 269, New York County, New York",2926,145,2781,2704,9215,37549,1939,2002,1181,36.7,450,138,447,44,2292,2781,812
2018,36061026900,"Census Tract 269, New York County, New York",2915,143,2772,2676,8569,42350,0,2003,1230,34.1,570,130,410,86,2231,2772,613
2019,36061026900,"Census Tract 269, New York County, New York",2971,136,2835,2755,8531,41025,0,2004,1300,33.6,529,141,404,109,2215,2835,703
2020,36061026900,"Census Tract 269, New York County, New York",2954,163,2791,2713,9140,52446,0,2003,1235,32.6,446,89,327,95,2240,2791,657
2012,36061027100,"Census Tract 271, New York County, New York",3039,166,2873,2696,8676,45963,1939,1998,1156,30.1,793,897,191,27,1668,2873,639
2013,36061027100,"Census Tract 271, New York County, New York",3005,86,2919,2708,8665,45326,1939,1998,1177,29.9,825,853,190,29,1734,2919,729
2014,36061027100,"Census Tract 271, New York County, New York",3032,59,2973,2742,8791,48609,1939,2000,1268,29.4,1000,862,213,56,1739,2973,755
2015,36061027100,"Census Tract 271, New York County, New York",3074,34,3040,2823,9056,48680,1939,2001,1282,29.8,1160,875,198,46,1793,3040,828
2016,36061027100,"Census Tract 271, New York County, New York",3088,27,3061,2816,9042,49962,1939,2002,1333,29.3,1314,894,171,94,1779,3061,803
2017,36061027100,"Census Tract 271, New York County, New York",3077,76,3001,2714,8848,55273,1939,2004,1404,29.6,1169,884,113,74,1729,3001,785
2018,36061027100,"Census Tract 271, New York County, New York",3083,79,3004,2745,8948,58786,0,2005,1505,29.5,1225,885,157,97,1728,3004,709
2019,36061027100,"Census Tract 271, New York County, New York",3110,154,2956,2631,7859,66146,0,2007,1463,28.6,1238,1026,180,91,1470,2956,631
2020,36061027100,"Census Tract 271, New York County, New York",3036,116,2920,2590,7752,66957,0,2007,1560,29.2,1232,1088,146,98,1376,2920,555
2012,36061027300,"Census Tract 273, New York County, New York",3347,169,3178,2333,4956,58525,1939,2002,1370,30.9,1448,1415,86,68,724,3178,388
2013,36061027300,"Census Tract 273, New York County, New York",3314,52,3262,2404,5356,65809,1939,2003,1504,29.3,1567,1464,179,60,686,3262,425
2014,36061027300,"Census Tract 273, New York County, New York",3374,111,3263,2504,5338,66436,1939,2003,1493,27.8,1736,1472,171,62,774,3263,501
2015,36061027300,"Census Tract 273, New York County, New York",3356,137,3219,2479,5438,71847,1939,2005,1519,24.7,1837,1490,169,119,713,3219,440
2016,36061027300,"Census Tract 273, New York County, New York",3344,238,3106,2340,5300,65521,1939,2008,1625,29.4,1781,1429,185,97,592,3106,380
2017,36061027300,"Census Tract 273, New York County, New York",3366,282,3084,2364,5486,73891,1939,2009,1725,27.1,1829,1486,171,94,612,3084,321
2018,36061027300,"Census Tract 273, New York County, New York",3446,305,3141,2425,5599,77449,0,2010,1791,25.8,1869,1520,140,89,635,3141,215
2019,36061027300,"Census Tract 273, New York County, New York",3409,222,3187,2462,5458,79322,0,2011,1842,27.3,1858,1530,196,73,680,3187,123
2020,36061027300,"Census Tract 273, New York County, New York",3374,225,3149,2317,5080,92177,0,2012,1945,28.2,1733,1461,233,16,594,3149,109
2012,36061027500,"Census Tract 275, New York County, New York",1690,149,1541,801,1438,65707,1939,1997,1549,26.2,496,646,31,49,86,1541,61
2013,36061027500,"Census Tract 275, New York County, New York",1686,126,1560,835,1804,65489,1939,1998,1507,25.9,529,633,22,47,145,1560,72
2014,36061027500,"Census Tract 275, New York County, New York",1690,117,1573,849,1916,77986,1939,2001,1559,25.7,528,542,62,63,202,1573,124
2015,36061027500,"Census Tract 275, New York County, New York",1680,78,1602,847,2109,67344,1939,2002,1525,32.8,560,480,62,52,270,1602,158
2016,36061027500,"Census Tract 275, New York County, New York",1666,119,1547,794,1980,78750,1939,2005,1672,30.6,522,464,70,44,230,1547,144
2017,36061027500,"Census Tract 275, New York County, New York",1652,102,1550,789,1974,65139,1939,2004,1700,33.8,487,428,81,44,254,1550,142
2018,36061027500,"Census Tract 275, New York County, New York",1641,121,1520,729,1740,64760,0,2007,1796,35.9,500,389,74,45,252,1520,109
2019,36061027500,"Census Tract 275, New York County, New York",1658,140,1518,698,1615,71389,0,2008,1887,32.6,529,475,5,45,186,1518,85
2020,36061027500,"Census Tract 275, New York County, New York",1626,166,1460,628,1371,85263,0,2012,1962,29.8,488,458,0,55,121,1460,85
2012,36061027700,"Census Tract 277, New York County, New York",2166,163,2003,2003,5916,27568,1939,1998,937,32.7,386,222,196,0,1669,2003,765
2013,36061027700,"Census Tract 277, New York County, New York",2121,98,2023,2023,6134,26517,1939,1996,985,36.9,426,214,168,0,1700,2023,824
2014,36061027700,"Census Tract 277, New York County, New York",2166,31,2135,2135,6435,28302,1939,1995,1022,33.8,445,257,186,0,1769,2135,804
2015,36061027700,"Census Tract 277, New York County, New York",2203,35,2168,2168,6183,28449,1939,2000,1082,38.2,433,261,234,37,1697,2168,858
2016,36061027700,"Census Tract 277, New York County, New York",2233,38,2195,2195,5949,25896,1939,1999,1071,41.2,336,234,277,59,1749,2195,843
2017,36061027700,"Census Tract 277, New York County, New York",2209,65,2144,2144,6397,31327,1939,2003,1166,42.9,413,320,260,79,1596,2144,767
2018,36061027700,"Census Tract 277, New York County, New York",2233,113,2120,2120,5485,30125,0,2004,1172,45.1,504,385,305,101,1478,2120,713
2019,36061027700,"Census Tract 277, New York County, New York",2269,109,2160,2160,5397,28864,0,2005,1203,47.2,607,443,280,115,1481,2160,786
2020,36061027700,"Census Tract 277, New York County, New York",2283,130,2153,2153,5558,21525,0,2004,1221,51,727,391,232,64,1665,2153,927
2012,36061027900,"Census Tract 279, New York County, New York",4078,66,4012,3917,10987,42423,1939,2001,1139,30.4,1497,1016,552,84,2449,4012,790
2013,36061027900,"Census Tract 279, New York County, New York",4068,194,3874,3728,11345,45222,1939,2003,1185,30.5,1490,990,451,123,2332,3874,723
2014,36061027900,"Census Tract 279, New York County, New York",4156,184,3972,3682,10706,47989,1939,2003,1246,31.4,1322,870,441,95,2427,3972,602
2015,36061027900,"Census Tract 279, New York County, New York",4211,287,3924,3654,10598,45059,1939,2004,1285,32.6,1291,872,322,119,2397,3924,631
2016,36061027900,"Census Tract 279, New York County, New York",4239,304,3935,3649,11887,45183,1939,2005,1327,33,1088,859,314,90,2473,3935,829
2017,36061027900,"Census Tract 279, New York County, New York",4324,339,3985,3679,11725,41721,1939,2003,1324,34.9,1141,788,422,104,2532,3985,873
2018,36061027900,"Census Tract 279, New York County, New York",4250,296,3954,3679,11364,43873,0,2004,1476,34.8,1163,864,342,82,2522,3954,924
2019,36061027900,"Census Tract 279, New York County, New York",4296,264,4032,3756,11617,46541,0,2006,1477,34.2,1348,935,372,82,2489,4032,918
2020,36061027900,"Census Tract 279, New York County, New York",4320,139,4181,3719,11349,48388,0,2009,1536,34.4,1498,1080,324,70,2354,4181,897
2012,36061028100,"Census Tract 281, New York County, New York",1393,73,1320,913,1994,78203,1939,2000,1667,25.1,727,830,15,14,54,1320,84
2013,36061028100,"Census Tract 281, New York County, New York",1398,81,1317,952,2076,83088,1939,2001,1689,24.3,742,861,21,11,62,1317,81
2014,36061028100,"Census Tract 281, New York County, New York",1414,94,1320,959,2047,92250,1939,2001,1719,22.8,760,888,21,14,43,1320,55
2015,36061028100,"Census Tract 281, New York County, New York",1419,65,1354,1011,2239,102679,1939,2006,1775,23.3,742,910,43,26,44,1354,67
2016,36061028100,"Census Tract 281, New York County, New York",1440,28,1412,1013,2123,94728,1940,2007,1738,23.4,757,886,69,28,41,1412,97
2017,36061028100,"Census Tract 281, New York County, New York",1447,25,1422,1034,2216,93750,1942,2008,1823,24.7,778,878,70,25,71,1422,106
2018,36061028100,"Census Tract 281, New York County, New York",1459,24,1435,1017,2277,91250,1942,2009,1868,25,739,814,67,61,77,1435,90
2019,36061028100,"Census Tract 281, New York County, New York",1465,7,1458,1061,2406,88194,1944,2011,1917,26.8,795,833,51,83,84,1458,92
2020,36061028100,"Census Tract 281, New York County, New York",1520,5,1515,1104,2207,82247,1943,2012,1986,29,910,740,42,65,81,1515,55
2012,36061028300,"Census Tract 283, New York County, New York",3313,169,3144,2515,6322,39139,1939,2001,1047,31.7,818,691,207,92,1577,3144,614
2013,36061028300,"Census Tract 283, New York County, New York",3249,186,3063,2508,6367,42880,1939,2001,1069,28.6,846,729,275,83,1437,3063,624
2014,36061028300,"Census Tract 283, New York County, New York",3298,215,3083,2571,6885,49213,1939,2000,1075,27.4,817,678,234,134,1519,3083,504
2015,36061028300,"Census Tract 283, New York County, New York",3262,122,3140,2573,6604,47124,1939,2001,1111,30.5,904,601,335,155,1527,3140,478
2016,36061028300,"Census Tract 283, New York County, New York",3291,212,3079,2520,6439,50360,1939,2004,1143,30.5,1076,660,412,176,1347,3079,448
2017,36061028300,"Census Tract 283, New York County, New York",3371,184,3187,2626,6744,53780,1942,2004,1244,30.6,1136,679,412,102,1487,3187,475
2018,36061028300,"Census Tract 283, New York County, New York",3369,145,3224,2635,6565,49473,1944,2005,1309,33.3,954,621,357,171,1579,3224,648
2019,36061028300,"Census Tract 283, New York County, New York",3397,151,3246,2639,6747,56006,1944,2007,1351,31.7,982,634,298,159,1678,3246,579
2020,36061028300,"Census Tract 283, New York County, New York",3132,149,2983,2349,6820,59676,1944,2006,1353,28.6,907,481,157,162,1640,2983,525
2012,36061028500,"Census Tract 285, New York County, New York",2804,180,2624,2624,7809,35373,1939,2000,1028,32.1,614,308,334,49,2083,2624,654
2013,36061028500,"Census Tract 285, New York County, New York",2745,139,2606,2606,8101,34409,1939,2001,1075,33.6,664,294,406,58,2061,2606,634
2014,36061028500,"Census Tract 285, New York County, New York",2782,163,2619,2619,7777,32214,1939,2003,1158,35.9,623,283,416,31,2125,2619,735
2015,36061028500,"Census Tract 285, New York County, New York",2830,122,2708,2708,7743,36500,1939,2005,1223,38.2,768,340,409,46,2087,2708,696
2016,36061028500,"Census Tract 285, New York County, New York",2842,160,2682,2682,7013,32164,1939,2006,1101,39.5,814,313,347,49,2142,2682,692
2017,36061028500,"Census Tract 285, New York County, New York",2902,200,2702,2702,7635,43553,1939,2004,1198,33.6,916,409,311,42,2066,2702,630
2018,36061028500,"Census Tract 285, New York County, New York",2941,237,2704,2704,7964,47939,0,2004,1286,32.2,874,406,230,29,2129,2704,591
2019,36061028500,"Census Tract 285, New York County, New York",3002,257,2745,2745,7879,48504,0,2005,1312,32.7,892,407,302,30,2155,2745,548
2020,36061028500,"Census Tract 285, New York County, New York",2779,227,2552,2552,8380,51389,0,2005,1329,30.7,845,391,270,28,1969,2552,525
2012,36061028700,"Census Tract 287, New York County, New York",1742,63,1679,1607,4233,46484,1939,2001,1232,30.8,690,620,131,44,789,1679,343
2013,36061028700,"Census Tract 287, New York County, New York",1738,93,1645,1577,4175,44536,1939,2001,1260,33.1,693,621,121,54,760,1645,290
2014,36061028700,"Census Tract 287, New York County, New York",1765,147,1618,1548,4161,45325,1939,2002,1265,32.9,729,644,105,47,727,1618,276
2015,36061028700,"Census Tract 287, New York County, New York",1751,147,1604,1547,4015,46266,1939,2003,1290,32.5,723,645,95,39,762,1604,353
2016,36061028700,"Census Tract 287, New York County, New York",1763,234,1529,1481,3857,46782,1939,2005,1377,32,744,660,113,40,695,1529,332
2017,36061028700,"Census Tract 287, New York County, New York",1787,220,1567,1518,3943,46724,1939,2005,1421,31.8,769,690,79,37,743,1567,316
2018,36061028700,"Census Tract 287, New York County, New York",1783,201,1582,1529,3935,49556,0,2006,1508,33.5,704,641,105,24,818,1582,365
2019,36061028700,"Census Tract 287, New York County, New York",1812,171,1641,1585,4062,56518,0,2005,1574,34.2,698,636,83,23,905,1641,299
2020,36061028700,"Census Tract 287, New York County, New York",1817,188,1629,1580,4035,61897,0,2010,1652,33.2,631,557,105,58,877,1629,293
2012,36061029100,"Census Tract 291, New York County, New York",3918,75,3843,3718,12241,36031,1939,2001,1012,32.6,603,207,407,31,3308,3843,1082
2013,36061029100,"Census Tract 291, New York County, New York",3860,113,3747,3664,12017,31029,1939,2000,1015,33.6,606,221,313,42,3241,3747,1171
2014,36061029100,"Census Tract 291, New York County, New York",3992,93,3899,3809,12037,29303,1939,2001,1040,35.5,631,215,322,79,3353,3899,1215
2015,36061029100,"Census Tract 291, New York County, New York",4024,94,3930,3808,12078,28570,1939,2003,1032,34.9,599,250,332,83,3287,3930,1204
2016,36061029100,"Census Tract 291, New York County, New York",4143,67,4076,3944,11891,30338,1939,2004,1120,33.7,647,393,424,108,3177,4076,1098
2017,36061029100,"Census Tract 291, New York County, New York",4221,99,4122,3962,11799,33201,1939,2005,1183,33.9,699,339,500,96,3244,4122,975
2018,36061029100,"Census Tract 291, New York County, New York",4179,77,4102,3901,12168,44297,0,2007,1273,30.2,856,304,580,146,3125,4102,876
2019,36061029100,"Census Tract 291, New York County, New York",4203,77,4126,3920,11658,44643,0,2010,1296,29.8,1016,391,649,156,3046,4126,997
2020,36061029100,"Census Tract 291, New York County, New York",4303,132,4171,4028,11826,49408,0,2012,1309,29.3,1138,349,785,158,3186,4171,1000
2012,36061029300,"Census Tract 293, New York County, New York",3044,209,2835,2818,8813,34005,1939,2001,1065,34.1,572,202,260,102,2330,2835,809
2013,36061029300,"Census Tract 293, New York County, New York",2985,228,2757,2746,8905,33639,1939,2002,1060,35.9,563,233,238,93,2251,2757,877
2014,36061029300,"Census Tract 293, New York County, New York",3044,239,2805,2789,8983,32915,1939,2001,1119,38.2,555,234,203,97,2331,2805,1015
2015,36061029300,"Census Tract 293, New York County, New York",3067,168,2899,2881,9255,32321,1939,2002,1138,35.8,644,337,272,123,2258,2899,1055
2016,36061029300,"Census Tract 293, New York County, New York",3127,162,2965,2948,9270,34504,1939,2003,1198,34.1,692,360,310,62,2333,2965,1040
2017,36061029300,"Census Tract 293, New York County, New York",3169,145,3024,3009,9439,37420,1939,2004,1187,28.2,786,375,319,75,2352,3024,871
2018,36061029300,"Census Tract 293, New York County, New York",3178,102,3076,3053,8772,37099,0,2005,1215,28.6,761,378,382,53,2402,3076,881
2019,36061029300,"Census Tract 293, New York County, New York",3224,31,3193,3167,9288,41384,0,2007,1208,26.9,826,387,472,29,2529,3193,728
2020,36061029300,"Census Tract 293, New York County, New York",3140,99,3041,3027,9498,51864,0,2006,1240,25.8,946,401,377,17,2421,3041,586
2012,36061029500,"Census Tract 295, New York County, New York",3451,289,3162,2869,7065,54848,1939,2001,1256,28.4,1596,1061,184,50,1473,3162,457
2013,36061029500,"Census Tract 295, New York County, New York",3452,279,3173,2833,6650,56362,1939,2002,1278,28.6,1526,1090,190,110,1332,3173,491
2014,36061029500,"Census Tract 295, New York County, New York",3503,252,3251,2972,7662,62610,1939,2003,1341,26.5,1414,1245,86,139,1412,3251,349
2015,36061029500,"Census Tract 295, New York County, New York",3544,221,3323,3023,7483,63662,1939,2004,1344,25.1,1497,1197,45,191,1443,3323,433
2016,36061029500,"Census Tract 295, New York County, New York",3578,182,3396,3075,7755,61834,1939,2005,1366,25.4,1476,1335,67,188,1379,3396,492
2017,36061029500,"Census Tract 295, New York County, New York",3554,97,3457,3089,7737,67482,1939,2005,1430,24.9,1504,1405,83,219,1358,3457,432
2018,36061029500,"Census Tract 295, New York County, New York",3522,124,3398,3020,7506,71518,0,2007,1528,25.9,1645,1508,216,185,1152,3398,329
2019,36061029500,"Census Tract 295, New York County, New York",3542,188,3354,2996,7503,66402,0,2010,1611,28.6,1638,1403,266,129,1247,3354,384
2020,36061029500,"Census Tract 295, New York County, New York",3481,215,3266,3001,7358,75664,0,2012,1658,24.8,1622,1313,335,164,1335,3266,231
2012,36061029700,"Census Tract 297, New York County, New York",0,0,0,0,0,NA,NA,NA,NA,NA,0,0,0,0,0,0,0
2013,36061029700,"Census Tract 297, New York County, New York",0,0,0,0,0,NA,NA,NA,NA,NA,0,0,0,0,0,0,0
2014,36061029700,"Census Tract 297, New York County, New York",0,0,0,0,0,NA,NA,NA,NA,NA,0,0,0,0,0,0,0
2015,36061029700,"Census Tract 297, New York County, New York",0,0,0,0,0,NA,NA,NA,NA,NA,0,0,0,0,0,0,0
2016,36061029700,"Census Tract 297, New York County, New York",0,0,0,0,0,NA,NA,NA,NA,NA,0,0,0,0,0,0,0
2017,36061029700,"Census Tract 297, New York County, New York",0,0,0,0,0,NA,NA,NA,NA,NA,0,0,0,0,0,0,0
2018,36061029700,"Census Tract 297, New York County, New York",0,0,0,0,0,NA,NA,NA,NA,NA,0,0,0,0,0,0,0
2019,36061029700,"Census Tract 297, New York County, New York",0,0,0,0,0,NA,NA,NA,NA,NA,0,0,0,0,0,0,0
2020,36061029700,"Census Tract 297, New York County, New York",0,0,0,0,0,NA,NA,NA,NA,NA,0,0,0,0,0,0,0
2012,36061029900,"Census Tract 299, New York County, New York",1536,92,1444,1436,4168,21789,1954,1998,548,26.9,166,56,483,17,992,1444,470
2013,36061029900,"Census Tract 299, New York County, New York",1533,91,1442,1436,4273,21299,1954,1998,547,27.4,177,84,432,20,989,1442,493
2014,36061029900,"Census Tract 299, New York County, New York",1544,110,1434,1426,4270,20152,1953,1999,546,28.8,180,69,367,0,1039,1434,548
2015,36061029900,"Census Tract 299, New York County, New York",1552,88,1464,1459,4548,23549,1953,2001,616,30,193,75,368,0,1071,1464,565
2016,36061029900,"Census Tract 299, New York County, New York",1569,83,1486,1482,4597,24542,1953,2001,657,30.8,191,56,326,0,1157,1486,604
2017,36061029900,"Census Tract 299, New York County, New York",1618,68,1550,1521,4242,21431,1951,1998,693,32.2,212,54,358,0,1198,1550,768
2018,36061029900,"Census Tract 299, New York County, New York",1614,36,1578,1552,3972,19804,1951,1998,686,32.3,215,50,339,9,1243,1578,770
2019,36061029900,"Census Tract 299, New York County, New York",1629,50,1579,1563,3693,18976,1952,1998,566,32.8,213,60,408,9,1215,1579,764
2020,36061029900,"Census Tract 299, New York County, New York",1587,65,1522,1501,3443,19982,1952,1998,594,32.5,217,61,430,10,1111,1522,676
2012,36061030300,"Census Tract 303, New York County, New York",1836,60,1776,1688,3357,53103,1939,2002,1252,28.5,953,799,116,86,689,1776,288
2013,36061030300,"Census Tract 303, New York County, New York",1834,62,1772,1674,3896,52035,1939,2003,1338,28.3,853,835,126,46,711,1772,374
2014,36061030300,"Census Tract 303, New York County, New York",1866,41,1825,1690,4195,52404,1939,2004,1347,28.6,863,806,118,43,740,1825,408
2015,36061030300,"Census Tract 303, New York County, New York",1869,62,1807,1670,4478,53387,1939,2005,1386,28.1,845,770,163,35,722,1807,389
2016,36061030300,"Census Tract 303, New York County, New York",1880,70,1810,1683,4694,57658,1939,2006,1428,27.8,837,758,181,53,740,1810,382
2017,36061030300,"Census Tract 303, New York County, New York",1899,65,1834,1730,4955,61286,1939,2007,1581,29,874,860,227,82,660,1834,337
2018,36061030300,"Census Tract 303, New York County, New York",1918,101,1817,1707,4401,70938,0,2008,1630,28.2,886,808,217,83,673,1817,211
2019,36061030300,"Census Tract 303, New York County, New York",1929,90,1839,1730,4351,64559,0,2010,1625,28.4,951,796,188,97,738,1839,176
2020,36061030300,"Census Tract 303, New York County, New York",1901,164,1737,1613,4058,77775,0,2011,1669,27,857,778,135,85,686,1737,131
2012,36061030700,"Census Tract 307, New York County, New York",1888,146,1742,962,2090,50962,1939,1997,1320,28.8,563,630,86,22,242,1742,82
2013,36061030700,"Census Tract 307, New York County, New York",1876,122,1754,1019,2228,51793,1939,1999,1311,27.9,606,700,98,27,248,1754,57
2014,36061030700,"Census Tract 307, New York County, New York",1902,126,1776,1004,2083,57133,1939,2002,1363,25,544,647,37,26,289,1776,70
2015,36061030700,"Census Tract 307, New York County, New York",1911,126,1785,1028,2074,55625,1939,2004,1433,27.4,515,741,33,24,226,1785,108
2016,36061030700,"Census Tract 307, New York County, New York",1923,87,1836,1150,2402,53281,1939,2005,1483,28.7,549,732,71,32,306,1836,169
2017,36061030700,"Census Tract 307, New York County, New York",1957,75,1882,1184,2440,58152,1939,2005,1464,27.3,627,761,91,31,293,1882,162
2018,36061030700,"Census Tract 307, New York County, New York",1933,74,1859,1139,2350,65375,0,2007,1586,27.4,570,698,81,44,324,1859,181
2019,36061030700,"Census Tract 307, New York County, New York",1943,111,1832,1054,2396,79141,0,2006,1658,25.8,612,601,105,35,330,1832,118
2020,36061030700,"Census Tract 307, New York County, New York",1937,151,1786,1005,2244,80906,0,2010,1658,26.6,672,479,106,39,355,1786,112
2012,36061030900,"Census Tract 309, New York County, New York",3451,85,3366,3221,9130,26882,1951,2002,860,29.4,692,127,1055,33,2161,3366,959
2013,36061030900,"Census Tract 309, New York County, New York",3412,101,3311,3113,8677,23464,1952,2001,767,31.4,621,126,1037,20,2112,3311,1021
2014,36061030900,"Census Tract 309, New York County, New York",3539,59,3480,3255,8877,25413,1952,2002,826,31.1,705,182,1043,17,2151,3480,1015
2015,36061030900,"Census Tract 309, New York County, New York",3582,115,3467,3193,8658,25279,1952,2002,928,33.5,737,222,829,0,2234,3467,989
2016,36061030900,"Census Tract 309, New York County, New York",3630,142,3488,3199,8660,25897,1951,2004,1006,36.1,769,267,932,0,2162,3488,917
2017,36061030900,"Census Tract 309, New York County, New York",3873,126,3747,3403,8874,27836,1951,2004,1046,35.6,801,235,1200,0,2273,3747,1085
2018,36061030900,"Census Tract 309, New York County, New York",4016,140,3876,3627,9632,29287,1951,2006,1122,33.5,836,262,1097,0,2592,3876,1069
2019,36061030900,"Census Tract 309, New York County, New York",4074,169,3905,3769,9986,30023,1951,2005,1142,33.1,780,246,1220,8,2708,3905,1018
2020,36061030900,"Census Tract 309, New York County, New York",4016,103,3913,3755,10482,30464,1951,2004,1170,34.1,773,243,1351,0,2704,3913,1241
2012,36061031100,"Census Tract 311, New York County, New York",0,0,0,0,0,NA,NA,NA,NA,NA,0,0,0,0,0,0,0
2013,36061031100,"Census Tract 311, New York County, New York",0,0,0,0,0,NA,NA,NA,NA,NA,0,0,0,0,0,0,0
2014,36061031100,"Census Tract 311, New York County, New York",0,0,0,0,0,NA,NA,NA,NA,NA,0,0,0,0,0,0,0
2015,36061031100,"Census Tract 311, New York County, New York",0,0,0,0,0,NA,NA,NA,NA,NA,0,0,0,0,0,0,0
2016,36061031100,"Census Tract 311, New York County, New York",0,0,0,0,0,NA,NA,NA,NA,NA,0,0,0,0,0,0,0
2017,36061031100,"Census Tract 311, New York County, New York",0,0,0,0,0,NA,NA,NA,NA,NA,0,0,0,0,0,0,0
2018,36061031100,"Census Tract 311, New York County, New York",0,0,0,0,0,NA,NA,NA,NA,NA,0,0,0,0,0,0,0
2019,36061031100,"Census Tract 311, New York County, New York",0,0,0,0,0,NA,NA,NA,NA,NA,0,0,0,0,0,0,0
2020,36061031100,"Census Tract 311, New York County, New York",0,0,0,0,0,NA,NA,NA,NA,NA,0,0,0,0,0,0,0
2012,36061031703,"Census Tract 317.03, New York County, New York",3930,362,3568,3465,7544,183558,1996,2005,2001,21.7,3065,2745,24,368,294,3568,133
2013,36061031703,"Census Tract 317.03, New York County, New York",4231,371,3860,3681,8048,164185,1998,2007,2001,23,3258,2955,47,415,226,3860,213
2014,36061031703,"Census Tract 317.03, New York County, New York",4388,476,3912,3746,8118,188958,1997,2008,2001,21.4,3339,3058,62,409,170,3912,200
2015,36061031703,"Census Tract 317.03, New York County, New York",4474,517,3957,3752,8196,174020,1995,2010,2967,21.6,3335,3020,149,423,155,3957,233
2016,36061031703,"Census Tract 317.03, New York County, New York",4570,537,4033,3823,8235,170255,1994,2011,2957,21.5,3239,3063,143,456,135,4033,337
2017,36061031703,"Census Tract 317.03, New York County, New York",2900,488,2412,2191,4882,248295,2003,2012,2962,17,1842,1761,58,285,72,2412,237
2018,36061031703,"Census Tract 317.03, New York County, New York",2780,549,2231,2039,4916,250001,2002,2013,3501,15.5,1653,1492,45,344,144,2231,143
2019,36061031703,"Census Tract 317.03, New York County, New York",2772,481,2291,2077,5059,250001,2002,2015,3435,14.8,1668,1574,28,329,133,2291,110
2020,36061031703,"Census Tract 317.03, New York County, New York",2840,341,2499,2284,5360,250001,2001,2016,3501,14.7,1563,1658,72,301,206,2499,88
2012,36061031704,"Census Tract 317.04, New York County, New York",3666,896,2770,1791,3712,121835,1988,2006,2001,23.7,1252,1237,92,260,173,2770,127
2013,36061031704,"Census Tract 317.04, New York County, New York",3790,709,3081,1890,4054,127292,1988,2008,2001,22.9,1327,1293,66,270,246,3081,124
2014,36061031704,"Census Tract 317.04, New York County, New York",3873,797,3076,1921,3923,130691,1987,2010,2001,22.6,1416,1422,74,172,224,3076,140
2015,36061031704,"Census Tract 317.04, New York County, New York",3926,666,3260,2025,4220,125330,1987,2011,2883,23,1561,1433,39,238,282,3260,116
2016,36061031704,"Census Tract 317.04, New York County, New York",3918,532,3386,2145,4398,150313,1988,2012,2928,21.9,1733,1536,0,276,302,3386,190
2017,36061031704,"Census Tract 317.04, New York County, New York",5622,698,4924,3430,7133,160239,1986,2012,3177,24.1,2932,2617,83,400,288,4924,218
2018,36061031704,"Census Tract 317.04, New York County, New York",5629,809,4820,3361,6949,167292,1986,2012,3326,23.5,2857,2512,86,432,289,4820,207
2019,36061031704,"Census Tract 317.04, New York County, New York",5738,863,4875,3169,6704,180933,1986,2013,3385,22.1,2805,2229,140,414,414,4875,232
2020,36061031704,"Census Tract 317.04, New York County, New York",5741,807,4934,3307,6760,170742,1985,2015,3501,22.1,2842,2496,32,314,457,4934,225
2012,36061031900,"Census Tract 319, New York County, New York",0,0,0,0,0,NA,NA,NA,NA,NA,0,0,0,0,0,0,0
2013,36061031900,"Census Tract 319, New York County, New York",0,0,0,0,0,NA,NA,NA,NA,NA,0,0,0,0,0,0,0
2014,36061031900,"Census Tract 319, New York County, New York",0,0,0,0,0,NA,NA,NA,NA,NA,0,0,0,0,0,0,0
2015,36061031900,"Census Tract 319, New York County, New York",0,0,0,0,0,NA,NA,NA,NA,NA,0,0,0,0,0,0,0
2016,36061031900,"Census Tract 319, New York County, New York",0,0,0,0,0,NA,NA,NA,NA,NA,0,0,0,0,0,0,0
2017,36061031900,"Census Tract 319, New York County, New York",0,0,0,0,0,NA,NA,NA,NA,NA,0,0,0,0,0,0,0
2018,36061031900,"Census Tract 319, New York County, New York",0,0,0,0,0,NA,NA,NA,NA,NA,0,0,0,0,0,0,0
2019,36061031900,"Census Tract 319, New York County, New York",0,0,0,0,0,NA,NA,NA,NA,NA,0,0,0,0,0,0,0
2020,36061031900,"Census Tract 319, New York County, New York",0,0,0,0,0,NA,NA,NA,NA,NA,0,0,0,0,0,0,0
2012,36081000100,"Census Tract 1, Queens County, New York",2799,376,2423,1937,3418,120095,NA,NA,2001,27.5,1556,1269,84,444,87,2423,230
2013,36081000100,"Census Tract 1, Queens County, New York",3248,430,2818,2339,4018,117083,2005,2010,2001,28.5,1904,1544,56,509,133,2818,263
2014,36081000100,"Census Tract 1, Queens County, New York",3606,425,3181,2634,4731,120400,NA,2011,2001,27.2,2074,1767,86,562,112,3181,361
2015,36081000100,"Census Tract 1, Queens County, New York",4036,706,3330,2814,5230,125057,2006,NA,2846,27.2,2232,1854,118,547,153,3330,356
2016,36081000100,"Census Tract 1, Queens County, New York",4474,928,3546,3098,5770,130592,2007,2013,2983,26.9,2535,1931,149,633,210,3546,347
2017,36081000100,"Census Tract 1, Queens County, New York",4940,1132,3808,3415,6580,135561,2009,2013,3088,26.6,2897,2192,117,706,226,3808,286
2018,36081000100,"Census Tract 1, Queens County, New York",5664,1513,4151,3642,7412,141646,2010,2014,3164,26,3033,2409,166,705,262,4151,243
2019,36081000100,"Census Tract 1, Queens County, New York",6302,1935,4367,3891,8201,150096,2011,2016,3173,25.5,3277,2425,165,881,321,4367,144
2020,36081000101,"Census Tract 1.01, Queens County, New York",2590,386,2204,1672,3707,161780,2013,2017,2880,25.1,1450,842,46,335,244,2204,61
2020,36081000102,"Census Tract 1.02, Queens County, New York",3854,1534,2320,2269,4914,186701,2011,NA,3440,23.1,2072,1474,91,616,121,2320,33
2020,36081000103,"Census Tract 1.03, Queens County, New York",55,55,0,0,0,NA,NA,NA,NA,NA,0,0,0,0,0,0,0
2020,36081000104,"Census Tract 1.04, Queens County, New York",0,0,0,0,0,NA,NA,NA,NA,NA,0,0,0,0,0,0,0
2012,36081000200,"Census Tract 2, Queens County, New York",1003,104,899,408,1353,41686,1943,2004,1289,38.2,123,19,26,88,255,899,148
2013,36081000200,"Census Tract 2, Queens County, New York",1015,90,925,464,1423,43750,1944,2004,1355,38.8,121,32,25,50,341,925,152
2014,36081000200,"Census Tract 2, Queens County, New York",1022,61,961,482,1483,51351,1942,2004,1408,36.8,111,36,12,52,365,961,112
2015,36081000200,"Census Tract 2, Queens County, New York",1009,41,968,430,1346,44342,1939,2004,1400,32.3,109,43,16,56,301,968,128
2016,36081000200,"Census Tract 2, Queens County, New York",1024,34,990,443,1416,63935,1939,2005,1488,24.1,86,48,18,36,337,990,98
2017,36081000200,"Census Tract 2, Queens County, New York",1003,39,964,432,1422,63056,1939,2007,1593,30.8,76,45,15,28,353,964,91
2018,36081000200,"Census Tract 2, Queens County, New York",981,46,935,415,1412,59102,0,2008,1707,31.9,93,38,16,29,341,935,86
2019,36081000200,"Census Tract 2, Queens County, New York",957,60,897,424,1376,47381,1941,2009,1777,34.2,114,38,16,44,334,897,113
2020,36081000200,"Census Tract 2, Queens County, New York",913,89,824,388,1130,42361,0,2009,1800,44.4,117,44,18,48,278,824,67
2012,36081000400,"Census Tract 4, Queens County, New York",1420,99,1321,619,1871,31676,1939,2005,1306,47.4,18,15,96,39,479,1321,217
2013,36081000400,"Census Tract 4, Queens County, New York",1432,94,1338,549,1581,26875,1939,2006,1291,50,13,14,53,60,416,1338,204
2014,36081000400,"Census Tract 4, Queens County, New York",1422,113,1309,499,1428,23750,1939,2007,1350,50,8,23,81,57,331,1309,241
2015,36081000400,"Census Tract 4, Queens County, New York",1350,126,1224,581,1777,35813,1939,2009,1393,47.2,90,34,66,55,417,1224,174
2016,36081000400,"Census Tract 4, Queens County, New York",1396,105,1291,621,2024,40191,1939,2009,1444,42.2,115,40,50,79,443,1291,182
2017,36081000400,"Census Tract 4, Queens County, New York",1331,70,1261,589,2288,44115,1939,2010,1525,39.9,125,18,43,62,456,1261,188
2018,36081000400,"Census Tract 4, Queens County, New York",1281,93,1188,633,2441,53257,0,2010,1554,37.8,190,24,45,88,476,1188,118
2019,36081000400,"Census Tract 4, Queens County, New York",1234,68,1166,640,2504,60600,0,2011,1652,35.7,205,23,48,108,461,1166,135
2020,36081000400,"Census Tract 4, Queens County, New York",1192,115,1077,600,2544,67083,0,2011,1716,32.5,112,8,39,116,412,1077,70
2012,36081000600,"Census Tract 6, Queens County, New York",1130,110,1020,573,1958,44542,1939,2007,1312,35.1,52,53,97,49,368,1020,171
2013,36081000600,"Census Tract 6, Queens County, New York",1108,84,1024,535,1793,44087,1939,2007,1358,36,56,56,60,50,353,1024,178
2014,36081000600,"Census Tract 6, Queens County, New York",1186,140,1046,505,1781,52520,1939,2009,1395,33.3,87,59,64,69,295,1046,178
2015,36081000600,"Census Tract 6, Queens County, New York",1183,113,1070,509,1642,43491,1939,2010,1382,42.2,79,38,34,91,308,1070,211
2016,36081000600,"Census Tract 6, Queens County, New York",1194,109,1085,446,1388,56127,1941,2010,1423,30,72,38,10,80,279,1085,136
2017,36081000600,"Census Tract 6, Queens County, New York",1159,114,1045,366,1168,46029,1942,2010,1597,34.1,111,18,9,71,251,1045,100
2018,36081000600,"Census Tract 6, Queens County, New York",1170,204,966,388,1309,49844,1945,2012,1678,39.1,104,9,14,67,298,966,136
2019,36081000600,"Census Tract 6, Queens County, New York",1176,155,1021,482,1777,53553,1944,2013,1792,38.7,118,0,35,73,373,1021,152
2020,36081000600,"Census Tract 6, Queens County, New York",1140,184,956,429,1674,61641,1942,2015,1808,37.7,85,0,32,48,346,956,142
2012,36081000700,"Census Tract 7, Queens County, New York",2780,317,2463,1836,3342,56786,1939,2004,1531,28.5,1007,1166,27,203,435,2463,162
2013,36081000700,"Census Tract 7, Queens County, New York",2961,263,2698,1941,3533,58264,1939,2004,1578,28.1,1067,1186,66,198,521,2698,141
2014,36081000700,"Census Tract 7, Queens County, New York",3086,221,2865,1949,3488,59638,1939,2005,1665,28.6,1234,1282,53,205,400,2865,187
2015,36081000700,"Census Tract 7, Queens County, New York",3194,241,2953,1982,3711,75246,1939,2007,1782,27.5,1294,1359,46,172,389,2953,194
2016,36081000700,"Census Tract 7, Queens County, New York",3232,330,2902,1957,3978,86696,1939,2009,1888,24.3,1313,1368,44,179,370,2902,173
2017,36081000700,"Census Tract 7, Queens County, New York",3344,475,2869,1852,3831,84697,1939,2012,2068,23.7,1303,1223,45,148,429,2869,166
2018,36081000700,"Census Tract 7, Queens County, New York",3483,629,2854,1783,3654,99904,0,2014,2223,24.6,1328,1168,24,185,365,2854,171
2019,36081000700,"Census Tract 7, Queens County, New York",3633,726,2907,1815,3748,119663,0,2015,2273,23.1,1366,1175,43,191,361,2907,200
2020,36081000701,"Census Tract 7.01, Queens County, New York",1673,480,1193,579,1191,104063,0,2016,2510,20.6,410,455,0,42,71,1193,13
2020,36081000702,"Census Tract 7.02, Queens County, New York",1949,411,1538,1199,2571,107128,0,2016,2337,20.7,934,771,34,162,166,1538,108
2012,36081000800,"Census Tract 8, Queens County, New York",1069,54,1015,460,1792,58889,1939,2006,1496,26,88,58,5,72,330,1015,120
2013,36081000800,"Census Tract 8, Queens County, New York",1067,56,1011,443,1785,34792,1939,2006,1453,25,71,55,7,40,348,1011,179
2014,36081000800,"Census Tract 8, Queens County, New York",1027,58,969,435,1605,29107,1939,2009,1399,36,88,60,7,54,321,969,210
2015,36081000800,"Census Tract 8, Queens County, New York",1014,80,934,349,1322,45917,1939,2011,1420,37.3,105,37,5,51,240,934,161
2016,36081000800,"Census Tract 8, Queens County, New York",1010,76,934,361,1360,37153,1939,2010,1486,36.2,113,24,13,49,264,934,185
2017,36081000800,"Census Tract 8, Queens County, New York",1017,50,967,319,1108,47083,1939,2011,1475,27.2,73,33,6,19,233,967,152
2018,36081000800,"Census Tract 8, Queens County, New York",981,82,899,319,945,48906,0,2011,1482,29.5,69,24,31,9,225,899,108
2019,36081000800,"Census Tract 8, Queens County, New York",979,49,930,310,883,48152,0,2011,1480,30.7,83,29,36,0,217,930,97
2020,36081000800,"Census Tract 8, Queens County, New York",949,39,910,265,697,66125,0,2013,1518,28.4,70,23,40,1,206,910,46
2012,36081001000,"Census Tract 10, Queens County, New York",1072,105,967,561,1878,40688,1939,2005,1283,33,124,164,56,119,245,967,82
2013,36081001000,"Census Tract 10, Queens County, New York",1078,91,987,537,1815,44554,1939,2007,1310,29.3,113,138,62,81,273,987,99
2014,36081001000,"Census Tract 10, Queens County, New York",1022,85,937,482,1590,44744,1939,2008,1257,30,99,135,59,64,243,937,98
2015,36081001000,"Census Tract 10, Queens County, New York",1009,57,952,464,1764,45417,1939,2010,1344,31.3,96,110,47,81,226,952,101
2016,36081001000,"Census Tract 10, Queens County, New York",1010,72,938,458,1809,48594,1939,2011,1512,33.3,87,104,40,77,242,938,124
2017,36081001000,"Census Tract 10, Queens County, New York",1010,42,968,478,2037,55147,1939,2011,1574,31.5,81,84,43,85,271,968,138
2018,36081001000,"Census Tract 10, Queens County, New York",993,48,945,421,1837,55625,0,2012,1674,32.8,80,79,20,69,263,945,117
2019,36081001000,"Census Tract 10, Queens County, New York",1024,39,985,508,2378,74773,0,2013,1762,27,92,83,16,94,326,985,108
2020,36081001000,"Census Tract 10, Queens County, New York",1029,42,987,523,2419,73958,0,2013,1906,31.1,103,69,20,63,391,987,68
2012,36081001200,"Census Tract 12, Queens County, New York",1355,71,1284,744,2130,44250,1939,2004,1298,38,160,170,75,82,408,1284,189
2013,36081001200,"Census Tract 12, Queens County, New York",1355,75,1280,671,2035,60993,1939,2005,1348,28.9,165,138,59,57,436,1280,178
2014,36081001200,"Census Tract 12, Queens County, New York",1426,71,1355,646,2067,56250,1939,2005,1401,29.4,195,111,103,49,385,1355,147
2015,36081001200,"Census Tract 12, Queens County, New York",1460,31,1429,668,1949,47946,1939,2004,1381,32.8,211,180,68,58,353,1429,181
2016,36081001200,"Census Tract 12, Queens County, New York",1410,80,1330,620,1882,42057,1939,2007,1457,35.1,174,170,66,80,302,1330,150
2017,36081001200,"Census Tract 12, Queens County, New York",1359,89,1270,607,1886,40995,1939,2007,1492,36.3,139,175,49,100,279,1270,163
2018,36081001200,"Census Tract 12, Queens County, New York",1341,112,1229,694,2067,44028,0,2008,1552,38.4,165,215,82,81,320,1229,81
2019,36081001200,"Census Tract 12, Queens County, New York",1267,111,1156,756,2071,48125,0,2008,1536,36.5,200,219,55,128,373,1156,106
2020,36081001200,"Census Tract 12, Queens County, New York",1279,140,1139,810,2319,73289,0,2011,1522,29.7,169,210,24,83,507,1139,88
2012,36081001400,"Census Tract 14, Queens County, New York",1198,150,1048,517,2123,65302,1939,2004,1505,23.8,261,144,0,88,267,1048,162
2013,36081001400,"Census Tract 14, Queens County, New York",1152,124,1028,495,1741,63859,1939,2004,1509,24.9,224,114,0,65,316,1028,110
2014,36081001400,"Census Tract 14, Queens County, New York",1167,127,1040,516,1959,69375,1941,2005,1582,25,150,89,23,31,373,1040,56
2015,36081001400,"Census Tract 14, Queens County, New York",1221,147,1074,514,2002,61071,1948,2007,1705,31.5,88,74,22,53,365,1074,87
2016,36081001400,"Census Tract 14, Queens County, New York",1218,150,1068,584,2171,62500,1943,2008,1670,32.7,105,75,45,55,409,1068,56
2017,36081001400,"Census Tract 14, Queens County, New York",1198,150,1048,565,2126,62809,1947,2008,1657,32.8,81,93,43,40,389,1048,66
2018,36081001400,"Census Tract 14, Queens County, New York",1214,150,1064,572,2170,59792,1942,2011,1645,30.9,122,137,42,29,364,1064,82
2019,36081001400,"Census Tract 14, Queens County, New York",1155,111,1044,516,1977,59348,0,2012,1704,30.5,132,122,21,35,338,1044,90
2020,36081001400,"Census Tract 14, Queens County, New York",1302,109,1193,576,1753,66042,0,2015,1654,28.5,115,96,78,132,270,1193,109
2012,36081001600,"Census Tract 16, Queens County, New York",847,46,801,230,954,11724,1939,2007,1289,50,5,22,24,0,157,801,258
2013,36081001600,"Census Tract 16, Queens County, New York",880,38,842,270,1183,19808,1939,2005,1345,50,4,13,38,0,200,842,256
2014,36081001600,"Census Tract 16, Queens County, New York",887,46,841,246,1051,47679,1939,2011,1327,33.4,11,16,42,4,164,841,194
2015,36081001600,"Census Tract 16, Queens County, New York",875,67,808,325,1423,45096,1939,2010,1406,37.3,21,23,49,5,241,808,171
2016,36081001600,"Census Tract 16, Queens County, New York",879,100,779,318,1276,39824,1944,2010,1389,36.4,51,29,19,9,263,779,168
2017,36081001600,"Census Tract 16, Queens County, New York",885,82,803,304,1107,51324,1939,2007,1459,29.6,44,27,36,10,231,803,107
2018,36081001600,"Census Tract 16, Queens County, New York",854,61,793,269,859,53603,0,2010,1449,32.3,34,40,27,11,201,793,98
2019,36081001600,"Census Tract 16, Queens County, New York",769,33,736,232,815,54250,0,2009,1479,32,48,39,28,16,157,736,65
2020,36081001600,"Census Tract 16, Queens County, New York",783,53,730,260,888,56548,0,2011,1467,32.9,30,32,29,20,187,730,43
2012,36081001800,"Census Tract 18, Queens County, New York",962,0,962,493,1631,39063,1939,2005,1236,37.7,158,43,34,91,339,962,227
2013,36081001800,"Census Tract 18, Queens County, New York",946,0,946,504,1722,47545,1939,2007,1301,37.5,188,66,37,62,336,946,178
2014,36081001800,"Census Tract 18, Queens County, New York",938,16,922,517,1960,34199,1939,2008,1350,39.5,121,68,30,82,325,922,217
2015,36081001800,"Census Tract 18, Queens County, New York",943,17,926,492,1679,NA,1939,2010,1331,39.7,121,75,36,61,306,926,194
2016,36081001800,"Census Tract 18, Queens County, New York",953,55,898,457,1508,37404,1939,2011,1340,38.2,90,47,31,56,310,898,149
2017,36081001800,"Census Tract 18, Queens County, New York",921,70,851,403,1224,42798,1939,2012,1471,38.1,54,39,7,36,301,851,129
2018,36081001800,"Census Tract 18, Queens County, New York",887,79,808,407,1312,NA,0,2013,1700,29.9,67,26,6,50,325,808,72
2019,36081001800,"Census Tract 18, Queens County, New York",904,61,843,404,1155,45128,0,2013,1710,41.4,71,24,6,43,331,843,71
2020,36081001800,"Census Tract 18, Queens County, New York",885,68,817,362,1147,38654,0,2014,1790,45.4,47,16,0,51,295,817,94
2012,36081001900,"Census Tract 19, Queens County, New York",589,90,499,263,564,69208,1957,2007,1511,24.6,183,166,6,18,73,499,13
2013,36081001900,"Census Tract 19, Queens County, New York",683,67,616,318,676,72024,1970,2010,1633,24.2,229,196,6,42,74,616,53
2014,36081001900,"Census Tract 19, Queens County, New York",795,60,735,359,693,104764,2001,2011,2001,24.2,306,239,6,51,63,735,79
2015,36081001900,"Census Tract 19, Queens County, New York",1011,134,877,510,996,107500,2007,NA,2573,24.9,442,294,5,107,84,877,68
2016,36081001900,"Census Tract 19, Queens County, New York",1394,389,1005,640,1155,121667,2011,2013,2762,23.6,573,390,15,134,74,1005,76
2017,36081001900,"Census Tract 19, Queens County, New York",1910,643,1267,853,1578,131917,2012,2014,2909,23.9,783,465,10,266,86,1267,112
2018,36081001900,"Census Tract 19, Queens County, New York",2786,1050,1736,1302,2504,132857,NA,NA,3004,25,1093,692,32,409,132,1736,128
2019,36081001900,"Census Tract 19, Queens County, New York",3800,1607,2193,1773,3438,139063,18,2017,3106,24.6,1516,845,65,630,196,2193,194
2020,36081001901,"Census Tract 19.01, Queens County, New York",781,292,489,367,687,150341,18,NA,2878,26.2,265,171,77,55,44,489,6
2020,36081001902,"Census Tract 19.02, Queens County, New York",3136,1409,1727,1415,2587,118221,18,NA,3258,26.1,1176,591,28,599,218,1727,134
2020,36081001903,"Census Tract 19.03, Queens County, New York",1497,827,670,611,1444,148125,2013,2016,3128,23.3,476,254,14,236,89,670,84
2012,36081002000,"Census Tract 20, Queens County, New York",532,33,499,214,752,51250,1957,2005,1332,28.4,34,4,46,26,129,499,50
2013,36081002000,"Census Tract 20, Queens County, New York",529,38,491,236,838,51875,2000,2005,1399,27.3,49,3,39,37,144,491,58
2014,36081002000,"Census Tract 20, Queens County, New York",532,31,501,225,803,55288,2002,2006,1525,27.5,68,19,25,38,134,501,74
2015,36081002000,"Census Tract 20, Queens County, New York",538,22,516,235,875,51908,2002,2006,1542,32.5,64,27,23,41,133,516,85
2016,36081002000,"Census Tract 20, Queens County, New York",549,23,526,212,832,55714,1945,2008,1600,27,69,26,0,47,124,526,59
2017,36081002000,"Census Tract 20, Queens County, New York",532,37,495,204,823,81429,2001,2008,1779,30.1,60,27,0,48,129,495,51
2018,36081002000,"Census Tract 20, Queens County, New York",521,30,491,210,897,83750,2000,2009,1846,31.4,60,31,0,53,126,491,47
2019,36081002000,"Census Tract 20, Queens County, New York",513,48,465,210,789,72292,2002,2012,1998,34.6,37,12,0,44,154,465,32
2020,36081002000,"Census Tract 20, Queens County, New York",477,42,435,212,781,86324,2003,2013,2220,30.8,59,6,0,30,176,435,26
2012,36081002200,"Census Tract 22, Queens County, New York",753,29,724,546,1226,44936,1939,2004,1130,31.1,86,164,46,40,281,724,56
2013,36081002200,"Census Tract 22, Queens County, New York",756,28,728,513,1190,44471,1939,2005,1138,24.4,90,163,38,59,223,728,91
2014,36081002200,"Census Tract 22, Queens County, New York",733,21,712,483,1177,50417,1939,2005,1169,24.8,116,115,59,65,202,712,93
2015,36081002200,"Census Tract 22, Queens County, New York",759,47,712,438,1230,50789,1939,2006,1205,27.9,73,72,54,48,234,712,103
2016,36081002200,"Census Tract 22, Queens County, New York",760,50,710,408,1202,55469,1939,2007,1346,26.6,87,57,60,54,227,710,90
2017,36081002200,"Census Tract 22, Queens County, New York",794,36,758,441,1285,57760,1939,2009,1438,28.8,122,69,45,85,230,758,87
2018,36081002200,"Census Tract 22, Queens County, New York",776,33,743,429,1212,59135,0,2010,1510,32.2,131,52,40,72,253,743,101
2019,36081002200,"Census Tract 22, Queens County, New York",757,34,723,414,1252,59750,0,2011,1558,35.4,147,59,20,77,245,723,95
2020,36081002200,"Census Tract 22, Queens County, New York",730,17,713,455,1335,60298,0,2011,1524,33.5,184,74,7,85,270,713,87
2012,36081002400,"Census Tract 24, Queens County, New York",738,77,661,260,886,58036,1939,2004,1377,25.1,38,24,46,11,179,661,73
2013,36081002400,"Census Tract 24, Queens County, New York",737,71,666,269,883,59313,1939,2005,1391,23.9,48,28,30,23,188,666,79
2014,36081002400,"Census Tract 24, Queens County, New York",710,79,631,266,876,56774,1939,2005,1440,28.5,46,18,14,18,221,631,91
2015,36081002400,"Census Tract 24, Queens County, New York",710,73,637,298,935,46364,1939,2007,1394,29.8,49,22,26,21,235,637,125
2016,36081002400,"Census Tract 24, Queens County, New York",708,60,648,297,915,48750,1939,2008,1426,29.6,59,19,25,30,228,648,113
2017,36081002400,"Census Tract 24, Queens County, New York",719,70,649,299,982,54135,1948,2011,1456,28.7,69,13,26,38,227,649,100
2018,36081002400,"Census Tract 24, Queens County, New York",738,43,695,304,987,53462,1948,2011,1502,29.8,84,24,26,27,232,695,99
2019,36081002400,"Census Tract 24, Queens County, New York",738,49,689,300,972,51667,1945,2012,1481,29.6,92,28,19,36,217,689,113
2020,36081002400,"Census Tract 24, Queens County, New York",703,64,639,320,1172,44022,1943,2011,1555,40.7,74,34,16,19,251,639,74
2012,36081002500,"Census Tract 25, Queens County, New York",3148,55,3093,3058,7051,20804,1943,2000,492,25.3,294,75,1555,102,1382,3093,1109
2013,36081002500,"Census Tract 25, Queens County, New York",3208,66,3142,3091,6904,20865,1943,2001,508,25.8,276,60,1623,137,1290,3142,1164
2014,36081002500,"Census Tract 25, Queens County, New York",3225,126,3099,3088,6319,19141,1942,2001,486,28.8,264,62,1794,188,1100,3099,1345
2015,36081002500,"Census Tract 25, Queens County, New York",3275,132,3143,3129,6335,16513,1943,2003,419,28.5,179,53,1615,193,1330,3143,1501
2016,36081002500,"Census Tract 25, Queens County, New York",3384,208,3176,3149,6489,15379,1943,2004,339,28,146,0,1540,270,1394,3176,1539
2017,36081002500,"Census Tract 25, Queens County, New York",3447,211,3236,3195,7302,17999,1943,2006,378,27.7,196,122,1599,284,1239,3236,1387
2018,36081002500,"Census Tract 25, Queens County, New York",3463,228,3235,3207,7295,17364,1943,2006,345,26.7,208,125,1656,313,1200,3235,1500
2019,36081002500,"Census Tract 25, Queens County, New York",3359,302,3057,3019,6702,19122,1943,2007,343,26,121,89,1575,259,1167,3057,1288
2020,36081002500,"Census Tract 25, Queens County, New York",3831,464,3367,3336,6569,19041,1943,2010,397,28.7,158,90,1482,276,1020,3367,1516
2012,36081002600,"Census Tract 26, Queens County, New York",697,22,675,302,807,49569,1939,2006,1157,35,35,53,75,21,112,675,37
2013,36081002600,"Census Tract 26, Queens County, New York",682,36,646,280,840,47800,1939,2008,1157,35.9,48,33,77,27,109,646,52
2014,36081002600,"Census Tract 26, Queens County, New York",688,37,651,325,926,47212,1939,2008,1097,36.6,68,44,80,26,156,651,66
2015,36081002600,"Census Tract 26, Queens County, New York",699,39,660,305,1004,35521,1939,2010,1113,38.9,62,47,30,23,187,660,79
2016,36081002600,"Census Tract 26, Queens County, New York",677,28,649,257,932,37344,1939,2010,1179,48.5,85,49,47,24,118,649,89
2017,36081002600,"Census Tract 26, Queens County, New York",665,36,629,255,957,41375,1939,2011,1245,48.9,76,48,45,47,109,629,81
2018,36081002600,"Census Tract 26, Queens County, New York",645,19,626,227,890,40461,0,2011,1361,51,63,36,40,37,109,626,79
2019,36081002600,"Census Tract 26, Queens County, New York",643,26,617,217,873,32330,0,2012,1582,51,42,40,44,41,92,617,77
2020,36081002600,"Census Tract 26, Queens County, New York",670,22,648,141,518,47386,1950,2015,1810,51,17,22,34,15,70,648,34
2012,36081002800,"Census Tract 28, Queens County, New York",974,45,929,592,1812,51250,1939,2005,1284,30.8,94,79,60,121,332,929,147
2013,36081002800,"Census Tract 28, Queens County, New York",971,74,897,624,1847,55526,1939,2006,1219,28.2,84,69,78,113,375,897,159
2014,36081002800,"Census Tract 28, Queens County, New York",958,89,869,617,1732,46477,1939,2008,1204,29.5,94,114,60,83,378,869,189
2015,36081002800,"Census Tract 28, Queens County, New York",1011,60,951,663,1941,47386,1939,2009,1266,28.8,90,128,47,59,443,951,185
2016,36081002800,"Census Tract 28, Queens County, New York",1017,81,936,640,2107,53295,1939,2010,1333,28.9,56,132,34,97,368,936,139
2017,36081002800,"Census Tract 28, Queens County, New York",1014,98,916,656,2108,51154,1939,2011,1338,27.9,65,123,37,103,397,916,135
2018,36081002800,"Census Tract 28, Queens County, New York",1026,95,931,612,2011,46711,0,2011,1412,30.8,56,144,24,89,334,931,157
2019,36081002800,"Census Tract 28, Queens County, New York",1040,99,941,596,2070,49844,1940,2012,1545,31.7,69,110,17,121,316,941,125
2020,36081002800,"Census Tract 28, Queens County, New York",1207,100,1107,745,1981,66624,0,2012,1483,28.4,126,68,86,122,444,1107,102
2012,36081003000,"Census Tract 30, Queens County, New York",463,10,453,196,472,41771,1945,2005,1176,29.4,34,101,10,17,68,453,22
2013,36081003000,"Census Tract 30, Queens County, New York",461,8,453,232,803,35833,1944,2005,1312,45,27,35,9,15,173,453,73
2014,36081003000,"Census Tract 30, Queens County, New York",451,0,451,257,690,23594,1948,2010,1228,50,69,37,22,17,176,451,99
2015,36081003000,"Census Tract 30, Queens County, New York",463,11,452,242,685,24615,1950,2007,1294,50,29,42,26,17,153,452,79
2016,36081003000,"Census Tract 30, Queens County, New York",454,40,414,219,678,31417,1954,2008,1391,46.1,38,45,13,11,145,414,91
2017,36081003000,"Census Tract 30, Queens County, New York",451,35,416,223,730,35208,1939,2009,1591,50,31,63,12,5,134,416,94
2018,36081003000,"Census Tract 30, Queens County, New York",465,37,428,208,706,36923,0,2010,1630,44.4,34,65,12,9,114,428,78
2019,36081003000,"Census Tract 30, Queens County, New York",452,40,412,176,631,42000,0,2009,1664,41.3,35,74,0,9,89,412,71
2020,36081003000,"Census Tract 30, Queens County, New York",434,25,409,135,532,45341,0,2011,1688,37.5,27,51,4,8,68,409,53
2012,36081003100,"Census Tract 31, Queens County, New York",536,39,497,416,1002,56818,1946,2002,1414,28.3,92,244,15,22,123,497,72
2013,36081003100,"Census Tract 31, Queens County, New York",535,61,474,403,987,44583,1939,2004,1387,38.8,111,180,19,43,171,474,74
2014,36081003100,"Census Tract 31, Queens County, New York",504,66,438,382,869,56618,1943,2006,1381,25.5,136,180,20,48,145,438,58
2015,36081003100,"Census Tract 31, Queens County, New York",536,88,448,370,881,55417,1939,2008,1380,28.5,125,136,30,39,179,448,53
2016,36081003100,"Census Tract 31, Queens County, New York",535,109,426,362,867,57727,1939,2010,1461,30.5,137,151,19,40,152,426,43
2017,36081003100,"Census Tract 31, Queens County, New York",541,132,409,357,883,52679,1939,2010,1574,37,109,158,9,47,143,409,54
2018,36081003100,"Census Tract 31, Queens County, New York",553,145,408,335,801,60096,0,2011,1560,28.9,116,160,10,35,127,408,57
2019,36081003100,"Census Tract 31, Queens County, New York",664,199,465,383,904,83203,0,2013,1787,32.9,156,180,9,45,145,465,65
2020,36081003100,"Census Tract 31, Queens County, New York",721,232,489,444,940,88333,0,2015,1757,25.8,203,230,0,73,129,489,66
2012,36081003200,"Census Tract 32, Queens County, New York",454,79,375,177,616,76181,1939,2004,1392,23.3,52,40,36,13,78,375,89
2013,36081003200,"Census Tract 32, Queens County, New York",445,56,389,201,574,70625,1939,2004,1304,23.9,59,63,36,10,71,389,72
2014,36081003200,"Census Tract 32, Queens County, New York",490,67,423,209,696,62266,1954,2006,1505,29.2,44,51,9,17,132,423,46
2015,36081003200,"Census Tract 32, Queens County, New York",494,39,455,200,566,49750,1939,2009,1417,34.6,36,20,11,19,150,455,61
2016,36081003200,"Census Tract 32, Queens County, New York",518,27,491,206,602,44000,1958,2011,1527,40.9,29,21,18,22,145,491,62
2017,36081003200,"Census Tract 32, Queens County, New York",535,32,503,233,587,46250,1958,2011,1433,38.9,37,20,14,23,172,503,68
2018,36081003200,"Census Tract 32, Queens County, New York",538,26,512,223,598,47188,1958,2012,1534,39.6,32,10,15,21,172,512,88
2019,36081003200,"Census Tract 32, Queens County, New York",538,24,514,226,559,40577,1959,2014,1627,47.4,53,6,30,15,151,514,75
2020,36081003200,"Census Tract 32, Queens County, New York",546,33,513,188,442,36818,1963,2015,1546,48.2,29,5,39,15,108,513,98
2012,36081003300,"Census Tract 33, Queens County, New York",881,122,759,617,1973,38750,1944,2004,1573,43.6,224,150,48,227,185,759,225
2013,36081003300,"Census Tract 33, Queens County, New York",974,126,848,701,2159,44083,1946,2006,1607,41.6,267,210,39,254,174,848,262
2014,36081003300,"Census Tract 33, Queens County, New York",1084,95,989,842,2314,45000,1960,2007,1654,41.4,311,268,44,278,235,989,239
2015,36081003300,"Census Tract 33, Queens County, New York",1219,116,1103,945,2349,53210,1952,2011,1691,33.5,428,358,19,303,216,1103,203
2016,36081003300,"Census Tract 33, Queens County, New York",1297,132,1165,1022,2482,56214,1953,2012,1785,31.2,476,405,18,303,201,1165,229
2017,36081003300,"Census Tract 33, Queens County, New York",1580,333,1247,1110,2551,59535,1973,2013,1981,30.8,549,443,9,331,222,1247,185
2018,36081003300,"Census Tract 33, Queens County, New York",1821,438,1383,1200,2651,63393,1992,2013,2120,31.9,616,425,19,398,253,1383,222
2019,36081003300,"Census Tract 33, Queens County, New York",2419,787,1632,1412,2964,92000,2004,2015,2473,29.4,856,542,25,499,237,1632,263
2020,36081003301,"Census Tract 33.01, Queens County, New York",1978,720,1258,1200,2263,136069,2013,2017,2775,22.5,1004,451,46,463,181,1258,114
2020,36081003302,"Census Tract 33.02, Queens County, New York",631,180,451,331,871,40078,0,2012,1712,43.2,94,71,0,170,90,451,90
2012,36081003400,"Census Tract 34, Queens County, New York",714,124,590,185,467,25417,1949,2004,1425,50,17,42,12,10,121,590,93
2013,36081003400,"Census Tract 34, Queens County, New York",691,81,610,205,582,50750,1950,2005,1413,41.1,22,36,12,23,136,610,77
2014,36081003400,"Census Tract 34, Queens County, New York",667,78,589,207,637,46736,1943,2007,1405,40.1,25,51,9,47,101,589,64
2015,36081003400,"Census Tract 34, Queens County, New York",688,48,640,242,738,46176,1939,2009,1396,41.9,38,57,10,44,132,640,98
2016,36081003400,"Census Tract 34, Queens County, New York",697,37,660,270,863,31375,1939,2010,1472,50,35,49,10,61,145,660,119
2017,36081003400,"Census Tract 34, Queens County, New York",709,55,654,258,870,31579,1939,2011,1482,50,36,28,0,86,140,654,128
2018,36081003400,"Census Tract 34, Queens County, New York",698,57,641,271,916,27847,0,2011,1570,51,33,32,11,89,140,641,146
2019,36081003400,"Census Tract 34, Queens County, New York",724,62,662,217,753,27063,0,2011,1658,51,31,17,15,69,119,662,137
2020,36081003400,"Census Tract 34, Queens County, New York",724,57,667,330,1026,43036,0,2014,1477,41.9,13,10,35,71,215,667,114
2012,36081003600,"Census Tract 36, Queens County, New York",1137,181,956,616,2361,55543,1939,2005,1505,34,145,36,112,190,291,956,102
2013,36081003600,"Census Tract 36, Queens County, New York",1111,169,942,572,2025,57375,1943,2005,1331,30.8,184,35,89,191,247,942,68
2014,36081003600,"Census Tract 36, Queens County, New York",1094,179,915,528,1827,67963,1943,2006,1305,27.6,154,37,53,157,226,915,76
2015,36081003600,"Census Tract 36, Queens County, New York",1110,174,936,545,1940,67629,1939,2009,1322,27.1,182,54,67,128,270,936,80
2016,36081003600,"Census Tract 36, Queens County, New York",1052,105,947,530,1991,67868,1939,2010,1323,24.6,171,66,28,137,279,947,56
2017,36081003600,"Census Tract 36, Queens County, New York",1015,118,897,469,1772,58897,1939,2010,1357,29.1,142,78,18,123,235,897,69
2018,36081003600,"Census Tract 36, Queens County, New York",1017,103,914,495,1964,77760,0,2011,1403,24.1,152,70,0,126,299,914,85
2019,36081003600,"Census Tract 36, Queens County, New York",973,92,881,509,2026,71719,0,2012,1469,24.1,176,77,0,132,300,881,79
2020,36081003600,"Census Tract 36, Queens County, New York",1111,120,991,600,2154,71058,1953,2011,1477,24,146,180,30,102,288,991,78
2012,36081003700,"Census Tract 37, Queens County, New York",0,0,0,0,0,NA,NA,NA,NA,NA,0,0,0,0,0,0,0
2013,36081003700,"Census Tract 37, Queens County, New York",0,0,0,0,0,NA,NA,NA,NA,NA,0,0,0,0,0,0,0
2014,36081003700,"Census Tract 37, Queens County, New York",0,0,0,0,0,NA,NA,NA,NA,NA,0,0,0,0,0,0,0
2015,36081003700,"Census Tract 37, Queens County, New York",0,0,0,0,0,NA,NA,NA,NA,NA,0,0,0,0,0,0,0
2016,36081003700,"Census Tract 37, Queens County, New York",0,0,0,0,0,NA,NA,NA,NA,NA,0,0,0,0,0,0,0
2017,36081003700,"Census Tract 37, Queens County, New York",0,0,0,0,0,NA,NA,NA,NA,NA,0,0,0,0,0,0,0
2018,36081003700,"Census Tract 37, Queens County, New York",0,0,0,0,0,NA,NA,NA,NA,NA,0,0,0,0,0,0,0
2019,36081003700,"Census Tract 37, Queens County, New York",0,0,0,0,0,NA,NA,NA,NA,NA,0,0,0,0,0,0,0
2020,36081003700,"Census Tract 37, Queens County, New York",0,0,0,0,0,NA,NA,NA,NA,NA,0,0,0,0,0,0,0
2012,36081003800,"Census Tract 38, Queens County, New York",804,73,731,459,1489,50295,1957,2004,1363,32.5,77,68,8,72,311,731,154
2013,36081003800,"Census Tract 38, Queens County, New York",825,42,783,546,1666,34938,1948,2006,1242,40.4,81,78,22,59,387,783,179
2014,36081003800,"Census Tract 38, Queens County, New York",821,58,763,559,1713,47566,1948,2008,1237,34.2,117,87,20,69,383,763,214
2015,36081003800,"Census Tract 38, Queens County, New York",797,57,740,563,1768,39297,1950,2009,1261,33.8,112,92,34,77,360,740,176
2016,36081003800,"Census Tract 38, Queens County, New York",788,42,746,551,1739,42460,1941,2010,1337,34.6,115,90,36,78,347,746,136
2017,36081003800,"Census Tract 38, Queens County, New York",795,30,765,569,1869,54181,1943,2011,1359,32.5,111,93,37,68,364,765,113
2018,36081003800,"Census Tract 38, Queens County, New York",772,39,733,538,1953,68333,0,2011,1535,31.8,119,73,44,52,361,733,84
2019,36081003800,"Census Tract 38, Queens County, New York",756,32,724,517,1878,62321,0,2012,1597,32.1,109,45,55,68,337,724,78
2020,36081003800,"Census Tract 38, Queens County, New York",729,25,704,508,1940,77727,0,2012,1639,29.1,99,53,35,102,306,704,82
2012,36081003900,"Census Tract 39, Queens County, New York",495,14,481,414,1231,29737,1947,2003,988,43,88,89,45,7,312,481,193
2013,36081003900,"Census Tract 39, Queens County, New York",497,50,447,383,1179,40625,1944,2004,1121,42,97,108,35,33,248,447,154
2014,36081003900,"Census Tract 39, Queens County, New York",523,76,447,381,1153,40583,1954,2006,1278,38.3,110,111,19,45,226,447,111
2015,36081003900,"Census Tract 39, Queens County, New York",523,60,463,384,1235,NA,1953,2008,1510,38,124,92,11,74,218,463,122
2016,36081003900,"Census Tract 39, Queens County, New York",542,67,475,404,1238,41518,1960,2010,1545,39,159,131,21,83,176,475,103
2017,36081003900,"Census Tract 39, Queens County, New York",544,71,473,399,1300,42639,1953,2011,1633,38.3,169,140,20,81,168,473,99
2018,36081003900,"Census Tract 39, Queens County, New York",492,83,409,339,1084,46750,1957,2011,1715,38.4,130,127,21,69,125,409,73
2019,36081003900,"Census Tract 39, Queens County, New York",496,80,416,374,1188,47500,1964,2011,1708,38.5,106,120,8,46,187,416,53
2020,36081003900,"Census Tract 39, Queens County, New York",577,104,473,437,1161,46366,1980,2015,1712,43.3,102,128,9,41,244,473,24
2012,36081004001,"Census Tract 40.01, Queens County, New York",741,90,651,407,931,38906,1948,2004,1184,37,110,158,27,44,181,651,80
2013,36081004001,"Census Tract 40.01, Queens County, New York",729,77,652,357,872,46250,1951,2005,1240,36,113,155,30,9,171,652,75
2014,36081004001,"Census Tract 40.01, Queens County, New York",755,73,682,395,945,46250,1951,2007,1222,33,104,159,14,8,204,682,72
2015,36081004001,"Census Tract 40.01, Queens County, New York",732,52,680,406,1167,51250,1952,2010,1359,33.4,110,142,13,28,216,680,86
2016,36081004001,"Census Tract 40.01, Queens County, New York",715,62,653,397,1221,40250,1958,2009,1350,37.8,91,140,10,31,180,653,91
2017,36081004001,"Census Tract 40.01, Queens County, New York",696,58,638,373,1283,48977,1961,2010,1385,34.4,75,124,16,33,183,638,84
2018,36081004001,"Census Tract 40.01, Queens County, New York",700,68,632,381,1306,51106,1957,2011,1449,34.8,63,132,14,32,195,632,102
2019,36081004001,"Census Tract 40.01, Queens County, New York",708,52,656,374,1279,51638,1956,2012,1493,35.2,38,124,34,45,156,656,106
2020,36081004001,"Census Tract 40.01, Queens County, New York",662,52,610,325,1036,44063,1961,2014,1533,40.6,29,90,37,26,168,610,79
2012,36081004002,"Census Tract 40.02, Queens County, New York",372,39,333,232,751,49583,1945,2004,1258,29.5,38,25,19,67,95,333,91
2013,36081004002,"Census Tract 40.02, Queens County, New York",353,40,313,228,705,31296,1944,2004,1223,50,34,32,11,76,79,313,74
2014,36081004002,"Census Tract 40.02, Queens County, New York",414,35,379,273,1000,52574,1939,2007,1286,29.2,43,16,13,116,90,379,94
2015,36081004002,"Census Tract 40.02, Queens County, New York",406,29,377,253,999,51250,1939,2008,1320,29.3,44,10,1,130,103,377,111
2016,36081004002,"Census Tract 40.02, Queens County, New York",419,31,388,262,1099,55769,1939,2011,1374,28.5,49,18,0,114,111,388,94
2017,36081004002,"Census Tract 40.02, Queens County, New York",424,13,411,285,1255,49327,1939,2011,1461,29.1,28,12,19,123,112,411,69
2018,36081004002,"Census Tract 40.02, Queens County, New York",428,10,418,300,1240,52500,0,2012,1533,28.3,49,13,25,109,118,418,57
2019,36081004002,"Census Tract 40.02, Queens County, New York",425,22,403,278,1078,51500,0,2012,1712,30.5,41,31,29,100,91,403,39
2020,36081004002,"Census Tract 40.02, Queens County, New York",447,32,415,234,888,51700,1940,2013,1719,28.5,39,27,23,85,77,415,26
2012,36081004200,"Census Tract 42, Queens County, New York",1269,85,1184,726,2328,45598,1939,2004,1180,32.4,103,184,109,189,273,1184,112
2013,36081004200,"Census Tract 42, Queens County, New York",1301,70,1231,730,2519,47565,1939,2005,1234,32.1,121,112,94,204,359,1231,153
2014,36081004200,"Census Tract 42, Queens County, New York",1276,45,1231,668,2602,44410,1939,2006,1254,33,89,114,47,207,311,1231,196
2015,36081004200,"Census Tract 42, Queens County, New York",1268,55,1213,708,2832,43487,1939,2008,1370,38.5,78,82,48,192,396,1213,276
2016,36081004200,"Census Tract 42, Queens County, New York",1243,71,1172,647,2449,43199,1939,2009,1403,40.9,51,60,51,203,343,1172,233
2017,36081004200,"Census Tract 42, Queens County, New York",1259,40,1219,732,2687,44375,1939,2010,1401,38.2,95,43,70,230,414,1219,250
2018,36081004200,"Census Tract 42, Queens County, New York",1287,53,1234,732,2521,41400,0,2010,1435,38.1,124,51,55,235,382,1234,205
2019,36081004200,"Census Tract 42, Queens County, New York",1257,75,1182,702,2177,41429,0,2008,1445,37.1,141,65,57,186,385,1182,188
2020,36081004200,"Census Tract 42, Queens County, New York",1207,95,1112,583,1735,54375,0,2010,1431,28.6,116,62,37,198,285,1112,108
2012,36081004300,"Census Tract 43, Queens County, New York",1055,43,1012,955,2047,14551,1953,1997,488,31,131,143,382,26,379,1012,471
2013,36081004300,"Census Tract 43, Queens County, New York",1071,59,1012,945,1954,13510,1955,1998,470,29.5,103,109,404,20,431,1012,443
2014,36081004300,"Census Tract 43, Queens County, New York",1079,47,1032,1007,2270,17255,1954,2001,515,29.8,102,75,489,18,441,1032,482
2015,36081004300,"Census Tract 43, Queens County, New York",1115,75,1040,1013,2294,17539,1954,2002,514,29.2,102,105,397,31,508,1040,513
2016,36081004300,"Census Tract 43, Queens County, New York",1148,52,1096,1068,2535,27625,1955,2003,601,26.6,163,46,403,84,555,1096,441
2017,36081004300,"Census Tract 43, Queens County, New York",1196,72,1124,1114,2648,24950,1956,2003,557,26.9,143,50,408,64,562,1124,496
2018,36081004300,"Census Tract 43, Queens County, New York",1138,60,1078,1078,2613,24515,1954,2005,496,27,152,42,446,103,460,1078,477
2019,36081004300,"Census Tract 43, Queens County, New York",1145,118,1027,1027,2260,22939,1954,2005,451,29.2,139,47,399,101,473,1027,482
2020,36081004300,"Census Tract 43, Queens County, New York",1135,61,1074,1074,2162,19504,1954,2003,481,31.3,106,26,455,132,447,1074,447
2012,36081004401,"Census Tract 44.01, Queens County, New York",1015,30,985,503,1587,53935,1957,2006,1331,32.4,112,62,99,189,158,985,150
2013,36081004401,"Census Tract 44.01, Queens County, New York",1029,10,1019,573,1865,44676,1956,2006,1308,34.3,125,51,92,237,188,1019,198
2014,36081004401,"Census Tract 44.01, Queens County, New York",1015,29,986,473,1561,42656,1955,2007,1243,37.2,77,37,72,163,192,986,204
2015,36081004401,"Census Tract 44.01, Queens County, New York",1002,48,954,463,1649,49297,1954,2010,1310,35,93,47,75,205,131,954,181
2016,36081004401,"Census Tract 44.01, Queens County, New York",1009,68,941,479,1762,46875,1953,2011,1274,39.2,81,53,55,195,171,941,237
2017,36081004401,"Census Tract 44.01, Queens County, New York",1011,69,942,499,1904,49271,1947,2011,1350,38.5,82,59,42,207,181,942,227
2018,36081004401,"Census Tract 44.01, Queens County, New York",960,70,890,485,1893,52019,0,2011,1497,39.5,125,44,35,215,197,890,182
2019,36081004401,"Census Tract 44.01, Queens County, New York",947,60,887,502,1978,59821,1942,2012,1659,36.7,163,42,34,232,200,887,149
2020,36081004401,"Census Tract 44.01, Queens County, New York",969,58,911,538,2099,62679,1943,2012,1709,34.3,217,72,12,249,211,911,198
2012,36081004500,"Census Tract 45, Queens County, New York",1506,89,1417,456,732,48587,1989,2002,605,21.1,156,320,11,59,52,1417,151
2013,36081004500,"Census Tract 45, Queens County, New York",1512,54,1458,457,771,40664,1982,2002,834,25.4,141,271,13,62,69,1458,171
2014,36081004500,"Census Tract 45, Queens County, New York",1575,48,1527,448,962,54000,1958,2004,1388,27.8,106,234,15,54,96,1527,141
2015,36081004500,"Census Tract 45, Queens County, New York",1577,27,1550,374,856,60167,1957,2004,1397,32.9,77,206,0,54,72,1550,149
2016,36081004500,"Census Tract 45, Queens County, New York",1614,93,1521,392,837,57500,1956,2006,1470,22.8,110,218,0,83,49,1521,164
2017,36081004500,"Census Tract 45, Queens County, New York",1632,109,1523,409,967,51208,1956,2008,1260,22.4,153,227,0,114,32,1523,165
2018,36081004500,"Census Tract 45, Queens County, New York",1610,122,1488,401,876,36683,1956,2002,925,31.2,137,214,0,133,46,1488,189
2019,36081004500,"Census Tract 45, Queens County, New York",1612,142,1470,351,672,32639,1962,2002,914,32.5,141,205,0,135,11,1470,175
2020,36081004500,"Census Tract 45, Queens County, New York",1697,143,1554,415,711,40817,1956,2005,954,30.6,199,233,0,171,11,1554,199
2012,36081004700,"Census Tract 47, Queens County, New York",1866,80,1786,1708,3733,27179,1956,2002,615,31.2,401,415,572,114,660,1786,561
2013,36081004700,"Census Tract 47, Queens County, New York",1864,58,1806,1741,3696,25099,1956,2003,526,31.5,452,439,635,90,630,1806,634
2014,36081004700,"Census Tract 47, Queens County, New York",1865,84,1781,1691,3845,27106,1956,2003,603,31.8,409,404,605,66,684,1781,513
2015,36081004700,"Census Tract 47, Queens County, New York",1838,138,1700,1585,3688,27969,1957,2005,605,31.4,416,407,529,106,599,1700,516
2016,36081004700,"Census Tract 47, Queens County, New York",1834,165,1669,1562,3612,31602,1956,2006,682,30.2,425,410,478,142,602,1669,443
2017,36081004700,"Census Tract 47, Queens County, New York",1862,152,1710,1577,3583,31589,1956,2004,685,28.2,349,372,450,151,616,1710,384
2018,36081004700,"Census Tract 47, Queens County, New York",1870,165,1705,1544,3228,31389,1956,2007,831,28.2,385,383,391,164,621,1705,369
2019,36081004700,"Census Tract 47, Queens County, New York",1899,172,1727,1569,3061,34353,1956,2007,878,27.5,407,405,454,137,566,1727,420
2020,36081004700,"Census Tract 47, Queens County, New York",1809,151,1658,1536,3121,38990,1955,2007,895,28.2,435,337,438,146,577,1658,314
2012,36081005000,"Census Tract 50, Queens County, New York",0,0,0,0,0,NA,NA,NA,NA,NA,0,0,0,0,0,0,0
2013,36081005000,"Census Tract 50, Queens County, New York",0,0,0,0,0,NA,NA,NA,NA,NA,0,0,0,0,0,0,0
2014,36081005000,"Census Tract 50, Queens County, New York",4,0,4,0,0,NA,NA,NA,NA,NA,0,0,0,0,0,4,0
2015,36081005000,"Census Tract 50, Queens County, New York",18,0,18,14,29,NA,NA,NA,NA,NA,0,0,0,0,14,18,0
2016,36081005000,"Census Tract 50, Queens County, New York",32,0,32,14,28,NA,NA,NA,NA,NA,0,0,0,0,14,32,14
2017,36081005000,"Census Tract 50, Queens County, New York",28,0,28,14,28,NA,NA,NA,NA,NA,0,0,0,0,14,28,14
2018,36081005000,"Census Tract 50, Queens County, New York",33,0,33,24,83,NA,1972,2014,1700,47.8,0,0,0,0,24,33,9
2019,36081005000,"Census Tract 50, Queens County, New York",31,0,31,21,30,NA,NA,NA,NA,NA,0,0,0,0,21,31,10
2020,36081005000,"Census Tract 50, Queens County, New York",0,0,0,0,0,NA,NA,NA,NA,NA,0,0,0,0,0,0,0
2012,36081005100,"Census Tract 51, Queens County, New York",753,20,733,662,1702,42634,1942,2002,1207,34.2,297,312,1,179,143,733,210
2013,36081005100,"Census Tract 51, Queens County, New York",766,21,745,696,1866,44087,1944,2005,1317,35.4,295,244,5,275,137,745,239
2014,36081005100,"Census Tract 51, Queens County, New York",745,37,708,642,1787,45000,1939,2006,1271,30.3,281,258,21,257,95,708,174
2015,36081005100,"Census Tract 51, Queens County, New York",775,68,707,618,1794,NA,1939,2010,1351,31.7,284,177,12,318,127,707,216
2016,36081005100,"Census Tract 51, Queens County, New York",838,147,691,615,1717,46993,1939,2010,1428,32.6,258,173,9,316,112,691,216
2017,36081005100,"Census Tract 51, Queens County, New York",861,163,698,603,1696,48922,1941,2011,1521,32.2,281,189,8,310,95,698,190
2018,36081005100,"Census Tract 51, Queens County, New York",889,196,693,590,1558,51172,1942,2011,1624,34.8,291,202,20,263,100,693,168
2019,36081005100,"Census Tract 51, Queens County, New York",915,198,717,629,1606,50189,1941,2012,1745,39.6,283,227,13,266,113,717,150
2020,36081005100,"Census Tract 51, Queens County, New York",905,242,663,574,1526,61613,0,2012,1795,36.5,241,192,8,237,115,663,76
2012,36081005200,"Census Tract 52, Queens County, New York",854,65,789,467,1694,37829,1947,2005,1366,37.2,117,70,21,157,169,789,150
2013,36081005200,"Census Tract 52, Queens County, New York",843,54,789,478,1687,38542,1953,2005,1501,37.3,130,55,37,122,218,789,141
2014,36081005200,"Census Tract 52, Queens County, New York",806,63,743,461,1529,40550,1957,2008,1423,33.7,107,61,42,105,214,743,119
2015,36081005200,"Census Tract 52, Queens County, New York",768,29,739,476,1599,41600,1962,2009,1400,35.5,105,72,31,108,223,739,123
2016,36081005200,"Census Tract 52, Queens County, New York",789,34,755,505,1561,40208,1945,2011,1430,38.5,108,104,39,110,209,755,130
2017,36081005200,"Census Tract 52, Queens County, New York",750,35,715,438,1434,45000,1949,2011,1536,40.1,81,74,39,114,191,715,101
2018,36081005200,"Census Tract 52, Queens County, New York",794,55,739,441,1415,48021,1940,2011,1578,39.6,89,53,47,141,176,739,105
2019,36081005200,"Census Tract 52, Queens County, New York",794,67,727,433,1524,56250,1941,2011,1713,38,84,54,38,156,146,727,109
2020,36081005200,"Census Tract 52, Queens County, New York",865,68,797,504,1624,41953,1957,2011,1721,43.9,113,46,31,183,214,797,88
2012,36081005300,"Census Tract 53, Queens County, New York",2433,116,2317,1919,3839,48393,1944,2001,1323,29.3,930,1035,0,277,484,2317,412
2013,36081005300,"Census Tract 53, Queens County, New York",2460,247,2213,1828,3384,45827,1946,2002,1348,34.2,863,1095,0,208,428,2213,355
2014,36081005300,"Census Tract 53, Queens County, New York",2551,269,2282,1905,3512,49270,1944,2005,1418,35.3,1018,1085,13,191,502,2282,319
2015,36081005300,"Census Tract 53, Queens County, New York",2537,372,2165,1772,3213,49663,1945,2006,1402,35.8,980,916,13,327,488,2165,305
2016,36081005300,"Census Tract 53, Queens County, New York",2664,279,2385,1963,3486,50151,1942,2009,1468,34.4,1213,1024,10,321,560,2385,219
2017,36081005300,"Census Tract 53, Queens County, New York",2600,249,2351,2028,4142,59091,1942,2011,1607,32.2,1263,979,10,364,510,2351,184
2018,36081005300,"Census Tract 53, Queens County, New York",2594,206,2388,2127,4093,70985,1943,2012,1679,25.5,1490,1131,25,390,438,2388,160
2019,36081005300,"Census Tract 53, Queens County, New York",2615,243,2372,1990,4074,86709,1944,2012,1758,23.3,1406,1040,12,438,319,2372,169
2020,36081005300,"Census Tract 53, Queens County, New York",2591,218,2373,2021,3962,95202,1940,2014,1799,24.2,1495,1259,12,328,314,2373,191
2012,36081005400,"Census Tract 54, Queens County, New York",1747,149,1598,704,2026,35556,1941,2004,1277,32.4,115,173,49,108,333,1598,333
2013,36081005400,"Census Tract 54, Queens County, New York",1766,171,1595,636,1942,35625,1943,2006,1336,41.7,132,145,29,83,326,1595,339
2014,36081005400,"Census Tract 54, Queens County, New York",1797,167,1630,663,2106,36094,1943,2006,1401,34,166,131,18,113,344,1630,378
2015,36081005400,"Census Tract 54, Queens County, New York",1799,154,1645,649,1939,37796,1944,2007,1406,45.4,167,178,17,127,306,1645,373
2016,36081005400,"Census Tract 54, Queens County, New York",1760,137,1623,676,2021,29808,1948,2010,1492,42.4,217,152,52,109,340,1623,287
2017,36081005400,"Census Tract 54, Queens County, New York",1769,145,1624,587,1882,41250,1943,2011,1546,34.5,121,112,74,112,280,1624,301
2018,36081005400,"Census Tract 54, Queens County, New York",1797,121,1676,621,2051,60221,0,2012,1586,30.1,172,98,71,107,337,1676,218
2019,36081005400,"Census Tract 54, Queens County, New York",1752,107,1645,595,1881,53350,1961,2013,1610,32.5,157,124,90,107,274,1645,241
2020,36081005400,"Census Tract 54, Queens County, New York",1994,103,1891,826,2191,71250,0,2010,1418,31.3,171,104,174,82,383,1891,244
2012,36081005500,"Census Tract 55, Queens County, New York",405,13,392,326,1039,53641,1939,2001,1450,43.8,101,99,11,57,159,392,89
2013,36081005500,"Census Tract 55, Queens County, New York",393,26,367,298,998,54545,1942,2001,1542,34.2,99,96,3,59,140,367,88
2014,36081005500,"Census Tract 55, Queens County, New York",404,25,379,309,931,54583,1939,2001,1337,28,113,89,5,63,141,379,81
2015,36081005500,"Census Tract 55, Queens County, New York",404,24,380,318,789,59722,1939,2004,1254,27.2,120,103,4,70,129,380,73
2016,36081005500,"Census Tract 55, Queens County, New York",427,32,395,330,751,59674,1939,2008,1353,32.4,148,140,8,45,127,395,78
2017,36081005500,"Census Tract 55, Queens County, New York",412,43,369,304,692,58977,1939,2010,1314,32.9,117,105,17,38,133,369,70
2018,36081005500,"Census Tract 55, Queens County, New York",418,60,358,300,605,58125,0,2007,1277,30.6,117,96,12,32,151,358,74
2019,36081005500,"Census Tract 55, Queens County, New York",444,56,388,330,721,70407,0,2008,1317,28.4,151,115,15,22,183,388,78
2020,36081005500,"Census Tract 55, Queens County, New York",501,129,372,322,792,86324,0,2010,1545,14.8,142,134,15,29,148,372,37
2012,36081005700,"Census Tract 57, Queens County, New York",1872,41,1831,1620,3763,52355,1945,2002,1295,27.9,689,714,53,273,563,1831,286
2013,36081005700,"Census Tract 57, Queens County, New York",1848,77,1771,1560,3728,52616,1943,2004,1359,29.2,737,776,68,255,447,1771,301
2014,36081005700,"Census Tract 57, Queens County, New York",1901,61,1840,1655,4158,60269,1945,2005,1432,28.7,832,787,89,260,514,1840,308
2015,36081005700,"Census Tract 57, Queens County, New York",1880,50,1830,1670,4028,59236,1942,2006,1444,29.2,884,785,87,298,446,1830,332
2016,36081005700,"Census Tract 57, Queens County, New York",1846,106,1740,1610,3781,61226,1939,2010,1491,28.9,909,781,43,294,448,1740,397
2017,36081005700,"Census Tract 57, Queens County, New York",1857,185,1672,1565,3954,62011,1939,2011,1617,31,848,724,85,316,409,1672,319
2018,36081005700,"Census Tract 57, Queens County, New York",1874,142,1732,1624,4118,65217,1940,2012,1701,30.9,905,724,93,357,411,1732,299
2019,36081005700,"Census Tract 57, Queens County, New York",1847,198,1649,1571,3953,67352,0,2013,1790,30.4,914,742,71,293,402,1649,240
2020,36081005700,"Census Tract 57, Queens County, New York",1902,249,1653,1568,3950,83971,0,2013,1858,26.6,953,748,66,250,488,1653,198
2012,36081005800,"Census Tract 58, Queens County, New York",2100,124,1976,865,2198,49637,1963,2005,1283,29.8,215,315,66,96,371,1976,231
2013,36081005800,"Census Tract 58, Queens County, New York",2160,58,2102,970,2251,60018,1961,2005,1248,27.4,337,368,85,75,421,2102,196
2014,36081005800,"Census Tract 58, Queens County, New York",2199,94,2105,1015,2419,56518,1961,2005,1278,27.5,395,306,116,89,498,2105,208
2015,36081005800,"Census Tract 58, Queens County, New York",2125,143,1982,855,2153,58207,1962,2007,1266,28.2,317,255,94,98,403,1982,184
2016,36081005800,"Census Tract 58, Queens County, New York",2098,168,1930,819,2204,55054,1960,2008,1362,29.1,316,283,42,96,391,1930,219
2017,36081005800,"Census Tract 58, Queens County, New York",2064,142,1922,737,2038,56639,1960,2009,1535,29.5,275,262,60,51,358,1922,207
2018,36081005800,"Census Tract 58, Queens County, New York",2071,119,1952,721,2062,55529,1963,2010,1602,33.2,215,259,70,49,338,1952,240
2019,36081005800,"Census Tract 58, Queens County, New York",2067,140,1927,705,2052,65094,1964,2011,1668,29.6,187,272,66,46,308,1927,196
2020,36081005800,"Census Tract 58, Queens County, New York",2051,151,1900,781,2672,80417,1965,2013,1768,30.8,266,311,125,19,301,1900,221
2012,36081005900,"Census Tract 59, Queens County, New York",2002,303,1699,1426,3048,64487,1939,2004,1449,26.5,806,960,34,71,351,1699,216
2013,36081005900,"Census Tract 59, Queens County, New York",1950,289,1661,1392,2966,60227,1939,2005,1507,29.9,809,762,29,159,418,1661,222
2014,36081005900,"Census Tract 59, Queens County, New York",1899,220,1679,1431,3144,65996,1939,2008,1640,28.2,859,815,33,141,394,1679,171
2015,36081005900,"Census Tract 59, Queens County, New York",1904,158,1746,1495,3490,NA,1939,2010,1705,26.7,857,886,42,151,345,1746,193
2016,36081005900,"Census Tract 59, Queens County, New York",1921,125,1796,1507,3603,73867,1939,2011,1723,27,876,915,42,148,337,1796,157
2017,36081005900,"Census Tract 59, Queens County, New York",1867,102,1765,1476,3533,78409,1940,NA,1778,26.4,934,928,18,147,313,1765,154
2018,36081005900,"Census Tract 59, Queens County, New York",1936,210,1726,1467,3554,82525,1942,2012,1853,26.4,921,931,21,142,295,1726,177
2019,36081005900,"Census Tract 59, Queens County, New York",2014,285,1729,1446,3376,81250,1941,2012,1871,26.1,910,921,29,182,262,1729,193
2020,36081005900,"Census Tract 59, Queens County, New York",1880,313,1567,1304,3149,96204,0,2013,1903,25.7,876,845,32,146,228,1567,96
2012,36081006100,"Census Tract 61, Queens County, New York",2894,173,2721,2558,5324,53985,1941,2004,1321,30.3,1141,1457,66,350,654,2721,417
2013,36081006100,"Census Tract 61, Queens County, New York",2879,158,2721,2520,5343,59178,1943,2005,1372,29.4,1184,1548,84,336,508,2721,358
2014,36081006100,"Census Tract 61, Queens County, New York",2953,189,2764,2549,5403,55067,1941,2006,1437,30.8,1390,1519,88,392,517,2764,377
2015,36081006100,"Census Tract 61, Queens County, New York",3027,201,2826,2593,5432,NA,1939,2007,1517,30.8,1403,1471,78,381,648,2826,361
2016,36081006100,"Census Tract 61, Queens County, New York",2975,201,2774,2540,5203,56146,1939,2010,1589,31,1439,1508,126,382,539,2774,344
2017,36081006100,"Census Tract 61, Queens County, New York",3017,221,2796,2523,5085,61509,1939,2011,1664,28.9,1483,1457,99,436,545,2796,251
2018,36081006100,"Census Tract 61, Queens County, New York",3175,400,2775,2521,4919,61682,0,2011,1707,30.7,1606,1502,88,415,536,2775,237
2019,36081006100,"Census Tract 61, Queens County, New York",3234,474,2760,2520,4935,76453,0,2012,1776,26,1685,1506,103,412,507,2760,195
2020,36081006100,"Census Tract 61, Queens County, New York",3180,536,2644,2432,4980,93273,1941,2013,1846,24.4,1651,1440,125,397,481,2644,160
2012,36081006201,"Census Tract 62.01, Queens County, New York",2943,62,2881,587,1322,39398,1967,2001,1292,36.9,15,470,68,0,102,2881,249
2013,36081006201,"Census Tract 62.01, Queens County, New York",2930,76,2854,617,1342,34747,1967,2003,1213,40.6,21,489,79,0,99,2854,217
2014,36081006201,"Census Tract 62.01, Queens County, New York",2941,190,2751,606,1583,36543,1966,2005,1528,45.6,57,423,41,0,142,2751,321
2015,36081006201,"Census Tract 62.01, Queens County, New York",2969,210,2759,630,1610,55085,1965,2007,1530,33.6,118,384,78,13,148,2759,353
2016,36081006201,"Census Tract 62.01, Queens County, New York",2972,210,2762,465,1246,36536,1964,2008,1166,46.7,111,254,14,14,174,2762,308
2017,36081006201,"Census Tract 62.01, Queens County, New York",3026,163,2863,515,1369,39006,1964,2008,1240,47.6,120,301,12,13,180,2863,303
2018,36081006201,"Census Tract 62.01, Queens County, New York",2972,183,2789,397,1163,39273,1964,2007,1414,45.2,106,212,13,13,152,2789,300
2019,36081006201,"Census Tract 62.01, Queens County, New York",2973,91,2882,305,631,55179,1962,2006,1143,51,65,203,0,15,77,2882,180
2020,36081006201,"Census Tract 62.01, Queens County, New York",3138,127,3011,293,540,17697,1962,2001,1158,51,12,199,0,0,94,3011,249
2012,36081006202,"Census Tract 62.02, Queens County, New York",2714,106,2608,1599,4298,54461,1969,2005,1405,29.6,240,601,195,52,825,2608,406
2013,36081006202,"Census Tract 62.02, Queens County, New York",2706,118,2588,1490,3649,54643,1974,2006,1501,29.6,242,540,247,36,741,2588,380
2014,36081006202,"Census Tract 62.02, Queens County, New York",2711,124,2587,1435,3759,51518,1974,2009,1417,33.3,333,710,131,14,583,2587,349
2015,36081006202,"Census Tract 62.02, Queens County, New York",2716,45,2671,1564,4208,44633,1972,2010,1352,33.9,410,747,100,52,681,2671,391
2016,36081006202,"Census Tract 62.02, Queens County, New York",2672,68,2604,1601,4224,44936,1973,2010,1480,36.4,434,761,132,57,625,2604,504
2017,36081006202,"Census Tract 62.02, Queens County, New York",2560,74,2486,1534,4200,43920,1969,2011,1444,37.6,515,722,145,84,555,2486,551
2018,36081006202,"Census Tract 62.02, Queens County, New York",2497,32,2465,1623,4617,46616,1970,2011,1509,40.3,507,809,87,99,505,2465,612
2019,36081006202,"Census Tract 62.02, Queens County, New York",2466,66,2400,1446,4150,48405,1965,2011,1656,39.6,373,591,142,64,572,2400,586
2020,36081006202,"Census Tract 62.02, Queens County, New York",2369,174,2195,1363,3821,51981,1963,2010,1658,38.7,355,520,114,35,616,2195,518
2012,36081006300,"Census Tract 63, Queens County, New York",2767,203,2564,2375,5016,52816,1939,2003,1393,30.9,1171,1528,36,301,507,2564,618
2013,36081006300,"Census Tract 63, Queens County, New York",2727,178,2549,2343,5239,53865,1939,2004,1400,30.7,1132,1522,62,318,505,2549,508
2014,36081006300,"Census Tract 63, Queens County, New York",2753,257,2496,2281,4708,58060,1939,2006,1394,30.5,1206,1371,97,247,627,2496,498
2015,36081006300,"Census Tract 63, Queens County, New York",2806,308,2498,2269,4901,60560,1939,2008,1405,29.4,1209,1277,100,264,683,2498,516
2016,36081006300,"Census Tract 63, Queens County, New York",2753,290,2463,2301,4767,63589,1941,2010,1496,28.3,1287,1314,87,306,637,2463,360
2017,36081006300,"Census Tract 63, Queens County, New York",2813,302,2511,2323,4919,70453,1942,2012,1685,28.4,1456,1332,26,341,616,2511,325
2018,36081006300,"Census Tract 63, Queens County, New York",2906,454,2452,2284,4868,81585,0,2012,1774,25.9,1487,1170,11,437,631,2452,388
2019,36081006300,"Census Tract 63, Queens County, New York",2952,414,2538,2293,4897,75525,1941,2013,1852,28.3,1560,1271,0,451,553,2538,355
2020,36081006300,"Census Tract 63, Queens County, New York",3082,426,2656,2390,5075,87944,0,2015,1870,26.8,1848,1499,0,423,449,2656,239
2012,36081006501,"Census Tract 65.01, Queens County, New York",1876,108,1768,1665,3601,56683,1939,2004,1419,31.7,1074,1134,18,152,317,1768,201
2013,36081006501,"Census Tract 65.01, Queens County, New York",1878,172,1706,1616,3203,56795,1939,2006,1444,31.5,1040,1280,17,130,168,1706,227
2014,36081006501,"Census Tract 65.01, Queens County, New York",1859,159,1700,1632,3276,56903,1939,2008,1564,33.4,1039,1289,18,122,183,1700,183
2015,36081006501,"Census Tract 65.01, Queens County, New York",1871,175,1696,1613,3384,NA,1939,2009,1502,29.1,987,1141,22,117,289,1696,180
2016,36081006501,"Census Tract 65.01, Queens County, New York",1875,185,1690,1605,3251,59890,1939,2010,1550,27.7,1059,1153,33,167,205,1690,194
2017,36081006501,"Census Tract 65.01, Queens County, New York",1913,233,1680,1571,3270,64250,1939,2011,1655,28,998,1086,39,170,252,1680,241
2018,36081006501,"Census Tract 65.01, Queens County, New York",1917,226,1691,1584,3235,74012,1941,2012,1708,27.5,1033,1144,35,134,265,1691,179
2019,36081006501,"Census Tract 65.01, Queens County, New York",2017,337,1680,1547,3209,79292,1941,2012,1770,26.9,1035,1054,38,196,264,1680,196
2020,36081006501,"Census Tract 65.01, Queens County, New York",2036,439,1597,1465,2940,92178,1943,2014,1855,25.5,970,939,46,197,318,1597,139
2012,36081006502,"Census Tract 65.02, Queens County, New York",1910,204,1706,1309,2974,56192,1941,2005,1436,32.3,739,761,80,174,294,1706,271
2013,36081006502,"Census Tract 65.02, Queens County, New York",1938,222,1716,1372,2954,54662,1948,2006,1425,31.6,728,814,82,183,282,1716,287
2014,36081006502,"Census Tract 65.02, Queens County, New York",1951,254,1697,1414,3038,66100,1949,2007,1561,27.5,826,839,54,270,209,1697,288
2015,36081006502,"Census Tract 65.02, Queens County, New York",1943,200,1743,1485,3169,62468,1946,2010,1546,27.6,926,933,9,226,265,1743,292
2016,36081006502,"Census Tract 65.02, Queens County, New York",1979,237,1742,1480,3113,67344,1946,2011,1620,26.1,895,853,8,238,324,1742,200
2017,36081006502,"Census Tract 65.02, Queens County, New York",2008,281,1727,1516,3119,80870,1950,2011,1656,24.9,908,898,9,227,326,1727,184
2018,36081006502,"Census Tract 65.02, Queens County, New York",2017,300,1717,1490,2994,84400,1946,2012,1766,24.8,926,884,9,219,323,1717,240
2019,36081006502,"Census Tract 65.02, Queens County, New York",2053,299,1754,1499,2880,84433,1945,2013,1885,26.2,999,999,11,144,323,1754,246
2020,36081006502,"Census Tract 65.02, Queens County, New York",2075,287,1788,1576,3293,82908,1949,2015,1923,28.1,961,1004,28,143,361,1788,298
2012,36081006900,"Census Tract 69, Queens County, New York",2057,238,1819,1522,3307,39444,1970,2006,1470,35.7,709,768,38,362,332,1819,363
2013,36081006900,"Census Tract 69, Queens County, New York",2088,214,1874,1622,3739,46734,1968,2008,1454,34.5,792,791,42,387,392,1874,293
2014,36081006900,"Census Tract 69, Queens County, New York",2181,286,1895,1584,3604,47270,1968,2009,1499,32.9,823,831,42,354,357,1895,236
2015,36081006900,"Census Tract 69, Queens County, New York",2159,250,1909,1641,3639,45696,1972,2011,1527,37,787,849,97,368,327,1909,239
2016,36081006900,"Census Tract 69, Queens County, New York",2193,320,1873,1619,3575,52829,1972,2011,1580,31.6,914,893,64,404,258,1873,270
2017,36081006900,"Census Tract 69, Queens County, New York",2249,527,1722,1509,3530,59353,1964,2012,1636,29.4,862,836,77,304,306,1722,263
2018,36081006900,"Census Tract 69, Queens County, New York",2343,781,1562,1331,2788,67266,1974,2013,1747,28.8,872,749,92,295,226,1562,279
2019,36081006900,"Census Tract 69, Queens County, New York",2431,783,1648,1416,2807,87938,1976,2014,1859,25.6,1001,804,88,301,222,1648,225
2020,36081006900,"Census Tract 69, Queens County, New York",2559,931,1628,1377,2724,127022,2000,2016,2130,22.6,1098,900,49,232,197,1628,195
2012,36081007100,"Census Tract 71, Queens County, New York",1898,106,1792,1679,3425,47188,1948,2004,1439,36.1,848,1012,40,233,338,1792,215
2013,36081007100,"Census Tract 71, Queens County, New York",1865,128,1737,1645,3302,55152,1948,2006,1508,32.4,868,1041,38,228,306,1737,210
2014,36081007100,"Census Tract 71, Queens County, New York",1893,103,1790,1703,3590,62533,1950,2008,1587,31.3,956,1067,39,280,268,1790,256
2015,36081007100,"Census Tract 71, Queens County, New York",1907,143,1764,1667,3590,69696,1948,2010,1628,28.3,996,1039,50,253,280,1764,242
2016,36081007100,"Census Tract 71, Queens County, New York",1964,175,1789,1662,3526,73041,1947,NA,1728,28,1061,1103,28,292,224,1789,225
2017,36081007100,"Census Tract 71, Queens County, New York",1991,245,1746,1620,3249,72683,1944,2012,1827,28.5,1104,1069,29,307,202,1746,235
2018,36081007100,"Census Tract 71, Queens County, New York",2024,333,1691,1589,3058,76791,1942,2013,1884,28.3,1162,1072,36,248,181,1691,181
2019,36081007100,"Census Tract 71, Queens County, New York",2124,422,1702,1562,3004,76534,1943,2013,1880,27.3,1168,992,50,234,218,1702,154
2020,36081007100,"Census Tract 71, Queens County, New York",2257,558,1699,1562,2928,93176,1948,2015,2035,25.7,1172,910,46,218,318,1699,150
2012,36081007300,"Census Tract 73, Queens County, New York",2187,264,1923,1577,3002,59010,1946,2003,1434,30.7,929,1215,15,181,166,1923,143
2013,36081007300,"Census Tract 73, Queens County, New York",2204,164,2040,1671,3180,66370,1953,2005,1472,27.1,1048,1246,31,227,183,2040,255
2014,36081007300,"Census Tract 73, Queens County, New York",2242,173,2069,1769,3425,60305,1955,2008,1652,32.2,1075,1158,33,202,377,2069,240
2015,36081007300,"Census Tract 73, Queens County, New York",2356,207,2149,1878,3551,60444,1957,2010,1624,32.5,1225,1229,30,233,388,2149,297
2016,36081007300,"Census Tract 73, Queens County, New York",2326,206,2120,1814,3223,62305,1958,2011,1684,30.8,1241,1156,30,307,323,2120,272
2017,36081007300,"Census Tract 73, Queens County, New York",2342,185,2157,1828,3491,70057,1956,2011,1791,29.5,1239,1087,58,333,352,2157,296
2018,36081007300,"Census Tract 73, Queens County, New York",2350,324,2026,1742,3504,79167,1952,2012,1865,28.5,1241,1083,39,351,257,2026,215
2019,36081007300,"Census Tract 73, Queens County, New York",2410,447,1963,1672,3463,83194,1948,2013,1941,28.9,1166,1027,41,394,246,1963,226
2020,36081007300,"Census Tract 73, Queens County, New York",2720,684,2036,1823,3559,100944,1948,2015,2064,26.1,1353,1025,37,358,221,2036,225
2012,36081007500,"Census Tract 75, Queens County, New York",2236,174,2062,1775,3396,43160,1957,2004,1316,28.1,803,1112,55,253,360,2062,594
2013,36081007500,"Census Tract 75, Queens County, New York",2242,114,2128,1853,3601,40653,1955,2004,1335,28.9,873,1071,17,273,450,2128,560
2014,36081007500,"Census Tract 75, Queens County, New York",2243,96,2147,1895,3595,53458,1955,2005,1328,27,950,1153,14,257,437,2147,470
2015,36081007500,"Census Tract 75, Queens County, New York",2315,182,2133,1877,3731,64554,1950,2006,1415,25.8,1020,1071,14,337,424,2133,439
2016,36081007500,"Census Tract 75, Queens County, New York",2353,209,2144,1878,3812,68318,1953,2007,1557,26.2,1095,877,13,471,486,2144,345
2017,36081007500,"Census Tract 75, Queens County, New York",2363,313,2050,1672,3314,76333,1955,2008,1606,24,1122,817,28,452,345,2050,222
2018,36081007500,"Census Tract 75, Queens County, New York",2384,367,2017,1638,2967,78140,1950,2010,1677,25,1134,879,55,442,262,2017,229
2019,36081007500,"Census Tract 75, Queens County, New York",2407,392,2015,1647,3049,73789,1952,2011,1691,25.9,1113,752,48,533,314,2015,356
2020,36081007500,"Census Tract 75, Queens County, New York",2460,271,2189,1728,3056,68571,1958,2013,1688,25.4,1091,700,55,442,456,2189,388
2012,36081007700,"Census Tract 77, Queens County, New York",678,75,603,441,1080,75208,1988,2005,1508,28,193,192,10,98,138,603,24
2013,36081007700,"Census Tract 77, Queens County, New York",662,89,573,414,915,66121,1990,2007,1678,32,223,207,13,99,90,573,21
2014,36081007700,"Census Tract 77, Queens County, New York",676,107,569,450,1066,73654,1993,2010,1727,31.7,254,225,13,97,102,569,33
2015,36081007700,"Census Tract 77, Queens County, New York",708,114,594,471,1132,74676,1993,2011,1802,31.8,290,233,10,122,96,594,33
2016,36081007700,"Census Tract 77, Queens County, New York",765,108,657,501,1172,75069,2001,2012,1916,31.9,352,279,7,130,80,657,34
2017,36081007700,"Census Tract 77, Queens County, New York",826,94,732,609,1450,83661,2000,NA,2148,31,404,359,0,119,120,732,51
2018,36081007700,"Census Tract 77, Queens County, New York",837,107,730,567,1348,89375,2003,2013,2299,29.9,381,333,5,91,120,730,54
2019,36081007700,"Census Tract 77, Queens County, New York",855,125,730,568,1378,94625,2007,2014,2397,28.3,403,322,5,72,139,730,64
2020,36081007700,"Census Tract 77, Queens County, New York",901,105,796,692,1577,118214,2007,2015,2396,25.1,471,385,6,81,168,796,97
2012,36081007900,"Census Tract 79, Queens County, New York",1304,123,1181,937,2348,36424,1949,2004,1364,37.2,369,398,35,178,326,1181,223
2013,36081007900,"Census Tract 79, Queens County, New York",1398,139,1259,996,2667,37917,1956,2005,1419,44.1,418,464,11,205,316,1259,349
2014,36081007900,"Census Tract 79, Queens County, New York",1341,103,1238,928,2592,30848,1951,2005,1481,49,288,307,50,222,369,1238,311
2015,36081007900,"Census Tract 79, Queens County, New York",1384,74,1310,971,2416,39491,1955,2006,1600,43.1,363,392,38,178,382,1310,240
2016,36081007900,"Census Tract 79, Queens County, New York",1417,102,1315,1077,2617,46366,1958,2008,1512,40.5,440,485,33,244,333,1315,190
2017,36081007900,"Census Tract 79, Queens County, New York",1479,160,1319,1053,2457,38239,1959,2010,1511,45.7,413,476,20,232,345,1319,245
2018,36081007900,"Census Tract 79, Queens County, New York",1475,297,1178,972,2296,38056,1956,2010,1495,44.7,396,456,18,236,280,1178,184
2019,36081007900,"Census Tract 79, Queens County, New York",1578,395,1183,939,2000,61607,1961,2012,1665,37.3,465,508,0,220,196,1183,148
2020,36081007900,"Census Tract 79, Queens County, New York",1761,569,1192,832,1787,54342,1961,2014,1629,35.7,461,394,0,259,163,1192,174
2012,36081008100,"Census Tract 81, Queens County, New York",431,98,333,228,735,53500,1948,2006,1456,31.2,74,84,0,23,86,333,14
2013,36081008100,"Census Tract 81, Queens County, New York",477,108,369,261,890,43646,1949,2006,1634,34,44,85,4,26,94,369,28
2014,36081008100,"Census Tract 81, Queens County, New York",504,115,389,268,852,54444,1943,2007,1673,30.2,77,87,4,31,133,389,50
2015,36081008100,"Census Tract 81, Queens County, New York",536,75,461,304,806,53250,1939,2008,1734,30.2,95,121,4,23,134,461,50
2016,36081008100,"Census Tract 81, Queens County, New York",609,74,535,377,1005,55536,1945,2011,1827,30.3,161,163,9,24,153,535,71
2017,36081008100,"Census Tract 81, Queens County, New York",659,62,597,437,1033,53917,1939,2012,1992,33.2,183,181,19,37,175,597,72
2018,36081008100,"Census Tract 81, Queens County, New York",741,122,619,448,969,76944,0,2013,2024,32.3,219,186,21,46,190,619,63
2019,36081008100,"Census Tract 81, Queens County, New York",755,165,590,445,937,83047,0,2015,2168,31.4,227,202,29,43,156,590,42
2020,36081008100,"Census Tract 81, Queens County, New York",825,259,566,463,965,72331,1991,2015,2476,33.5,276,200,32,94,122,566,51
2012,36081008300,"Census Tract 83, Queens County, New York",1289,101,1188,995,3007,42775,1962,2002,1337,30.5,313,333,150,107,347,1188,143
2013,36081008300,"Census Tract 83, Queens County, New York",1313,65,1248,1107,3368,46065,1963,2004,1341,29.4,356,380,134,156,398,1248,167
2014,36081008300,"Census Tract 83, Queens County, New York",1293,68,1225,1077,3328,45031,1964,2005,1423,30.5,397,361,137,182,360,1225,167
2015,36081008300,"Census Tract 83, Queens County, New York",1265,95,1170,1026,3016,44598,1957,2006,1384,31,389,384,117,135,355,1170,158
2016,36081008300,"Census Tract 83, Queens County, New York",1210,124,1086,965,2744,46426,1963,2007,1341,30.3,406,376,108,147,318,1086,146
2017,36081008300,"Census Tract 83, Queens County, New York",1207,220,987,844,2407,47121,1958,2010,1337,32,378,313,109,150,288,987,126
2018,36081008300,"Census Tract 83, Queens County, New York",1263,290,973,825,2091,44918,1950,2011,1593,36.7,334,273,122,117,299,973,99
2019,36081008300,"Census Tract 83, Queens County, New York",1341,378,963,798,1894,52929,1948,2012,1698,33.5,323,255,82,138,301,963,76
2020,36081008300,"Census Tract 83, Queens County, New York",1483,507,976,850,1875,73750,1971,2012,1849,31.6,417,318,91,134,281,976,56
2012,36081008500,"Census Tract 85, Queens County, New York",405,89,316,252,887,43125,1939,2005,1359,42.8,50,103,28,13,114,316,82
2013,36081008500,"Census Tract 85, Queens County, New York",382,59,323,261,925,31979,1945,2005,1385,47.6,63,98,33,21,97,323,87
2014,36081008500,"Census Tract 85, Queens County, New York",386,55,331,294,1011,31833,1941,2006,1388,50,70,102,20,20,136,331,65
2015,36081008500,"Census Tract 85, Queens County, New York",415,87,328,281,933,33894,1939,2006,1398,45.3,86,100,22,17,128,328,49
2016,36081008500,"Census Tract 85, Queens County, New York",474,93,381,341,942,40938,1939,2010,1411,38.8,133,151,41,15,109,381,67
2017,36081008500,"Census Tract 85, Queens County, New York",558,202,356,329,919,40750,1943,2012,1557,38.6,125,101,35,49,126,356,79
2018,36081008500,"Census Tract 85, Queens County, New York",475,148,327,274,711,45526,0,2012,1665,35.7,91,97,21,44,119,327,67
2019,36081008500,"Census Tract 85, Queens County, New York",485,150,335,283,697,30795,0,2012,1625,51,96,111,12,40,123,335,78
2020,36081008500,"Census Tract 85, Queens County, New York",427,111,316,272,764,47000,0,2011,1533,39,69,79,11,45,140,316,67
2012,36081008600,"Census Tract 86, Queens County, New York",999,163,836,297,1006,63523,1950,2004,1367,30.8,66,178,0,15,104,836,79
2013,36081008600,"Census Tract 86, Queens County, New York",1010,170,840,243,598,50893,1943,2007,1280,32.7,85,97,0,40,96,840,91
2014,36081008600,"Census Tract 86, Queens County, New York",993,172,821,262,770,46154,1942,2006,1234,32.5,100,69,0,55,131,821,107
2015,36081008600,"Census Tract 86, Queens County, New York",998,181,817,299,1034,38958,1942,2006,1378,48.3,47,52,0,39,198,817,129
2016,36081008600,"Census Tract 86, Queens County, New York",1000,153,847,316,1099,48833,1943,2008,1348,34.2,44,71,0,41,191,847,90
2017,36081008600,"Census Tract 86, Queens County, New York",963,155,808,304,1089,41875,1949,2009,1436,36.6,52,69,0,48,181,808,89
2018,36081008600,"Census Tract 86, Queens County, New York",957,118,839,275,1004,61985,1948,2011,1608,30.6,90,68,0,44,149,839,84
2019,36081008600,"Census Tract 86, Queens County, New York",959,64,895,297,1020,60994,1944,2012,1525,32.6,81,75,0,33,174,895,102
2020,36081008600,"Census Tract 86, Queens County, New York",969,55,914,300,1137,70526,1951,2013,1493,24.6,78,57,0,32,197,914,105
2012,36081008700,"Census Tract 87, Queens County, New York",1571,61,1510,1499,4128,22718,1955,2002,598,29.3,140,213,663,0,676,1510,606
2013,36081008700,"Census Tract 87, Queens County, New York",1591,118,1473,1456,4286,24052,1955,2002,610,28.8,171,170,716,14,603,1473,545
2014,36081008700,"Census Tract 87, Queens County, New York",1630,96,1534,1521,4798,21416,1955,2001,593,32.4,202,191,727,16,624,1534,636
2015,36081008700,"Census Tract 87, Queens County, New York",1650,121,1529,1529,5107,21767,1955,2001,583,30.8,229,200,780,31,546,1529,578
2016,36081008700,"Census Tract 87, Queens County, New York",1682,123,1559,1559,5196,23648,1953,2001,582,30.3,260,179,769,37,585,1559,585
2017,36081008700,"Census Tract 87, Queens County, New York",1696,196,1500,1500,5089,27544,1954,2002,596,30.2,219,210,700,35,584,1500,510
2018,36081008700,"Census Tract 87, Queens County, New York",1725,266,1459,1459,4470,26542,1953,2004,550,31,185,217,609,22,646,1459,502
2019,36081008700,"Census Tract 87, Queens County, New York",1743,352,1391,1391,4052,26750,1953,2006,575,29.5,194,224,583,32,557,1391,455
2020,36081008700,"Census Tract 87, Queens County, New York",2007,491,1516,1516,3536,20292,1952,2007,554,31.2,219,236,539,20,724,1516,667
2012,36081008800,"Census Tract 88, Queens County, New York",1241,132,1109,324,823,38816,1958,2005,1220,36.7,36,174,22,49,65,1109,63
2013,36081008800,"Census Tract 88, Queens County, New York",1244,100,1144,296,819,39891,1964,2006,1422,37.3,37,129,44,38,70,1144,63
2014,36081008800,"Census Tract 88, Queens County, New York",1255,101,1154,346,1065,57188,1960,2006,1427,33,37,133,61,37,99,1154,68
2015,36081008800,"Census Tract 88, Queens County, New York",1265,82,1183,442,1300,64167,1955,2007,1314,27.6,45,198,98,17,111,1183,64
2016,36081008800,"Census Tract 88, Queens County, New York",1272,79,1193,397,1082,70063,1959,2008,1407,27.4,60,149,94,26,108,1193,54
2017,36081008800,"Census Tract 88, Queens County, New York",1268,94,1174,315,882,73533,1956,2007,1384,24.2,29,132,93,10,80,1174,55
2018,36081008800,"Census Tract 88, Queens County, New York",1272,84,1188,368,922,51944,0,2007,1418,24.3,31,161,73,10,124,1188,108
2019,36081008800,"Census Tract 88, Queens County, New York",1288,121,1167,332,744,37000,0,2009,1448,34,30,168,58,24,82,1167,162
2020,36081008800,"Census Tract 88, Queens County, New York",1249,106,1143,311,880,53259,1950,2012,1941,28.2,45,113,77,50,105,1143,129
2012,36081009100,"Census Tract 91, Queens County, New York",1334,122,1212,831,1854,53438,1962,2004,1491,29.7,409,468,63,58,216,1212,176
2013,36081009100,"Census Tract 91, Queens County, New York",1353,127,1226,873,1905,47019,1961,2006,1480,30,368,484,43,87,221,1226,159
2014,36081009100,"Census Tract 91, Queens County, New York",1372,194,1178,838,1927,48895,1963,2008,1498,29.8,356,457,45,71,205,1178,150
2015,36081009100,"Census Tract 91, Queens County, New York",1458,265,1193,772,1777,46630,1968,2010,1608,30.1,305,391,48,58,233,1193,137
2016,36081009100,"Census Tract 91, Queens County, New York",1398,236,1162,806,1643,60702,1980,2011,1752,27.5,408,429,52,78,226,1162,149
2017,36081009100,"Census Tract 91, Queens County, New York",1412,223,1189,799,1676,63750,1978,2012,1786,26,389,446,33,110,191,1189,122
2018,36081009100,"Census Tract 91, Queens County, New York",1440,312,1128,785,1561,64209,1981,2012,1740,26.4,340,407,38,100,240,1128,158
2019,36081009100,"Census Tract 91, Queens County, New York",1445,358,1087,681,1332,68299,1978,2012,1761,25.9,310,359,36,71,208,1087,116
2020,36081009100,"Census Tract 91, Queens County, New York",1483,363,1120,676,1179,74537,1973,2014,1768,26.4,309,386,24,40,211,1120,103
2012,36081009400,"Census Tract 94, Queens County, New York",947,79,868,589,1814,40363,1954,2005,1238,36.5,109,51,105,266,161,868,221
2013,36081009400,"Census Tract 94, Queens County, New York",954,87,867,580,1849,46750,1954,2006,1259,33.2,133,22,97,302,148,867,226
2014,36081009400,"Census Tract 94, Queens County, New York",962,55,907,530,1636,37308,1951,2006,1360,34.2,110,22,69,295,127,907,224
2015,36081009400,"Census Tract 94, Queens County, New York",951,89,862,465,1597,40893,1950,2006,1302,34.4,95,23,47,270,112,862,189
2016,36081009400,"Census Tract 94, Queens County, New York",936,85,851,429,1481,36467,1942,2008,1390,35.5,138,11,53,231,105,851,170
2017,36081009400,"Census Tract 94, Queens County, New York",885,108,777,368,1286,33200,1939,2009,1454,42.8,108,17,47,197,84,777,126
2018,36081009400,"Census Tract 94, Queens County, New York",870,96,774,330,1136,40000,0,2010,1462,34.5,102,19,47,148,94,774,120
2019,36081009400,"Census Tract 94, Queens County, New York",840,124,716,336,1226,56091,0,2012,1618,31.7,107,34,50,167,67,716,95
2020,36081009400,"Census Tract 94, Queens County, New York",767,96,671,303,1141,58355,0,2013,1705,31.1,81,18,30,143,75,671,109
2012,36081009500,"Census Tract 95, Queens County, New York",1117,35,1082,787,1958,58313,1939,2003,1622,31.8,416,589,18,70,100,1082,107
2013,36081009500,"Census Tract 95, Queens County, New York",1065,47,1018,779,1909,63165,1943,2005,1704,28.7,428,601,22,56,90,1018,72
2014,36081009500,"Census Tract 95, Queens County, New York",1079,75,1004,764,1957,62244,1950,2007,1671,30.4,426,568,33,48,115,1004,70
2015,36081009500,"Census Tract 95, Queens County, New York",1074,75,999,758,1993,61716,1951,2010,1752,30.9,411,565,33,52,108,999,92
2016,36081009500,"Census Tract 95, Queens County, New York",1057,99,958,737,1887,68920,1950,2011,1734,28.1,435,556,38,64,70,958,75
2017,36081009500,"Census Tract 95, Queens County, New York",1075,145,930,701,1862,67989,1952,2011,1797,28,436,514,41,59,81,930,69
2018,36081009500,"Census Tract 95, Queens County, New York",1096,180,916,664,1754,80667,1947,2012,1902,28.1,405,472,37,49,100,916,68
2019,36081009500,"Census Tract 95, Queens County, New York",1087,237,850,618,1652,84435,1943,2012,2083,28.3,383,451,26,51,82,850,49
2020,36081009500,"Census Tract 95, Queens County, New York",1147,306,841,622,1680,92500,1941,2014,2090,26.7,411,429,5,90,88,841,31
2012,36081009600,"Census Tract 96, Queens County, New York",913,36,877,314,941,24013,1939,2004,1204,47.4,17,18,100,80,64,877,107
2013,36081009600,"Census Tract 96, Queens County, New York",951,29,922,354,1044,23153,1939,2004,1198,50,15,15,125,116,57,922,152
2014,36081009600,"Census Tract 96, Queens County, New York",961,28,933,314,1129,30547,1939,2006,1396,43,21,21,97,58,65,933,119
2015,36081009600,"Census Tract 96, Queens County, New York",993,0,993,262,1031,NA,1939,2007,1471,38.2,29,13,78,43,62,993,136
2016,36081009600,"Census Tract 96, Queens County, New York",961,0,961,224,909,57396,1939,2007,1613,35.1,34,12,44,26,75,961,119
2017,36081009600,"Census Tract 96, Queens County, New York",953,0,953,246,1013,59214,1939,2007,1546,35.3,38,10,42,10,59,953,108
2018,36081009600,"Census Tract 96, Queens County, New York",941,14,927,265,1126,60250,0,2008,1601,35.7,34,13,11,17,85,927,108
2019,36081009600,"Census Tract 96, Queens County, New York",939,14,925,237,911,87557,0,2010,1688,23.6,61,8,7,38,107,925,96
2020,36081009600,"Census Tract 96, Queens County, New York",905,35,870,192,779,87222,0,2010,1652,22.8,52,8,0,34,83,870,82
2012,36081009700,"Census Tract 97, Queens County, New York",1727,162,1565,993,2095,76050,1942,2004,1585,25.4,661,830,0,22,120,1565,151
2013,36081009700,"Census Tract 97, Queens County, New York",1719,226,1493,983,2148,76799,1944,2005,1667,26.2,676,803,0,48,112,1493,113
2014,36081009700,"Census Tract 97, Queens County, New York",1672,218,1454,950,2103,77733,1939,2007,1665,27.8,643,805,0,51,87,1454,91
2015,36081009700,"Census Tract 97, Queens County, New York",1596,185,1411,923,2123,78512,1939,2009,1747,29.9,635,746,25,53,92,1411,55
2016,36081009700,"Census Tract 97, Queens County, New York",1580,126,1454,1020,2276,78235,1939,2010,1753,28,747,795,23,90,100,1454,44
2017,36081009700,"Census Tract 97, Queens County, New York",1618,223,1395,1015,2405,87375,1939,2011,1802,24.7,722,728,28,127,97,1395,63
2018,36081009700,"Census Tract 97, Queens County, New York",1671,223,1448,1018,2418,95729,0,2012,1897,24.5,754,737,32,110,100,1448,83
2019,36081009700,"Census Tract 97, Queens County, New York",1675,204,1471,1098,2554,94722,0,2013,1992,24.9,795,804,33,116,105,1471,51
2020,36081009700,"Census Tract 97, Queens County, New York",1735,230,1505,1128,2622,101021,1944,2014,1992,24.2,850,832,9,128,134,1505,68
2012,36081009800,"Census Tract 98, Queens County, New York",730,53,677,360,1410,40000,1939,2005,1336,38.6,28,0,101,131,21,677,83
2013,36081009800,"Census Tract 98, Queens County, New York",737,67,670,351,1416,34975,1939,2005,1330,42,30,0,82,140,16,670,103
2014,36081009800,"Census Tract 98, Queens County, New York",823,73,750,410,1561,37917,1939,2006,1292,37.9,37,5,70,159,63,750,144
2015,36081009800,"Census Tract 98, Queens County, New York",823,84,739,409,1473,34609,1939,2009,1305,41.2,51,6,51,137,97,739,159
2016,36081009800,"Census Tract 98, Queens County, New York",831,78,753,412,1477,32037,1939,2009,1385,46.3,71,5,48,140,104,753,195
2017,36081009800,"Census Tract 98, Queens County, New York",756,70,686,400,1462,42969,1939,2010,1404,36,72,5,42,124,107,686,155
2018,36081009800,"Census Tract 98, Queens County, New York",736,53,683,406,1474,63333,0,2010,1549,30.1,65,6,63,110,118,683,151
2019,36081009800,"Census Tract 98, Queens County, New York",718,45,673,392,1391,51250,0,2011,1645,33.7,63,0,58,130,86,673,135
2020,36081009800,"Census Tract 98, Queens County, New York",696,43,653,367,1285,60469,0,2011,1720,30.9,76,0,52,170,57,653,77
2012,36081009900,"Census Tract 99, Queens County, New York",0,0,0,0,0,NA,NA,NA,NA,NA,0,0,0,0,0,0,0
2013,36081009900,"Census Tract 99, Queens County, New York",0,0,0,0,0,NA,NA,NA,NA,NA,0,0,0,0,0,0,0
2014,36081009900,"Census Tract 99, Queens County, New York",0,0,0,0,0,NA,NA,NA,NA,NA,0,0,0,0,0,0,0
2015,36081009900,"Census Tract 99, Queens County, New York",0,0,0,0,0,NA,NA,NA,NA,NA,0,0,0,0,0,0,0
2016,36081009900,"Census Tract 99, Queens County, New York",0,0,0,0,0,NA,NA,NA,NA,NA,0,0,0,0,0,0,0
2017,36081009900,"Census Tract 99, Queens County, New York",0,0,0,0,0,NA,NA,NA,NA,NA,0,0,0,0,0,0,0
2018,36081009900,"Census Tract 99, Queens County, New York",0,0,0,0,0,NA,NA,NA,NA,NA,0,0,0,0,0,0,0
2019,36081009900,"Census Tract 99, Queens County, New York",0,0,0,0,0,NA,NA,NA,NA,NA,0,0,0,0,0,0,0
2020,36081009900,"Census Tract 99, Queens County, New York",0,0,0,0,0,NA,NA,NA,NA,NA,0,0,0,0,0,0,0
2012,36081010000,"Census Tract 100, Queens County, New York",985,59,926,272,1014,72778,1939,2005,1566,29.9,80,0,98,16,103,926,36
2013,36081010000,"Census Tract 100, Queens County, New York",953,0,953,293,1073,52813,1939,2006,1639,38,100,0,101,45,60,953,50
2014,36081010000,"Census Tract 100, Queens County, New York",983,7,976,256,970,36419,1942,2007,1278,44.3,61,0,109,42,43,976,104
2015,36081010000,"Census Tract 100, Queens County, New York",1007,12,995,317,1339,37163,1945,2008,1359,41.3,66,0,123,69,49,995,120
2016,36081010000,"Census Tract 100, Queens County, New York",1020,14,1006,433,2082,55837,1946,2007,1315,36.1,142,0,102,145,91,1006,219
2017,36081010000,"Census Tract 100, Queens County, New York",1054,17,1037,227,867,38625,1939,2010,887,36.3,42,0,49,70,50,1037,75
2018,36081010000,"Census Tract 100, Queens County, New York",1022,17,1005,217,755,NA,1959,2012,1301,32.8,25,9,19,43,90,1005,66
2019,36081010000,"Census Tract 100, Queens County, New York",970,7,963,223,933,74821,1955,2015,1687,29.5,29,9,18,78,91,963,25
2020,36081010000,"Census Tract 100, Queens County, New York",1215,37,1178,254,928,NA,0,2014,1580,33.5,17,8,26,117,77,1178,208
2012,36081010100,"Census Tract 101, Queens County, New York",1132,62,1070,692,1413,51338,1944,2005,1370,27.5,425,453,0,99,140,1070,118
2013,36081010100,"Census Tract 101, Queens County, New York",1104,39,1065,696,1495,49516,1944,2008,1425,32.3,402,490,0,86,120,1065,150
2014,36081010100,"Census Tract 101, Queens County, New York",1071,19,1052,746,1580,52325,1942,2011,1468,28.4,430,517,0,72,157,1052,134
2015,36081010100,"Census Tract 101, Queens County, New York",1058,32,1026,742,1639,53519,1939,2010,1488,28,456,548,0,54,140,1026,127
2016,36081010100,"Census Tract 101, Queens County, New York",1118,34,1084,781,1792,60164,1939,2011,1573,30.6,443,543,0,60,178,1084,198
2017,36081010100,"Census Tract 101, Queens County, New York",1080,41,1039,728,1657,65000,1939,2011,1659,27.2,410,538,0,63,115,1039,153
2018,36081010100,"Census Tract 101, Queens County, New York",1112,71,1041,735,1702,80660,0,2011,1732,24.3,448,554,22,49,95,1041,106
2019,36081010100,"Census Tract 101, Queens County, New York",1097,89,1008,671,1630,87528,0,2012,1764,29.9,408,482,37,51,91,1008,118
2020,36081010100,"Census Tract 101, Queens County, New York",1143,150,993,663,1599,69798,0,2013,1867,32.1,342,444,47,54,108,993,80
2012,36081010200,"Census Tract 102, Queens County, New York",807,62,745,329,1090,45521,1939,2005,1068,30.4,16,65,48,41,81,745,104
2013,36081010200,"Census Tract 102, Queens County, New York",810,62,748,311,1127,43508,1939,2006,1145,31.6,16,42,41,24,109,748,40
2014,36081010200,"Census Tract 102, Queens County, New York",774,23,751,351,1369,42266,1939,2008,1354,35.9,47,38,43,29,113,751,49
2015,36081010200,"Census Tract 102, Queens County, New York",805,7,798,345,1377,40417,1939,2008,1378,40.9,52,40,58,30,115,798,77
2016,36081010200,"Census Tract 102, Queens County, New York",814,22,792,346,1311,37372,1939,2010,1387,40.3,44,25,49,43,107,792,53
2017,36081010200,"Census Tract 102, Queens County, New York",796,36,760,274,1054,38879,1939,2011,1527,50,44,32,38,23,111,760,67
2018,36081010200,"Census Tract 102, Queens County, New York",796,61,735,282,1139,43839,0,2012,1541,48.4,43,35,35,42,104,735,95
2019,36081010200,"Census Tract 102, Queens County, New York",810,85,725,235,907,43347,0,2014,1528,51,27,17,17,79,75,725,130
2020,36081010200,"Census Tract 102, Queens County, New York",820,81,739,265,926,55417,0,2012,1576,40.7,33,23,0,64,97,739,116
2012,36081010300,"Census Tract 103, Queens County, New York",2090,143,1947,1500,2618,49253,1943,2005,1313,31.1,734,812,40,241,355,1947,271
2013,36081010300,"Census Tract 103, Queens County, New York",2059,198,1861,1434,2565,50561,1941,2007,1378,31.7,748,832,56,189,305,1861,272
2014,36081010300,"Census Tract 103, Queens County, New York",2017,216,1801,1465,2869,51234,1943,2009,1419,30.5,736,887,51,190,279,1801,218
2015,36081010300,"Census Tract 103, Queens County, New York",1983,159,1824,1450,2791,57361,1942,2011,1432,29.6,901,989,73,137,208,1824,145
2016,36081010300,"Census Tract 103, Queens County, New York",1951,166,1785,1438,2870,60103,1939,2010,1471,29.1,840,963,79,150,242,1785,150
2017,36081010300,"Census Tract 103, Queens County, New York",1996,218,1778,1415,2809,63480,1941,2011,1608,28.4,901,905,83,159,271,1778,122
2018,36081010300,"Census Tract 103, Queens County, New York",2003,183,1820,1397,2893,67250,1946,2010,1645,28.9,771,868,62,116,356,1820,171
2019,36081010300,"Census Tract 103, Queens County, New York",1973,145,1828,1393,2964,70139,1944,2011,1686,28.9,816,906,54,115,297,1828,178
2020,36081010300,"Census Tract 103, Queens County, New York",2047,150,1897,1396,2870,69265,1945,2014,1715,29.2,797,868,58,109,348,1897,205
2012,36081010400,"Census Tract 104, Queens County, New York",975,124,851,364,1339,32283,1939,2002,1214,42.8,12,5,114,107,9,851,122
2013,36081010400,"Census Tract 104, Queens County, New York",996,75,921,420,1481,30076,1939,2004,1277,50,7,7,106,84,14,921,162
2014,36081010400,"Census Tract 104, Queens County, New York",1022,79,943,376,1372,28831,1939,2004,1307,50,27,12,127,86,13,943,168
2015,36081010400,"Census Tract 104, Queens County, New York",1017,82,935,432,1472,28633,1939,2005,1312,50,29,23,189,76,14,935,208
2016,36081010400,"Census Tract 104, Queens County, New York",1033,103,930,349,1106,47011,1939,2005,1309,32.6,29,24,117,52,20,930,124
2017,36081010400,"Census Tract 104, Queens County, New York",1050,87,963,321,1072,49297,1939,2007,1458,35.8,37,25,119,28,39,963,85
2018,36081010400,"Census Tract 104, Queens County, New York",996,83,913,281,859,49250,0,2008,1349,35.9,37,25,92,36,35,913,58
2019,36081010400,"Census Tract 104, Queens County, New York",974,126,848,238,664,54167,1946,2011,1585,36.8,11,19,66,40,34,848,79
2020,36081010400,"Census Tract 104, Queens County, New York",1049,82,967,375,797,34303,1949,2006,1390,51,16,27,212,37,31,967,54
2012,36081010500,"Census Tract 105, Queens County, New York",1829,55,1774,1524,3967,46500,1950,2000,1213,26.4,474,642,117,105,651,1774,323
2013,36081010500,"Census Tract 105, Queens County, New York",1795,54,1741,1499,3715,45341,1952,2001,1266,28.6,470,725,127,72,575,1741,400
2014,36081010500,"Census Tract 105, Queens County, New York",1748,54,1694,1510,3726,39303,1950,2002,1349,29.9,470,707,107,84,613,1694,372
2015,36081010500,"Census Tract 105, Queens County, New York",1737,62,1675,1468,3670,32279,1949,2003,1459,34.9,475,734,100,80,553,1675,432
2016,36081010500,"Census Tract 105, Queens County, New York",1752,68,1684,1469,3549,37250,1950,2005,1472,33.4,448,753,126,78,503,1684,367
2017,36081010500,"Census Tract 105, Queens County, New York",1777,89,1688,1452,3554,32459,1948,2007,1535,34.2,440,758,94,157,439,1688,363
2018,36081010500,"Census Tract 105, Queens County, New York",1745,113,1632,1408,3818,44211,1947,2010,1610,33.2,453,706,86,138,475,1632,312
2019,36081010500,"Census Tract 105, Queens County, New York",1770,83,1687,1442,3843,56944,1947,2010,1717,31.3,518,757,78,178,428,1687,298
2020,36081010500,"Census Tract 105, Queens County, New York",1711,69,1642,1457,4227,58631,1948,2012,1818,30.9,540,730,104,174,449,1642,273
2012,36081010600,"Census Tract 106, Queens County, New York",905,59,846,403,1392,35117,1939,2004,1278,42.9,63,0,85,142,84,846,186
2013,36081010600,"Census Tract 106, Queens County, New York",867,23,844,350,1281,36058,1939,2005,1233,41.8,54,5,64,128,40,844,192
2014,36081010600,"Census Tract 106, Queens County, New York",891,18,873,378,1453,36136,1942,2005,1257,44.6,23,4,90,103,44,873,190
2015,36081010600,"Census Tract 106, Queens County, New York",926,42,884,360,1370,27065,1939,2006,1170,47.5,26,6,81,110,26,884,217
2016,36081010600,"Census Tract 106, Queens County, New York",898,52,846,315,1336,NA,1939,2007,1210,44.7,44,10,72,109,5,846,158
2017,36081010600,"Census Tract 106, Queens County, New York",933,62,871,360,1505,52500,1942,2008,1351,39.5,60,12,64,129,27,871,113
2018,36081010600,"Census Tract 106, Queens County, New York",936,68,868,358,1541,55238,1945,2011,1416,41.1,59,5,76,162,34,868,114
2019,36081010600,"Census Tract 106, Queens County, New York",905,62,843,351,1506,56319,0,2011,1513,41.1,77,6,70,173,35,843,126
2020,36081010600,"Census Tract 106, Queens County, New York",1021,42,979,305,1239,58681,0,2013,1650,40,83,16,51,164,40,979,63
2012,36081010701,"Census Tract 107.01, Queens County, New York",0,0,0,0,0,NA,NA,NA,NA,NA,0,0,0,0,0,0,0
2013,36081010701,"Census Tract 107.01, Queens County, New York",0,0,0,0,0,NA,NA,NA,NA,NA,0,0,0,0,0,0,0
2014,36081010701,"Census Tract 107.01, Queens County, New York",0,0,0,0,0,NA,NA,NA,NA,NA,0,0,0,0,0,0,0
2015,36081010701,"Census Tract 107.01, Queens County, New York",0,0,0,0,0,NA,NA,NA,NA,NA,0,0,0,0,0,0,0
2016,36081010701,"Census Tract 107.01, Queens County, New York",0,0,0,0,0,NA,NA,NA,NA,NA,0,0,0,0,0,0,0
2017,36081010701,"Census Tract 107.01, Queens County, New York",0,0,0,0,0,NA,NA,NA,NA,NA,0,0,0,0,0,0,0
2018,36081010701,"Census Tract 107.01, Queens County, New York",0,0,0,0,0,NA,NA,NA,NA,NA,0,0,0,0,0,0,0
2019,36081010701,"Census Tract 107.01, Queens County, New York",0,0,0,0,0,NA,NA,NA,NA,NA,0,0,0,0,0,0,0
2020,36081010701,"Census Tract 107.01, Queens County, New York",0,0,0,0,0,NA,NA,NA,NA,NA,0,0,0,0,0,0,0
2012,36081010800,"Census Tract 108, Queens County, New York",900,38,862,432,1639,37917,1939,2003,1346,44,21,76,24,107,105,862,111
2013,36081010800,"Census Tract 108, Queens County, New York",885,53,832,340,1298,35952,1942,2005,1297,45.5,27,68,11,100,90,832,137
2014,36081010800,"Census Tract 108, Queens County, New York",869,27,842,397,1328,33250,1946,2008,1285,48.4,50,61,28,131,68,842,132
2015,36081010800,"Census Tract 108, Queens County, New York",836,32,804,332,1422,34674,1949,2009,1495,46.7,50,22,22,132,55,804,106
2016,36081010800,"Census Tract 108, Queens County, New York",844,26,818,413,1746,43125,1942,2010,1508,39,62,5,40,117,103,818,85
2017,36081010800,"Census Tract 108, Queens County, New York",845,25,820,421,1821,48068,1941,2010,1614,35.2,78,0,54,151,93,820,95
2018,36081010800,"Census Tract 108, Queens County, New York",852,23,829,452,1796,48654,0,2011,1640,40.1,94,7,57,157,77,829,75
2019,36081010800,"Census Tract 108, Queens County, New York",809,24,785,421,1757,51169,0,2010,1698,40.7,83,8,46,153,89,785,82
2020,36081010800,"Census Tract 108, Queens County, New York",863,36,827,379,1350,55417,0,2011,1709,35.6,90,8,41,146,73,827,76
2012,36081011000,"Census Tract 110, Queens County, New York",819,25,794,361,1356,41181,1943,2003,1291,39.3,62,5,55,173,92,794,121
2013,36081011000,"Census Tract 110, Queens County, New York",834,42,792,366,1418,37083,1939,2003,1342,41.8,56,5,71,152,121,792,132
2014,36081011000,"Census Tract 110, Queens County, New York",862,56,806,405,1577,42196,1939,2004,1434,37.3,83,12,57,134,184,806,153
2015,36081011000,"Census Tract 110, Queens County, New York",925,53,872,505,2076,57829,1940,2008,1446,28.9,81,33,75,159,203,872,180
2016,36081011000,"Census Tract 110, Queens County, New York",931,34,897,561,2292,46563,1941,2009,1431,35.1,78,50,69,178,217,897,203
2017,36081011000,"Census Tract 110, Queens County, New York",888,29,859,472,1829,56667,1941,2010,1411,31.1,82,35,75,135,158,859,167
2018,36081011000,"Census Tract 110, Queens County, New York",865,23,842,451,1646,55956,1948,2009,1452,30,81,31,61,123,172,842,129
2019,36081011000,"Census Tract 110, Queens County, New York",852,24,828,436,1615,64000,1951,2009,1485,29.8,78,32,61,103,186,828,78
2020,36081011000,"Census Tract 110, Queens County, New York",760,25,735,382,1453,58409,1942,2009,1558,33.7,70,10,55,84,180,735,35
2012,36081011100,"Census Tract 111, Queens County, New York",1293,100,1193,807,1757,78304,1947,2006,1497,21.2,500,527,6,0,198,1193,140
2013,36081011100,"Census Tract 111, Queens County, New York",1259,76,1183,729,1648,69583,1951,2006,1481,23.4,459,501,8,10,131,1183,142
2014,36081011100,"Census Tract 111, Queens County, New York",1310,144,1166,788,1821,61429,1950,2008,1574,27.6,486,485,0,60,158,1166,184
2015,36081011100,"Census Tract 111, Queens County, New York",1322,80,1242,901,2294,59222,1953,2009,1677,29.9,571,574,2,132,135,1242,161
2016,36081011100,"Census Tract 111, Queens County, New York",1317,87,1230,879,2273,62175,1950,2010,1739,29.7,532,570,5,163,87,1230,116
2017,36081011100,"Census Tract 111, Queens County, New York",1299,61,1238,847,2181,63953,1945,2010,1782,30.3,508,541,13,145,133,1238,118
2018,36081011100,"Census Tract 111, Queens County, New York",1356,144,1212,880,2200,67167,1944,2011,1833,30.5,551,548,15,135,172,1212,117
2019,36081011100,"Census Tract 111, Queens County, New York",1333,91,1242,923,2234,78958,1946,2012,1934,30.5,622,643,18,91,167,1242,84
2020,36081011100,"Census Tract 111, Queens County, New York",1369,124,1245,885,2228,108188,1944,2015,1956,24.9,560,622,12,54,171,1245,79
2012,36081011200,"Census Tract 112, Queens County, New York",729,111,618,330,1326,46250,1958,2003,1512,40.8,135,60,6,218,46,618,73
2013,36081011200,"Census Tract 112, Queens County, New York",756,102,654,363,1461,51208,1954,2004,1506,33.8,162,72,6,210,62,654,87
2014,36081011200,"Census Tract 112, Queens County, New York",758,125,633,355,1347,46250,1949,2006,1553,41.2,107,62,27,165,89,633,125
2015,36081011200,"Census Tract 112, Queens County, New York",745,122,623,322,1128,41071,1939,2009,1225,33.5,78,86,19,136,70,623,139
2016,36081011200,"Census Tract 112, Queens County, New York",724,102,622,336,1169,43194,1939,2008,1259,33.9,64,108,17,101,91,622,129
2017,36081011200,"Census Tract 112, Queens County, New York",732,98,634,347,1194,52548,1941,2009,1341,32.7,69,108,19,98,91,634,101
2018,36081011200,"Census Tract 112, Queens County, New York",697,76,621,308,903,52708,1942,2011,1326,29.8,62,138,20,78,57,621,97
2019,36081011200,"Census Tract 112, Queens County, New York",692,60,632,305,995,62981,0,2011,1500,29.3,61,124,7,88,64,632,73
2020,36081011200,"Census Tract 112, Queens County, New York",759,48,711,339,983,57250,0,2012,1700,33.9,47,78,12,71,156,711,129
2012,36081011300,"Census Tract 113, Queens County, New York",2022,119,1903,1287,2797,55565,1941,2003,1420,30,715,682,20,141,449,1903,244
2013,36081011300,"Census Tract 113, Queens County, New York",1959,124,1835,1244,2481,52129,1943,2003,1420,29.5,685,747,18,162,307,1835,212
2014,36081011300,"Census Tract 113, Queens County, New York",1960,101,1859,1320,2661,53179,1944,2006,1477,29.6,720,742,27,188,376,1859,206
2015,36081011300,"Census Tract 113, Queens County, New York",1973,54,1919,1343,2718,54017,1942,2008,1455,29.3,754,850,23,214,255,1919,149
2016,36081011300,"Census Tract 113, Queens County, New York",1965,145,1820,1304,2802,57500,1943,2010,1485,28.9,752,776,26,219,276,1820,146
2017,36081011300,"Census Tract 113, Queens County, New York",1982,187,1795,1346,3212,75577,1939,2011,1593,27.4,780,768,25,236,327,1795,102
2018,36081011300,"Census Tract 113, Queens County, New York",2016,203,1813,1313,2968,75481,0,2012,1670,28.9,723,718,20,191,364,1813,134
2019,36081011300,"Census Tract 113, Queens County, New York",2018,229,1789,1291,2975,80268,0,2013,1795,28.5,749,723,24,158,340,1789,133
2020,36081011300,"Census Tract 113, Queens County, New York",1997,247,1750,1348,2985,85887,0,2016,2006,24.7,857,840,53,109,318,1750,133
2012,36081011400,"Census Tract 114, Queens County, New York",439,104,335,190,478,22012,1951,2005,1127,38.5,59,28,36,0,122,335,99
2013,36081011400,"Census Tract 114, Queens County, New York",389,73,316,213,513,35966,1950,2007,1197,39.2,73,45,34,0,129,316,62
2014,36081011400,"Census Tract 114, Queens County, New York",386,58,328,237,588,37938,1939,2007,1315,50,65,35,74,0,124,328,77
2015,36081011400,"Census Tract 114, Queens County, New York",388,62,326,247,763,26042,1939,2008,1327,50,22,29,48,16,150,326,99
2016,36081011400,"Census Tract 114, Queens County, New York",375,53,322,263,891,35673,1939,2010,1370,50,5,33,50,18,162,322,93
2017,36081011400,"Census Tract 114, Queens County, New York",375,40,335,240,899,41042,1939,2010,1356,38.3,5,26,51,26,137,335,51
2018,36081011400,"Census Tract 114, Queens County, New York",383,35,348,219,863,47992,0,2009,1408,37,8,22,57,29,111,348,37
2019,36081011400,"Census Tract 114, Queens County, New York",378,27,351,197,792,48007,1948,2012,1345,36.9,10,19,17,38,108,351,28
2020,36081011400,"Census Tract 114, Queens County, New York",375,27,348,202,819,49309,0,2011,1462,37.6,33,34,19,16,102,348,31
2012,36081011500,"Census Tract 115, Queens County, New York",1229,113,1116,870,1973,47935,1940,2003,1375,33.4,354,519,0,142,191,1116,256
2013,36081011500,"Census Tract 115, Queens County, New York",1223,160,1063,859,1936,49950,1940,2005,1422,29.8,404,501,0,141,188,1063,208
2014,36081011500,"Census Tract 115, Queens County, New York",1210,180,1030,881,1997,60924,1944,2006,1502,28.5,506,542,8,155,133,1030,161
2015,36081011500,"Census Tract 115, Queens County, New York",1191,183,1008,895,2052,62940,1946,2008,1551,28,578,564,15,153,126,1008,140
2016,36081011500,"Census Tract 115, Queens County, New York",1201,164,1037,850,1810,63462,1944,2009,1543,26.7,553,526,15,136,139,1037,98
2017,36081011500,"Census Tract 115, Queens County, New York",1197,202,995,799,1708,74591,1946,2011,1698,24.7,613,595,8,106,57,995,68
2018,36081011500,"Census Tract 115, Queens County, New York",1248,153,1095,823,1739,79740,1945,2012,1792,24.8,586,617,10,117,68,1095,90
2019,36081011500,"Census Tract 115, Queens County, New York",1233,143,1090,779,1584,87188,0,2013,1813,24.2,526,593,0,88,98,1090,79
2020,36081011500,"Census Tract 115, Queens County, New York",1283,155,1128,808,1630,87125,0,2015,1910,25.3,554,640,0,70,98,1128,81
2012,36081011600,"Census Tract 116, Queens County, New York",617,41,576,280,1039,42500,1949,2003,1270,37.4,27,27,0,82,104,576,43
2013,36081011600,"Census Tract 116, Queens County, New York",663,20,643,339,1149,44830,1964,2003,1168,37.6,51,36,18,76,120,643,83
2014,36081011600,"Census Tract 116, Queens County, New York",646,31,615,321,1097,50481,1956,2006,1204,35.7,47,25,19,88,129,615,75
2015,36081011600,"Census Tract 116, Queens County, New York",621,45,576,283,1074,43393,1947,2007,1441,40.8,42,24,28,90,135,576,66
2016,36081011600,"Census Tract 116, Queens County, New York",618,62,556,277,1033,45114,1950,2010,1338,39.1,36,20,36,80,125,556,79
2017,36081011600,"Census Tract 116, Queens County, New York",613,51,562,295,1124,44539,1939,2011,1593,40.2,27,28,36,69,150,562,108
2018,36081011600,"Census Tract 116, Queens County, New York",604,62,542,290,1090,45750,0,2011,1666,37.5,22,24,24,85,139,542,84
2019,36081011600,"Census Tract 116, Queens County, New York",610,53,557,285,1009,50875,0,2011,1793,29.6,43,41,23,82,132,557,70
2020,36081011600,"Census Tract 116, Queens County, New York",664,58,606,344,1060,40833,0,2014,1637,43.2,71,35,11,86,206,606,129
2012,36081011700,"Census Tract 117, Queens County, New York",1802,116,1686,1324,2588,65037,1943,2005,1476,27.8,869,969,29,167,189,1686,153
2013,36081011700,"Census Tract 117, Queens County, New York",1732,131,1601,1186,2297,61815,1943,2006,1536,29,710,904,27,146,99,1601,71
2014,36081011700,"Census Tract 117, Queens County, New York",1767,131,1636,1248,2692,56944,1941,2008,1501,29.9,736,839,32,202,168,1636,108
2015,36081011700,"Census Tract 117, Queens County, New York",1760,146,1614,1223,2717,60956,1939,2011,1606,28.3,687,799,45,223,165,1614,170
2016,36081011700,"Census Tract 117, Queens County, New York",1781,178,1603,1185,2656,57321,1939,2011,1548,29.4,600,790,10,180,215,1603,173
2017,36081011700,"Census Tract 117, Queens County, New York",1763,221,1542,1086,2561,55096,1939,2011,1592,30.1,509,724,10,188,174,1542,198
2018,36081011700,"Census Tract 117, Queens County, New York",1775,256,1519,1113,2685,59650,0,2012,1660,27.4,561,770,22,176,167,1519,200
2019,36081011700,"Census Tract 117, Queens County, New York",1735,277,1458,1056,2578,85000,0,2012,1738,25.2,578,801,10,134,121,1458,205
2020,36081011700,"Census Tract 117, Queens County, New York",1675,208,1467,1071,2740,103073,1942,2013,1805,23.2,681,774,9,149,192,1467,187
2012,36081011800,"Census Tract 118, Queens County, New York",757,67,690,379,1373,36756,1939,2004,1417,34,116,47,39,153,93,690,78
2013,36081011800,"Census Tract 118, Queens County, New York",757,44,713,409,1488,39602,1939,2005,1397,33.5,126,51,42,203,90,713,122
2014,36081011800,"Census Tract 118, Queens County, New York",751,50,701,426,1595,46389,1939,2006,1555,34.7,133,32,28,221,141,701,104
2015,36081011800,"Census Tract 118, Queens County, New York",711,32,679,433,1666,45521,1939,2009,1596,36.5,85,41,25,200,145,679,122
2016,36081011800,"Census Tract 118, Queens County, New York",724,19,705,447,1687,52250,1939,2009,1629,34.9,69,42,59,170,170,705,127
2017,36081011800,"Census Tract 118, Queens County, New York",726,27,699,412,1572,56719,1950,2010,1643,34.2,70,21,57,152,176,699,137
2018,36081011800,"Census Tract 118, Queens County, New York",683,22,661,397,1568,62202,0,2011,1720,33.8,71,20,58,146,166,661,112
2019,36081011800,"Census Tract 118, Queens County, New York",650,22,628,322,1335,72000,1944,2012,1690,36.2,47,0,55,126,135,628,85
2020,36081011800,"Census Tract 118, Queens County, New York",674,33,641,281,1065,70573,1942,2014,1557,37.4,30,0,36,136,109,641,80
2012,36081011900,"Census Tract 119, Queens County, New York",849,98,751,593,1297,50563,1956,2003,1280,33.4,277,412,0,98,83,751,104
2013,36081011900,"Census Tract 119, Queens County, New York",821,109,712,585,1288,48021,1955,2004,1313,36.9,318,362,5,68,150,712,98
2014,36081011900,"Census Tract 119, Queens County, New York",805,102,703,588,1399,56136,1952,2005,1467,31.6,347,400,5,43,140,703,93
2015,36081011900,"Census Tract 119, Queens County, New York",822,133,689,567,1312,56761,1951,2007,1564,31.6,356,379,5,46,127,689,87
2016,36081011900,"Census Tract 119, Queens County, New York",840,175,665,560,1307,61346,1948,2009,1574,29.6,327,355,4,24,141,665,63
2017,36081011900,"Census Tract 119, Queens County, New York",835,147,688,572,1290,61389,1944,2010,1606,29.8,327,354,5,19,150,688,89
2018,36081011900,"Census Tract 119, Queens County, New York",846,168,678,570,1193,69500,1943,2012,1734,28.9,314,398,0,23,103,678,104
2019,36081011900,"Census Tract 119, Queens County, New York",846,177,669,531,1132,71250,0,2012,1759,28.5,271,344,0,24,113,669,93
2020,36081011900,"Census Tract 119, Queens County, New York",766,127,639,525,1185,85030,1943,2012,1755,28.9,271,323,0,21,146,639,71
2012,36081012000,"Census Tract 120, Queens County, New York",681,10,671,204,629,19510,1939,2006,1547,50,54,15,26,37,122,671,154
2013,36081012000,"Census Tract 120, Queens County, New York",666,10,656,263,911,40708,1939,2008,1430,50,70,15,26,78,128,656,148
2014,36081012000,"Census Tract 120, Queens County, New York",640,34,606,273,1038,41950,1939,2011,1429,49.3,73,7,30,106,110,606,127
2015,36081012000,"Census Tract 120, Queens County, New York",664,39,625,314,1211,41154,1939,2011,1241,41.2,58,8,21,126,96,625,147
2016,36081012000,"Census Tract 120, Queens County, New York",680,50,630,300,1129,42708,1939,2011,1306,33.5,75,5,11,136,92,630,167
2017,36081012000,"Census Tract 120, Queens County, New York",661,37,624,335,1143,42750,1939,2011,1213,41.4,96,9,16,153,76,624,139
2018,36081012000,"Census Tract 120, Queens County, New York",659,51,608,291,876,38661,0,2012,1424,34.9,68,11,19,96,91,608,116
2019,36081012000,"Census Tract 120, Queens County, New York",666,34,632,287,817,57813,0,2013,1530,32.9,76,19,17,87,111,632,117
2020,36081012000,"Census Tract 120, Queens County, New York",622,31,591,293,956,62212,0,2012,1747,29,100,45,0,82,111,591,105
2012,36081012100,"Census Tract 121, Queens County, New York",983,50,933,704,1467,63333,1952,2004,1550,27.4,452,430,33,28,224,933,95
2013,36081012100,"Census Tract 121, Queens County, New York",954,71,883,672,1448,53625,1953,2005,1580,30.8,416,392,25,43,212,883,101
2014,36081012100,"Census Tract 121, Queens County, New York",945,73,872,638,1392,55179,1953,2006,1582,31,383,427,20,76,115,872,130
2015,36081012100,"Census Tract 121, Queens County, New York",951,68,883,608,1346,58041,1953,2009,1590,28.3,333,392,10,63,140,883,124
2016,36081012100,"Census Tract 121, Queens County, New York",987,78,909,654,1465,56919,1952,2010,1529,29.7,351,381,9,73,179,909,121
2017,36081012100,"Census Tract 121, Queens County, New York",1008,88,920,665,1433,57257,1951,2011,1671,29.4,401,421,17,64,157,920,112
2018,36081012100,"Census Tract 121, Queens County, New York",1015,100,915,644,1315,66538,1954,2012,1694,27.4,398,428,25,58,133,915,92
2019,36081012100,"Census Tract 121, Queens County, New York",1011,153,858,577,1205,80650,1951,2013,1832,26.6,351,370,29,43,135,858,58
2020,36081012100,"Census Tract 121, Queens County, New York",1004,188,816,505,1070,74531,1949,2013,1839,29.2,302,287,38,50,127,816,56
2012,36081012200,"Census Tract 122, Queens County, New York",934,83,851,550,1810,43289,1939,2004,1283,35.3,75,85,39,144,253,851,153
2013,36081012200,"Census Tract 122, Queens County, New York",911,86,825,442,1414,42821,1939,2005,1324,36.8,67,72,36,149,155,825,185
2014,36081012200,"Census Tract 122, Queens County, New York",971,86,885,474,1631,52000,1939,2007,1380,30.8,59,88,45,122,193,885,171
2015,36081012200,"Census Tract 122, Queens County, New York",977,84,893,499,1733,56607,1939,2008,1350,31.4,82,68,55,123,209,893,172
2016,36081012200,"Census Tract 122, Queens County, New York",915,97,818,427,1524,46635,1939,2009,1268,28.9,65,34,47,131,172,818,151
2017,36081012200,"Census Tract 122, Queens County, New York",864,101,763,417,1696,44350,1939,2009,1221,28.7,76,42,43,142,142,763,145
2018,36081012200,"Census Tract 122, Queens County, New York",849,84,765,443,1651,46188,0,2008,1284,28.4,93,53,39,122,172,765,122
2019,36081012200,"Census Tract 122, Queens County, New York",793,72,721,366,1204,42188,0,2008,1333,39,95,26,37,117,129,721,137
2020,36081012200,"Census Tract 122, Queens County, New York",713,40,673,293,1048,33125,0,2009,1599,46.4,61,43,6,128,75,673,119
2012,36081012301,"Census Tract 123.01, Queens County, New York",1292,83,1209,734,1580,54741,1949,2005,1557,32,320,558,10,52,124,1209,197
2013,36081012301,"Census Tract 123.01, Queens County, New York",1273,127,1146,726,1483,63241,1951,2006,1581,28.9,402,613,9,58,55,1146,173
2014,36081012301,"Census Tract 123.01, Queens County, New York",1263,119,1144,719,1569,66174,1953,2007,1530,27.4,380,517,58,54,126,1144,159
2015,36081012301,"Census Tract 123.01, Queens County, New York",1269,158,1111,704,1536,82817,1953,2011,1550,23.3,414,502,31,62,118,1111,110
2016,36081012301,"Census Tract 123.01, Queens County, New York",1285,185,1100,691,1535,72019,1955,2011,1715,26.7,351,420,23,81,167,1100,127
2017,36081012301,"Census Tract 123.01, Queens County, New York",1303,161,1142,671,1510,82827,1957,2012,1697,26.1,391,433,25,51,154,1142,135
2018,36081012301,"Census Tract 123.01, Queens County, New York",1389,205,1184,626,1440,76818,1959,2012,1678,27.9,354,369,25,62,162,1184,143
2019,36081012301,"Census Tract 123.01, Queens County, New York",1384,255,1129,638,1537,89071,1955,2012,1865,28.3,385,371,46,61,151,1129,110
2020,36081012301,"Census Tract 123.01, Queens County, New York",1390,237,1153,681,1754,92269,1947,2014,2039,27.7,429,377,52,68,175,1153,114
2012,36081012400,"Census Tract 124, Queens County, New York",899,57,842,531,1791,45489,1939,2004,1262,26.9,131,56,41,133,219,842,149
2013,36081012400,"Census Tract 124, Queens County, New York",892,49,843,557,1898,43516,1939,2004,1325,28.6,137,48,36,101,272,843,172
2014,36081012400,"Census Tract 124, Queens County, New York",908,51,857,539,1765,40885,1939,2005,1339,32.5,174,48,59,128,233,857,127
2015,36081012400,"Census Tract 124, Queens County, New York",927,60,867,533,1799,40388,1939,2006,1339,32.9,133,43,77,81,278,867,153
2016,36081012400,"Census Tract 124, Queens County, New York",898,52,846,511,1806,40492,1939,2007,1344,32.8,119,37,82,68,281,846,134
2017,36081012400,"Census Tract 124, Queens County, New York",875,49,826,497,1613,55250,1939,2009,1357,31.3,112,51,77,81,256,826,106
2018,36081012400,"Census Tract 124, Queens County, New York",888,53,835,523,1694,57125,0,2010,1459,32,108,55,87,91,275,835,95
2019,36081012400,"Census Tract 124, Queens County, New York",919,78,841,484,1656,62805,0,2011,1527,31.6,99,52,66,95,259,841,80
2020,36081012400,"Census Tract 124, Queens County, New York",921,63,858,544,1679,41983,0,2012,1676,34.9,80,41,192,94,206,858,52
2012,36081012500,"Census Tract 125, Queens County, New York",865,100,765,588,1538,60641,1947,2003,1443,28.4,297,293,9,59,186,765,70
2013,36081012500,"Census Tract 125, Queens County, New York",831,123,708,560,1486,60200,1948,2004,1472,29.2,266,252,8,53,207,708,58
2014,36081012500,"Census Tract 125, Queens County, New York",770,94,676,523,1376,58480,1946,2003,1486,30.7,260,222,9,53,207,676,60
2015,36081012500,"Census Tract 125, Queens County, New York",770,98,672,512,1396,54643,1940,2005,1504,32.4,275,304,14,45,137,672,74
2016,36081012500,"Census Tract 125, Queens County, New York",765,58,707,546,1405,54857,1939,2008,1553,33,272,306,25,43,154,707,72
2017,36081012500,"Census Tract 125, Queens County, New York",750,43,707,542,1464,75870,1939,2010,1651,30.5,279,334,27,40,128,707,55
2018,36081012500,"Census Tract 125, Queens County, New York",761,66,695,548,1437,77143,0,2011,1738,30.7,263,326,42,51,129,695,28
2019,36081012500,"Census Tract 125, Queens County, New York",778,69,709,603,1563,82734,0,2012,1794,29.1,309,399,45,40,115,709,37
2020,36081012500,"Census Tract 125, Queens County, New York",871,207,664,573,1435,101118,0,2014,1837,25.8,315,338,40,59,115,664,21
2012,36081012601,"Census Tract 126.01, Queens County, New York",802,30,772,437,1385,48917,1939,2005,1242,33.9,81,29,43,110,204,772,104
2013,36081012601,"Census Tract 126.01, Queens County, New York",825,56,769,420,1397,48382,1939,2006,1323,33.8,71,20,42,83,246,769,124
2014,36081012601,"Census Tract 126.01, Queens County, New York",819,59,760,480,1514,44063,1939,2007,1371,30.8,86,19,63,81,286,760,142
2015,36081012601,"Census Tract 126.01, Queens County, New York",815,51,764,483,1683,51688,1939,2006,1413,30.6,107,15,66,61,305,764,150
2016,36081012601,"Census Tract 126.01, Queens County, New York",792,67,725,436,1674,54844,1939,2008,1406,30.3,94,21,58,53,272,725,127
2017,36081012601,"Census Tract 126.01, Queens County, New York",789,56,733,433,1762,64267,1939,2008,1533,24.9,92,19,78,50,248,733,97
2018,36081012601,"Census Tract 126.01, Queens County, New York",779,27,752,451,1818,70250,0,2009,1602,26.1,129,19,67,42,280,752,70
2019,36081012601,"Census Tract 126.01, Queens County, New York",756,25,731,428,1817,67364,0,2011,1606,29.2,136,18,56,39,256,731,67
2020,36081012601,"Census Tract 126.01, Queens County, New York",740,16,724,396,1623,67778,0,2011,1546,30.8,122,12,54,37,256,724,55
2012,36081012602,"Census Tract 126.02, Queens County, New York",806,24,782,305,875,32010,1939,2004,1170,40.4,9,55,32,14,185,782,74
2013,36081012602,"Census Tract 126.02, Queens County, New York",795,23,772,307,947,52054,1939,2007,1295,33.1,16,32,28,47,187,772,110
2014,36081012602,"Census Tract 126.02, Queens County, New York",805,58,747,355,1141,56016,1939,2009,1238,26.7,36,33,32,77,198,747,109
2015,36081012602,"Census Tract 126.02, Queens County, New York",838,78,760,389,1306,51146,1939,2009,1366,32.6,55,45,26,73,218,760,117
2016,36081012602,"Census Tract 126.02, Queens County, New York",815,78,737,332,1165,52083,1939,2010,1411,28.2,60,39,30,86,181,737,125
2017,36081012602,"Census Tract 126.02, Queens County, New York",808,76,732,342,1364,47143,1939,2010,1500,32.6,57,34,28,87,199,732,116
2018,36081012602,"Census Tract 126.02, Queens County, New York",810,71,739,351,1299,42457,0,2010,1413,36.4,65,41,26,67,217,739,117
2019,36081012602,"Census Tract 126.02, Queens County, New York",790,55,735,354,1336,44167,0,2011,1558,43.9,69,32,24,56,243,735,121
2020,36081012602,"Census Tract 126.02, Queens County, New York",779,25,754,370,1393,47692,1941,2013,1518,46.6,79,12,29,58,223,754,126
2012,36081012800,"Census Tract 128, Queens County, New York",744,29,715,386,885,43654,1939,2005,1068,31,82,118,4,49,215,715,95
2013,36081012800,"Census Tract 128, Queens County, New York",696,42,654,384,943,44450,1939,2005,1139,31.1,108,124,11,79,170,654,91
2014,36081012800,"Census Tract 128, Queens County, New York",749,90,659,328,893,44196,1939,2005,1269,35.1,111,128,16,44,140,659,98
2015,36081012800,"Census Tract 128, Queens County, New York",741,91,650,297,858,38688,1939,2008,1378,40.4,130,112,13,55,112,650,107
2016,36081012800,"Census Tract 128, Queens County, New York",731,45,686,335,985,47356,1939,2010,1384,35.7,125,95,6,36,195,686,102
2017,36081012800,"Census Tract 128, Queens County, New York",730,42,688,313,944,46417,1939,2010,1449,38.5,111,101,8,27,167,688,83
2018,36081012800,"Census Tract 128, Queens County, New York",734,27,707,332,1024,41607,0,2011,1544,38,122,109,33,12,186,707,70
2019,36081012800,"Census Tract 128, Queens County, New York",745,6,739,363,1043,48083,0,2011,1558,36.2,127,119,32,17,197,739,54
2020,36081012800,"Census Tract 128, Queens County, New York",741,4,737,365,986,52610,0,2012,1650,36.8,130,124,29,5,208,737,51
2012,36081013000,"Census Tract 130, Queens County, New York",581,79,502,287,779,58125,1939,2006,1222,36.5,89,109,7,28,121,502,26
2013,36081013000,"Census Tract 130, Queens County, New York",598,72,526,334,910,41711,1939,2009,1282,47.9,99,134,41,61,98,526,30
2014,36081013000,"Census Tract 130, Queens County, New York",593,60,533,352,856,60682,1939,2009,1379,33,152,158,33,48,113,533,71
2015,36081013000,"Census Tract 130, Queens County, New York",586,25,561,386,1012,60870,1939,2010,1407,34.1,202,153,39,50,132,561,58
2016,36081013000,"Census Tract 130, Queens County, New York",588,24,564,409,1067,61619,1939,2009,1444,30,224,137,36,89,135,564,64
2017,36081013000,"Census Tract 130, Queens County, New York",568,12,556,400,1033,58750,1939,2010,1460,32.3,201,144,39,86,120,556,89
2018,36081013000,"Census Tract 130, Queens County, New York",581,31,550,393,978,62635,0,2006,1484,33.2,190,149,10,75,143,550,99
2019,36081013000,"Census Tract 130, Queens County, New York",574,33,541,340,1039,53889,0,2008,1586,35.6,168,134,22,82,86,541,79
2020,36081013000,"Census Tract 130, Queens County, New York",647,33,614,366,1046,41468,0,2014,1555,38.7,65,205,0,74,87,614,96
2012,36081013200,"Census Tract 132, Queens County, New York",642,30,612,356,930,70694,1963,2004,1382,24.6,121,76,81,13,199,612,60
2013,36081013200,"Census Tract 132, Queens County, New York",639,61,578,353,927,60329,1961,2004,1392,26.8,125,75,74,29,181,578,56
2014,36081013200,"Census Tract 132, Queens County, New York",667,63,604,379,1133,58705,1945,2004,1475,28.1,108,118,91,41,124,604,57
2015,36081013200,"Census Tract 132, Queens County, New York",696,59,637,394,1291,60313,1944,2005,1408,28.6,101,114,56,58,159,637,92
2016,36081013200,"Census Tract 132, Queens County, New York",690,51,639,406,1557,62500,1943,2008,1397,27.2,92,99,38,60,200,639,75
2017,36081013200,"Census Tract 132, Queens County, New York",659,49,610,359,1360,58750,1945,2009,1531,30.3,69,96,38,60,151,610,87
2018,36081013200,"Census Tract 132, Queens County, New York",658,24,634,409,1508,60966,1952,2011,1654,31.2,79,127,24,61,174,634,95
2019,36081013200,"Census Tract 132, Queens County, New York",640,15,625,386,1433,59706,1956,2011,1619,28.2,64,138,17,42,168,625,114
2020,36081013200,"Census Tract 132, Queens County, New York",669,15,654,368,1103,72059,1953,2012,1640,26.3,119,143,31,22,144,654,85
2012,36081013400,"Census Tract 134, Queens County, New York",2802,235,2567,1708,3199,54515,1948,2003,1243,27.3,976,1003,123,89,412,2567,34
2013,36081013400,"Census Tract 134, Queens County, New York",2872,221,2651,1813,3685,53849,1949,2003,1329,29.3,1036,1053,185,180,386,2651,177
2014,36081013400,"Census Tract 134, Queens County, New York",2898,305,2593,1754,3672,58438,1950,2005,1411,29,1051,1051,171,188,331,2593,198
2015,36081013400,"Census Tract 134, Queens County, New York",2906,230,2676,1771,3799,54587,1950,2005,1408,30.5,943,1021,195,222,320,2676,210
2016,36081013400,"Census Tract 134, Queens County, New York",2908,344,2564,1788,3978,48676,1949,2007,1469,34.6,877,1079,154,237,284,2564,337
2017,36081013400,"Census Tract 134, Queens County, New York",2929,335,2594,1864,4189,47542,1948,2009,1557,34.1,795,1023,185,297,325,2594,349
2018,36081013400,"Census Tract 134, Queens County, New York",2929,455,2474,1749,3635,51104,1949,2009,1579,33.2,640,1055,116,214,320,2474,327
2019,36081013400,"Census Tract 134, Queens County, New York",2932,411,2521,1871,3606,49451,1947,2010,1518,34.4,681,988,264,185,476,2521,356
2020,36081013400,"Census Tract 134, Queens County, New York",2710,577,2133,1442,2660,57177,1950,2010,1546,32.3,562,816,270,120,288,2133,314
2012,36081013500,"Census Tract 135, Queens County, New York",720,44,676,285,561,51917,1955,2005,1296,27.5,113,243,0,15,21,676,27
2013,36081013500,"Census Tract 135, Queens County, New York",721,57,664,280,589,51719,1955,2006,1129,26.5,85,217,0,18,28,664,37
2014,36081013500,"Census Tract 135, Queens County, New York",692,56,636,288,588,51098,1958,2007,1278,29,96,206,0,18,43,636,47
2015,36081013500,"Census Tract 135, Queens County, New York",680,59,621,308,699,51711,1958,2010,1408,31.3,94,217,0,16,52,621,25
2016,36081013500,"Census Tract 135, Queens County, New York",663,109,554,271,622,55750,1958,2008,1421,28.3,82,189,0,15,44,554,19
2017,36081013500,"Census Tract 135, Queens County, New York",650,77,573,263,650,61058,1957,2007,1548,27.9,73,209,0,10,32,573,32
2018,36081013500,"Census Tract 135, Queens County, New York",692,105,587,296,678,63594,1956,2008,1569,29,85,236,7,16,31,587,34
2019,36081013500,"Census Tract 135, Queens County, New York",693,180,513,251,610,79861,1957,2010,1673,24,95,208,5,12,26,513,30
2020,36081013500,"Census Tract 135, Queens County, New York",634,151,483,197,419,124250,1957,2011,1486,19.9,74,151,4,13,29,483,29
2012,36081013600,"Census Tract 136, Queens County, New York",952,92,860,507,1086,30797,1949,2001,1250,43.4,93,207,41,13,253,860,179
2013,36081013600,"Census Tract 136, Queens County, New York",943,71,872,505,1094,32110,1948,2002,1271,37.9,119,203,34,18,246,872,130
2014,36081013600,"Census Tract 136, Queens County, New York",969,79,890,483,914,32139,1947,2003,1293,45.4,141,240,18,14,206,890,141
2015,36081013600,"Census Tract 136, Queens County, New York",944,105,839,426,848,41771,1947,2003,1375,37.2,144,247,28,15,132,839,123
2016,36081013600,"Census Tract 136, Queens County, New York",953,103,850,431,728,42311,1948,2005,1374,35.2,183,255,16,13,136,850,139
2017,36081013600,"Census Tract 136, Queens County, New York",949,91,858,424,747,49688,1947,2006,1413,29.1,195,240,31,22,127,858,129
2018,36081013600,"Census Tract 136, Queens County, New York",952,109,843,447,799,63750,1949,2010,1533,26.8,188,218,59,37,122,843,114
2019,36081013600,"Census Tract 136, Queens County, New York",919,97,822,456,845,68750,1950,2010,1520,27,162,204,61,35,152,822,77
2020,36081013600,"Census Tract 136, Queens County, New York",844,63,781,468,887,69167,1949,2012,1477,27.8,179,194,63,68,138,781,72
2012,36081013700,"Census Tract 137, Queens County, New York",759,64,695,475,901,50181,1960,2005,1363,32.4,231,352,0,23,61,695,38
2013,36081013700,"Census Tract 137, Queens County, New York",795,65,730,486,1102,53426,1953,2005,1593,32.3,249,359,0,33,90,730,59
2014,36081013700,"Census Tract 137, Queens County, New York",842,112,730,510,1241,61250,1953,2008,1683,29,294,332,0,63,110,730,70
2015,36081013700,"Census Tract 137, Queens County, New York",841,101,740,555,1324,65129,1953,2010,1724,29.3,328,345,0,72,128,740,70
2016,36081013700,"Census Tract 137, Queens County, New York",848,121,727,544,1339,68833,1955,2011,1847,29.8,314,331,0,68,129,727,72
2017,36081013700,"Census Tract 137, Queens County, New York",844,146,698,512,1145,68750,1952,2011,1843,31,271,351,0,53,92,698,44
2018,36081013700,"Census Tract 137, Queens County, New York",856,154,702,492,1064,78409,1954,2012,1903,29.3,273,350,0,70,62,702,21
2019,36081013700,"Census Tract 137, Queens County, New York",854,114,740,527,1152,95350,1954,2014,2116,26.9,294,376,0,63,78,740,20
2020,36081013700,"Census Tract 137, Queens County, New York",905,127,778,596,1233,100789,1953,2015,2164,24.6,353,410,0,61,97,778,23
2012,36081013800,"Census Tract 138, Queens County, New York",1462,136,1326,891,2500,48609,1947,2003,1226,30,358,371,89,116,274,1326,231
2013,36081013800,"Census Tract 138, Queens County, New York",1468,96,1372,910,2146,50405,1946,2004,1207,30.7,389,408,90,75,309,1372,130
2014,36081013800,"Census Tract 138, Queens County, New York",1480,108,1372,932,2401,54352,1946,2005,1283,30.1,341,441,92,139,231,1372,227
2015,36081013800,"Census Tract 138, Queens County, New York",1508,139,1369,908,2260,52794,1944,2006,1310,36.2,379,409,76,181,228,1369,214
2016,36081013800,"Census Tract 138, Queens County, New York",1535,144,1391,912,2215,46250,1945,2007,1343,39.8,361,363,93,154,294,1391,207
2017,36081013800,"Census Tract 138, Queens County, New York",1578,118,1460,993,2424,51971,1946,2008,1358,39.8,352,416,73,153,321,1460,222
2018,36081013800,"Census Tract 138, Queens County, New York",1576,147,1429,951,2475,60060,1947,2010,1529,38,387,335,50,182,324,1429,268
2019,36081013800,"Census Tract 138, Queens County, New York",1580,92,1488,952,2214,62500,1953,2011,1555,32.1,426,331,52,141,339,1488,237
2020,36081013800,"Census Tract 138, Queens County, New York",1501,59,1442,795,1884,64688,1955,2013,1647,29.4,351,278,35,91,310,1442,174
2012,36081014000,"Census Tract 140, Queens County, New York",1529,164,1365,949,2472,51148,1947,2005,1356,31.6,416,456,73,119,301,1365,152
2013,36081014000,"Census Tract 140, Queens County, New York",1524,94,1430,1017,2570,65054,1950,2005,1386,29.2,451,452,88,171,306,1430,91
2014,36081014000,"Census Tract 140, Queens County, New York",1546,138,1408,911,1965,54223,1951,2007,1412,30.9,320,481,52,109,269,1408,118
2015,36081014000,"Census Tract 140, Queens County, New York",1539,157,1382,925,2173,55991,1953,2010,1501,32,362,513,101,120,195,1382,150
2016,36081014000,"Census Tract 140, Queens County, New York",1538,174,1364,840,2003,59050,1957,2011,1533,31.1,389,377,102,120,239,1364,135
2017,36081014000,"Census Tract 140, Queens County, New York",1542,169,1373,816,1999,59355,1958,2011,1588,30.3,369,348,120,115,206,1373,149
2018,36081014000,"Census Tract 140, Queens County, New York",1579,224,1355,785,1965,59856,1957,2011,1593,33.9,332,359,92,79,193,1355,141
2019,36081014000,"Census Tract 140, Queens County, New York",1568,244,1324,743,1970,62036,1955,2012,1652,31.2,346,368,83,49,186,1324,120
2020,36081014000,"Census Tract 140, Queens County, New York",1386,229,1157,606,1646,63558,1953,2012,1606,29.9,298,319,23,24,166,1157,65
2012,36081014100,"Census Tract 141, Queens County, New York",772,29,743,667,1387,58487,1942,2004,1285,30.6,302,485,41,36,114,743,117
2013,36081014100,"Census Tract 141, Queens County, New York",743,18,725,670,1563,59167,1939,2004,1364,31.5,280,474,30,38,143,725,92
2014,36081014100,"Census Tract 141, Queens County, New York",749,23,726,658,1637,64167,1939,2006,1390,30.2,293,451,36,45,144,726,74
2015,36081014100,"Census Tract 141, Queens County, New York",762,66,696,638,1565,65000,1939,2010,1413,29.8,324,394,35,56,157,696,75
2016,36081014100,"Census Tract 141, Queens County, New York",774,64,710,649,1580,61902,1941,2011,1425,30.4,301,366,38,48,209,710,78
2017,36081014100,"Census Tract 141, Queens County, New York",769,83,686,626,1626,60192,1944,2011,1492,33.3,269,340,33,56,204,686,58
2018,36081014100,"Census Tract 141, Queens County, New York",766,101,665,593,1526,67292,1948,2012,1689,32.3,240,351,13,42,165,665,45
2019,36081014100,"Census Tract 141, Queens County, New York",781,127,654,581,1399,65673,1945,2012,1690,33.2,236,294,19,33,189,654,65
2020,36081014100,"Census Tract 141, Queens County, New York",779,95,684,590,1386,72639,1943,2013,1697,32.9,239,301,19,28,206,684,87
2012,36081014201,"Census Tract 142.01, Queens County, New York",1336,108,1228,682,2718,51056,1939,2004,1300,28.9,151,27,88,197,369,1228,129
2013,36081014201,"Census Tract 142.01, Queens County, New York",1340,166,1174,649,2546,53012,1939,2005,1454,28.3,102,27,82,226,297,1174,181
2014,36081014201,"Census Tract 142.01, Queens County, New York",1315,142,1173,787,2861,53671,1942,2006,1380,27.6,106,30,89,205,443,1173,206
2015,36081014201,"Census Tract 142.01, Queens County, New York",1329,164,1165,736,2677,53534,1939,2007,1396,29.7,79,44,104,194,375,1165,227
2016,36081014201,"Census Tract 142.01, Queens County, New York",1301,158,1143,769,2684,47543,1951,2010,1404,34.9,107,41,104,200,378,1143,266
2017,36081014201,"Census Tract 142.01, Queens County, New York",1291,116,1175,843,2884,58015,1955,2011,1425,30.1,148,28,173,192,423,1175,241
2018,36081014201,"Census Tract 142.01, Queens County, New York",1281,71,1210,859,2878,51674,1958,2011,1424,32.1,213,32,161,194,434,1210,199
2019,36081014201,"Census Tract 142.01, Queens County, New York",1306,79,1227,892,3110,52188,1949,2012,1424,30.3,279,28,208,241,350,1227,212
2020,36081014201,"Census Tract 142.01, Queens County, New York",1359,19,1340,871,2919,50610,1950,2013,1427,30.4,291,19,204,210,334,1340,229
2012,36081014202,"Census Tract 142.02, Queens County, New York",645,67,578,346,1097,36705,1939,2004,1218,33.8,120,0,29,109,206,578,90
2013,36081014202,"Census Tract 142.02, Queens County, New York",651,82,569,322,1090,64000,1939,2006,1171,28.2,85,11,5,128,170,569,112
2014,36081014202,"Census Tract 142.02, Queens County, New York",627,60,567,303,951,54306,1939,2006,1194,29.5,65,10,14,155,115,567,108
2015,36081014202,"Census Tract 142.02, Queens County, New York",648,49,599,311,1145,51898,1939,2007,1276,33.9,24,10,23,129,141,599,123
2016,36081014202,"Census Tract 142.02, Queens County, New York",665,67,598,268,1113,57174,1945,2009,1590,32.9,27,9,24,92,143,598,105
2017,36081014202,"Census Tract 142.02, Queens County, New York",649,54,595,315,1183,59427,1939,2010,1559,29,50,15,24,98,178,595,84
2018,36081014202,"Census Tract 142.02, Queens County, New York",670,56,614,341,1416,57813,0,2008,1666,32.2,45,8,31,68,211,614,86
2019,36081014202,"Census Tract 142.02, Queens County, New York",679,54,625,369,1486,60208,0,2008,1622,28.5,88,15,27,66,241,625,88
2020,36081014202,"Census Tract 142.02, Queens County, New York",697,50,647,396,1271,88064,1944,2004,1681,26.2,174,22,10,63,198,647,71
2012,36081014300,"Census Tract 143, Queens County, New York",1830,147,1683,1423,3219,53958,1942,2004,1315,28.6,532,807,52,151,397,1683,202
2013,36081014300,"Census Tract 143, Queens County, New York",1772,113,1659,1409,3222,53053,1942,2004,1312,31.1,502,774,41,162,422,1659,203
2014,36081014300,"Census Tract 143, Queens County, New York",1797,153,1644,1418,3443,55526,1941,2005,1377,31.8,550,785,22,165,446,1644,206
2015,36081014300,"Census Tract 143, Queens County, New York",1792,143,1649,1441,3555,55777,1943,2006,1384,31,610,843,34,174,392,1649,178
2016,36081014300,"Census Tract 143, Queens County, New York",1795,144,1651,1400,3635,61131,1940,2008,1460,30.8,653,742,25,210,432,1651,164
2017,36081014300,"Census Tract 143, Queens County, New York",1828,206,1622,1413,3624,59858,1941,2007,1553,32.2,611,724,26,188,451,1622,183
2018,36081014300,"Census Tract 143, Queens County, New York",1829,219,1610,1395,3434,66535,0,2011,1610,30,688,780,32,206,350,1610,174
2019,36081014300,"Census Tract 143, Queens County, New York",1830,220,1610,1404,3350,68636,0,2011,1613,29.7,715,810,32,190,326,1610,183
2020,36081014300,"Census Tract 143, Queens County, New York",1773,239,1534,1348,3103,69375,0,2012,1683,30.6,818,766,29,176,368,1534,202
2012,36081014400,"Census Tract 144, Queens County, New York",547,28,519,333,1089,43295,1952,2004,1260,34.4,67,10,29,99,174,519,99
2013,36081014400,"Census Tract 144, Queens County, New York",594,23,571,353,1127,35733,1956,2007,1235,33.6,85,8,33,127,165,571,89
2014,36081014400,"Census Tract 144, Queens County, New York",583,42,541,328,1125,36293,1957,2008,1160,33.6,60,8,37,114,141,541,84
2015,36081014400,"Census Tract 144, Queens County, New York",590,47,543,341,1143,36728,1950,2009,1303,34.5,79,0,37,117,183,543,90
2016,36081014400,"Census Tract 144, Queens County, New York",585,49,536,333,1291,38977,1950,2010,1426,46.6,88,0,41,125,167,536,97
2017,36081014400,"Census Tract 144, Queens County, New York",608,50,558,354,1270,41071,1947,2011,1401,42,84,0,46,128,180,558,112
2018,36081014400,"Census Tract 144, Queens County, New York",584,58,526,318,1076,40147,0,2012,1396,43,63,11,49,116,142,526,86
2019,36081014400,"Census Tract 144, Queens County, New York",602,61,541,334,1106,43889,1942,2011,1456,40,73,31,54,80,157,541,77
2020,36081014400,"Census Tract 144, Queens County, New York",594,56,538,341,1217,40625,1944,2011,1525,49.2,55,31,31,162,105,538,121
2012,36081014500,"Census Tract 145, Queens County, New York",1061,156,905,635,1300,53839,1949,2004,1407,32.6,375,483,59,32,70,905,42
2013,36081014500,"Census Tract 145, Queens County, New York",1021,171,850,614,1411,52895,1946,2005,1526,34.3,316,452,70,29,75,850,87
2014,36081014500,"Census Tract 145, Queens County, New York",1017,149,868,641,1530,54671,1939,2007,1566,32.7,317,419,54,62,124,868,100
2015,36081014500,"Census Tract 145, Queens County, New York",1049,156,893,655,1664,57969,1939,2009,1518,31.9,356,429,61,29,144,893,115
2016,36081014500,"Census Tract 145, Queens County, New York",1037,131,906,597,1451,64750,1941,2011,1623,31.2,326,414,26,38,114,906,98
2017,36081014500,"Census Tract 145, Queens County, New York",1072,169,903,566,1453,66705,1942,2011,1617,31.8,317,384,12,49,118,903,116
2018,36081014500,"Census Tract 145, Queens County, New York",1069,188,881,593,1549,72163,1945,2012,1710,32.2,357,357,11,57,165,881,82
2019,36081014500,"Census Tract 145, Queens County, New York",1095,219,876,593,1671,80529,1946,2012,1780,31.2,357,355,12,53,169,876,97
2020,36081014500,"Census Tract 145, Queens County, New York",1093,207,886,651,1681,85436,1950,2014,1926,27.2,399,385,14,46,171,886,77
2012,36081014700,"Census Tract 147, Queens County, New York",1500,199,1301,1047,2076,51369,1939,2004,1382,31.4,566,755,9,56,201,1301,65
2013,36081014700,"Census Tract 147, Queens County, New York",1494,149,1345,1107,2380,47154,1939,2004,1384,31.8,533,820,31,47,187,1345,136
2014,36081014700,"Census Tract 147, Queens County, New York",1512,111,1401,1153,2493,50739,1945,2006,1448,31.8,619,769,33,55,275,1401,128
2015,36081014700,"Census Tract 147, Queens County, New York",1462,72,1390,1141,2649,65352,1944,2007,1487,28.7,592,788,60,34,272,1390,93
2016,36081014700,"Census Tract 147, Queens County, New York",1420,79,1341,1109,2522,73170,1941,2008,1504,27.9,580,782,62,48,222,1341,99
2017,36081014700,"Census Tract 147, Queens County, New York",1440,74,1366,1093,2398,77139,1952,2008,1586,27.8,548,745,50,54,252,1366,108
2018,36081014700,"Census Tract 147, Queens County, New York",1445,150,1295,1005,2148,82893,1952,2010,1637,26.8,546,675,34,64,241,1295,35
2019,36081014700,"Census Tract 147, Queens County, New York",1400,210,1190,922,1986,83590,1946,2010,1689,27.5,453,651,25,81,165,1190,73
2020,36081014700,"Census Tract 147, Queens County, New York",1494,208,1286,1066,2181,81429,1947,2011,1756,29.6,551,727,133,77,116,1286,123
2012,36081014800,"Census Tract 148, Queens County, New York",591,68,523,245,993,32969,1941,2004,1410,46.6,64,0,58,103,49,523,70
2013,36081014800,"Census Tract 148, Queens County, New York",618,74,544,227,1027,41536,1939,2003,1396,34,65,13,15,61,108,544,57
2014,36081014800,"Census Tract 148, Queens County, New York",594,82,512,223,909,42019,1939,2004,1502,35.8,28,14,27,59,107,512,88
2015,36081014800,"Census Tract 148, Queens County, New York",607,52,555,233,930,37083,1939,2005,1352,37.5,34,14,27,71,105,555,98
2016,36081014800,"Census Tract 148, Queens County, New York",610,63,547,233,857,61058,1939,2005,1526,35.5,41,16,14,61,105,547,74
2017,36081014800,"Census Tract 148, Queens County, New York",618,56,562,237,829,41895,1939,2005,1356,40.9,38,14,13,74,98,562,75
2018,36081014800,"Census Tract 148, Queens County, New York",590,64,526,215,679,41793,1942,2005,1585,40.7,15,0,31,82,71,526,73
2019,36081014800,"Census Tract 148, Queens County, New York",530,59,471,161,500,63015,1940,2005,1610,38.2,18,0,13,59,81,471,46
2020,36081014800,"Census Tract 148, Queens County, New York",509,59,450,144,460,NA,0,2005,1650,43.8,6,0,20,39,66,450,83
2012,36081014900,"Census Tract 149, Queens County, New York",1112,202,910,790,1666,61563,1939,2004,1410,25.5,444,476,6,82,197,910,151
2013,36081014900,"Census Tract 149, Queens County, New York",1079,170,909,822,1841,68500,1939,2003,1512,28.1,396,478,3,75,226,909,102
2014,36081014900,"Census Tract 149, Queens County, New York",1069,141,928,833,2023,74938,1941,2005,1527,26.3,431,505,38,49,221,928,86
2015,36081014900,"Census Tract 149, Queens County, New York",1086,58,1028,915,2140,NA,1944,2006,1587,28.8,455,570,43,53,240,1028,97
2016,36081014900,"Census Tract 149, Queens County, New York",1058,101,957,879,2076,75384,1943,2007,1553,26.6,470,547,38,74,228,957,54
2017,36081014900,"Census Tract 149, Queens County, New York",1082,118,964,866,2036,68587,1945,2007,1638,28.1,468,573,45,72,194,964,34
2018,36081014900,"Census Tract 149, Queens County, New York",1102,226,876,793,1739,64135,0,2011,1712,30.8,502,537,38,58,185,876,32
2019,36081014900,"Census Tract 149, Queens County, New York",1086,213,873,790,1644,68864,0,2012,1744,29.9,460,556,3,62,169,873,28
2020,36081014900,"Census Tract 149, Queens County, New York",1017,205,812,779,1744,69453,0,2013,1830,31.6,414,544,5,92,138,812,0
2012,36081015000,"Census Tract 150, Queens County, New York",645,0,645,144,471,38684,1939,2004,1333,49.7,36,0,9,91,0,645,128
2013,36081015000,"Census Tract 150, Queens County, New York",626,0,626,165,643,38533,1939,2006,1375,50,64,0,9,117,13,626,106
2014,36081015000,"Census Tract 150, Queens County, New York",631,0,631,204,767,43333,1939,2007,1419,37.6,72,0,22,91,53,631,127
2015,36081015000,"Census Tract 150, Queens County, New York",632,0,632,223,901,72386,1939,2007,1471,30.6,78,0,21,97,67,632,97
2016,36081015000,"Census Tract 150, Queens County, New York",653,0,653,235,1050,71705,1939,2008,1431,30.1,75,0,26,100,70,653,82
2017,36081015000,"Census Tract 150, Queens County, New York",632,5,627,231,952,69375,1939,2011,1414,29.4,66,0,19,100,70,627,55
2018,36081015000,"Census Tract 150, Queens County, New York",655,4,651,215,742,68942,0,2012,1375,27.6,62,9,10,93,62,651,50
2019,36081015000,"Census Tract 150, Queens County, New York",666,5,661,169,649,100089,0,2013,1469,26.1,43,7,7,97,20,661,42
2020,36081015000,"Census Tract 150, Queens County, New York",621,6,615,217,759,NA,0,2016,1646,34.2,28,11,21,153,8,615,46
2012,36081015100,"Census Tract 151, Queens County, New York",1249,101,1148,813,1602,49918,1939,2003,1323,32.2,345,409,0,108,239,1148,134
2013,36081015100,"Census Tract 151, Queens County, New York",1236,80,1156,864,1624,50870,1939,2004,1374,35,375,487,0,107,234,1156,134
2014,36081015100,"Census Tract 151, Queens County, New York",1236,61,1175,874,1657,60135,1940,2006,1394,29.4,418,631,0,82,131,1175,137
2015,36081015100,"Census Tract 151, Queens County, New York",1254,19,1235,996,1955,59028,1943,2007,1431,29.9,470,781,0,88,110,1235,211
2016,36081015100,"Census Tract 151, Queens County, New York",1245,80,1165,945,1869,61250,1945,2009,1479,30,487,803,0,59,73,1165,157
2017,36081015100,"Census Tract 151, Queens County, New York",1257,138,1119,917,1941,64583,1944,2009,1598,29,461,770,0,66,70,1119,152
2018,36081015100,"Census Tract 151, Queens County, New York",1290,148,1142,881,1798,66510,1945,2009,1568,27.5,454,709,0,72,78,1142,165
2019,36081015100,"Census Tract 151, Queens County, New York",1354,153,1201,963,2094,64196,1944,2011,1637,25,521,692,0,68,173,1201,137
2020,36081015100,"Census Tract 151, Queens County, New York",1389,204,1185,924,1981,64833,1942,2013,1664,26.8,508,618,0,75,206,1185,81
2012,36081015200,"Census Tract 152, Queens County, New York",795,37,758,408,1580,38068,1946,2004,1490,50,97,0,124,75,84,758,148
2013,36081015200,"Census Tract 152, Queens County, New York",814,36,778,368,1388,39457,1948,2005,1395,36.3,128,0,117,105,55,778,108
2014,36081015200,"Census Tract 152, Queens County, New York",812,43,769,416,1483,50278,1947,2006,1401,33.9,152,0,104,141,99,769,127
2015,36081015200,"Census Tract 152, Queens County, New York",776,46,730,354,1309,46923,1942,2009,1433,33.6,71,0,80,82,86,730,130
2016,36081015200,"Census Tract 152, Queens County, New York",799,39,760,398,1605,50568,1941,2009,1622,34.8,81,11,69,107,99,760,121
2017,36081015200,"Census Tract 152, Queens County, New York",794,28,766,382,1549,45435,1943,2010,1698,42.4,80,9,75,105,105,766,154
2018,36081015200,"Census Tract 152, Queens County, New York",770,44,726,401,1590,49837,1946,2011,1728,34.4,63,13,63,134,101,726,115
2019,36081015200,"Census Tract 152, Queens County, New York",750,38,712,362,1452,49091,0,2011,1719,34,71,12,63,97,128,712,89
2020,36081015200,"Census Tract 152, Queens County, New York",784,38,746,353,1415,37031,1945,2012,1668,44.1,69,17,56,98,113,746,111
2012,36081015300,"Census Tract 153, Queens County, New York",996,116,880,672,1538,57933,1944,2004,1476,31.4,354,361,19,129,131,880,92
2013,36081015300,"Census Tract 153, Queens County, New York",980,91,889,744,1614,55625,1945,2005,1477,32.8,374,382,27,161,150,889,103
2014,36081015300,"Census Tract 153, Queens County, New York",1026,106,920,756,1616,45250,1951,2007,1522,36,387,380,6,183,163,920,121
2015,36081015300,"Census Tract 153, Queens County, New York",1035,82,953,791,1632,46302,1947,2010,1554,35.5,409,386,16,137,211,953,138
2016,36081015300,"Census Tract 153, Queens County, New York",1051,117,934,791,1637,52344,1947,2011,1572,33.6,425,368,23,136,223,934,142
2017,36081015300,"Census Tract 153, Queens County, New York",1035,151,884,762,1679,60857,1946,2011,1670,31.8,442,359,26,116,218,884,101
2018,36081015300,"Census Tract 153, Queens County, New York",1031,153,878,732,1574,66875,1949,2011,1789,31,449,376,25,100,182,878,97
2019,36081015300,"Census Tract 153, Queens County, New York",1017,203,814,686,1534,81774,1946,2012,1819,26.3,430,386,32,85,137,814,78
2020,36081015300,"Census Tract 153, Queens County, New York",991,184,807,699,1583,92344,1953,2014,1969,24,470,407,23,127,128,807,104
2012,36081015400,"Census Tract 154, Queens County, New York",586,74,512,272,838,36875,1944,2004,1138,35.7,21,39,26,69,69,512,105
2013,36081015400,"Census Tract 154, Queens County, New York",610,66,544,286,904,34250,1946,2007,1173,34.6,24,29,46,85,49,544,97
2014,36081015400,"Census Tract 154, Queens County, New York",648,62,586,271,794,36328,1939,2007,1195,35.5,29,36,29,52,71,586,99
2015,36081015400,"Census Tract 154, Queens County, New York",647,39,608,283,817,30469,1939,2010,1327,49.2,42,17,38,54,79,608,106
2016,36081015400,"Census Tract 154, Queens County, New York",655,39,616,295,919,29063,1939,2010,1369,50,61,12,44,75,57,616,123
2017,36081015400,"Census Tract 154, Queens County, New York",679,46,633,331,1078,34375,1944,2011,1434,46.3,80,12,57,113,47,633,113
2018,36081015400,"Census Tract 154, Queens County, New York",649,52,597,315,947,40694,1942,2010,1554,44.8,86,16,40,114,55,597,107
2019,36081015400,"Census Tract 154, Queens County, New York",641,48,593,304,898,50556,0,2011,1643,40.4,85,5,36,133,38,593,101
2020,36081015400,"Census Tract 154, Queens County, New York",595,64,531,286,909,66000,0,2013,1654,30.4,87,6,29,129,29,531,74
2012,36081015500,"Census Tract 155, Queens County, New York",1026,104,922,755,1709,61713,1952,2004,1436,26.9,294,465,21,106,143,922,104
2013,36081015500,"Census Tract 155, Queens County, New York",1032,113,919,751,1738,57396,1949,2005,1474,25.6,314,428,5,118,177,919,84
2014,36081015500,"Census Tract 155, Queens County, New York",1019,76,943,781,1874,62083,1950,2006,1496,25.7,331,420,20,106,230,943,82
2015,36081015500,"Census Tract 155, Queens County, New York",1007,71,936,773,1877,72760,1948,2008,1480,24.9,387,446,24,88,217,936,81
2016,36081015500,"Census Tract 155, Queens County, New York",1010,36,974,823,2080,70750,1947,2009,1568,24.3,452,471,26,117,209,974,89
2017,36081015500,"Census Tract 155, Queens County, New York",1020,97,923,745,1944,72750,1945,2010,1654,24.3,383,410,20,93,204,923,75
2018,36081015500,"Census Tract 155, Queens County, New York",1016,125,891,706,1912,82000,1947,2011,1848,24.4,379,381,34,103,184,891,70
2019,36081015500,"Census Tract 155, Queens County, New York",1028,181,847,663,1818,92125,1947,2012,2000,23.4,379,396,24,98,147,847,82
2020,36081015500,"Census Tract 155, Queens County, New York",1015,214,801,616,1558,108000,1954,2015,2018,22.7,348,346,19,98,146,801,49
2012,36081015600,"Census Tract 156, Queens County, New York",924,39,885,440,1631,31618,1939,2004,1382,49.2,77,22,63,179,50,885,206
2013,36081015600,"Census Tract 156, Queens County, New York",907,44,863,378,1485,31136,1939,2006,1385,50,78,0,90,156,26,863,198
2014,36081015600,"Census Tract 156, Queens County, New York",909,57,852,405,1531,32917,1939,2007,1398,49.4,75,5,100,139,47,852,166
2015,36081015600,"Census Tract 156, Queens County, New York",877,75,802,375,1354,42813,1941,2009,1418,39.2,64,5,76,124,55,802,145
2016,36081015600,"Census Tract 156, Queens County, New York",894,72,822,348,1247,44844,1943,2010,1460,35.1,47,17,75,97,52,822,122
2017,36081015600,"Census Tract 156, Queens County, New York",918,77,841,340,1065,45781,1945,2011,1515,39.8,49,22,57,106,44,841,160
2018,36081015600,"Census Tract 156, Queens County, New York",885,87,798,303,869,45885,1945,2012,1583,38.4,51,26,44,116,32,798,146
2019,36081015600,"Census Tract 156, Queens County, New York",881,70,811,316,1008,53482,1946,2012,1646,36.8,52,9,41,115,51,811,116
2020,36081015600,"Census Tract 156, Queens County, New York",796,58,738,267,865,65417,1950,2013,1467,28.8,45,12,31,142,28,738,116
2012,36081015700,"Census Tract 157, Queens County, New York",689,0,689,683,1549,43750,1946,2001,1278,35.7,275,244,34,154,245,689,107
2013,36081015700,"Census Tract 157, Queens County, New York",720,0,720,716,1557,45938,1945,2004,1306,36.2,334,280,37,184,203,720,126
2014,36081015700,"Census Tract 157, Queens County, New York",714,0,714,703,1558,45845,1945,2006,1359,35.8,310,341,20,164,151,714,136
2015,36081015700,"Census Tract 157, Queens County, New York",724,35,689,679,1432,46632,1942,2008,1376,34.7,319,334,17,153,145,689,131
2016,36081015700,"Census Tract 157, Queens County, New York",736,64,672,664,1484,50455,1939,2009,1391,30.7,302,318,6,140,178,672,126
2017,36081015700,"Census Tract 157, Queens County, New York",738,111,627,616,1460,54722,1939,2010,1469,30.1,297,286,21,124,162,627,106
2018,36081015700,"Census Tract 157, Queens County, New York",738,135,603,582,1249,66000,0,2011,1588,28.9,295,236,43,112,176,603,66
2019,36081015700,"Census Tract 157, Queens County, New York",741,159,582,566,1279,62708,0,2013,1632,30.1,303,236,26,104,192,582,61
2020,36081015700,"Census Tract 157, Queens County, New York",784,196,588,572,1253,62167,0,2014,1706,31.3,329,273,40,82,177,588,50
2012,36081015801,"Census Tract 158.01, Queens County, New York",1069,97,972,443,1223,31932,1939,2003,1321,49.7,6,0,142,79,156,972,95
2013,36081015801,"Census Tract 158.01, Queens County, New York",1059,80,979,398,1028,31875,1939,2003,1375,50,13,0,154,64,116,979,133
2014,36081015801,"Census Tract 158.01, Queens County, New York",1052,67,985,431,1243,32470,1939,2004,1387,50,17,0,133,61,125,985,146
2015,36081015801,"Census Tract 158.01, Queens County, New York",1055,108,947,392,1160,42589,1939,2006,1429,49.7,14,0,106,33,71,947,129
2016,36081015801,"Census Tract 158.01, Queens County, New York",1030,96,934,304,1014,31500,1939,2007,1463,50,17,0,78,33,39,934,140
2017,36081015801,"Census Tract 158.01, Queens County, New York",1037,101,936,277,992,55515,1939,2008,1593,33.4,16,0,90,39,21,936,163
2018,36081015801,"Census Tract 158.01, Queens County, New York",1042,113,929,325,1174,70221,0,2007,1669,32.2,47,0,107,39,10,929,124
2019,36081015801,"Census Tract 158.01, Queens County, New York",1079,106,973,353,1224,71908,0,2007,1689,29.6,53,0,115,86,0,973,104
2020,36081015801,"Census Tract 158.01, Queens County, New York",1125,91,1034,260,1030,69348,1946,2011,1795,32.1,45,0,96,81,0,1034,134
2012,36081015802,"Census Tract 158.02, Queens County, New York",1379,90,1289,655,2275,54879,1939,2006,1323,30.1,189,42,69,133,141,1289,98
2013,36081015802,"Census Tract 158.02, Queens County, New York",1355,44,1311,696,2377,52188,1939,2006,1315,30.2,170,26,99,147,106,1311,107
2014,36081015802,"Census Tract 158.02, Queens County, New York",1312,45,1267,635,2063,43507,1939,2007,1376,35,146,45,111,138,140,1267,97
2015,36081015802,"Census Tract 158.02, Queens County, New York",1249,34,1215,560,1939,46591,1939,2008,1378,32.5,129,16,93,142,132,1215,102
2016,36081015802,"Census Tract 158.02, Queens County, New York",1284,49,1235,520,1988,54917,1939,2008,1467,29.7,108,17,85,121,119,1235,111
2017,36081015802,"Census Tract 158.02, Queens County, New York",1281,46,1235,474,1796,55833,1939,2009,1450,36.1,74,32,67,72,122,1235,135
2018,36081015802,"Census Tract 158.02, Queens County, New York",1265,47,1218,492,2028,56818,0,2011,1491,37,68,31,31,98,136,1218,115
2019,36081015802,"Census Tract 158.02, Queens County, New York",1249,49,1200,445,1775,63295,0,2011,1539,33.9,73,14,14,91,128,1200,62
2020,36081015802,"Census Tract 158.02, Queens County, New York",1244,46,1198,460,1737,57763,0,2013,1532,37.2,72,12,27,79,180,1198,70
2012,36081015900,"Census Tract 159, Queens County, New York",1998,114,1884,1709,3448,43479,1943,2001,1377,33.6,702,975,23,367,344,1884,258
2013,36081015900,"Census Tract 159, Queens County, New York",2037,102,1935,1690,3560,51226,1942,2001,1348,32.3,640,1050,24,283,322,1935,314
2014,36081015900,"Census Tract 159, Queens County, New York",2033,75,1958,1730,3595,50189,1941,2003,1361,33.5,762,1085,26,280,312,1958,318
2015,36081015900,"Census Tract 159, Queens County, New York",2068,137,1931,1752,3474,45685,1939,2006,1381,38,931,1113,26,299,279,1931,411
2016,36081015900,"Census Tract 159, Queens County, New York",2058,168,1890,1697,3428,46507,1939,2007,1426,37,888,1092,9,280,281,1890,367
2017,36081015900,"Census Tract 159, Queens County, New York",2074,256,1818,1628,3424,50000,1939,2008,1442,35.9,853,1124,0,156,301,1818,263
2018,36081015900,"Census Tract 159, Queens County, New York",2060,317,1743,1600,3365,48418,0,2010,1546,37.7,868,1092,0,157,305,1743,261
2019,36081015900,"Census Tract 159, Queens County, New York",2054,413,1641,1485,3083,61192,0,2012,1642,33.7,883,1058,0,141,235,1641,235
2020,36081015900,"Census Tract 159, Queens County, New York",2011,422,1589,1424,2899,74929,0,2012,1744,30.4,835,979,0,100,304,1589,165
2012,36081016100,"Census Tract 161, Queens County, New York",895,87,808,538,1435,50463,1939,2003,1383,32.1,221,213,52,116,184,808,93
2013,36081016100,"Census Tract 161, Queens County, New York",873,104,769,603,1836,50494,1939,2004,1510,36.6,231,187,37,150,241,769,111
2014,36081016100,"Census Tract 161, Queens County, New York",878,73,805,678,2040,49423,1939,2005,1478,37.1,271,241,37,136,276,805,131
2015,36081016100,"Census Tract 161, Queens County, New York",891,61,830,662,2126,49868,1939,2006,1556,35.1,274,242,54,101,295,830,140
2016,36081016100,"Census Tract 161, Queens County, New York",896,68,828,657,2075,53750,1939,2007,1600,32,284,268,24,100,305,828,139
2017,36081016100,"Census Tract 161, Queens County, New York",888,79,809,638,2056,53462,1943,2007,1663,35,296,236,19,109,293,809,116
2018,36081016100,"Census Tract 161, Queens County, New York",896,123,773,571,1760,61761,1943,2008,1740,31,299,251,17,93,225,773,98
2019,36081016100,"Census Tract 161, Queens County, New York",914,153,761,574,1804,73750,0,2009,1743,29.5,297,215,15,109,233,761,87
2020,36081016100,"Census Tract 161, Queens County, New York",914,154,760,607,1877,75679,1941,2010,1861,32.5,226,212,25,134,214,760,78
2012,36081016300,"Census Tract 163, Queens County, New York",1734,63,1671,1479,3507,27259,1947,1997,599,28.3,143,142,520,72,732,1671,417
2013,36081016300,"Census Tract 163, Queens County, New York",1740,51,1689,1471,3550,26766,1947,1996,611,28,202,130,477,140,716,1689,466
2014,36081016300,"Census Tract 163, Queens County, New York",1770,24,1746,1600,3706,25150,1947,1994,618,30.1,194,151,461,127,872,1746,515
2015,36081016300,"Census Tract 163, Queens County, New York",1782,53,1729,1555,3348,NA,1946,1994,591,30.2,232,185,450,128,803,1729,505
2016,36081016300,"Census Tract 163, Queens County, New York",1742,26,1716,1569,3367,21237,1946,1993,555,30.7,178,212,450,166,769,1716,515
2017,36081016300,"Census Tract 163, Queens County, New York",1743,52,1691,1579,3320,20468,1946,1992,532,30.2,199,252,472,194,678,1691,557
2018,36081016300,"Census Tract 163, Queens County, New York",1781,50,1731,1615,3260,21128,1946,1996,496,29.7,174,289,477,123,757,1731,510
2019,36081016300,"Census Tract 163, Queens County, New York",1774,66,1708,1582,3220,21676,1947,1998,527,28.9,178,267,516,173,664,1708,459
2020,36081016300,"Census Tract 163, Queens County, New York",1742,77,1665,1574,3212,23300,1947,1999,485,27,173,259,419,149,798,1665,467
2012,36081016400,"Census Tract 164, Queens County, New York",973,48,925,313,1025,28475,1942,2006,1415,50,60,0,134,53,74,925,166
2013,36081016400,"Census Tract 164, Queens County, New York",948,46,902,262,863,33045,1943,2007,1347,50,59,0,122,37,44,902,141
2014,36081016400,"Census Tract 164, Queens County, New York",926,21,905,265,939,33806,1943,2011,1348,49.6,37,0,95,16,61,905,130
2015,36081016400,"Census Tract 164, Queens County, New York",917,51,866,256,987,41000,1939,2010,1362,46.3,6,0,83,31,35,866,91
2016,36081016400,"Census Tract 164, Queens County, New York",928,55,873,247,909,50234,1939,2010,1474,40.5,20,0,79,46,53,873,67
2017,36081016400,"Census Tract 164, Queens County, New York",945,76,869,236,954,47167,1939,2011,1665,41.1,15,0,61,49,72,869,70
2018,36081016400,"Census Tract 164, Queens County, New York",998,89,909,226,963,47143,0,2011,1643,39.8,13,0,57,35,67,909,95
2019,36081016400,"Census Tract 164, Queens County, New York",980,93,887,212,793,67500,0,2011,1569,29.9,28,0,66,54,56,887,82
2020,36081016400,"Census Tract 164, Queens County, New York",994,46,948,181,651,81420,0,2013,1535,27.4,27,0,65,41,49,948,73
2012,36081016600,"Census Tract 166, Queens County, New York",1066,27,1039,559,1879,32420,1939,2005,1226,38.1,96,14,105,161,159,1039,207
2013,36081016600,"Census Tract 166, Queens County, New York",1045,54,991,506,1603,31385,1939,2005,1245,43.7,59,8,125,110,127,991,162
2014,36081016600,"Census Tract 166, Queens County, New York",1032,62,970,541,1550,30774,1943,2004,1351,50,84,8,122,80,160,970,147
2015,36081016600,"Census Tract 166, Queens County, New York",1028,70,958,581,1814,34193,1945,2002,1296,48.9,50,10,89,84,238,958,97
2016,36081016600,"Census Tract 166, Queens County, New York",1141,49,1092,550,1580,38421,1952,2002,1279,42.2,0,0,64,66,228,1092,141
2017,36081016600,"Census Tract 166, Queens County, New York",1058,54,1004,451,1294,43566,1953,2003,1325,36.8,0,0,50,44,228,1004,57
2018,36081016600,"Census Tract 166, Queens County, New York",1092,28,1064,497,1486,42904,1953,2005,1343,38,13,13,61,85,221,1064,80
2019,36081016600,"Census Tract 166, Queens County, New York",1103,60,1043,396,1395,46308,0,2008,1392,37.3,14,12,57,148,145,1043,72
2020,36081016600,"Census Tract 166, Queens County, New York",1097,54,1043,402,1365,58254,1942,2011,1641,35.5,29,10,60,184,67,1043,95
2012,36081016800,"Census Tract 168, Queens County, New York",888,53,835,195,550,54228,1957,2005,1270,25.4,6,0,72,18,62,835,59
2013,36081016800,"Census Tract 168, Queens County, New York",938,47,891,207,602,52617,1966,2005,1296,28.5,19,0,65,28,95,891,51
2014,36081016800,"Census Tract 168, Queens County, New York",960,46,914,210,654,40385,1963,2004,1230,37.3,19,0,52,33,79,914,69
2015,36081016800,"Census Tract 168, Queens County, New York",932,46,886,233,725,49028,1960,2006,1261,37.5,22,14,41,41,73,886,66
2016,36081016800,"Census Tract 168, Queens County, New York",892,32,860,261,848,47750,1961,2006,1334,37.6,23,20,54,42,76,860,96
2017,36081016800,"Census Tract 168, Queens County, New York",895,23,872,238,778,41875,1950,2005,1429,38.5,29,16,48,38,57,872,102
2018,36081016800,"Census Tract 168, Queens County, New York",882,24,858,261,983,44306,1949,2009,1641,38.8,15,16,77,44,61,858,132
2019,36081016800,"Census Tract 168, Queens County, New York",863,34,829,235,930,54596,1945,2012,1728,34.4,24,14,82,50,46,829,123
2020,36081016800,"Census Tract 168, Queens County, New York",888,27,861,243,1060,87313,1949,2010,1816,24.5,31,0,80,44,91,861,131
2012,36081016900,"Census Tract 169, Queens County, New York",2548,248,2300,1619,3528,52540,1939,2002,1288,28.9,572,807,9,436,359,2300,166
2013,36081016900,"Census Tract 169, Queens County, New York",2538,271,2267,1645,3798,39736,1939,2002,1273,32,697,863,10,403,366,2267,144
2014,36081016900,"Census Tract 169, Queens County, New York",2505,224,2281,1598,3554,37390,1939,2003,1382,40,698,848,23,353,382,2281,161
2015,36081016900,"Census Tract 169, Queens County, New York",2554,222,2332,1636,3806,45057,1939,2004,1422,33.4,781,813,15,356,439,2332,169
2016,36081016900,"Census Tract 169, Queens County, New York",2614,203,2411,1663,3991,48958,1939,2006,1544,34.6,819,756,66,312,498,2411,138
2017,36081016900,"Census Tract 169, Queens County, New York",2670,172,2498,1655,4155,55029,1943,2004,1474,32.5,690,632,63,353,574,2498,207
2018,36081016900,"Census Tract 169, Queens County, New York",2661,110,2551,1658,4056,55762,0,2007,1635,33.7,708,573,66,383,605,2551,265
2019,36081016900,"Census Tract 169, Queens County, New York",2702,143,2559,1604,3750,57630,1940,2010,1699,32.6,669,600,61,423,489,2559,232
2020,36081016900,"Census Tract 169, Queens County, New York",2727,170,2557,1587,3407,58331,0,2011,1734,33.3,820,738,53,305,474,2557,234
2012,36081017000,"Census Tract 170, Queens County, New York",738,20,718,255,827,31361,1951,2005,1197,48.4,0,3,61,99,44,718,100
2013,36081017000,"Census Tract 170, Queens County, New York",723,21,702,262,821,34070,1946,2006,1205,49.6,12,12,107,28,66,702,100
2014,36081017000,"Census Tract 170, Queens County, New York",760,30,730,233,750,40341,1953,2006,1368,50,16,12,95,21,49,730,116
2015,36081017000,"Census Tract 170, Queens County, New York",735,47,688,234,682,21731,1941,2007,1235,50,24,16,63,33,72,688,136
2016,36081017000,"Census Tract 170, Queens County, New York",768,41,727,227,765,NA,1947,2008,1261,50,25,28,61,26,51,727,127
2017,36081017000,"Census Tract 170, Queens County, New York",776,60,716,190,621,44342,1955,2009,1489,43.7,24,14,47,45,22,716,83
2018,36081017000,"Census Tract 170, Queens County, New York",816,78,738,228,744,52679,1953,2012,1686,39.6,11,17,14,62,45,738,107
2019,36081017000,"Census Tract 170, Queens County, New York",820,80,740,186,625,56316,1948,2014,1672,36.7,7,19,15,57,29,740,94
2020,36081017000,"Census Tract 170, Queens County, New York",759,58,701,135,499,58750,0,2014,1810,27.9,0,13,16,45,24,701,104
2012,36081017100,"Census Tract 171, Queens County, New York",0,0,0,0,0,NA,NA,NA,NA,NA,0,0,0,0,0,0,0
2013,36081017100,"Census Tract 171, Queens County, New York",0,0,0,0,0,NA,NA,NA,NA,NA,0,0,0,0,0,0,0
2014,36081017100,"Census Tract 171, Queens County, New York",0,0,0,0,0,NA,NA,NA,NA,NA,0,0,0,0,0,0,0
2015,36081017100,"Census Tract 171, Queens County, New York",0,0,0,0,0,NA,NA,NA,NA,NA,0,0,0,0,0,0,0
2016,36081017100,"Census Tract 171, Queens County, New York",0,0,0,0,0,NA,NA,NA,NA,NA,0,0,0,0,0,0,0
2017,36081017100,"Census Tract 171, Queens County, New York",0,0,0,0,0,NA,NA,NA,NA,NA,0,0,0,0,0,0,0
2018,36081017100,"Census Tract 171, Queens County, New York",0,0,0,0,0,NA,NA,NA,NA,NA,0,0,0,0,0,0,0
2019,36081017100,"Census Tract 171, Queens County, New York",27,0,27,27,40,NA,NA,NA,NA,NA,14,27,0,0,0,27,0
2020,36081017101,"Census Tract 171.01, Queens County, New York",0,0,0,0,0,NA,NA,NA,NA,NA,0,0,0,0,0,0,0
2020,36081017102,"Census Tract 171.02, Queens County, New York",0,0,0,0,0,NA,NA,NA,NA,NA,0,0,0,0,0,0,0
2012,36081017200,"Census Tract 172, Queens County, New York",604,23,581,72,265,57750,1948,2003,1250,29.3,0,0,61,11,0,581,81
2013,36081017200,"Census Tract 172, Queens County, New York",616,25,591,95,263,30515,1949,2004,1253,50,0,0,64,11,0,591,88
2014,36081017200,"Census Tract 172, Queens County, New York",635,39,596,143,388,30221,1951,2005,1290,50,0,0,90,17,0,596,96
2015,36081017200,"Census Tract 172, Queens County, New York",621,13,608,164,475,31111,1949,2007,1174,50,0,0,73,34,17,608,63
2016,36081017200,"Census Tract 172, Queens County, New York",658,13,645,204,588,40000,1951,2007,1145,36.8,18,0,79,49,16,645,63
2017,36081017200,"Census Tract 172, Queens County, New York",662,37,625,191,541,45368,1948,2010,1157,35.3,14,0,69,54,15,625,65
2018,36081017200,"Census Tract 172, Queens County, New York",669,49,620,189,562,49408,1944,2011,1317,30,16,0,66,60,28,620,80
2019,36081017200,"Census Tract 172, Queens County, New York",650,63,587,118,317,53333,1944,2012,1219,25.9,16,0,34,45,23,587,65
2020,36081017200,"Census Tract 172, Queens County, New York",697,107,590,107,275,37981,1948,2013,1297,31.7,16,0,31,49,11,590,79
2012,36081017400,"Census Tract 174, Queens County, New York",738,33,705,210,746,32286,1951,2004,1102,38.1,31,10,101,36,38,705,143
2013,36081017400,"Census Tract 174, Queens County, New York",737,30,707,182,632,32357,1952,2005,1167,35.4,19,8,79,33,23,707,100
2014,36081017400,"Census Tract 174, Queens County, New York",756,10,746,201,714,32165,1952,2005,1227,36.4,20,11,80,45,19,746,125
2015,36081017400,"Census Tract 174, Queens County, New York",748,17,731,215,750,32303,1952,2007,1250,34.6,11,11,78,55,19,731,107
2016,36081017400,"Census Tract 174, Queens County, New York",713,39,674,149,519,49135,1953,2004,1341,36.3,7,0,64,50,26,674,92
2017,36081017400,"Census Tract 174, Queens County, New York",742,41,701,154,510,35500,1939,2007,1432,44.8,7,0,59,56,24,701,84
2018,36081017400,"Census Tract 174, Queens County, New York",732,39,693,126,480,50208,0,2006,1541,40.3,0,0,35,46,23,693,84
2019,36081017400,"Census Tract 174, Queens County, New York",726,59,667,122,436,50536,1942,2008,1612,36.1,0,5,36,27,33,667,71
2020,36081017400,"Census Tract 174, Queens County, New York",719,67,652,114,425,64615,0,2009,1673,32.8,0,6,26,45,32,652,65
2012,36081017600,"Census Tract 176, Queens County, New York",634,5,629,217,615,41287,1947,2004,1143,25.2,43,0,158,42,10,629,74
2013,36081017600,"Census Tract 176, Queens County, New York",635,5,630,222,729,43205,1945,2006,1261,29.2,30,0,161,30,28,630,67
2014,36081017600,"Census Tract 176, Queens County, New York",639,5,634,222,724,42917,1961,2009,1564,41.2,35,0,170,21,28,634,73
2015,36081017600,"Census Tract 176, Queens County, New York",656,11,645,234,798,46354,1965,2009,1598,42.6,48,6,132,29,58,645,70
2016,36081017600,"Census Tract 176, Queens County, New York",650,31,619,218,797,45761,1961,2010,1559,41.2,33,6,127,26,43,619,76
2017,36081017600,"Census Tract 176, Queens County, New York",674,49,625,230,854,47750,1961,2011,1606,39.5,32,15,137,31,36,625,98
2018,36081017600,"Census Tract 176, Queens County, New York",676,66,610,210,709,48393,1948,2012,1588,28.6,21,15,106,33,36,610,109
2019,36081017600,"Census Tract 176, Queens County, New York",668,62,606,170,594,55000,1943,2012,1559,31.3,27,14,75,33,36,606,100
2020,36081017600,"Census Tract 176, Queens County, New York",638,59,579,184,720,68293,0,2012,1530,25.8,30,6,118,46,7,579,99
2012,36081017800,"Census Tract 178, Queens County, New York",631,45,586,184,505,35652,1939,2004,1071,50,14,0,104,0,58,586,114
2013,36081017800,"Census Tract 178, Queens County, New York",646,18,628,191,482,35492,1942,2005,1132,50,6,0,74,6,69,628,102
2014,36081017800,"Census Tract 178, Queens County, New York",627,19,608,177,525,23021,1948,2006,1263,50,6,0,94,6,41,608,123
2015,36081017800,"Census Tract 178, Queens County, New York",641,37,604,174,582,45045,1950,2007,1455,47.5,17,0,80,5,39,604,105
2016,36081017800,"Census Tract 178, Queens County, New York",668,63,605,182,601,46429,1946,2007,1447,34.3,18,0,78,6,42,605,96
2017,36081017800,"Census Tract 178, Queens County, New York",664,52,612,164,602,49063,1950,2007,1433,32.4,30,0,74,6,28,612,71
2018,36081017800,"Census Tract 178, Queens County, New York",674,40,634,135,425,60938,1949,2011,1765,30.8,32,12,74,13,23,634,83
2019,36081017800,"Census Tract 178, Queens County, New York",666,42,624,138,478,69559,1942,2010,1700,27.1,44,12,75,13,31,624,50
2020,36081017800,"Census Tract 178, Queens County, New York",631,50,581,117,362,63523,1945,2012,1813,30.8,31,11,71,35,6,581,54
2012,36081017900,"Census Tract 179, Queens County, New York",449,23,426,389,884,39180,1939,2001,1138,35.4,97,129,10,75,162,426,60
2013,36081017900,"Census Tract 179, Queens County, New York",438,28,410,370,795,40278,1939,2002,1200,35.3,94,122,9,66,162,410,36
2014,36081017900,"Census Tract 179, Queens County, New York",455,35,420,397,945,39583,1939,2003,1274,36,123,131,17,69,167,420,67
2015,36081017900,"Census Tract 179, Queens County, New York",452,37,415,382,923,NA,1939,2005,1347,34.3,153,109,19,102,147,415,76
2016,36081017900,"Census Tract 179, Queens County, New York",455,49,406,371,900,42292,1939,2006,1402,38,159,131,6,108,110,406,73
2017,36081017900,"Census Tract 179, Queens County, New York",454,40,414,367,863,42279,1939,2011,1490,38.1,151,98,7,105,152,414,48
2018,36081017900,"Census Tract 179, Queens County, New York",468,23,445,397,972,41982,0,2011,1518,40,168,114,15,108,150,445,80
2019,36081017900,"Census Tract 179, Queens County, New York",471,24,447,378,877,42279,0,2013,1480,36.9,161,115,11,96,147,447,62
2020,36081017901,"Census Tract 179.01, Queens County, New York",451,22,429,385,1054,59083,0,2013,1616,36.7,161,129,19,89,136,429,102
2020,36081017902,"Census Tract 179.02, Queens County, New York",5,0,5,0,0,NA,NA,NA,NA,NA,0,0,0,0,0,5,5
2012,36081018000,"Census Tract 180, Queens County, New York",339,0,339,155,545,50542,1939,1987,1127,29.3,10,0,77,52,65,339,37
2013,36081018000,"Census Tract 180, Queens County, New York",358,0,358,179,603,37026,1939,2001,1161,29.6,30,11,109,39,64,358,52
2014,36081018000,"Census Tract 180, Queens County, New York",363,0,363,154,553,38833,1942,2005,1108,28.9,36,13,82,33,44,363,67
2015,36081018000,"Census Tract 180, Queens County, New York",374,0,374,176,736,51579,1939,2009,1223,29,28,13,82,33,50,374,83
2016,36081018000,"Census Tract 180, Queens County, New York",368,0,368,178,761,51711,1939,2006,1333,29.4,23,28,58,37,32,368,63
2017,36081018000,"Census Tract 180, Queens County, New York",353,13,340,120,610,52500,1939,2010,1446,30.7,8,33,0,24,9,340,40
2018,36081018000,"Census Tract 180, Queens County, New York",345,23,322,136,491,44773,0,2012,1663,37.5,15,15,41,23,9,322,51
2019,36081018000,"Census Tract 180, Queens County, New York",364,30,334,142,538,45595,0,2011,1787,40.5,18,20,36,20,3,334,81
2020,36081018000,"Census Tract 180, Queens County, New York",387,27,360,118,469,46750,0,2011,1793,40.5,19,22,31,9,4,360,66
2012,36081018101,"Census Tract 181.01, Queens County, New York",1850,24,1826,1742,3934,34690,1940,2004,1247,39.1,537,719,0,474,511,1826,220
2013,36081018101,"Census Tract 181.01, Queens County, New York",1807,41,1766,1685,3842,38825,1939,2005,1291,38.6,597,718,0,468,458,1766,230
2014,36081018101,"Census Tract 181.01, Queens County, New York",1803,64,1739,1687,4335,40688,1939,2005,1340,37.7,569,670,0,441,578,1739,255
2015,36081018101,"Census Tract 181.01, Queens County, New York",1820,118,1702,1601,4148,49295,1939,2006,1385,37.4,569,702,0,394,506,1702,202
2016,36081018101,"Census Tract 181.01, Queens County, New York",1827,132,1695,1600,3559,43816,1939,2006,1357,37,611,765,12,298,526,1695,230
2017,36081018101,"Census Tract 181.01, Queens County, New York",1837,151,1686,1572,3389,52077,1939,2007,1488,34.8,649,715,14,324,521,1686,284
2018,36081018101,"Census Tract 181.01, Queens County, New York",1850,169,1681,1537,3244,55156,0,2009,1503,34.4,671,648,19,352,515,1681,267
2019,36081018101,"Census Tract 181.01, Queens County, New York",1868,140,1728,1569,3126,58576,0,2011,1578,31.9,768,697,19,378,451,1728,199
2020,36081018101,"Census Tract 181.01, Queens County, New York",1862,141,1721,1611,3305,61033,0,2011,1591,29.8,765,558,22,413,592,1721,255
2012,36081018102,"Census Tract 181.02, Queens County, New York",2072,182,1890,1651,3316,52094,1939,2004,1355,31.3,557,976,11,334,255,1890,227
2013,36081018102,"Census Tract 181.02, Queens County, New York",2052,155,1897,1629,3254,46995,1939,2005,1429,35.4,625,968,13,347,267,1897,239
2014,36081018102,"Census Tract 181.02, Queens County, New York",2019,149,1870,1584,3015,48750,1939,2006,1477,35.4,755,1008,28,286,211,1870,292
2015,36081018102,"Census Tract 181.02, Queens County, New York",2014,21,1993,1722,3340,NA,1940,2008,1470,32.4,851,1103,30,231,290,1993,300
2016,36081018102,"Census Tract 181.02, Queens County, New York",2036,62,1974,1708,3275,53357,1940,2009,1455,31.4,819,963,49,288,384,1974,269
2017,36081018102,"Census Tract 181.02, Queens County, New York",2038,118,1920,1650,3099,63547,1939,2010,1498,28.6,834,1010,41,225,350,1920,239
2018,36081018102,"Census Tract 181.02, Queens County, New York",2064,134,1930,1604,2942,66806,0,2010,1559,29.6,797,971,43,224,339,1930,241
2019,36081018102,"Census Tract 181.02, Queens County, New York",2037,179,1858,1554,2803,70878,0,2011,1613,29,782,874,40,223,381,1858,193
2020,36081018102,"Census Tract 181.02, Queens County, New York",1896,211,1685,1435,2700,76225,0,2011,1711,28.4,715,721,36,284,347,1685,140
2012,36081018200,"Census Tract 182, Queens County, New York",736,86,650,179,432,39688,1942,2003,1405,37.6,9,0,129,19,10,650,43
2013,36081018200,"Census Tract 182, Queens County, New York",741,83,658,183,498,39390,1944,2004,1344,37.5,2,0,114,19,14,658,47
2014,36081018200,"Census Tract 182, Queens County, New York",734,78,656,138,428,34091,1943,2005,1562,38.9,18,0,80,18,20,656,58
2015,36081018200,"Census Tract 182, Queens County, New York",738,73,665,148,443,33864,1944,2007,1573,39.8,13,0,72,28,20,665,80
2016,36081018200,"Census Tract 182, Queens County, New York",747,31,716,142,467,45278,1951,2011,1423,40.7,25,11,44,50,14,716,76
2017,36081018200,"Census Tract 182, Queens County, New York",760,49,711,167,550,26875,1990,2013,1638,45.9,24,11,68,42,13,711,90
2018,36081018200,"Census Tract 182, Queens County, New York",767,50,717,157,541,28977,1973,2013,1682,49.3,25,12,68,44,13,717,84
2019,36081018200,"Census Tract 182, Queens County, New York",763,54,709,175,593,28472,1967,2012,1645,51,12,12,82,47,12,709,93
2020,36081018200,"Census Tract 182, Queens County, New York",705,34,671,140,492,29211,1990,2013,1665,51,14,11,74,32,13,671,97
2012,36081018300,"Census Tract 183, Queens County, New York",2864,186,2678,2270,4725,52732,1939,2001,1296,25.8,1136,1026,53,510,670,2678,380
2013,36081018300,"Census Tract 183, Queens County, New York",2794,198,2596,2201,4633,56032,1939,2002,1337,24.2,1092,1040,39,498,614,2596,367
2014,36081018300,"Census Tract 183, Queens County, New York",2764,177,2587,2020,4680,64167,1941,2004,1377,24.7,1009,960,59,401,592,2587,378
2015,36081018300,"Census Tract 183, Queens County, New York",2787,198,2589,2069,5145,NA,1943,2006,1417,27.8,943,998,86,398,608,2589,397
2016,36081018300,"Census Tract 183, Queens County, New York",2846,236,2610,1949,5009,65789,1939,2007,1470,27.2,895,922,81,300,686,2610,382
2017,36081018300,"Census Tract 183, Queens County, New York",2836,238,2598,1818,4535,53457,1939,2008,1481,30.7,864,859,64,345,531,2598,296
2018,36081018300,"Census Tract 183, Queens County, New York",2838,192,2646,1912,4768,57153,0,2011,1573,30,961,887,76,366,555,2646,254
2019,36081018300,"Census Tract 183, Queens County, New York",2848,230,2618,1975,4489,66797,0,2011,1657,29.2,1048,974,79,356,542,2618,199
2020,36081018300,"Census Tract 183, Queens County, New York",2765,179,2586,1783,4126,75821,0,2012,1742,27.1,963,1045,44,237,422,2586,145
2012,36081018401,"Census Tract 184.01, Queens County, New York",725,132,593,327,1232,39549,1983,2000,608,29.5,5,0,303,0,17,593,100
2013,36081018401,"Census Tract 184.01, Queens County, New York",711,85,626,277,1124,42083,1982,2002,1015,32.6,10,0,247,0,16,626,76
2014,36081018401,"Census Tract 184.01, Queens County, New York",694,52,642,246,882,42404,1982,2002,1204,39.4,14,0,200,0,32,642,68
2015,36081018401,"Census Tract 184.01, Queens County, New York",689,40,649,297,917,41949,1981,2000,1156,32.9,14,0,241,7,33,649,82
2016,36081018401,"Census Tract 184.01, Queens County, New York",696,65,631,238,778,41711,1973,2001,1293,33.9,23,0,199,8,22,631,80
2017,36081018401,"Census Tract 184.01, Queens County, New York",693,37,656,250,754,43304,1968,2001,750,29,22,0,213,7,23,656,87
2018,36081018401,"Census Tract 184.01, Queens County, New York",703,25,678,278,784,41429,1981,2001,1038,30.9,23,0,236,17,25,678,122
2019,36081018401,"Census Tract 184.01, Queens County, New York",708,27,681,302,760,41552,1981,2004,1183,27.1,22,0,270,19,7,681,137
2020,36081018401,"Census Tract 184.01, Queens County, New York",686,41,645,284,680,48056,1984,2004,NA,19.8,20,0,244,11,7,645,128
2012,36081018402,"Census Tract 184.02, Queens County, New York",687,71,616,107,388,27321,1956,2002,1482,50,10,0,107,0,4,616,80
2013,36081018402,"Census Tract 184.02, Queens County, New York",680,78,602,93,314,42604,1939,2003,1602,50,9,0,93,0,5,602,82
2014,36081018402,"Census Tract 184.02, Queens County, New York",682,74,608,108,341,18125,1939,2007,1313,50,8,0,98,0,14,608,96
2015,36081018402,"Census Tract 184.02, Queens County, New York",692,54,638,159,508,29063,1942,2008,1361,50,0,0,134,0,30,638,129
2016,36081018402,"Census Tract 184.02, Queens County, New York",710,53,657,159,529,42969,1939,2011,1597,42.8,29,0,121,0,29,657,87
2017,36081018402,"Census Tract 184.02, Queens County, New York",702,39,663,151,482,45139,1950,2011,1393,36.9,23,0,116,0,25,663,86
2018,36081018402,"Census Tract 184.02, Queens County, New York",673,58,615,159,460,41369,0,2011,1316,36.9,34,0,121,0,29,615,54
2019,36081018402,"Census Tract 184.02, Queens County, New York",682,69,613,167,513,44135,1956,2011,1409,40,41,0,141,0,17,613,46
2020,36081018402,"Census Tract 184.02, Queens County, New York",671,58,613,135,436,60272,1955,2011,1271,41.5,45,0,125,0,1,613,37
2012,36081018501,"Census Tract 185.01, Queens County, New York",1686,64,1622,1151,2548,49458,1939,2003,1211,36.1,325,326,71,208,556,1622,107
2013,36081018501,"Census Tract 185.01, Queens County, New York",1641,57,1584,1168,2673,49746,1939,2003,1210,32.3,407,475,82,149,461,1584,117
2014,36081018501,"Census Tract 185.01, Queens County, New York",1674,21,1653,1200,2876,50900,1939,2005,1296,35.6,479,440,43,193,537,1653,116
2015,36081018501,"Census Tract 185.01, Queens County, New York",1689,50,1639,1072,2608,51293,1939,2007,1346,31.7,445,421,31,169,469,1639,178
2016,36081018501,"Census Tract 185.01, Queens County, New York",1684,96,1588,1001,2625,60069,1942,2008,1391,31.1,399,386,28,187,400,1588,222
2017,36081018501,"Census Tract 185.01, Queens County, New York",1654,103,1551,969,2250,61406,1943,2010,1429,30.4,384,418,26,192,308,1551,212
2018,36081018501,"Census Tract 185.01, Queens County, New York",1689,139,1550,967,2197,47458,1944,2011,1442,39.4,274,367,27,209,333,1550,237
2019,36081018501,"Census Tract 185.01, Queens County, New York",1724,178,1546,927,1986,47227,1943,2012,1459,38.9,239,371,32,169,319,1546,236
2020,36081018501,"Census Tract 185.01, Queens County, New York",1747,131,1616,949,1977,55368,1943,2012,1509,37.6,305,431,39,131,310,1616,175
2012,36081018502,"Census Tract 185.02, Queens County, New York",1626,152,1474,1240,2953,66079,1939,2004,1383,27.3,512,687,12,199,326,1474,203
2013,36081018502,"Census Tract 185.02, Queens County, New York",1604,138,1466,1229,2866,65713,1939,2005,1453,28,518,680,16,194,339,1466,200
2014,36081018502,"Census Tract 185.02, Queens County, New York",1614,155,1459,1256,3035,67331,1939,2008,1527,28.8,498,662,18,213,357,1459,163
2015,36081018502,"Census Tract 185.02, Queens County, New York",1618,161,1457,1212,3017,68854,1939,2010,1569,28.1,550,660,18,223,306,1457,220
2016,36081018502,"Census Tract 185.02, Queens County, New York",1614,149,1465,1210,2901,73846,1939,2011,1585,28,632,685,21,221,282,1465,174
2017,36081018502,"Census Tract 185.02, Queens County, New York",1648,159,1489,1188,2943,77212,1939,2011,1666,28.1,548,658,15,197,317,1489,160
2018,36081018502,"Census Tract 185.02, Queens County, New York",1647,133,1514,1231,3071,72880,0,2011,1699,28.7,603,685,48,174,322,1514,177
2019,36081018502,"Census Tract 185.02, Queens County, New York",1651,134,1517,1202,2720,75714,0,2011,1736,26.5,649,700,57,156,281,1517,170
2020,36081018502,"Census Tract 185.02, Queens County, New York",1609,104,1505,1173,2399,87031,0,2013,1812,24.2,706,646,55,119,287,1505,96
2012,36081018600,"Census Tract 186, Queens County, New York",550,96,454,156,592,41250,1963,2005,1873,50,8,0,111,0,8,454,74
2013,36081018600,"Census Tract 186, Queens County, New York",558,114,444,128,420,41522,1965,2004,1675,40,19,0,100,5,16,444,56
2014,36081018600,"Census Tract 186, Queens County, New York",557,84,473,146,476,46667,1964,2002,1701,34.8,34,0,111,6,16,473,50
2015,36081018600,"Census Tract 186, Queens County, New York",549,81,468,103,354,NA,1970,2005,1599,35.6,37,6,71,6,7,468,73
2016,36081018600,"Census Tract 186, Queens County, New York",547,49,498,102,306,31591,1939,2001,1684,42.1,41,5,54,20,8,498,60
2017,36081018600,"Census Tract 186, Queens County, New York",560,51,509,98,252,46250,1939,2004,1528,39.5,27,5,46,24,8,509,38
2018,36081018600,"Census Tract 186, Queens County, New York",557,47,510,109,447,59712,0,2002,1801,33.9,20,11,51,17,0,510,49
2019,36081018600,"Census Tract 186, Queens County, New York",554,52,502,118,445,NA,0,2011,1609,46.6,6,23,57,19,0,502,59
2020,36081018600,"Census Tract 186, Queens County, New York",545,0,545,142,524,41731,0,2015,1823,48.8,10,17,87,18,0,545,23
2012,36081018700,"Census Tract 187, Queens County, New York",1229,158,1071,619,1519,59345,1939,2004,1323,26.4,225,272,23,179,135,1071,84
2013,36081018700,"Census Tract 187, Queens County, New York",1218,165,1053,603,1461,63681,1939,2004,1318,24.6,219,286,24,147,135,1053,79
2014,36081018700,"Census Tract 187, Queens County, New York",1153,145,1008,565,1443,72545,1941,2007,1281,25.4,206,242,0,121,188,1008,92
2015,36081018700,"Census Tract 187, Queens County, New York",1167,116,1051,635,1775,48882,1946,2010,1350,28.2,213,255,8,139,233,1051,87
2016,36081018700,"Census Tract 187, Queens County, New York",1159,87,1072,618,1651,51196,1941,2011,1384,30.6,234,255,7,151,205,1072,65
2017,36081018700,"Census Tract 187, Queens County, New York",1137,91,1046,591,1461,51929,1941,2011,1322,33.5,229,277,10,104,200,1046,60
2018,36081018700,"Census Tract 187, Queens County, New York",1107,78,1029,638,1724,52865,1943,2011,1641,35.7,227,231,18,133,256,1029,36
2019,36081018700,"Census Tract 187, Queens County, New York",1145,91,1054,649,1835,55341,1942,2011,1756,34.2,286,208,31,159,243,1054,14
2020,36081018700,"Census Tract 187, Queens County, New York",1109,124,985,554,1571,59792,0,2013,1757,33.1,251,185,43,105,239,985,34
2012,36081018800,"Census Tract 188, Queens County, New York",421,25,396,88,246,23000,1961,2005,1674,29.1,8,0,88,0,10,396,37
2013,36081018800,"Census Tract 188, Queens County, New York",420,35,385,97,287,37031,1956,2006,1676,31.4,12,0,97,0,10,385,32
2014,36081018800,"Census Tract 188, Queens County, New York",418,15,403,127,359,43750,1955,2006,1632,30.2,27,0,127,0,11,403,38
2015,36081018800,"Census Tract 188, Queens County, New York",428,17,411,161,422,65139,1960,2010,1396,29.9,55,0,154,0,18,411,28
2016,36081018800,"Census Tract 188, Queens County, New York",434,31,403,158,481,67500,1963,2011,1349,26.7,65,0,146,0,12,403,26
2017,36081018800,"Census Tract 188, Queens County, New York",429,42,387,131,392,52083,1963,2011,1343,31.4,47,0,118,0,13,387,26
2018,36081018800,"Census Tract 188, Queens County, New York",422,38,384,138,427,55536,1964,2011,1319,23.7,63,7,113,0,18,384,30
2019,36081018800,"Census Tract 188, Queens County, New York",434,36,398,134,400,56618,1965,2012,1392,23.8,43,6,118,0,10,398,48
2020,36081018800,"Census Tract 188, Queens County, New York",445,43,402,148,446,57935,1966,2009,1519,30.4,27,5,123,0,20,402,68
2012,36081018900,"Census Tract 189, Queens County, New York",1457,118,1339,1084,2621,44464,1953,2001,1302,33,425,309,35,228,514,1339,230
2013,36081018900,"Census Tract 189, Queens County, New York",1446,38,1408,1158,2832,51938,1952,2002,1374,29.3,466,375,88,219,504,1408,206
2014,36081018900,"Census Tract 189, Queens County, New York",1482,92,1390,1162,2769,52727,1951,2004,1384,30.7,374,355,95,129,614,1390,231
2015,36081018900,"Census Tract 189, Queens County, New York",1446,108,1338,1059,2667,52292,1952,2005,1383,30.7,395,345,68,168,486,1338,202
2016,36081018900,"Census Tract 189, Queens County, New York",1462,148,1314,1012,2700,55754,1952,2008,1511,31.7,403,365,66,150,433,1314,189
2017,36081018900,"Census Tract 189, Queens County, New York",1458,159,1299,1039,2833,65352,1953,2010,1589,30.5,436,390,71,176,415,1299,129
2018,36081018900,"Census Tract 189, Queens County, New York",1464,218,1246,961,2430,70194,1952,2011,1594,30.8,490,364,9,236,363,1246,128
2019,36081018900,"Census Tract 189, Queens County, New York",1476,270,1206,889,2154,74306,1951,2011,1642,30.5,472,406,10,221,265,1206,131
2020,36081018900,"Census Tract 189, Queens County, New York",1493,295,1198,872,1928,74386,1951,2006,1358,30.7,388,386,0,189,310,1198,119
2012,36081019000,"Census Tract 190, Queens County, New York",684,98,586,167,536,27051,1945,2005,1263,48.1,23,0,107,29,37,586,31
2013,36081019000,"Census Tract 190, Queens County, New York",680,54,626,182,577,27042,1961,2006,1333,45.2,32,0,128,5,49,626,43
2014,36081019000,"Census Tract 190, Queens County, New York",696,61,635,158,521,35750,1947,2007,1457,38.8,34,0,101,4,55,635,40
2015,36081019000,"Census Tract 190, Queens County, New York",683,73,610,181,531,34750,1943,2008,1407,45.6,17,0,132,5,43,610,52
2016,36081019000,"Census Tract 190, Queens County, New York",696,60,636,196,566,31974,1946,2010,1428,48.8,8,0,132,11,54,636,66
2017,36081019000,"Census Tract 190, Queens County, New York",717,50,667,143,500,54464,1953,2010,1646,36.1,9,0,67,12,47,667,48
2018,36081019000,"Census Tract 190, Queens County, New York",717,52,665,115,474,88295,1948,2011,1832,27.5,0,0,45,11,46,665,37
2019,36081019000,"Census Tract 190, Queens County, New York",690,37,653,159,619,89625,1947,2012,1911,26.9,4,0,80,10,55,653,77
2020,36081019000,"Census Tract 190, Queens County, New York",789,40,749,193,625,72250,1950,2013,1858,29.5,40,0,128,9,47,749,58
2012,36081019200,"Census Tract 192, Queens County, New York",722,75,647,145,351,22961,1939,2003,1116,50,12,0,100,38,16,647,93
2013,36081019200,"Census Tract 192, Queens County, New York",728,96,632,158,390,25985,1939,2003,1153,50,15,0,103,32,38,632,50
2014,36081019200,"Census Tract 192, Queens County, New York",715,114,601,150,439,26719,1939,2005,1290,50,0,5,100,25,35,601,50
2015,36081019200,"Census Tract 192, Queens County, New York",727,95,632,177,481,27583,1944,2006,1408,49.3,0,5,145,0,42,632,26
2016,36081019200,"Census Tract 192, Queens County, New York",729,95,634,200,506,35643,1945,2008,1396,47.8,22,6,155,0,44,634,26
2017,36081019200,"Census Tract 192, Queens County, New York",731,96,635,203,573,45069,1958,2011,1495,43.6,18,6,141,0,38,635,25
2018,36081019200,"Census Tract 192, Queens County, New York",735,86,649,201,548,47102,1952,2011,1736,40.9,24,5,137,0,37,649,27
2019,36081019200,"Census Tract 192, Queens County, New York",729,90,639,205,484,46985,1963,2012,1656,38.4,54,0,159,0,29,639,31
2020,36081019200,"Census Tract 192, Queens County, New York",690,79,611,200,508,58750,1960,2011,1685,35.8,53,0,140,0,33,611,39
2012,36081019400,"Census Tract 194, Queens County, New York",869,110,759,254,748,53788,1961,2004,1564,39.9,8,0,168,50,0,759,117
2013,36081019400,"Census Tract 194, Queens County, New York",869,84,785,274,802,53611,1949,2005,1581,29.3,11,0,184,44,0,785,74
2014,36081019400,"Census Tract 194, Queens County, New York",844,67,777,253,759,38875,1959,2006,1710,46.4,12,0,178,18,0,777,104
2015,36081019400,"Census Tract 194, Queens County, New York",840,86,754,229,678,49653,1954,2008,1551,29.8,17,0,147,19,0,754,70
2016,36081019400,"Census Tract 194, Queens County, New York",841,55,786,198,568,45227,1948,2010,1197,33.8,6,0,161,0,0,786,68
2017,36081019400,"Census Tract 194, Queens County, New York",849,56,793,216,632,47083,1952,2011,1413,31.6,18,0,180,0,5,793,56
2018,36081019400,"Census Tract 194, Queens County, New York",871,60,811,210,633,54773,1955,2011,1518,33.3,40,0,166,8,5,811,66
2019,36081019400,"Census Tract 194, Queens County, New York",893,73,820,194,549,55682,1957,2012,1625,32.5,39,0,147,21,5,820,80
2020,36081019400,"Census Tract 194, Queens County, New York",878,80,798,199,583,70875,1958,2013,1747,31.6,47,0,129,21,7,798,83
2012,36081019600,"Census Tract 196, Queens County, New York",873,133,740,367,1183,39095,1954,2005,1309,47,69,0,218,48,97,740,93
2013,36081019600,"Census Tract 196, Queens County, New York",839,117,722,308,995,34348,1965,2006,1336,50,36,0,176,20,89,722,117
2014,36081019600,"Census Tract 196, Queens County, New York",825,114,711,349,1301,36397,1964,2006,1351,44.2,2,0,234,18,86,711,84
2015,36081019600,"Census Tract 196, Queens County, New York",826,82,744,368,1327,43333,1967,2007,1332,42.7,23,5,234,17,70,744,108
2016,36081019600,"Census Tract 196, Queens County, New York",860,59,801,419,1330,46793,1965,2009,1296,24.1,38,4,279,27,65,801,75
2017,36081019600,"Census Tract 196, Queens County, New York",868,76,792,432,1348,46061,1964,2010,1336,28,37,2,278,5,83,792,96
2018,36081019600,"Census Tract 196, Queens County, New York",843,49,794,426,1186,56042,1963,2011,1319,28,56,4,255,9,89,794,101
2019,36081019600,"Census Tract 196, Queens County, New York",828,26,802,433,1342,59844,1941,2013,1457,28.2,75,4,225,37,93,802,112
2020,36081019600,"Census Tract 196, Queens County, New York",786,24,762,430,1526,61538,1947,2014,1511,28.9,87,0,273,30,86,762,153
2012,36081019800,"Census Tract 198, Queens County, New York",918,129,789,480,1619,21955,1944,2005,1293,50,36,16,240,65,111,789,222
2013,36081019800,"Census Tract 198, Queens County, New York",893,129,764,527,1870,22478,1948,2007,1336,50,46,18,251,74,129,764,262
2014,36081019800,"Census Tract 198, Queens County, New York",892,71,821,550,1875,26422,1951,2008,1335,45.9,56,17,278,82,127,821,259
2015,36081019800,"Census Tract 198, Queens County, New York",861,85,776,504,1781,27845,1959,2010,1327,50,46,0,283,47,138,776,267
2016,36081019800,"Census Tract 198, Queens County, New York",881,74,807,502,1782,26524,1963,2011,1249,50,33,16,271,40,148,807,278
2017,36081019800,"Census Tract 198, Queens County, New York",870,72,798,492,1815,28611,1959,2011,1317,46.5,32,17,244,53,148,798,223
2018,36081019800,"Census Tract 198, Queens County, New York",892,68,824,443,1614,36563,1952,2011,1321,46.6,48,11,226,34,154,824,169
2019,36081019800,"Census Tract 198, Queens County, New York",845,98,747,397,1409,39792,1948,2012,1498,42.9,47,23,209,30,118,747,115
2020,36081019800,"Census Tract 198, Queens County, New York",901,79,822,460,1297,45417,1943,2014,1530,30.9,29,22,248,71,100,822,77
2012,36081019900,"Census Tract 199, Queens County, New York",296,51,245,182,540,53387,1950,2002,1207,27.8,31,20,0,12,150,245,51
2013,36081019900,"Census Tract 199, Queens County, New York",295,64,231,160,501,73000,1947,2003,1278,20.3,5,20,5,24,111,231,30
2014,36081019900,"Census Tract 199, Queens County, New York",339,76,263,182,526,63036,1943,2004,1275,22.1,5,42,5,27,108,263,30
2015,36081019900,"Census Tract 199, Queens County, New York",281,60,221,182,502,NA,1939,2006,1289,25.7,4,24,4,36,118,221,40
2016,36081019900,"Census Tract 199, Queens County, New York",278,70,208,165,416,46250,1942,2005,1260,23.3,10,37,5,40,83,208,23
2017,36081019900,"Census Tract 199, Queens County, New York",287,94,193,164,401,39318,1939,2007,1309,26.8,30,33,8,26,97,193,21
2018,36081019900,"Census Tract 199, Queens County, New York",283,107,176,144,340,37917,1940,2006,1359,29.9,38,39,4,20,81,176,25
2019,36081019900,"Census Tract 199, Queens County, New York",303,141,162,141,309,41125,0,2009,1438,42.2,80,42,5,48,46,162,50
2020,36081019901,"Census Tract 199.01, Queens County, New York",262,164,98,75,146,55521,0,2011,1465,33.6,49,25,4,20,26,98,4
2020,36081019902,"Census Tract 199.02, Queens County, New York",0,0,0,0,0,NA,NA,NA,NA,NA,0,0,0,0,0,0,0
2020,36081019903,"Census Tract 199.03, Queens County, New York",0,0,0,0,0,NA,NA,NA,NA,NA,0,0,0,0,0,0,0
2012,36081020200,"Census Tract 202, Queens County, New York",475,9,466,84,189,24615,1939,2002,832,41.5,0,0,65,19,0,466,70
2013,36081020200,"Census Tract 202, Queens County, New York",475,0,475,141,458,25750,1992,2004,1053,43.2,0,0,67,23,14,475,83
2014,36081020200,"Census Tract 202, Queens County, New York",455,0,455,113,308,24792,1955,2003,1016,45.8,7,7,58,13,8,455,41
2015,36081020200,"Census Tract 202, Queens County, New York",453,0,453,161,458,NA,1949,2004,1088,47,10,11,86,19,13,453,68
2016,36081020200,"Census Tract 202, Queens County, New York",434,0,434,155,473,NA,1952,2004,1227,47.1,13,12,75,4,15,434,83
2017,36081020200,"Census Tract 202, Queens County, New York",440,0,440,156,441,51667,1981,2004,1298,44.7,25,12,80,5,16,440,66
2018,36081020200,"Census Tract 202, Queens County, New York",413,0,413,105,251,62578,1949,2002,1255,41.1,25,11,71,0,0,413,36
2019,36081020200,"Census Tract 202, Queens County, New York",408,0,408,78,206,58750,1986,2000,1507,41.3,16,0,64,0,0,408,28
2020,36081020200,"Census Tract 202, Queens County, New York",396,0,396,57,182,NA,1982,1998,1352,23,16,0,42,0,0,396,27
2012,36081020400,"Census Tract 204, Queens County, New York",656,59,597,470,1504,44722,1948,2004,1122,32.6,53,6,222,113,94,597,171
2013,36081020400,"Census Tract 204, Queens County, New York",657,54,603,449,1426,26458,1958,2006,1007,31.2,60,8,267,62,86,603,187
2014,36081020400,"Census Tract 204, Queens County, New York",653,36,617,454,1386,25486,1960,2006,1102,36,38,24,234,78,90,617,185
2015,36081020400,"Census Tract 204, Queens County, New York",660,30,630,466,1519,25814,1957,2007,1150,42,22,40,239,71,83,630,179
2016,36081020400,"Census Tract 204, Queens County, New York",656,21,635,436,1473,25859,1952,2008,1192,43,33,39,220,72,76,635,171
2017,36081020400,"Census Tract 204, Queens County, New York",662,32,630,427,1536,31042,1951,2010,1480,42.4,37,39,192,98,74,630,154
2018,36081020400,"Census Tract 204, Queens County, New York",673,21,652,478,1693,50750,0,2010,1638,34,75,38,138,116,138,652,113
2019,36081020400,"Census Tract 204, Queens County, New York",669,68,601,436,1580,53833,0,2010,1655,30.3,73,22,122,109,145,601,95
2020,36081020400,"Census Tract 204, Queens County, New York",753,55,698,484,1425,52736,1941,2012,1615,29.7,76,0,172,96,193,698,135
2012,36081020500,"Census Tract 205, Queens County, New York",394,90,304,128,320,48587,1948,2005,1212,30.7,38,19,0,6,103,304,40
2013,36081020500,"Census Tract 205, Queens County, New York",395,89,306,155,472,34821,1939,2007,1339,41.7,33,21,0,6,128,306,45
2014,36081020500,"Census Tract 205, Queens County, New York",390,54,336,208,598,40682,1939,2008,1325,38.4,54,33,0,6,169,336,36
2015,36081020500,"Census Tract 205, Queens County, New York",402,41,361,258,733,NA,1939,2008,1382,29.7,73,42,0,10,206,361,38
2016,36081020500,"Census Tract 205, Queens County, New York",441,44,397,280,881,58438,1939,2008,1403,29.8,57,35,0,7,238,397,30
2017,36081020500,"Census Tract 205, Queens County, New York",446,41,405,294,972,58000,1939,2009,1502,32,60,41,6,4,249,405,27
2018,36081020500,"Census Tract 205, Queens County, New York",449,58,391,281,850,56467,1948,2009,1600,33.3,60,30,16,5,242,391,28
2019,36081020500,"Census Tract 205, Queens County, New York",433,55,378,264,803,55278,1945,2008,1565,33.9,47,20,14,8,233,378,16
2020,36081020500,"Census Tract 205, Queens County, New York",431,41,390,216,726,41964,1943,2014,1616,41,48,17,16,0,196,390,47
2012,36081020600,"Census Tract 206, Queens County, New York",498,80,418,204,659,48382,1948,2005,1247,33,11,4,55,22,124,418,31
2013,36081020600,"Census Tract 206, Queens County, New York",560,90,470,218,687,48523,1951,2004,1312,34,15,5,51,27,135,470,39
2014,36081020600,"Census Tract 206, Queens County, New York",560,94,466,204,663,30192,1949,2005,1373,49.6,18,9,64,8,127,466,50
2015,36081020600,"Census Tract 206, Queens County, New York",552,42,510,306,1132,43152,1956,2006,1338,34.9,28,16,88,44,153,510,51
2016,36081020600,"Census Tract 206, Queens County, New York",553,41,512,316,1261,50500,1961,2007,1238,31.5,11,28,54,28,177,512,45
2017,36081020600,"Census Tract 206, Queens County, New York",538,64,474,311,1365,60446,1955,2008,1463,29.7,10,25,64,30,172,474,49
2018,36081020600,"Census Tract 206, Queens County, New York",525,33,492,323,1357,65302,1959,2007,1422,28.1,22,47,59,53,133,492,43
2019,36081020600,"Census Tract 206, Queens County, New York",507,32,475,290,1157,62679,1954,2008,1404,28.4,32,35,51,49,119,475,35
2020,36081020600,"Census Tract 206, Queens County, New York",454,31,423,260,1057,63190,1955,2009,1618,29,22,36,34,5,142,423,24
2012,36081020800,"Census Tract 208, Queens County, New York",778,9,769,371,1129,47917,1942,2003,1280,31.8,53,23,82,36,209,769,23
2013,36081020800,"Census Tract 208, Queens County, New York",778,10,768,440,1420,50577,1947,2004,1292,33.2,100,26,130,44,231,768,35
2014,36081020800,"Census Tract 208, Queens County, New York",741,32,709,401,1475,54141,1944,2004,1561,32.6,18,28,104,26,220,709,54
2015,36081020800,"Census Tract 208, Queens County, New York",719,47,672,360,1337,53920,1939,2006,1508,33.7,20,32,110,37,159,672,75
2016,36081020800,"Census Tract 208, Queens County, New York",745,47,698,374,1329,57381,1942,2007,1394,32.2,20,35,85,38,186,698,106
2017,36081020800,"Census Tract 208, Queens County, New York",716,49,667,338,1210,61250,1939,2008,1431,33.5,16,27,85,38,149,667,102
2018,36081020800,"Census Tract 208, Queens County, New York",689,51,638,316,1124,60385,0,2010,1319,31.7,17,29,86,12,136,638,120
2019,36081020800,"Census Tract 208, Queens County, New York",792,31,761,376,1257,61379,0,2011,1426,30,38,39,127,31,143,761,103
2020,36081020800,"Census Tract 208, Queens County, New York",822,40,782,469,1664,51542,0,2012,1665,41.2,55,120,147,17,133,782,89
2012,36081021200,"Census Tract 212, Queens County, New York",666,33,633,475,1372,27264,1939,2004,1071,44.7,48,15,45,47,350,633,191
2013,36081021200,"Census Tract 212, Queens County, New York",719,48,671,551,1735,31354,1939,2005,1098,43.2,122,29,44,83,346,671,181
2014,36081021200,"Census Tract 212, Queens County, New York",737,78,659,529,1563,27099,1940,2006,1143,46.9,114,31,30,75,340,659,150
2015,36081021200,"Census Tract 212, Queens County, New York",724,83,641,512,1606,32083,1940,2006,1182,33.1,109,28,27,41,365,641,121
2016,36081021200,"Census Tract 212, Queens County, New York",716,93,623,537,1716,40688,1939,2005,1177,31.9,101,36,20,38,383,623,118
2017,36081021200,"Census Tract 212, Queens County, New York",700,94,606,504,1723,44583,1944,2006,1243,32.2,80,54,29,43,338,606,124
2018,36081021200,"Census Tract 212, Queens County, New York",685,84,601,492,1657,41667,1942,2007,1459,34.6,30,37,46,5,378,601,136
2019,36081021200,"Census Tract 212, Queens County, New York",684,56,628,513,1778,43639,0,2010,1345,35.6,42,37,45,13,371,628,157
2020,36081021200,"Census Tract 212, Queens County, New York",701,26,675,508,1711,44943,0,2010,1519,34.8,68,62,36,62,288,675,161
2012,36081021400,"Census Tract 214, Queens County, New York",2200,131,2069,1353,2945,44803,1953,2004,1235,30.6,552,255,177,342,550,2069,183
2013,36081021400,"Census Tract 214, Queens County, New York",2236,84,2152,1448,3309,42216,1954,2004,1285,31.6,647,259,161,309,687,2152,251
2014,36081021400,"Census Tract 214, Queens County, New York",2290,90,2200,1676,4491,40700,1954,2005,1373,34.4,773,239,221,494,683,2200,413
2015,36081021400,"Census Tract 214, Queens County, New York",2324,78,2246,1580,4326,39048,1954,2006,1380,46.1,744,339,186,337,670,2246,467
2016,36081021400,"Census Tract 214, Queens County, New York",2311,70,2241,1516,4736,41311,1955,2008,1448,44.8,720,279,185,375,659,2241,388
2017,36081021400,"Census Tract 214, Queens County, New York",2266,86,2180,1432,4674,39643,1955,2008,1557,50,583,224,203,483,484,2180,481
2018,36081021400,"Census Tract 214, Queens County, New York",2284,91,2193,1357,4527,43069,1955,2011,1547,47.7,463,207,220,453,429,2193,490
2019,36081021400,"Census Tract 214, Queens County, New York",2307,128,2179,1372,4397,45777,1956,2011,1588,44.4,479,244,176,415,374,2179,330
2020,36081021400,"Census Tract 214, Queens County, New York",2346,179,2167,1521,4652,41992,1956,2012,1638,48.7,646,270,291,295,461,2167,475
2012,36081021600,"Census Tract 216, Queens County, New York",2005,150,1855,1309,3131,64884,1955,2002,1353,23.5,607,656,234,109,329,1855,115
2013,36081021600,"Census Tract 216, Queens County, New York",2022,136,1886,1301,3081,56859,1956,2001,1337,27.6,419,561,215,118,393,1886,136
2014,36081021600,"Census Tract 216, Queens County, New York",2047,158,1889,1267,2827,55505,1957,2001,1404,33,431,605,181,101,340,1889,192
2015,36081021600,"Census Tract 216, Queens County, New York",2038,158,1880,1223,2726,54659,1958,2002,1505,33.7,522,434,147,170,408,1880,205
2016,36081021600,"Census Tract 216, Queens County, New York",2025,141,1884,1205,2922,52827,1963,2004,1567,35.5,577,442,193,189,309,1884,200
2017,36081021600,"Census Tract 216, Queens County, New York",2006,171,1835,1140,2701,59125,1963,2004,1544,33.4,599,469,156,129,349,1835,134
2018,36081021600,"Census Tract 216, Queens County, New York",2002,170,1832,1114,2440,61310,1963,2004,1641,34.6,656,452,182,120,351,1832,153
2019,36081021600,"Census Tract 216, Queens County, New York",2010,160,1850,1189,2767,71493,1962,2010,1747,32.5,690,436,192,156,405,1850,91
2020,36081021601,"Census Tract 216.01, Queens County, New York",1462,155,1307,674,1284,87010,1964,2012,1785,26.3,460,342,95,87,150,1307,56
2020,36081021602,"Census Tract 216.02, Queens County, New York",619,72,547,340,1105,60387,1957,2011,1919,43.6,81,97,30,0,213,547,40
2020,36081021603,"Census Tract 216.03, Queens County, New York",0,0,0,0,0,NA,NA,NA,NA,NA,0,0,0,0,0,0,0
2012,36081021900,"Census Tract 219, Queens County, New York",9,9,0,0,0,NA,NA,NA,NA,NA,0,0,0,0,0,0,0
2013,36081021900,"Census Tract 219, Queens County, New York",13,9,4,0,0,NA,NA,NA,NA,NA,0,0,0,0,0,4,0
2014,36081021900,"Census Tract 219, Queens County, New York",13,9,4,0,0,NA,NA,NA,NA,NA,0,0,0,0,0,4,0
2015,36081021900,"Census Tract 219, Queens County, New York",13,9,4,0,0,NA,NA,NA,NA,NA,0,0,0,0,0,4,0
2016,36081021900,"Census Tract 219, Queens County, New York",4,0,4,0,0,NA,NA,NA,NA,NA,0,0,0,0,0,4,0
2017,36081021900,"Census Tract 219, Queens County, New York",4,0,4,0,0,NA,NA,NA,NA,NA,0,0,0,0,0,4,0
2018,36081021900,"Census Tract 219, Queens County, New York",0,0,0,0,0,NA,NA,NA,NA,NA,0,0,0,0,0,0,0
2019,36081021900,"Census Tract 219, Queens County, New York",0,0,0,0,0,NA,NA,NA,NA,NA,0,0,0,0,0,0,0
2020,36081021900,"Census Tract 219, Queens County, New York",0,0,0,0,0,NA,NA,NA,NA,NA,0,0,0,0,0,0,0
2012,36081022001,"Census Tract 220.01, Queens County, New York",2947,167,2780,2016,3863,58167,1957,2003,1326,26.9,1120,747,446,304,524,2780,374
2013,36081022001,"Census Tract 220.01, Queens County, New York",2892,186,2706,2018,3933,63750,1957,2004,1366,26,1084,854,361,355,460,2706,320
2014,36081022001,"Census Tract 220.01, Queens County, New York",2879,163,2716,2020,3782,63750,1956,2006,1384,26.8,1002,811,298,321,589,2716,272
2015,36081022001,"Census Tract 220.01, Queens County, New York",2906,106,2800,2129,4021,65123,1956,2007,1375,26.5,1023,799,371,358,608,2800,250
2016,36081022001,"Census Tract 220.01, Queens County, New York",2947,63,2884,2292,4335,69136,1956,2007,1391,24.4,1059,753,483,367,709,2884,277
2017,36081022001,"Census Tract 220.01, Queens County, New York",2986,62,2924,2382,4499,71281,1956,2008,1463,24.5,1230,800,445,380,790,2924,262
2018,36081022001,"Census Tract 220.01, Queens County, New York",3018,47,2971,2450,4617,74381,1956,2010,1501,23.9,1319,615,530,411,894,2971,305
2019,36081022001,"Census Tract 220.01, Queens County, New York",3025,83,2942,2407,4654,72578,1955,2011,1477,24.1,1293,642,463,362,860,2942,323
2020,36081022001,"Census Tract 220.01, Queens County, New York",2761,91,2670,2195,4339,77356,1956,2012,1500,23.8,1319,492,500,288,727,2670,320
2012,36081022002,"Census Tract 220.02, Queens County, New York",2579,163,2416,1264,2926,56304,1959,2003,1230,31.6,590,656,267,87,242,2416,319
2013,36081022002,"Census Tract 220.02, Queens County, New York",2646,141,2505,1317,3119,51904,1959,2004,1292,32.7,531,551,294,121,337,2505,382
2014,36081022002,"Census Tract 220.02, Queens County, New York",2667,195,2472,1328,3186,48654,1958,2007,1333,41.9,485,564,306,138,306,2472,354
2015,36081022002,"Census Tract 220.02, Queens County, New York",2700,127,2573,1516,3664,46857,1959,2009,1326,43.4,524,685,313,158,346,2573,484
2016,36081022002,"Census Tract 220.02, Queens County, New York",2802,98,2704,1539,3774,55341,1959,2010,1434,32.1,638,576,427,191,345,2704,390
2017,36081022002,"Census Tract 220.02, Queens County, New York",2818,131,2687,1416,3694,55726,1959,2010,1541,34.6,487,483,395,184,361,2687,384
2018,36081022002,"Census Tract 220.02, Queens County, New York",2869,162,2707,1493,3933,58160,1961,2011,1685,33.3,558,540,444,154,370,2707,381
2019,36081022002,"Census Tract 220.02, Queens County, New York",2862,128,2734,1541,4251,68750,1961,2011,1791,29.5,566,556,467,143,376,2734,350
2020,36081022002,"Census Tract 220.02, Queens County, New York",2799,128,2671,1507,4251,71138,1964,2013,1827,29.9,704,491,496,160,357,2671,279
2012,36081022900,"Census Tract 229, Queens County, New York",0,0,0,0,0,NA,NA,NA,NA,NA,0,0,0,0,0,0,0
2013,36081022900,"Census Tract 229, Queens County, New York",0,0,0,0,0,NA,NA,NA,NA,NA,0,0,0,0,0,0,0
2014,36081022900,"Census Tract 229, Queens County, New York",0,0,0,0,0,NA,NA,NA,NA,NA,0,0,0,0,0,0,0
2015,36081022900,"Census Tract 229, Queens County, New York",0,0,0,0,0,NA,NA,NA,NA,NA,0,0,0,0,0,0,0
2016,36081022900,"Census Tract 229, Queens County, New York",0,0,0,0,0,NA,NA,NA,NA,NA,0,0,0,0,0,0,0
2017,36081022900,"Census Tract 229, Queens County, New York",0,0,0,0,0,NA,NA,NA,NA,NA,0,0,0,0,0,0,0
2018,36081022900,"Census Tract 229, Queens County, New York",10,0,10,10,47,NA,NA,NA,NA,NA,0,0,0,0,10,10,10
2019,36081022900,"Census Tract 229, Queens County, New York",0,0,0,0,0,NA,NA,NA,NA,NA,0,0,0,0,0,0,0
2020,36081022900,"Census Tract 229, Queens County, New York",0,0,0,0,0,NA,NA,NA,NA,NA,0,0,0,0,0,0,0
2012,36081023000,"Census Tract 230, Queens County, New York",524,75,449,203,850,50417,1956,2003,1429,26,104,67,11,60,76,449,18
2013,36081023000,"Census Tract 230, Queens County, New York",546,49,497,189,808,50329,1956,2004,1473,26.3,88,61,9,66,53,497,18
2014,36081023000,"Census Tract 230, Queens County, New York",556,53,503,171,746,57132,1959,2005,1522,22.8,83,47,10,33,81,503,15
2015,36081023000,"Census Tract 230, Queens County, New York",579,43,536,167,727,NA,1963,2007,1644,29.4,84,42,7,38,80,536,25
2016,36081023000,"Census Tract 230, Queens County, New York",564,44,520,109,432,56063,1961,2009,1792,32.9,52,13,7,25,64,520,39
2017,36081023000,"Census Tract 230, Queens County, New York",571,34,537,132,469,58311,1956,2011,1659,32.3,62,9,10,71,42,537,38
2018,36081023000,"Census Tract 230, Queens County, New York",589,51,538,179,586,58942,1948,2012,1646,32.6,77,33,12,67,67,538,66
2019,36081023000,"Census Tract 230, Queens County, New York",574,42,532,198,698,62174,1945,2014,1690,32.6,80,36,19,79,64,532,78
2020,36081023000,"Census Tract 230, Queens County, New York",582,30,552,174,606,60625,1946,2014,1696,34.2,63,24,15,78,57,552,63
2012,36081023200,"Census Tract 232, Queens County, New York",1863,182,1681,842,2108,52864,1957,2005,1352,31.3,342,128,153,175,385,1681,140
2013,36081023200,"Census Tract 232, Queens County, New York",1839,153,1686,997,2412,53708,1957,2005,1360,30,340,180,168,157,492,1686,194
2014,36081023200,"Census Tract 232, Queens County, New York",1888,141,1747,944,2357,57016,1958,2007,1402,28.3,326,178,157,145,457,1747,229
2015,36081023200,"Census Tract 232, Queens County, New York",1906,118,1788,1023,2646,55536,1960,2009,1423,28.4,391,177,199,155,461,1788,232
2016,36081023200,"Census Tract 232, Queens County, New York",1898,81,1817,1037,2563,54489,1962,2011,1451,30.2,405,173,249,173,389,1817,302
2017,36081023200,"Census Tract 232, Queens County, New York",1887,95,1792,1021,2996,63646,1964,2011,1464,28.4,361,159,292,188,339,1792,228
2018,36081023200,"Census Tract 232, Queens County, New York",1889,100,1789,967,2728,60938,1965,2012,1509,30.9,387,129,240,249,307,1789,246
2019,36081023200,"Census Tract 232, Queens County, New York",1873,118,1755,958,2902,61250,1967,2012,1599,31.8,390,167,225,231,287,1755,169
2020,36081023200,"Census Tract 232, Queens County, New York",2218,159,2059,1315,3052,68315,1965,2014,1617,31.3,639,325,222,221,260,2059,347
2012,36081023500,"Census Tract 235, Queens County, New York",2741,57,2684,2401,6957,46307,1939,2002,1283,30.5,442,343,82,572,1408,2684,450
2013,36081023500,"Census Tract 235, Queens County, New York",2699,83,2616,2363,7216,45770,1939,2004,1323,32.4,432,310,85,576,1375,2616,521
2014,36081023500,"Census Tract 235, Queens County, New York",2768,72,2696,2500,7985,45462,1941,2005,1373,34.4,442,329,88,655,1393,2696,523
2015,36081023500,"Census Tract 235, Queens County, New York",2742,78,2664,2470,8224,47663,1939,2005,1363,33.3,483,285,72,684,1377,2664,522
2016,36081023500,"Census Tract 235, Queens County, New York",2792,68,2724,2540,8297,45175,1939,2007,1405,35.8,466,248,36,642,1514,2724,500
2017,36081023500,"Census Tract 235, Queens County, New York",2790,110,2680,2508,7764,48864,1939,2007,1456,34.3,473,344,35,586,1499,2680,444
2018,36081023500,"Census Tract 235, Queens County, New York",2789,137,2652,2460,7587,53300,0,2010,1471,32.9,473,398,46,599,1405,2652,335
2019,36081023500,"Census Tract 235, Queens County, New York",2813,144,2669,2399,6951,49124,0,2011,1515,32.1,510,351,22,525,1425,2669,274
2020,36081023501,"Census Tract 235.01, Queens County, New York",1670,33,1637,1492,4364,50856,0,2012,1561,29,252,43,0,374,1056,1637,134
2020,36081023502,"Census Tract 235.02, Queens County, New York",1189,111,1078,1030,2718,53750,0,2011,1467,34.2,322,296,25,124,534,1078,90
2012,36081023600,"Census Tract 236, Queens County, New York",769,6,763,529,1648,36250,1942,2004,1246,39.2,221,66,23,175,250,763,130
2013,36081023600,"Census Tract 236, Queens County, New York",765,16,749,567,1721,37560,1940,2004,1249,36.2,195,68,58,166,267,749,154
2014,36081023600,"Census Tract 236, Queens County, New York",802,16,786,603,1811,41806,1939,2005,1309,34.5,237,60,110,179,259,786,144
2015,36081023600,"Census Tract 236, Queens County, New York",802,23,779,586,1803,44868,1939,2008,1377,37.3,226,35,95,215,235,779,144
2016,36081023600,"Census Tract 236, Queens County, New York",837,27,810,645,2184,57250,1939,2009,1490,33.5,188,41,114,240,233,810,114
2017,36081023600,"Census Tract 236, Queens County, New York",887,50,837,680,2473,53988,1942,2010,1589,35.1,187,75,126,207,265,837,133
2018,36081023600,"Census Tract 236, Queens County, New York",885,32,853,694,2499,55795,1941,2011,1614,34.3,180,81,102,216,280,853,123
2019,36081023600,"Census Tract 236, Queens County, New York",876,53,823,700,2583,62000,1947,2011,1714,32,167,65,112,236,262,823,153
2020,36081023600,"Census Tract 236, Queens County, New York",861,54,807,657,2370,59653,1944,2012,1670,34.9,208,62,119,237,227,807,152
2012,36081023800,"Census Tract 238, Queens County, New York",1539,128,1411,1279,3909,38103,1950,2003,1155,37,243,24,256,360,617,1411,381
2013,36081023800,"Census Tract 238, Queens County, New York",1512,126,1386,1276,3917,35896,1952,2002,1138,37.3,192,27,300,314,641,1386,403
2014,36081023800,"Census Tract 238, Queens County, New York",1528,146,1382,1248,3943,36754,1952,2005,1247,42.4,255,52,245,368,547,1382,423
2015,36081023800,"Census Tract 238, Queens County, New York",1497,83,1414,1286,4002,36563,1951,2006,1225,38.3,280,55,266,399,511,1414,410
2016,36081023800,"Census Tract 238, Queens County, New York",1497,31,1466,1323,4257,38326,1952,2007,1263,37.9,320,61,221,413,549,1466,368
2017,36081023800,"Census Tract 238, Queens County, New York",1499,14,1485,1353,4204,44208,1953,2008,1288,37.8,329,57,261,438,510,1485,333
2018,36081023800,"Census Tract 238, Queens County, New York",1533,37,1496,1350,4155,47232,1955,2009,1351,37.8,268,69,290,413,491,1496,311
2019,36081023800,"Census Tract 238, Queens County, New York",1514,23,1491,1341,3867,51406,1957,2008,1374,33.4,190,48,338,342,540,1491,277
2020,36081023800,"Census Tract 238, Queens County, New York",1516,23,1493,1399,4175,52060,1956,2008,1470,35.7,220,30,368,360,586,1493,281
2012,36081024000,"Census Tract 240, Queens County, New York",1851,105,1746,1579,4812,34102,1949,2003,1179,40.4,240,52,351,290,850,1746,414
2013,36081024000,"Census Tract 240, Queens County, New York",1948,48,1900,1744,5539,35994,1947,2004,1224,41.2,253,79,374,222,980,1900,426
2014,36081024000,"Census Tract 240, Queens County, New York",2009,44,1965,1793,5571,39830,1948,2006,1246,38,365,71,456,267,858,1965,420
2015,36081024000,"Census Tract 240, Queens County, New York",2023,20,2003,1783,5327,39129,1949,2007,1255,38,374,68,443,241,887,2003,407
2016,36081024000,"Census Tract 240, Queens County, New York",2006,19,1987,1729,5262,35607,1948,2008,1346,37.6,399,65,453,286,818,1987,466
2017,36081024000,"Census Tract 240, Queens County, New York",2075,21,2054,1801,5490,40065,1947,2009,1410,36.3,452,68,434,315,869,2054,424
2018,36081024000,"Census Tract 240, Queens County, New York",2098,20,2078,1857,5139,40837,1950,2011,1403,36.1,541,58,438,468,826,2078,399
2019,36081024000,"Census Tract 240, Queens County, New York",2114,48,2066,1839,5793,41454,1954,2012,1492,36.6,438,56,370,467,927,2066,386
2020,36081024000,"Census Tract 240, Queens County, New York",2302,43,2259,2082,6151,55323,1969,2013,1591,39.8,669,87,308,433,1244,2259,442
2012,36081024300,"Census Tract 243, Queens County, New York",1977,188,1789,711,2093,46808,1968,2004,1445,29.6,160,180,24,173,325,1789,155
2013,36081024300,"Census Tract 243, Queens County, New York",1977,190,1787,802,2671,56905,1963,2005,1497,31.5,110,229,26,207,320,1787,273
2014,36081024300,"Census Tract 243, Queens County, New York",2001,155,1846,897,3054,58789,1958,2006,1550,32.8,106,217,27,232,402,1846,237
2015,36081024300,"Census Tract 243, Queens County, New York",1971,140,1831,972,3275,55197,1959,2007,1582,33.3,129,206,41,222,494,1831,214
2016,36081024300,"Census Tract 243, Queens County, New York",1935,91,1844,977,3431,56017,1954,2009,1615,33.4,126,231,8,258,478,1844,196
2017,36081024300,"Census Tract 243, Queens County, New York",1942,166,1776,993,3229,51897,1959,2010,1650,34,144,269,4,299,417,1776,150
2018,36081024300,"Census Tract 243, Queens County, New York",1909,195,1714,891,2634,53323,1958,2011,1619,35,145,250,19,267,341,1714,69
2019,36081024300,"Census Tract 243, Queens County, New York",1828,199,1629,855,2581,65246,1960,2013,1626,31.2,176,200,31,213,376,1629,45
2020,36081024300,"Census Tract 243, Queens County, New York",2123,213,1910,670,1991,68375,1956,2015,1630,29.5,99,137,21,240,254,1910,42
2012,36081024500,"Census Tract 245, Queens County, New York",2174,15,2159,1328,3393,38136,1964,2001,997,33.7,370,629,62,205,452,2159,242
2013,36081024500,"Census Tract 245, Queens County, New York",2205,15,2190,1330,3460,41696,1964,2002,1068,29,367,575,16,314,437,2190,275
2014,36081024500,"Census Tract 245, Queens County, New York",2221,42,2179,1279,3764,50328,1966,2005,1224,26.7,387,458,15,341,465,2179,242
2015,36081024500,"Census Tract 245, Queens County, New York",2185,39,2146,1253,3773,60234,1966,2006,1405,24.7,433,481,13,374,385,2146,137
2016,36081024500,"Census Tract 245, Queens County, New York",2172,48,2124,1087,3192,56307,1965,2008,1463,26.1,310,433,12,319,296,2124,91
2017,36081024500,"Census Tract 245, Queens County, New York",2133,111,2022,1121,3548,64871,1968,2009,1611,27.4,301,514,0,351,206,2022,158
2018,36081024500,"Census Tract 245, Queens County, New York",2148,106,2042,1050,3128,66034,1968,2011,1666,29.5,304,481,0,255,266,2042,187
2019,36081024500,"Census Tract 245, Queens County, New York",2104,66,2038,1080,2578,61288,1966,2009,1452,30.1,270,532,0,206,293,2038,188
2020,36081024500,"Census Tract 245, Queens County, New York",2078,54,2024,1116,2338,54857,1968,2010,1351,32,330,529,0,112,422,2024,210
2012,36081024600,"Census Tract 246, Queens County, New York",0,0,0,0,0,NA,NA,NA,NA,NA,0,0,0,0,0,0,0
2013,36081024600,"Census Tract 246, Queens County, New York",0,0,0,0,0,NA,NA,NA,NA,NA,0,0,0,0,0,0,0
2014,36081024600,"Census Tract 246, Queens County, New York",0,0,0,0,0,NA,NA,NA,NA,NA,0,0,0,0,0,0,0
2015,36081024600,"Census Tract 246, Queens County, New York",0,0,0,0,0,NA,NA,NA,NA,NA,0,0,0,0,0,0,0
2016,36081024600,"Census Tract 246, Queens County, New York",0,0,0,0,0,NA,NA,NA,NA,NA,0,0,0,0,0,0,0
2017,36081024600,"Census Tract 246, Queens County, New York",0,0,0,0,0,NA,NA,NA,NA,NA,0,0,0,0,0,0,0
2018,36081024600,"Census Tract 246, Queens County, New York",0,0,0,0,0,NA,NA,NA,NA,NA,0,0,0,0,0,0,0
2019,36081024600,"Census Tract 246, Queens County, New York",0,0,0,0,0,NA,NA,NA,NA,NA,0,0,0,0,0,0,0
2020,36081024600,"Census Tract 246, Queens County, New York",0,0,0,0,0,NA,NA,NA,NA,NA,0,0,0,0,0,0,0
2012,36081024700,"Census Tract 247, Queens County, New York",526,36,490,398,1035,50625,1949,2005,1382,33.4,128,108,5,135,150,490,10
2013,36081024700,"Census Tract 247, Queens County, New York",507,26,481,389,1050,45324,1962,2005,1375,33.6,124,114,4,98,173,481,24
2014,36081024700,"Census Tract 247, Queens County, New York",489,39,450,354,1119,40673,1950,2006,1402,36.6,53,59,10,102,178,450,27
2015,36081024700,"Census Tract 247, Queens County, New York",525,43,482,385,1264,55417,1957,2007,1463,30.1,83,77,10,107,187,482,21
2016,36081024700,"Census Tract 247, Queens County, New York",520,47,473,369,1201,59306,1963,2008,1413,29,69,66,10,131,158,473,40
2017,36081024700,"Census Tract 247, Queens County, New York",515,38,477,360,1212,58000,1959,2009,1500,29,76,76,5,140,135,477,55
2018,36081024700,"Census Tract 247, Queens County, New York",528,33,495,391,1223,73854,1958,2011,1592,28.3,106,63,6,173,132,495,44
2019,36081024700,"Census Tract 247, Queens County, New York",519,31,488,387,1219,76875,1959,2012,1649,27.6,106,58,0,168,150,488,55
2020,36081024700,"Census Tract 247, Queens County, New York",494,25,469,350,1065,62917,1959,2012,1639,30.4,84,41,0,183,119,469,50
2012,36081024900,"Census Tract 249, Queens County, New York",2271,188,2083,1760,4460,62772,1950,2004,1321,27.3,781,554,49,611,551,2083,203
2013,36081024900,"Census Tract 249, Queens County, New York",2216,250,1966,1738,4309,58889,1951,2005,1381,29.3,754,517,14,686,482,1966,212
2014,36081024900,"Census Tract 249, Queens County, New York",2254,286,1968,1723,4438,53625,1955,2007,1447,34.6,689,549,27,633,460,1968,287
2015,36081024900,"Census Tract 249, Queens County, New York",2204,314,1890,1546,3764,52668,1953,2008,1420,34.8,670,546,33,547,397,1890,294
2016,36081024900,"Census Tract 249, Queens County, New York",2205,268,1937,1568,3703,52849,1959,2010,1496,34.2,652,540,40,582,402,1937,305
2017,36081024900,"Census Tract 249, Queens County, New York",2125,289,1836,1511,3759,54950,1959,2010,1564,32.1,612,473,29,513,480,1836,200
2018,36081024900,"Census Tract 249, Queens County, New York",2054,179,1875,1312,3160,54012,1958,2010,1517,33.4,559,440,29,468,376,1875,156
2019,36081024900,"Census Tract 249, Queens County, New York",2049,156,1893,1328,3331,53548,1960,2010,1600,31.4,500,349,15,576,403,1893,243
2020,36081024900,"Census Tract 249, Queens County, New York",1892,53,1839,1392,3746,62910,1953,2012,1736,32.3,500,274,0,651,467,1839,254
2012,36081025100,"Census Tract 251, Queens County, New York",2496,138,2358,1386,3554,44868,1949,2002,1292,33.7,396,274,0,435,725,2358,297
2013,36081025100,"Census Tract 251, Queens County, New York",2500,135,2365,1384,3035,40765,1947,2002,1219,37,415,357,0,411,668,2365,317
2014,36081025100,"Census Tract 251, Queens County, New York",2485,132,2353,1374,3344,37602,1948,2005,1351,42.6,473,373,0,508,543,2353,265
2015,36081025100,"Census Tract 251, Queens County, New York",2544,251,2293,1361,3729,37231,1950,2006,1429,43.4,392,346,0,468,547,2293,211
2016,36081025100,"Census Tract 251, Queens County, New York",2603,228,2375,1434,4149,41500,1954,2007,1406,40.1,446,361,13,443,617,2375,179
2017,36081025100,"Census Tract 251, Queens County, New York",2625,165,2460,1419,4292,43954,1958,2006,1455,40.6,458,321,54,423,621,2460,170
2018,36081025100,"Census Tract 251, Queens County, New York",2649,192,2457,1343,3945,48475,1958,2006,1516,39.2,402,235,60,373,675,2457,152
2019,36081025100,"Census Tract 251, Queens County, New York",2554,195,2359,1149,3100,49107,1954,2006,1401,36.6,346,252,73,271,553,2359,163
2020,36081025100,"Census Tract 251, Queens County, New York",2505,82,2423,1204,2822,75284,1956,2010,1374,26.9,449,233,78,224,669,2423,157
2012,36081025301,"Census Tract 253.01, Queens County, New York",2115,146,1969,1765,4106,49915,1941,2001,1285,28.6,647,738,19,312,646,1969,220
2013,36081025301,"Census Tract 253.01, Queens County, New York",2075,187,1888,1671,3533,49558,1939,2003,1362,29.8,617,719,20,269,618,1888,220
2014,36081025301,"Census Tract 253.01, Queens County, New York",2061,217,1844,1675,3600,51279,1939,2004,1402,30.2,701,816,26,275,544,1844,237
2015,36081025301,"Census Tract 253.01, Queens County, New York",2044,205,1839,1682,3551,50335,1939,2005,1450,32.2,735,850,7,351,461,1839,247
2016,36081025301,"Census Tract 253.01, Queens County, New York",2045,255,1790,1637,3525,57060,1939,2010,1456,31.3,701,850,8,320,453,1790,172
2017,36081025301,"Census Tract 253.01, Queens County, New York",2070,290,1780,1654,3731,61042,1939,2011,1545,30.7,699,792,0,356,496,1780,137
2018,36081025301,"Census Tract 253.01, Queens County, New York",2127,341,1786,1661,3858,60544,0,2011,1615,31.7,795,729,10,400,511,1786,118
2019,36081025301,"Census Tract 253.01, Queens County, New York",2143,255,1888,1701,3804,63295,0,2012,1654,30.9,805,744,18,412,521,1888,129
2020,36081025301,"Census Tract 253.01, Queens County, New York",2045,253,1792,1631,3486,60344,0,2012,1616,32.2,740,614,31,463,529,1792,94
2012,36081025302,"Census Tract 253.02, Queens County, New York",1206,110,1096,985,2374,49418,1944,2003,1246,29.4,311,308,27,273,381,1096,196
2013,36081025302,"Census Tract 253.02, Queens County, New York",1214,132,1082,1017,2533,53143,1946,2004,1329,29.7,371,328,26,296,371,1082,183
2014,36081025302,"Census Tract 253.02, Queens County, New York",1208,142,1066,984,2589,49277,1944,2006,1406,31.9,308,258,33,270,397,1066,229
2015,36081025302,"Census Tract 253.02, Queens County, New York",1256,177,1079,1004,2780,55511,1941,2008,1405,28,248,251,36,241,447,1079,210
2016,36081025302,"Census Tract 253.02, Queens County, New York",1251,117,1134,1016,2858,60375,1941,2009,1408,28,267,268,30,184,505,1134,159
2017,36081025302,"Census Tract 253.02, Queens County, New York",1273,122,1151,1009,2791,62740,1940,2010,1429,27.9,262,236,19,149,524,1151,108
2018,36081025302,"Census Tract 253.02, Queens County, New York",1275,101,1174,988,2651,62054,0,2010,1485,27.7,247,252,27,128,498,1174,98
2019,36081025302,"Census Tract 253.02, Queens County, New York",1283,92,1191,1000,2649,63971,1941,2011,1604,28.4,265,270,13,172,505,1191,104
2020,36081025302,"Census Tract 253.02, Queens County, New York",1253,54,1199,996,2799,63629,1947,2014,1712,28.4,308,272,0,220,475,1199,94
2012,36081025400,"Census Tract 254, Queens County, New York",3203,302,2901,2341,6410,22762,1970,2005,807,33,143,3,1612,113,430,2901,918
2013,36081025400,"Census Tract 254, Queens County, New York",3268,362,2906,2282,6607,25474,1968,2005,868,31.9,229,4,1561,181,341,2906,896
2014,36081025400,"Census Tract 254, Queens County, New York",3327,392,2935,2405,10696,31976,1958,2004,696,27.1,232,6,1429,183,670,2935,733
2015,36081025400,"Census Tract 254, Queens County, New York",3332,458,2874,2298,6930,26680,1972,2006,871,33.2,355,4,1584,237,338,2874,742
2016,36081025400,"Census Tract 254, Queens County, New York",3308,453,2855,2379,7380,29665,1968,2007,889,31.8,353,0,1573,284,369,2855,659
2017,36081025400,"Census Tract 254, Queens County, New York",3190,353,2837,2269,7421,30429,1968,2008,954,32.4,403,0,1558,274,330,2837,506
2018,36081025400,"Census Tract 254, Queens County, New York",3207,285,2922,2204,6854,29934,1967,2009,964,33.2,311,43,1498,264,295,2922,507
2019,36081025400,"Census Tract 254, Queens County, New York",3149,196,2953,2211,6927,31270,1973,2011,1002,33.3,252,40,1479,237,358,2953,484
2020,36081025401,"Census Tract 254.01, Queens County, New York",979,42,937,549,2014,41397,1990,2011,1600,45.4,79,0,275,154,78,937,124
2020,36081025402,"Census Tract 254.02, Queens County, New York",2087,114,1973,1565,4119,32881,1972,2009,925,26.8,95,31,941,48,371,1973,247
2012,36081025500,"Census Tract 255, Queens County, New York",519,28,491,253,614,79013,1951,2004,1420,22.8,97,132,0,84,37,491,62
2013,36081025500,"Census Tract 255, Queens County, New York",517,25,492,260,615,70625,1948,2004,1433,25,113,129,0,97,38,492,71
2014,36081025500,"Census Tract 255, Queens County, New York",548,28,520,301,724,73625,1953,2006,1457,24.5,166,171,0,110,26,520,45
2015,36081025500,"Census Tract 255, Queens County, New York",536,29,507,299,704,66726,1957,2008,1429,28.2,196,175,0,90,28,507,52
2016,36081025500,"Census Tract 255, Queens County, New York",498,16,482,273,742,57250,1956,2009,1534,33.5,170,155,0,82,31,482,58
2017,36081025500,"Census Tract 255, Queens County, New York",505,14,491,282,738,59250,1956,2009,1574,28.8,169,183,0,69,21,491,58
2018,36081025500,"Census Tract 255, Queens County, New York",521,18,503,320,894,77609,1958,2011,1604,23.9,186,156,0,119,25,503,40
2019,36081025500,"Census Tract 255, Queens County, New York",512,16,496,322,997,75667,1957,2012,1708,30.9,176,132,0,105,64,496,41
2020,36081025500,"Census Tract 255, Queens County, New York",496,16,480,333,1156,75144,1956,2013,1877,33.2,175,123,0,136,74,480,37
2012,36081025700,"Census Tract 257, Queens County, New York",610,92,518,327,960,58346,1953,2005,1446,29,94,100,0,121,101,518,40
2013,36081025700,"Census Tract 257, Queens County, New York",580,100,480,298,667,52308,1944,2004,1348,28.2,83,85,0,72,118,480,53
2014,36081025700,"Census Tract 257, Queens County, New York",572,86,486,305,704,45875,1945,2006,1342,30.7,96,99,0,87,91,486,43
2015,36081025700,"Census Tract 257, Queens County, New York",560,62,498,331,840,52986,1949,2008,1309,28,62,93,18,91,98,498,67
2016,36081025700,"Census Tract 257, Queens County, New York",569,35,534,332,844,48636,1949,2011,1359,28.7,79,87,13,100,104,534,75
2017,36081025700,"Census Tract 257, Queens County, New York",591,35,556,349,816,45927,1948,2011,1364,30.2,68,100,14,93,111,556,71
2018,36081025700,"Census Tract 257, Queens County, New York",586,41,545,306,848,53214,1948,2012,1496,30.7,76,105,10,97,94,545,49
2019,36081025700,"Census Tract 257, Queens County, New York",565,31,534,248,699,56875,1946,2013,1590,28.6,86,76,11,68,82,534,57
2020,36081025700,"Census Tract 257, Queens County, New York",602,29,573,245,678,82188,1949,2014,1839,29.5,88,61,0,50,124,573,35
2012,36081025800,"Census Tract 258, Queens County, New York",567,138,429,120,529,2499,1946,2006,1717,22.6,4,0,105,12,3,429,74
2013,36081025800,"Census Tract 258, Queens County, New York",595,91,504,170,660,8529,1949,2006,1529,30,5,0,151,13,6,504,99
2014,36081025800,"Census Tract 258, Queens County, New York",610,74,536,206,763,39615,1956,2006,1576,36,14,0,176,12,18,536,80
2015,36081025800,"Census Tract 258, Queens County, New York",623,48,575,201,736,39712,1990,2007,1574,43.5,31,0,150,12,39,575,74
2016,36081025800,"Census Tract 258, Queens County, New York",620,34,586,219,838,53641,1959,2006,1615,38.5,44,0,168,12,39,586,42
2017,36081025800,"Census Tract 258, Queens County, New York",580,37,543,229,848,48750,1958,2006,1572,39.8,40,0,193,0,36,543,63
2018,36081025800,"Census Tract 258, Queens County, New York",569,23,546,225,874,47734,1956,2009,1696,44.7,41,0,184,0,41,546,81
2019,36081025800,"Census Tract 258, Queens County, New York",548,21,527,201,780,49625,1951,2008,1821,37.9,26,0,172,0,29,527,96
2020,36081025800,"Census Tract 258, Queens County, New York",541,44,497,152,562,50978,1946,2009,1900,37.6,12,0,134,0,18,497,70
2012,36081025900,"Census Tract 259, Queens County, New York",1231,83,1148,922,2777,49362,1949,2004,1362,28.9,352,185,13,297,414,1148,132
2013,36081025900,"Census Tract 259, Queens County, New York",1191,69,1122,952,2714,45921,1946,2005,1363,35.2,378,209,20,263,451,1122,130
2014,36081025900,"Census Tract 259, Queens County, New York",1173,111,1062,876,2851,48224,1948,2006,1426,32.2,339,163,20,208,463,1062,142
2015,36081025900,"Census Tract 259, Queens County, New York",1174,119,1055,804,2638,44728,1947,2007,1408,33,278,102,24,247,421,1055,149
2016,36081025900,"Census Tract 259, Queens County, New York",1205,98,1107,831,2699,43079,1946,2008,1447,36.1,254,129,18,212,454,1107,175
2017,36081025900,"Census Tract 259, Queens County, New York",1143,83,1060,771,2585,47974,1951,2007,1541,34,217,121,10,182,444,1060,150
2018,36081025900,"Census Tract 259, Queens County, New York",1169,65,1104,794,2726,57833,1957,2009,1703,31.7,217,99,0,265,406,1104,162
2019,36081025900,"Census Tract 259, Queens County, New York",1186,55,1131,823,2563,69018,1960,2011,1780,28.3,210,126,0,322,356,1131,167
2020,36081025900,"Census Tract 259, Queens County, New York",1273,54,1219,892,2316,54706,1961,2012,1677,31.6,228,143,0,276,462,1219,187
2012,36081026000,"Census Tract 260, Queens County, New York",703,64,639,467,1613,36406,1956,2005,1213,34.8,41,0,400,0,67,639,141
2013,36081026000,"Census Tract 260, Queens County, New York",713,51,662,466,1626,35781,1958,2005,1083,33.2,29,0,375,0,91,662,176
2014,36081026000,"Census Tract 260, Queens County, New York",777,63,714,527,1840,35850,1965,2007,1343,36.5,34,0,346,0,161,714,213
2015,36081026000,"Census Tract 260, Queens County, New York",787,65,722,532,1913,28611,1960,2008,1180,33.6,45,0,363,0,147,722,237
2016,36081026000,"Census Tract 260, Queens County, New York",784,60,724,564,1854,33500,1964,2009,1262,31.9,27,0,370,0,153,724,197
2017,36081026000,"Census Tract 260, Queens County, New York",796,61,735,566,2029,36131,1966,2010,1181,30.9,19,0,366,14,156,735,195
2018,36081026000,"Census Tract 260, Queens County, New York",780,77,703,551,1829,36921,1965,2011,1176,31.2,28,10,350,23,133,703,162
2019,36081026000,"Census Tract 260, Queens County, New York",791,58,733,592,2291,52000,1959,2012,1144,30.2,30,11,428,27,91,733,125
2020,36081026000,"Census Tract 260, Queens County, New York",737,35,702,545,2034,61985,1962,2012,1087,30.1,19,10,398,28,72,702,83
2012,36081026100,"Census Tract 261, Queens County, New York",2543,120,2423,2106,5985,45057,1939,2002,1221,32.6,577,292,61,1009,744,2423,461
2013,36081026100,"Census Tract 261, Queens County, New York",2513,129,2384,2033,5909,45724,1939,2003,1216,32.5,528,264,79,945,745,2384,502
2014,36081026100,"Census Tract 261, Queens County, New York",2470,152,2318,2047,6245,41053,1939,2004,1299,37,481,257,63,905,837,2318,534
2015,36081026100,"Census Tract 261, Queens County, New York",2465,174,2291,1896,5952,39345,1939,2005,1313,39.3,485,227,63,846,758,2291,603
2016,36081026100,"Census Tract 261, Queens County, New York",2458,164,2294,1883,5847,40019,1939,2008,1325,38.8,438,228,68,763,867,2294,545
2017,36081026100,"Census Tract 261, Queens County, New York",2524,160,2364,2053,6338,44904,1939,2008,1389,36.5,394,262,69,704,1060,2364,489
2018,36081026100,"Census Tract 261, Queens County, New York",2449,153,2296,2059,5904,45882,0,2010,1442,38.1,419,237,58,797,965,2296,444
2019,36081026100,"Census Tract 261, Queens County, New York",2405,169,2236,1933,5678,56497,0,2010,1482,33,498,214,71,756,869,2236,421
2020,36081026100,"Census Tract 261, Queens County, New York",2397,151,2246,2053,5836,56089,0,2011,1499,30.2,426,183,63,687,1128,2246,308
2012,36081026200,"Census Tract 262, Queens County, New York",446,46,400,154,560,32838,1958,2005,1601,50,0,0,89,0,77,400,80
2013,36081026200,"Census Tract 262, Queens County, New York",440,16,424,180,605,32927,1981,2007,1643,50,18,0,99,0,73,424,101
2014,36081026200,"Census Tract 262, Queens County, New York",430,45,385,118,435,15278,1968,2011,1397,50,18,0,98,0,11,385,95
2015,36081026200,"Census Tract 262, Queens County, New York",397,50,347,126,435,30577,1962,2011,1392,42.7,32,0,108,0,10,347,68
2016,36081026200,"Census Tract 262, Queens County, New York",389,55,334,126,396,35625,1951,2010,1402,34.3,32,0,100,0,18,334,40
2017,36081026200,"Census Tract 262, Queens County, New York",387,35,352,127,397,35469,1939,2011,1465,33,33,0,109,0,18,352,54
2018,36081026200,"Census Tract 262, Queens County, New York",400,52,348,118,331,38125,0,2012,1323,37.5,15,0,97,0,21,348,38
2019,36081026200,"Census Tract 262, Queens County, New York",398,24,374,115,289,48603,0,2012,1523,33.3,11,0,93,0,19,374,42
2020,36081026200,"Census Tract 262, Queens County, New York",402,17,385,133,419,66250,1960,2012,1664,36.3,12,0,93,12,18,385,49
2012,36081026300,"Census Tract 263, Queens County, New York",2149,109,2040,1522,4613,55549,1953,2003,1342,29.4,588,273,15,764,422,2040,251
2013,36081026300,"Census Tract 263, Queens County, New York",2181,146,2035,1487,4835,49391,1955,2004,1452,31.4,531,241,14,759,421,2035,244
2014,36081026300,"Census Tract 263, Queens County, New York",2208,205,2003,1532,4724,50500,1952,2005,1507,34.5,506,280,14,708,476,2003,326
2015,36081026300,"Census Tract 263, Queens County, New York",2221,158,2063,1545,4984,43704,1950,2007,1561,39.2,418,231,15,717,524,2063,405
2016,36081026300,"Census Tract 263, Queens County, New York",2226,227,1999,1538,5019,51351,1951,2007,1437,36.7,484,236,14,743,510,1999,364
2017,36081026300,"Census Tract 263, Queens County, New York",2241,209,2032,1443,4622,47375,1953,2010,1507,39.4,497,243,0,827,313,2032,332
2018,36081026300,"Census Tract 263, Queens County, New York",2131,206,1925,1422,4522,52632,1951,2008,1457,36.5,431,292,0,707,395,1925,208
2019,36081026300,"Census Tract 263, Queens County, New York",2136,172,1964,1384,4175,45938,1950,2010,1427,34.9,401,243,0,670,429,1964,180
2020,36081026300,"Census Tract 263, Queens County, New York",2320,260,2060,1534,4309,52500,1963,2013,1392,32.4,484,257,40,929,310,2060,79
2012,36081026400,"Census Tract 264, Queens County, New York",789,75,714,294,613,20887,1992,2002,739,32.3,28,0,264,5,39,714,128
2013,36081026400,"Census Tract 264, Queens County, New York",796,52,744,335,768,21384,1992,2005,821,34.3,24,0,295,6,55,744,144
2014,36081026400,"Census Tract 264, Queens County, New York",799,66,733,352,929,24732,1991,2006,940,33.3,34,0,286,12,85,733,120
2015,36081026400,"Census Tract 264, Queens County, New York",820,101,719,338,946,27885,1991,2007,1042,37.5,33,0,253,10,100,719,101
2016,36081026400,"Census Tract 264, Queens County, New York",843,95,748,390,1150,34038,1992,2008,1100,37.9,42,0,281,5,109,748,86
2017,36081026400,"Census Tract 264, Queens County, New York",844,102,742,361,954,37548,1986,2010,1121,38.8,31,0,265,19,79,742,99
2018,36081026400,"Census Tract 264, Queens County, New York",877,90,787,418,963,38229,1991,2011,1211,37.7,49,0,296,28,102,787,109
2019,36081026400,"Census Tract 264, Queens County, New York",882,93,789,442,1022,38875,1993,2012,1339,38,67,0,304,58,79,789,120
2020,36081026400,"Census Tract 264, Queens County, New York",872,35,837,500,1140,46622,1990,2012,1487,38.4,102,0,330,67,98,837,122
2012,36081026500,"Census Tract 265, Queens County, New York",1554,71,1483,1242,3430,40000,1950,2003,1228,40.6,377,140,37,737,328,1483,171
2013,36081026500,"Census Tract 265, Queens County, New York",1490,72,1418,1222,3201,47821,1955,2005,1315,34.4,427,176,35,722,289,1418,154
2014,36081026500,"Census Tract 265, Queens County, New York",1494,57,1437,1204,3194,48456,1958,2006,1399,34.4,348,218,26,669,291,1437,214
2015,36081026500,"Census Tract 265, Queens County, New York",1496,78,1418,1216,3431,47791,1957,2008,1425,35.7,450,224,8,671,304,1418,193
2016,36081026500,"Census Tract 265, Queens County, New York",1486,72,1414,1156,3465,51934,1959,2010,1471,32.3,520,202,20,698,220,1414,186
2017,36081026500,"Census Tract 265, Queens County, New York",1474,122,1352,1072,3032,53349,1959,2011,1479,32.9,453,178,30,636,211,1352,148
2018,36081026500,"Census Tract 265, Queens County, New York",1504,115,1389,1100,3172,54344,1959,2012,1552,33.2,411,132,37,644,268,1389,141
2019,36081026500,"Census Tract 265, Queens County, New York",1503,141,1362,1109,3184,54315,1962,2013,1553,34.4,453,120,34,662,268,1362,106
2020,36081026501,"Census Tract 265.01, Queens County, New York",1149,117,1032,845,2196,53375,1961,2014,1671,35.3,434,147,29,478,136,1032,144
2020,36081026502,"Census Tract 265.02, Queens County, New York",393,51,342,297,969,63188,1967,2015,1859,26,105,12,0,159,107,342,10
2012,36081026600,"Census Tract 266, Queens County, New York",824,48,776,538,733,14569,1981,2003,346,34.7,70,0,467,34,11,776,227
2013,36081026600,"Census Tract 266, Queens County, New York",848,41,807,496,724,14519,1979,2004,330,32.9,60,0,409,25,25,807,242
2014,36081026600,"Census Tract 266, Queens County, New York",848,75,773,455,617,14871,1976,2005,320,31.3,48,0,379,30,35,773,229
2015,36081026600,"Census Tract 266, Queens County, New York",845,79,766,454,733,16382,1978,2007,390,32.4,36,0,367,28,41,766,255
2016,36081026600,"Census Tract 266, Queens County, New York",835,78,757,414,714,16774,1971,2008,567,33.4,29,0,349,20,37,757,217
2017,36081026600,"Census Tract 266, Queens County, New York",854,95,759,420,773,16644,1963,2010,511,34.1,28,0,344,26,25,759,219
2018,36081026600,"Census Tract 266, Queens County, New York",840,104,736,466,832,16581,1964,2010,556,35.5,19,0,396,41,14,736,253
2019,36081026600,"Census Tract 266, Queens County, New York",832,79,753,516,1030,16111,1968,2010,536,36.7,26,5,442,39,13,753,285
2020,36081026600,"Census Tract 266, Queens County, New York",809,89,720,494,884,14405,1969,2011,450,36.3,27,5,413,39,15,720,260
2012,36081026700,"Census Tract 267, Queens County, New York",2148,112,2036,1709,5143,45165,1952,2005,1380,40.7,359,86,36,703,801,2036,341
2013,36081026700,"Census Tract 267, Queens County, New York",2195,162,2033,1719,5119,46372,1950,2006,1388,37.1,329,68,11,653,865,2033,272
2014,36081026700,"Census Tract 267, Queens County, New York",2251,186,2065,1784,5622,47581,1954,2007,1428,39.6,334,73,0,722,861,2065,272
2015,36081026700,"Census Tract 267, Queens County, New York",2286,146,2140,1877,5916,45560,1954,2009,1395,39.8,355,130,0,702,933,2140,349
2016,36081026700,"Census Tract 267, Queens County, New York",2280,177,2103,1846,5554,42396,1954,2009,1337,38.9,371,134,14,679,953,2103,422
2017,36081026700,"Census Tract 267, Queens County, New York",2246,301,1945,1582,4870,43235,1954,2009,1414,39.6,374,95,20,614,795,1945,367
2018,36081026700,"Census Tract 267, Queens County, New York",2292,299,1993,1678,4998,46136,1953,2009,1413,38.3,392,113,20,640,833,1993,342
2019,36081026700,"Census Tract 267, Queens County, New York",2280,320,1960,1606,4292,47422,1952,2009,1440,37.2,456,145,24,602,781,1960,343
2020,36081026700,"Census Tract 267, Queens County, New York",2488,306,2182,1863,3948,45712,1956,2011,1554,47.8,856,101,25,914,980,2182,376
2012,36081026901,"Census Tract 269.01, Queens County, New York",1717,36,1681,1491,4618,47485,1950,2002,1190,29.4,398,138,34,518,801,1681,407
2013,36081026901,"Census Tract 269.01, Queens County, New York",1699,56,1643,1418,4316,51548,1948,2003,1248,29.1,353,98,0,531,789,1643,324
2014,36081026901,"Census Tract 269.01, Queens County, New York",1724,60,1664,1422,4179,46359,1949,2004,1345,33.9,429,118,0,563,741,1664,303
2015,36081026901,"Census Tract 269.01, Queens County, New York",1734,82,1652,1352,4140,46850,1954,2008,1466,34.4,379,91,0,520,741,1652,297
2016,36081026901,"Census Tract 269.01, Queens County, New York",1746,64,1682,1401,4360,42198,1955,2010,1521,38.9,343,68,23,505,813,1682,285
2017,36081026901,"Census Tract 269.01, Queens County, New York",1764,114,1650,1353,3986,44153,1956,2011,1519,39.5,301,74,20,404,863,1650,202
2018,36081026901,"Census Tract 269.01, Queens County, New York",1747,90,1657,1392,3949,43773,1956,2011,1539,41.3,349,104,20,402,875,1657,233
2019,36081026901,"Census Tract 269.01, Queens County, New York",1743,121,1622,1352,4151,56937,1957,2013,1667,34.3,363,105,18,401,836,1622,203
2020,36081026901,"Census Tract 269.01, Queens County, New York",1669,92,1577,1338,4447,64244,1957,2014,1706,33.5,421,134,15,361,834,1577,144
2012,36081026902,"Census Tract 269.02, Queens County, New York",1550,0,1550,1140,3914,37955,1948,2001,1231,29.7,188,117,57,452,514,1550,307
2013,36081026902,"Census Tract 269.02, Queens County, New York",1550,25,1525,1171,3697,35572,1946,2004,1270,39,301,109,40,522,500,1525,315
2014,36081026902,"Census Tract 269.02, Queens County, New York",1534,22,1512,1191,3617,34859,1947,2005,1221,36.1,323,138,52,536,465,1512,372
2015,36081026902,"Census Tract 269.02, Queens County, New York",1549,75,1474,1172,3669,44904,1946,2006,1206,34.7,335,100,52,543,477,1474,349
2016,36081026902,"Census Tract 269.02, Queens County, New York",1551,142,1409,1182,3718,36714,1945,2007,1230,37.4,299,87,38,566,491,1409,296
2017,36081026902,"Census Tract 269.02, Queens County, New York",1540,220,1320,1031,2800,36979,1946,2009,1306,38.3,351,72,10,526,433,1320,256
2018,36081026902,"Census Tract 269.02, Queens County, New York",1488,245,1243,940,2635,38750,1949,2010,1367,36.4,285,54,9,490,396,1243,214
2019,36081026902,"Census Tract 269.02, Queens County, New York",1476,260,1216,916,2724,48733,1948,2008,1421,34.2,255,43,17,395,470,1216,239
2020,36081026902,"Census Tract 269.02, Queens County, New York",1358,197,1161,797,2336,46655,1951,2009,1618,36.3,256,32,28,358,400,1161,207
2012,36081027000,"Census Tract 270, Queens County, New York",534,106,428,129,323,14901,1964,2009,1493,50,7,0,76,0,53,428,62
2013,36081027000,"Census Tract 270, Queens County, New York",538,91,447,130,385,16406,1954,2008,1314,50,8,0,87,0,43,447,76
2014,36081027000,"Census Tract 270, Queens County, New York",546,72,474,207,706,16886,1947,2011,1303,50,8,0,142,0,65,474,130
2015,36081027000,"Census Tract 270, Queens County, New York",540,48,492,191,847,17863,1943,2011,1454,50,2,0,149,2,40,492,103
2016,36081027000,"Census Tract 270, Queens County, New York",540,76,464,154,738,16667,1939,2011,1257,50,2,0,108,2,44,464,112
2017,36081027000,"Census Tract 270, Queens County, New York",539,103,436,170,908,18421,1939,2011,1417,50,6,0,127,6,37,436,113
2018,36081027000,"Census Tract 270, Queens County, New York",539,81,458,157,787,19375,1942,2012,1528,51,14,0,136,4,17,458,94
2019,36081027000,"Census Tract 270, Queens County, New York",538,67,471,140,687,NA,1953,2011,1767,25.4,28,0,128,6,0,471,60
2020,36081027000,"Census Tract 270, Queens County, New York",499,92,407,91,410,100547,1948,2011,1625,18.9,21,0,86,0,0,407,25
2012,36081027100,"Census Tract 271, Queens County, New York",2842,67,2775,2339,7174,35021,1945,2003,1212,40.5,414,164,105,896,1189,2775,609
2013,36081027100,"Census Tract 271, Queens County, New York",2797,35,2762,2283,6900,48867,1945,2003,1232,33.9,452,163,118,886,1108,2762,551
2014,36081027100,"Census Tract 271, Queens County, New York",2819,31,2788,2157,6389,53092,1945,2006,1261,33.1,551,115,84,891,965,2788,504
2015,36081027100,"Census Tract 271, Queens County, New York",2850,67,2783,2070,5906,43092,1945,2007,1262,34.2,531,162,77,851,904,2783,639
2016,36081027100,"Census Tract 271, Queens County, New York",2881,206,2675,1994,5934,39773,1944,2008,1322,35.3,499,155,60,810,895,2675,556
2017,36081027100,"Census Tract 271, Queens County, New York",2843,191,2652,1950,6185,54265,1944,2010,1377,27.8,507,152,48,819,886,2652,615
2018,36081027100,"Census Tract 271, Queens County, New York",2827,201,2626,1942,6150,53689,1946,2011,1431,29.3,536,129,52,820,906,2626,614
2019,36081027100,"Census Tract 271, Queens County, New York",2793,183,2610,1965,6511,54137,1947,2011,1456,29.1,514,162,52,717,1057,2610,562
2020,36081027101,"Census Tract 271.01, Queens County, New York",2103,101,2002,1317,4184,50791,1957,2015,1654,31.3,533,55,12,773,477,2002,354
2020,36081027102,"Census Tract 271.02, Queens County, New York",1029,0,1029,952,3036,65500,1941,2005,1302,28.6,141,89,42,68,779,1029,188
2012,36081027200,"Census Tract 272, Queens County, New York",601,0,601,226,472,37308,1939,2003,1128,34,13,0,226,0,0,601,115
2013,36081027200,"Census Tract 272, Queens County, New York",604,0,604,192,409,85250,1939,2003,1241,19.2,9,0,192,0,0,604,65
2014,36081027200,"Census Tract 272, Queens County, New York",601,0,601,230,766,41688,1939,2006,1230,29.1,6,0,230,0,0,601,68
2015,36081027200,"Census Tract 272, Queens County, New York",600,0,600,199,664,38750,1939,2003,1131,46.4,7,0,199,0,0,600,69
2016,36081027200,"Census Tract 272, Queens County, New York",604,15,589,205,665,39531,1939,2005,1154,45,34,0,205,0,0,589,67
2017,36081027200,"Census Tract 272, Queens County, New York",591,11,580,212,673,39429,1939,2006,1221,45.5,26,0,212,0,0,580,51
2018,36081027200,"Census Tract 272, Queens County, New York",608,12,596,254,772,39000,0,2006,1361,51,36,0,239,0,15,596,56
2019,36081027200,"Census Tract 272, Queens County, New York",623,27,596,200,456,35093,0,2008,1404,51,60,0,181,0,19,596,24
2020,36081027200,"Census Tract 272, Queens County, New York",614,19,595,202,609,37014,0,2013,1473,51,75,0,172,0,30,595,16
2012,36081027300,"Census Tract 273, Queens County, New York",2472,24,2448,2038,6581,31834,1949,2002,1162,40.9,184,93,48,123,1670,2448,516
2013,36081027300,"Census Tract 273, Queens County, New York",2518,54,2464,2048,7098,37611,1950,2003,1206,39.2,157,69,40,100,1760,2464,564
2014,36081027300,"Census Tract 273, Queens County, New York",2507,101,2406,2063,7086,37379,1951,2004,1245,38,153,96,52,108,1718,2406,614
2015,36081027300,"Census Tract 273, Queens County, New York",2592,120,2472,2096,7061,37227,1951,2006,1234,39.1,173,95,55,115,1745,2472,635
2016,36081027300,"Census Tract 273, Queens County, New York",2600,192,2408,2094,7046,41102,1951,2008,1305,37.7,181,85,44,173,1774,2408,497
2017,36081027300,"Census Tract 273, Queens County, New York",2655,369,2286,1932,6567,46865,1949,2007,1362,36.7,156,80,57,217,1606,2286,379
2018,36081027300,"Census Tract 273, Queens County, New York",2642,391,2251,1934,5651,47627,1948,2008,1394,36.2,201,63,87,181,1624,2251,244
2019,36081027300,"Census Tract 273, Queens County, New York",2684,362,2322,2011,6044,47025,1948,2008,1479,38,256,61,77,263,1644,2322,207
2020,36081027301,"Census Tract 273.01, Queens County, New York",934,172,762,695,2327,41984,1943,2014,1518,39.8,10,0,0,59,636,762,187
2020,36081027302,"Census Tract 273.02, Queens County, New York",1539,77,1462,1234,3852,46429,1949,2006,1474,38.7,258,63,54,155,1001,1462,257
2012,36081027400,"Census Tract 274, Queens County, New York",622,28,594,196,633,43438,1956,2006,1216,28.3,48,0,165,0,57,594,66
2013,36081027400,"Census Tract 274, Queens County, New York",606,52,554,182,650,44444,1956,2008,1165,37.5,21,0,137,0,28,554,69
2014,36081027400,"Census Tract 274, Queens County, New York",600,53,547,158,540,47024,1951,2009,1139,32.5,9,0,114,0,23,547,72
2015,36081027400,"Census Tract 274, Queens County, New York",588,59,529,127,419,52946,1966,2011,1221,30.5,0,0,83,0,38,529,17
2016,36081027400,"Census Tract 274, Queens County, New York",589,57,532,134,416,53000,1966,2011,1293,29.4,14,0,96,0,23,532,29
2017,36081027400,"Census Tract 274, Queens County, New York",600,54,546,97,318,54297,1968,2011,1168,27.8,2,0,81,0,0,546,15
2018,36081027400,"Census Tract 274, Queens County, New York",616,40,576,109,289,NA,1971,2014,1545,43.9,20,0,109,0,0,576,53
2019,36081027400,"Census Tract 274, Queens County, New York",622,39,583,106,259,NA,1971,2014,1411,41.8,5,0,106,0,0,583,58
2020,36081027400,"Census Tract 274, Queens County, New York",661,40,621,70,162,NA,1962,2017,1643,44.3,19,0,70,0,0,621,93
2012,36081027500,"Census Tract 275, Queens County, New York",2270,131,2139,1031,3462,51771,1950,2001,1266,34.4,130,69,0,117,845,2139,388
2013,36081027500,"Census Tract 275, Queens County, New York",2296,90,2206,1191,4120,52348,1952,2002,1327,34.9,72,79,0,59,1053,2206,416
2014,36081027500,"Census Tract 275, Queens County, New York",2314,119,2195,1291,4382,38750,1952,2003,1351,40.7,118,90,17,106,1095,2195,357
2015,36081027500,"Census Tract 275, Queens County, New York",2319,134,2185,1542,5582,55000,1951,2003,1328,33.5,139,92,19,130,1320,2185,353
2016,36081027500,"Census Tract 275, Queens County, New York",2248,116,2132,1474,5153,53192,1952,2006,1345,32.6,142,77,22,82,1315,2132,297
2017,36081027500,"Census Tract 275, Queens County, New York",2205,170,2035,1377,4491,50934,1953,2007,1349,31.2,106,33,21,72,1272,2035,236
2018,36081027500,"Census Tract 275, Queens County, New York",2179,194,1985,1291,4195,44548,1953,2009,1404,33.3,80,30,20,98,1163,1985,231
2019,36081027500,"Census Tract 275, Queens County, New York",2159,142,2017,1145,4142,53878,1953,2012,1488,31.1,31,54,0,82,1009,2017,275
2020,36081027500,"Census Tract 275, Queens County, New York",2289,142,2147,1190,3522,42750,1951,2013,1394,38.3,39,155,0,112,923,2147,240
2012,36081027600,"Census Tract 276, Queens County, New York",417,30,387,155,406,19547,1969,2005,1369,50,0,0,116,0,43,387,36
2013,36081027600,"Census Tract 276, Queens County, New York",419,23,396,189,468,21188,1967,2005,1434,50,0,0,142,0,51,396,51
2014,36081027600,"Census Tract 276, Queens County, New York",440,23,417,219,586,24659,1964,2006,1487,49.7,3,0,173,0,51,417,63
2015,36081027600,"Census Tract 276, Queens County, New York",431,31,400,147,333,37614,1963,2007,1520,34.6,8,0,123,0,45,400,52
2016,36081027600,"Census Tract 276, Queens County, New York",427,33,394,159,346,28229,1965,2006,1608,40.4,8,0,132,0,43,394,42
2017,36081027600,"Census Tract 276, Queens County, New York",424,36,388,163,356,NA,1964,2006,1566,34.9,10,0,134,0,44,388,52
2018,36081027600,"Census Tract 276, Queens County, New York",433,17,416,132,334,40476,1959,2008,1313,45.5,12,0,114,0,37,416,33
2019,36081027600,"Census Tract 276, Queens County, New York",435,15,420,118,218,47500,1966,2008,1375,45,6,0,118,0,18,420,23
2020,36081027600,"Census Tract 276, Queens County, New York",425,12,413,74,152,53375,2001,2013,1650,46.8,0,0,72,0,2,413,34
2012,36081027700,"Census Tract 277, Queens County, New York",2965,137,2828,2028,5890,34079,1945,2003,1191,41.4,466,245,31,289,1404,2828,561
2013,36081027700,"Census Tract 277, Queens County, New York",2935,225,2710,2035,5928,33581,1948,2003,1169,41,445,214,49,241,1501,2710,558
2014,36081027700,"Census Tract 277, Queens County, New York",3018,237,2781,2134,6159,36577,1948,2003,1222,38.4,405,260,88,236,1518,2781,504
2015,36081027700,"Census Tract 277, Queens County, New York",3074,213,2861,2160,6117,34637,1951,2004,1241,39.1,375,268,88,211,1572,2861,493
2016,36081027700,"Census Tract 277, Queens County, New York",3107,164,2943,2248,6432,38315,1952,2004,1286,38.3,360,229,97,173,1727,2943,422
2017,36081027700,"Census Tract 277, Queens County, New York",3142,192,2950,2180,6764,44631,1950,2006,1383,37.1,336,259,101,171,1624,2950,411
2018,36081027700,"Census Tract 277, Queens County, New York",3088,148,2940,2112,6416,46000,1952,2009,1454,36.3,227,202,54,135,1710,2940,412
2019,36081027700,"Census Tract 277, Queens County, New York",3135,223,2912,2081,6059,48750,1949,2011,1517,37.2,208,170,15,194,1678,2912,452
2020,36081027701,"Census Tract 277.01, Queens County, New York",1258,0,1258,964,2825,53980,0,2010,1431,29.5,52,34,0,95,835,1258,197
2020,36081027702,"Census Tract 277.02, Queens County, New York",1730,126,1604,1083,3153,51180,1950,2013,1548,36.2,153,76,15,161,831,1604,218
2012,36081027800,"Census Tract 278, Queens County, New York",849,26,823,632,1776,31800,1965,2000,583,27.5,69,0,502,0,117,823,241
2013,36081027800,"Census Tract 278, Queens County, New York",855,5,850,627,1861,30272,1965,2000,654,28.4,58,0,499,0,107,850,232
2014,36081027800,"Census Tract 278, Queens County, New York",862,19,843,604,1690,32308,1965,1998,655,26.3,57,0,496,0,112,843,183
2015,36081027800,"Census Tract 278, Queens County, New York",843,8,835,607,1701,29250,1964,1998,639,27.3,69,0,509,5,76,835,183
2016,36081027800,"Census Tract 278, Queens County, New York",862,20,842,606,1657,22717,1964,1999,668,30.1,47,0,498,5,83,842,207
2017,36081027800,"Census Tract 278, Queens County, New York",863,19,844,594,1631,25114,1964,2000,721,30.5,34,0,505,5,62,844,200
2018,36081027800,"Census Tract 278, Queens County, New York",865,19,846,609,1645,29886,1963,2001,732,23.5,45,0,528,6,58,846,215
2019,36081027800,"Census Tract 278, Queens County, New York",890,18,872,634,1636,28676,1963,1998,737,27,57,0,538,5,69,872,240
2020,36081027800,"Census Tract 278, Queens County, New York",908,18,890,636,1508,26500,1964,2001,730,28,50,0,540,0,96,890,263
2012,36081027900,"Census Tract 279, Queens County, New York",2485,126,2359,1610,4791,41129,1943,2002,1181,33.4,185,171,27,196,1220,2359,434
2013,36081027900,"Census Tract 279, Queens County, New York",2448,128,2320,1480,4550,39032,1941,2003,1249,33.9,213,146,76,188,1100,2320,442
2014,36081027900,"Census Tract 279, Queens County, New York",2453,144,2309,1294,3558,34583,1944,2004,1271,40.4,160,94,68,204,930,2309,389
2015,36081027900,"Census Tract 279, Queens County, New York",2471,120,2351,1338,4026,45943,1946,2005,1371,34.1,263,168,81,179,882,2351,317
2016,36081027900,"Census Tract 279, Queens County, New York",2458,154,2304,1356,4513,54559,1951,2005,1395,30.8,262,212,86,168,898,2304,211
2017,36081027900,"Census Tract 279, Queens County, New York",2513,180,2333,1461,4304,46116,1947,2005,1358,36.6,391,196,71,127,1077,2333,255
2018,36081027900,"Census Tract 279, Queens County, New York",2586,180,2406,1540,4212,45486,1949,2005,1372,38.1,435,244,49,112,1136,2406,273
2019,36081027900,"Census Tract 279, Queens County, New York",2611,186,2425,1596,4181,44452,1949,2003,1376,39.4,436,250,59,95,1189,2425,431
2020,36081027900,"Census Tract 279, Queens County, New York",2507,174,2333,1556,4081,49435,1947,2000,1435,39,274,219,59,13,1292,2333,366
2012,36081028000,"Census Tract 280, Queens County, New York",552,117,435,110,371,45875,1945,2005,1265,27.8,0,0,91,0,19,435,21
2013,36081028000,"Census Tract 280, Queens County, New York",552,90,462,143,431,48869,1947,2008,1258,27.9,16,0,117,0,22,462,26
2014,36081028000,"Census Tract 280, Queens County, New York",551,120,431,117,355,62614,1950,2011,1308,28.3,16,0,91,0,22,431,5
2015,36081028000,"Census Tract 280, Queens County, New York",547,64,483,129,340,41583,1955,2012,1285,28.9,43,0,100,0,41,483,5
2016,36081028000,"Census Tract 280, Queens County, New York",530,54,476,137,354,41875,1956,2012,1287,30.7,39,0,119,0,27,476,5
2017,36081028000,"Census Tract 280, Queens County, New York",537,52,485,123,300,45250,1957,2013,1295,31.6,41,0,118,0,16,485,6
2018,36081028000,"Census Tract 280, Queens County, New York",542,63,479,149,321,42426,1956,2014,1314,36.4,38,0,149,0,20,479,18
2019,36081028000,"Census Tract 280, Queens County, New York",538,39,499,180,390,43833,1953,2015,1300,35.3,35,0,180,0,22,499,31
2020,36081028000,"Census Tract 280, Queens County, New York",527,43,484,218,519,46250,1950,2013,1322,35.4,27,0,202,16,7,484,67
2012,36081028100,"Census Tract 281, Queens County, New York",2516,180,2336,1547,3743,47807,1943,2001,1181,33.3,381,353,47,44,1165,2336,301
2013,36081028100,"Census Tract 281, Queens County, New York",2460,132,2328,1455,3369,48063,1939,1999,1170,28.9,436,387,26,44,1035,2328,242
2014,36081028100,"Census Tract 281, Queens County, New York",2499,164,2335,1631,3500,46188,1942,2002,1256,33.6,591,401,18,88,1153,2335,260
2015,36081028100,"Census Tract 281, Queens County, New York",2539,258,2281,1474,2950,43978,1942,2001,1269,36.9,489,308,9,90,1079,2281,227
2016,36081028100,"Census Tract 281, Queens County, New York",2567,388,2179,1396,3002,44495,1940,2000,1273,37,388,286,10,115,982,2179,105
2017,36081028100,"Census Tract 281, Queens County, New York",2577,334,2243,1511,3098,44929,1939,2001,1324,37.5,426,344,9,155,961,2243,160
2018,36081028100,"Census Tract 281, Queens County, New York",2596,379,2217,1530,3441,47065,1941,2004,1450,36.7,370,285,8,137,1059,2217,163
2019,36081028100,"Census Tract 281, Queens County, New York",2609,434,2175,1394,3464,48029,0,2003,1531,33.9,260,268,13,93,939,2175,205
2020,36081028100,"Census Tract 281, Queens County, New York",2597,304,2293,1312,3305,53598,0,2002,1623,33,217,211,6,51,971,2293,265
2012,36081028200,"Census Tract 282, Queens County, New York",507,36,471,182,500,49583,1942,2003,1584,34.5,33,0,182,0,0,471,50
2013,36081028200,"Census Tract 282, Queens County, New York",523,33,490,137,440,49345,1946,2003,1568,35.2,0,0,137,0,0,490,20
2014,36081028200,"Census Tract 282, Queens County, New York",537,36,501,141,429,32917,1943,2003,1561,50,0,0,141,0,0,501,43
2015,36081028200,"Census Tract 282, Queens County, New York",539,25,514,171,528,NA,1943,2005,1652,45,15,0,171,0,6,514,43
2016,36081028200,"Census Tract 282, Queens County, New York",536,10,526,169,523,65089,1942,2010,1491,34.8,20,0,164,0,11,526,45
2017,36081028200,"Census Tract 282, Queens County, New York",532,22,510,171,487,52431,1941,2010,1585,40.9,23,0,165,0,10,510,21
2018,36081028200,"Census Tract 282, Queens County, New York",550,20,530,166,454,55714,0,2009,1595,41.2,24,4,157,0,7,530,48
2019,36081028200,"Census Tract 282, Queens County, New York",554,26,528,186,602,58500,0,2011,1707,40.6,16,4,166,0,8,528,56
2020,36081028200,"Census Tract 282, Queens County, New York",539,15,524,238,837,NA,1944,2012,1752,51,22,4,217,0,6,524,53
2012,36081028300,"Census Tract 283, Queens County, New York",3153,131,3022,2122,4914,46708,1939,2002,1263,33.7,501,579,87,263,1234,3022,548
2013,36081028300,"Census Tract 283, Queens County, New York",3143,103,3040,2059,4668,49688,1939,2003,1280,34.1,535,559,106,280,1170,3040,506
2014,36081028300,"Census Tract 283, Queens County, New York",3199,101,3098,2141,4888,47246,1939,2003,1328,35.4,570,572,104,278,1271,3098,510
2015,36081028300,"Census Tract 283, Queens County, New York",3312,10,3302,2321,5504,54384,1939,2003,1361,31.4,641,593,117,283,1425,3302,414
2016,36081028300,"Census Tract 283, Queens County, New York",3302,66,3236,2198,5586,56944,1942,2006,1422,31.6,692,627,104,344,1164,3236,428
2017,36081028300,"Census Tract 283, Queens County, New York",3356,77,3279,2302,5940,58806,1941,2005,1560,33.5,708,528,99,401,1315,3279,346
2018,36081028300,"Census Tract 283, Queens County, New York",3331,159,3172,2165,5584,61969,1941,2008,1578,32,756,499,60,349,1246,3172,374
2019,36081028300,"Census Tract 283, Queens County, New York",3365,204,3161,2130,5429,64531,1943,2008,1687,32.4,726,517,60,259,1273,3161,388
2020,36081028300,"Census Tract 283, Queens County, New York",3319,164,3155,2253,5473,65573,1944,2008,1749,32.8,844,513,83,224,1209,3155,468
2012,36081028400,"Census Tract 284, Queens County, New York",1091,133,958,375,1190,58967,1956,2003,1380,37.4,43,0,313,0,39,958,107
2013,36081028400,"Census Tract 284, Queens County, New York",1117,76,1041,452,1502,74318,1974,2004,1570,30.4,43,0,389,0,39,1041,95
2014,36081028400,"Census Tract 284, Queens County, New York",1150,47,1103,457,1651,59025,1968,2006,1637,37,29,0,393,0,39,1103,225
2015,36081028400,"Census Tract 284, Queens County, New York",1169,64,1105,434,1629,56875,1964,2006,1625,34.2,28,0,386,0,40,1105,227
2016,36081028400,"Census Tract 284, Queens County, New York",1165,62,1103,392,1513,52105,1965,2008,1675,33.8,27,0,369,0,15,1103,189
2017,36081028400,"Census Tract 284, Queens County, New York",1195,61,1134,390,1502,54375,1963,2010,1768,34,8,0,363,0,0,1134,180
2018,36081028400,"Census Tract 284, Queens County, New York",1241,53,1188,345,1267,53681,1960,2010,1717,36.1,31,0,278,0,23,1188,208
2019,36081028400,"Census Tract 284, Queens County, New York",1228,39,1189,323,1048,61750,1955,2009,1720,31.4,44,0,240,0,29,1189,76
2020,36081028400,"Census Tract 284, Queens County, New York",1259,18,1241,494,1264,65113,1953,2011,1637,32.3,53,0,426,0,27,1241,52
2012,36081028500,"Census Tract 285, Queens County, New York",2267,244,2023,949,2073,34866,1939,2003,1178,38.7,296,310,0,67,560,2023,295
2013,36081028500,"Census Tract 285, Queens County, New York",2274,145,2129,1019,2142,48493,1942,2004,1275,33.9,439,312,17,56,622,2129,246
2014,36081028500,"Census Tract 285, Queens County, New York",2325,149,2176,1189,2765,41250,1943,2004,1332,34.8,570,308,16,148,733,2176,325
2015,36081028500,"Census Tract 285, Queens County, New York",2362,114,2248,1309,3115,51339,1939,2004,1365,33,560,327,16,133,794,2248,368
2016,36081028500,"Census Tract 285, Queens County, New York",2323,111,2212,1247,2962,41020,1939,2006,1380,37.3,599,357,17,148,733,2212,366
2017,36081028500,"Census Tract 285, Queens County, New York",2253,146,2107,1184,2857,34741,1939,2004,1383,35,499,372,16,149,625,2107,365
2018,36081028500,"Census Tract 285, Queens County, New York",2239,150,2089,1156,2687,34286,0,2006,1359,44,357,223,0,286,626,2089,401
2019,36081028500,"Census Tract 285, Queens County, New York",2210,165,2045,1107,2706,48558,0,2006,1447,34.4,257,221,0,261,613,2045,315
2020,36081028500,"Census Tract 285, Queens County, New York",2108,119,1989,1090,2736,52581,0,2010,1444,34.5,256,288,0,236,566,1989,222
2012,36081028700,"Census Tract 287, Queens County, New York",2821,209,2612,1761,4089,37688,1939,2001,1188,39.2,460,579,13,439,715,2612,589
2013,36081028700,"Census Tract 287, Queens County, New York",2871,270,2601,1783,4215,40272,1941,2001,1181,37,453,576,13,426,757,2601,571
2014,36081028700,"Census Tract 287, Queens County, New York",2892,289,2603,1744,4097,34677,1939,2002,1192,38.3,417,572,33,355,801,2603,554
2015,36081028700,"Census Tract 287, Queens County, New York",2883,242,2641,1751,4092,51528,1943,2002,1226,33.1,480,564,16,358,829,2641,437
2016,36081028700,"Census Tract 287, Queens County, New York",2890,309,2581,1764,4428,60486,1948,2003,1266,30.3,485,628,17,339,797,2581,315
2017,36081028700,"Census Tract 287, Queens County, New York",2934,295,2639,1747,4512,60348,1951,2005,1301,30.3,570,585,18,276,886,2639,267
2018,36081028700,"Census Tract 287, Queens County, New York",2914,238,2676,1742,4407,62698,1949,2007,1390,31.3,573,642,19,300,784,2676,311
2019,36081028700,"Census Tract 287, Queens County, New York",2914,218,2696,1813,4591,64665,1949,2005,1403,27.4,566,632,0,386,779,2696,346
2020,36081028700,"Census Tract 287, Queens County, New York",3083,168,2915,1866,4602,58875,1953,2008,1362,28.7,805,656,0,345,642,2915,469
2012,36081028800,"Census Tract 288, Queens County, New York",1406,261,1145,417,1227,38750,1955,2004,1378,34.2,35,0,352,0,73,1145,96
2013,36081028800,"Census Tract 288, Queens County, New York",1425,271,1154,438,1370,38833,1952,2005,1393,42.9,57,0,316,0,90,1154,79
2014,36081028800,"Census Tract 288, Queens County, New York",1470,258,1212,347,1083,40368,1952,2007,1528,45.2,74,0,262,0,60,1212,68
2015,36081028800,"Census Tract 288, Queens County, New York",1476,152,1324,406,1291,33689,1952,2006,1455,48.9,76,0,282,0,96,1324,116
2016,36081028800,"Census Tract 288, Queens County, New York",1471,134,1337,392,1283,34511,1958,2007,1445,45.3,93,0,225,0,119,1337,111
2017,36081028800,"Census Tract 288, Queens County, New York",1491,113,1378,365,1230,42560,1957,2005,1480,42.3,61,0,194,0,65,1378,113
2018,36081028800,"Census Tract 288, Queens County, New York",1521,103,1418,351,1104,51625,1957,2007,1640,37,65,0,226,0,52,1418,119
2019,36081028800,"Census Tract 288, Queens County, New York",1522,129,1393,400,1160,40395,1952,2009,1686,34.2,46,0,280,0,53,1393,158
2020,36081028801,"Census Tract 288.01, Queens County, New York",782,64,718,230,733,66711,1947,2012,1798,27.1,43,0,186,0,0,718,56
2020,36081028802,"Census Tract 288.02, Queens County, New York",686,70,616,124,525,56983,1994,2014,1732,34.1,0,0,45,0,61,616,74
2020,36081028803,"Census Tract 288.03, Queens County, New York",0,0,0,0,0,NA,NA,NA,NA,NA,0,0,0,0,0,0,0
2012,36081028900,"Census Tract 289, Queens County, New York",2231,82,2149,1752,4150,45595,1945,2002,1276,34.2,609,502,78,458,759,2149,229
2013,36081028900,"Census Tract 289, Queens County, New York",2203,58,2145,1775,4261,46820,1946,2004,1315,33.9,763,456,62,489,797,2145,285
2014,36081028900,"Census Tract 289, Queens County, New York",2201,30,2171,1797,4463,48729,1947,2005,1374,33.5,747,495,64,503,734,2171,263
2015,36081028900,"Census Tract 289, Queens County, New York",2197,28,2169,1775,4563,52011,1949,2007,1420,36.9,754,586,82,467,637,2169,270
2016,36081028900,"Census Tract 289, Queens County, New York",2199,161,2038,1574,3951,60590,1948,2008,1439,31.6,615,531,61,342,627,2038,178
2017,36081028900,"Census Tract 289, Queens County, New York",2206,132,2074,1522,4020,63148,1948,2009,1455,29.3,610,633,52,277,532,2074,150
2018,36081028900,"Census Tract 289, Queens County, New York",2212,140,2072,1502,4067,64878,1952,2011,1617,29.5,554,700,51,283,439,2072,128
2019,36081028900,"Census Tract 289, Queens County, New York",2222,211,2011,1375,3875,63508,1951,2012,1653,32.7,534,602,51,248,474,2011,100
2020,36081028900,"Census Tract 289, Queens County, New York",2042,212,1830,1263,3972,68101,1952,2011,1641,29.5,577,609,27,236,391,1830,99
2012,36081029100,"Census Tract 291, Queens County, New York",2450,226,2224,1524,4156,44263,1945,2004,1287,36.1,705,334,39,696,442,2224,495
2013,36081029100,"Census Tract 291, Queens County, New York",2506,188,2318,1634,4616,36566,1949,2004,1335,39.4,736,356,0,760,503,2318,573
2014,36081029100,"Census Tract 291, Queens County, New York",2554,202,2352,1642,4483,32021,1945,2005,1348,44.7,688,310,0,771,546,2352,562
2015,36081029100,"Census Tract 291, Queens County, New York",2564,187,2377,1690,4616,29167,1946,2006,1350,47.2,649,288,13,767,607,2377,557
2016,36081029100,"Census Tract 291, Queens County, New York",2573,195,2378,1606,4106,30285,1943,2006,1345,49.1,491,276,14,738,559,2378,468
2017,36081029100,"Census Tract 291, Queens County, New York",2556,268,2288,1626,4494,37647,1946,2006,1395,42.9,491,302,33,778,525,2288,346
2018,36081029100,"Census Tract 291, Queens County, New York",2490,264,2226,1489,3820,41145,1948,2009,1397,40.5,405,245,67,671,509,2226,253
2019,36081029100,"Census Tract 291, Queens County, New York",2461,260,2201,1468,4083,53333,1953,2011,1479,34.4,527,225,73,692,468,2201,215
2020,36081029100,"Census Tract 291, Queens County, New York",2470,246,2224,1580,4593,56265,1955,2011,1559,35.1,534,324,49,766,435,2224,127
2012,36081029300,"Census Tract 293, Queens County, New York",364,9,355,239,1069,60809,1963,1996,1704,35.8,78,17,0,52,119,355,34
2013,36081029300,"Census Tract 293, Queens County, New York",329,10,319,193,740,60292,1965,1997,1577,35.9,70,20,0,42,101,319,17
2014,36081029300,"Census Tract 293, Queens County, New York",377,20,357,196,621,58426,1964,2000,1529,34.7,68,15,0,68,85,357,18
2015,36081029300,"Census Tract 293, Queens County, New York",366,29,337,169,547,37656,1970,2007,1385,44.6,54,14,0,110,45,337,23
2016,36081029300,"Census Tract 293, Queens County, New York",356,23,333,151,394,48125,1971,2008,1533,30.9,67,27,0,101,23,333,14
2017,36081029300,"Census Tract 293, Queens County, New York",353,22,331,148,438,49000,1965,2008,1509,32.8,56,19,0,111,18,331,16
2018,36081029300,"Census Tract 293, Queens County, New York",356,43,313,174,570,60893,1971,2009,1649,27.9,46,38,0,117,19,313,16
2019,36081029300,"Census Tract 293, Queens County, New York",352,35,317,178,616,64688,2000,2012,1573,24.1,42,40,0,102,36,317,16
2020,36081029300,"Census Tract 293, Queens County, New York",367,27,340,207,748,61494,1949,2012,1964,40.5,59,74,0,107,26,340,24
2012,36081029400,"Census Tract 294, Queens County, New York",2298,145,2153,1047,3315,49199,1966,2004,1202,26.2,302,5,974,50,18,2153,277
2013,36081029400,"Census Tract 294, Queens County, New York",2357,158,2199,982,3053,48721,1966,2004,1157,26.7,236,4,904,30,44,2199,230
2014,36081029400,"Census Tract 294, Queens County, New York",2429,127,2302,802,2531,54194,1966,2006,1122,25.7,263,6,725,25,46,2302,166
2015,36081029400,"Census Tract 294, Queens County, New York",2487,163,2324,727,1869,56034,1968,2007,1196,23.3,242,7,678,0,42,2324,148
2016,36081029400,"Census Tract 294, Queens County, New York",2517,160,2357,725,1767,46952,1970,2010,1284,27.2,127,0,644,40,101,2357,152
2017,36081029400,"Census Tract 294, Queens County, New York",2522,149,2373,995,2103,45987,1966,2010,1269,28.5,146,0,917,40,95,2373,152
2018,36081029400,"Census Tract 294, Queens County, New York",2586,273,2313,1051,2176,52450,1966,2011,1456,28.1,197,0,976,40,79,2313,165
2019,36081029400,"Census Tract 294, Queens County, New York",2594,311,2283,1179,2500,51550,1968,2012,1594,29.2,221,0,1090,40,113,2283,191
2020,36081029400,"Census Tract 294, Queens County, New York",2597,337,2260,1354,2920,61188,1965,2010,1705,32.1,196,0,1301,38,106,2260,184
2012,36081029500,"Census Tract 295, Queens County, New York",1710,119,1591,744,1653,39015,1939,2003,1229,39.4,233,300,30,168,244,1591,262
2013,36081029500,"Census Tract 295, Queens County, New York",1706,83,1623,734,1767,53333,1939,2003,1259,30.7,219,269,24,167,289,1623,205
2014,36081029500,"Census Tract 295, Queens County, New York",1715,109,1606,713,1756,54028,1939,2004,1239,32,194,306,18,155,234,1606,203
2015,36081029500,"Census Tract 295, Queens County, New York",1755,144,1611,593,1477,59861,1942,2006,1359,29.6,146,258,10,85,240,1611,136
2016,36081029500,"Census Tract 295, Queens County, New York",1725,96,1629,599,1336,60074,1939,2007,1350,32.5,172,286,0,78,235,1629,98
2017,36081029500,"Census Tract 295, Queens County, New York",1752,164,1588,568,1332,63333,1939,2011,1537,33.5,204,230,0,129,209,1588,56
2018,36081029500,"Census Tract 295, Queens County, New York",1745,143,1602,643,1567,67870,0,2011,1561,34.6,219,245,0,158,231,1602,96
2019,36081029500,"Census Tract 295, Queens County, New York",1734,110,1624,619,1526,68357,0,2011,1638,32.7,202,175,0,198,219,1624,106
2020,36081029500,"Census Tract 295, Queens County, New York",1737,113,1624,714,1902,70597,0,2011,1653,32.4,221,192,0,206,253,1624,138
2012,36081029700,"Census Tract 297, Queens County, New York",751,19,732,394,1007,64697,1964,2006,1627,29.9,273,167,39,108,62,732,75
2013,36081029700,"Census Tract 297, Queens County, New York",741,33,708,382,1111,61833,1957,2006,1599,26.9,183,143,24,81,120,708,109
2014,36081029700,"Census Tract 297, Queens County, New York",750,42,708,463,1366,60966,1961,2006,1532,27.5,203,199,25,89,134,708,141
2015,36081029700,"Census Tract 297, Queens County, New York",757,31,726,467,1409,52228,1961,2007,1497,27.6,161,205,25,75,157,726,167
2016,36081029700,"Census Tract 297, Queens County, New York",763,28,735,434,1358,53500,1962,2009,1523,30,124,185,14,65,147,735,134
2017,36081029700,"Census Tract 297, Queens County, New York",703,41,662,364,1218,53571,1963,2009,1593,37.2,82,178,5,30,136,662,106
2018,36081029700,"Census Tract 297, Queens County, New York",692,42,650,279,836,49226,1964,2011,1615,39.3,75,120,6,28,109,650,75
2019,36081029700,"Census Tract 297, Queens County, New York",713,44,669,323,1011,57469,1970,2013,1821,37.4,95,74,5,37,199,669,52
2020,36081029700,"Census Tract 297, Queens County, New York",690,46,644,293,958,56648,1977,2015,1907,39.4,78,74,5,41,165,644,19
2012,36081029900,"Census Tract 299, Queens County, New York",0,0,0,0,0,NA,NA,NA,NA,NA,0,0,0,0,0,0,0
2013,36081029900,"Census Tract 299, Queens County, New York",0,0,0,0,0,NA,NA,NA,NA,NA,0,0,0,0,0,0,0
2014,36081029900,"Census Tract 299, Queens County, New York",0,0,0,0,0,NA,NA,NA,NA,NA,0,0,0,0,0,0,0
2015,36081029900,"Census Tract 299, Queens County, New York",0,0,0,0,0,NA,NA,NA,NA,NA,0,0,0,0,0,0,0
2016,36081029900,"Census Tract 299, Queens County, New York",0,0,0,0,0,NA,NA,NA,NA,NA,0,0,0,0,0,0,0
2017,36081029900,"Census Tract 299, Queens County, New York",0,0,0,0,0,NA,NA,NA,NA,NA,0,0,0,0,0,0,0
2018,36081029900,"Census Tract 299, Queens County, New York",0,0,0,0,0,NA,NA,NA,NA,NA,0,0,0,0,0,0,0
2019,36081029900,"Census Tract 299, Queens County, New York",0,0,0,0,0,NA,NA,NA,NA,NA,0,0,0,0,0,0,0
2020,36081029900,"Census Tract 299, Queens County, New York",0,0,0,0,0,NA,NA,NA,NA,NA,0,0,0,0,0,0,0
2012,36081030600,"Census Tract 306, Queens County, New York",1347,142,1205,427,1341,66779,1987,2005,1776,30.9,79,0,415,0,40,1205,119
2013,36081030600,"Census Tract 306, Queens County, New York",1325,152,1173,406,1105,68241,1992,2007,1793,32,112,0,398,0,22,1173,120
2014,36081030600,"Census Tract 306, Queens County, New York",1338,167,1171,444,1376,64423,1989,2010,1723,27.3,134,0,411,0,51,1171,115
2015,36081030600,"Census Tract 306, Queens County, New York",1347,123,1224,503,1480,49275,1990,2010,1681,44.5,137,0,466,0,57,1224,124
2016,36081030600,"Census Tract 306, Queens County, New York",1354,124,1230,527,1683,39962,1990,2011,1575,48.1,121,7,456,0,79,1230,158
2017,36081030600,"Census Tract 306, Queens County, New York",1385,101,1284,517,1707,45486,1984,2011,1520,44.4,102,7,437,0,73,1284,159
2018,36081030600,"Census Tract 306, Queens County, New York",1408,95,1313,453,1564,41319,1981,2011,1479,45.6,87,9,367,0,70,1313,148
2019,36081030600,"Census Tract 306, Queens County, New York",1367,26,1341,386,1233,42115,1981,2011,1590,49,59,9,329,0,45,1341,124
2020,36081030600,"Census Tract 306, Queens County, New York",1320,16,1304,315,1147,62865,1977,2012,1678,33.6,41,9,268,0,33,1304,86
2012,36081030902,"Census Tract 309.02, Queens County, New York",2856,336,2520,1608,5402,43577,1959,2003,1295,36.3,305,357,14,648,590,2520,579
2013,36081030902,"Census Tract 309.02, Queens County, New York",2825,350,2475,1677,5580,48019,1957,2004,1456,35.5,405,387,14,644,647,2475,596
2014,36081030902,"Census Tract 309.02, Queens County, New York",2855,315,2540,1683,5169,48605,1958,2004,1439,33.9,467,384,14,625,625,2540,595
2015,36081030902,"Census Tract 309.02, Queens County, New York",2902,262,2640,1691,4668,36654,1960,2005,1434,35.2,457,438,52,461,694,2640,661
2016,36081030902,"Census Tract 309.02, Queens County, New York",2893,289,2604,1624,4557,34122,1959,2007,1515,43.2,405,389,61,500,614,2604,603
2017,36081030902,"Census Tract 309.02, Queens County, New York",2890,311,2579,1604,4497,40882,1960,2010,1492,39.3,382,343,46,562,593,2579,418
2018,36081030902,"Census Tract 309.02, Queens County, New York",2933,491,2442,1424,3814,35878,1962,2009,1485,40.7,297,350,68,483,486,2442,418
2019,36081030902,"Census Tract 309.02, Queens County, New York",2961,619,2342,1488,3928,33771,1963,2011,1574,49.3,211,265,119,549,541,2342,447
2012,36081030903,"Census Tract 309.03, Queens County, New York",1968,252,1716,759,2394,36517,1955,2003,1143,39.8,141,178,0,152,367,1716,284
2013,36081030903,"Census Tract 309.03, Queens County, New York",1990,258,1732,803,2794,42607,1954,2004,1370,35.9,130,151,0,157,413,1732,230
2014,36081030903,"Census Tract 309.03, Queens County, New York",2000,286,1714,900,3106,45068,1953,2006,1530,37.2,158,126,0,162,499,1714,320
2015,36081030903,"Census Tract 309.03, Queens County, New York",2050,304,1746,966,3330,44451,1954,2007,1497,37,221,170,29,193,554,1746,351
2016,36081030903,"Census Tract 309.03, Queens County, New York",2071,242,1829,1012,3123,48676,1954,2009,1547,36.6,277,126,35,204,639,1829,299
2017,36081030903,"Census Tract 309.03, Queens County, New York",2074,423,1651,859,2526,49044,1952,2010,1585,37.3,205,135,28,160,529,1651,247
2018,36081030903,"Census Tract 309.03, Queens County, New York",2117,425,1692,820,2571,52286,1952,2011,1731,39.1,177,122,26,150,523,1692,254
2019,36081030903,"Census Tract 309.03, Queens County, New York",2182,559,1623,782,2493,61162,1952,2012,1766,34.4,156,92,23,108,549,1623,133
2020,36081030903,"Census Tract 309.03, Queens County, New York",2332,629,1703,656,2009,62411,1950,2013,1822,33,142,61,7,88,460,1703,84
2012,36081030904,"Census Tract 309.04, Queens County, New York",1385,135,1250,775,2312,51681,1964,2003,1557,29.2,191,173,0,188,414,1250,231
2013,36081030904,"Census Tract 309.04, Queens County, New York",1306,151,1155,710,2128,41447,1975,2003,1435,31.7,185,153,0,227,330,1155,180
2014,36081030904,"Census Tract 309.04, Queens County, New York",1301,138,1163,819,2507,47926,1972,2004,1465,30.8,185,182,0,224,413,1163,169
2015,36081030904,"Census Tract 309.04, Queens County, New York",1299,180,1119,746,2475,44750,1963,2005,1527,29.6,123,172,9,213,352,1119,177
2016,36081030904,"Census Tract 309.04, Queens County, New York",1278,139,1139,639,1781,44688,1964,2006,1393,29,154,148,9,165,317,1139,207
2017,36081030904,"Census Tract 309.04, Queens County, New York",1325,218,1107,625,1583,44188,1964,2008,1372,31.3,106,177,9,109,330,1107,145
2018,36081030904,"Census Tract 309.04, Queens County, New York",1393,299,1094,659,1705,50644,1963,2010,1358,29,120,218,8,100,326,1094,156
2019,36081030904,"Census Tract 309.04, Queens County, New York",1391,422,969,555,1464,51314,1964,2011,1443,29,122,183,8,103,254,969,116
2020,36081030904,"Census Tract 309.04, Queens County, New York",1492,467,1025,629,1342,52104,1967,2014,1365,29.9,107,219,0,109,282,1025,144
2020,36081030905,"Census Tract 309.05, Queens County, New York",1313,283,1030,638,2059,87611,1964,2011,1878,27.6,94,38,51,233,301,1030,171
2020,36081030906,"Census Tract 309.06, Queens County, New York",1458,349,1109,791,2056,55893,1962,2010,1474,39.3,164,206,62,348,219,1109,184
2012,36081031700,"Census Tract 317, Queens County, New York",2690,262,2428,1028,2637,59318,1961,2003,1566,31.4,398,852,0,33,143,2428,288
2013,36081031700,"Census Tract 317, Queens County, New York",2724,299,2425,975,2386,51691,1955,2005,1595,35.3,323,762,0,81,132,2425,235
2014,36081031700,"Census Tract 317, Queens County, New York",2736,257,2479,1050,2529,60357,1956,2007,1632,31.4,391,795,0,78,163,2479,207
2015,36081031700,"Census Tract 317, Queens County, New York",2829,290,2539,1194,2818,53667,1957,2008,1637,33.3,379,885,0,80,215,2539,220
2016,36081031700,"Census Tract 317, Queens County, New York",2807,409,2398,1089,2517,51651,1956,2009,1679,34.4,259,824,0,70,181,2398,177
2017,36081031700,"Census Tract 317, Queens County, New York",2835,403,2432,1066,2643,59181,1959,2010,1740,33.4,329,788,18,66,197,2432,171
2018,36081031700,"Census Tract 317, Queens County, New York",2831,545,2286,937,2253,68477,1961,2008,1702,32.7,346,775,19,23,124,2286,141
2019,36081031700,"Census Tract 317, Queens County, New York",2880,658,2222,835,1951,54458,1961,2007,1691,38,297,711,30,29,95,2222,158
2020,36081031700,"Census Tract 317, Queens County, New York",2945,872,2073,843,2101,70772,1965,2011,1815,31.9,403,747,24,14,82,2073,65
2012,36081032000,"Census Tract 320, Queens County, New York",1057,122,935,262,1061,60750,1975,2004,1757,32.1,49,0,255,7,0,935,103
2013,36081032000,"Census Tract 320, Queens County, New York",1081,83,998,313,1204,56302,1976,2005,1718,31.7,61,0,305,8,0,998,87
2014,36081032000,"Census Tract 320, Queens County, New York",1074,55,1019,267,918,62063,1976,2005,1348,26.6,40,0,259,8,0,1019,45
2015,36081032000,"Census Tract 320, Queens County, New York",1095,37,1058,330,1237,63207,1974,2008,1476,28.4,33,0,321,9,0,1058,64
2016,36081032000,"Census Tract 320, Queens County, New York",1127,57,1070,420,1351,51250,1963,2010,1500,30,28,0,420,0,0,1070,71
2017,36081032000,"Census Tract 320, Queens County, New York",1111,40,1071,425,1591,70074,1947,2011,1601,27.5,121,0,425,0,0,1071,39
2018,36081032000,"Census Tract 320, Queens County, New York",1132,43,1089,427,1562,71343,1952,2011,1671,28.3,80,0,427,0,0,1089,57
2019,36081032000,"Census Tract 320, Queens County, New York",1165,85,1080,545,1965,71676,1944,2012,1747,28.5,165,0,545,0,0,1080,62
2020,36081032000,"Census Tract 320, Queens County, New York",1140,77,1063,533,1728,69522,1955,2011,1926,27.8,201,0,467,0,0,1063,24
2012,36081032700,"Census Tract 327, Queens County, New York",1197,93,1104,760,2567,49527,1947,2006,1425,35.8,97,154,8,110,509,1104,200
2013,36081032700,"Census Tract 327, Queens County, New York",1252,73,1179,797,2716,44267,1948,2007,1471,43.5,123,145,8,134,510,1179,199
2014,36081032700,"Census Tract 327, Queens County, New York",1313,102,1211,796,2645,46000,1947,2008,1457,37.5,135,117,28,96,575,1211,214
2015,36081032700,"Census Tract 327, Queens County, New York",1328,112,1216,747,2475,48194,1946,2011,1369,33.8,141,101,29,127,511,1216,209
2016,36081032700,"Census Tract 327, Queens County, New York",1339,208,1131,669,2123,39904,1944,2011,1400,39,127,93,19,144,432,1131,180
2017,36081032700,"Census Tract 327, Queens County, New York",1363,275,1088,633,2141,38819,1939,2011,1408,43.7,111,15,19,133,485,1088,196
2018,36081032700,"Census Tract 327, Queens County, New York",1374,381,993,574,1948,40655,0,2011,1490,40.7,105,30,19,123,421,993,222
2019,36081032700,"Census Tract 327, Queens County, New York",1396,398,998,568,1941,39044,0,2010,1599,44.7,131,86,0,101,381,998,222
2020,36081032700,"Census Tract 327, Queens County, New York",1434,561,873,509,1688,40781,0,2009,1620,45.5,84,49,0,76,341,873,177
2012,36081032800,"Census Tract 328, Queens County, New York",753,77,676,234,855,60238,1963,2006,1507,25,27,17,217,0,14,676,70
2013,36081032800,"Census Tract 328, Queens County, New York",770,58,712,245,876,58047,1960,2008,1400,33.8,42,20,198,0,17,712,62
2014,36081032800,"Census Tract 328, Queens County, New York",776,63,713,273,942,41319,1962,2011,1559,35.6,51,5,235,0,16,713,55
2015,36081032800,"Census Tract 328, Queens County, New York",745,58,687,281,812,36771,1961,2011,1451,39.7,53,5,232,0,13,687,66
2016,36081032800,"Census Tract 328, Queens County, New York",781,47,734,316,956,39038,1959,2011,1569,39.3,73,11,259,0,9,734,55
2017,36081032800,"Census Tract 328, Queens County, New York",785,56,729,333,1019,40481,1957,2011,1446,36,58,10,282,0,5,729,50
2018,36081032800,"Census Tract 328, Queens County, New York",790,65,725,297,892,43875,1960,2011,1545,33.4,61,5,282,0,0,725,60
2019,36081032800,"Census Tract 328, Queens County, New York",783,63,720,278,892,60417,1961,2010,1513,29.2,83,6,261,0,0,720,58
2020,36081032800,"Census Tract 328, Queens County, New York",842,56,786,306,866,71333,1962,2013,1681,24.9,89,4,266,0,30,786,71
2012,36081032900,"Census Tract 329, Queens County, New York",1295,102,1193,389,1333,51607,1954,2005,1430,37.1,54,87,19,14,269,1193,108
2013,36081032900,"Census Tract 329, Queens County, New York",1240,46,1194,406,1410,39417,1960,2006,1418,37.6,55,65,29,27,285,1194,146
2014,36081032900,"Census Tract 329, Queens County, New York",1277,70,1207,385,1284,36806,1963,2006,1460,41.1,44,69,21,13,282,1207,136
2015,36081032900,"Census Tract 329, Queens County, New York",1282,177,1105,388,1225,33235,1963,2008,1449,46.9,63,31,8,14,321,1105,115
2016,36081032900,"Census Tract 329, Queens County, New York",1253,248,1005,305,1039,38807,1965,2010,1463,34.5,43,16,8,15,250,1005,90
2017,36081032900,"Census Tract 329, Queens County, New York",1267,323,944,234,846,31990,1965,2012,1955,50,26,21,8,6,186,944,103
2018,36081032900,"Census Tract 329, Queens County, New York",1268,423,845,222,761,32100,1961,2012,2080,51,24,29,0,23,154,845,118
2019,36081032900,"Census Tract 329, Queens County, New York",1264,432,832,219,566,NA,1958,2012,2058,51,37,13,0,40,150,832,119
2020,36081032900,"Census Tract 329, Queens County, New York",1335,438,897,237,763,41746,1949,2016,2120,49.8,15,21,0,96,120,897,93
2012,36081033000,"Census Tract 330, Queens County, New York",2075,163,1912,675,2314,53750,1954,2005,1330,30.9,179,0,628,0,64,1912,221
2013,36081033000,"Census Tract 330, Queens County, New York",2092,213,1879,726,2574,49722,1955,2005,1400,31.9,176,0,670,11,62,1879,194
2014,36081033000,"Census Tract 330, Queens County, New York",2152,198,1954,715,2580,54856,1953,2005,1556,33.6,129,0,628,11,76,1954,189
2015,36081033000,"Census Tract 330, Queens County, New York",2150,220,1930,708,2292,52679,1956,2005,1553,35.1,170,0,659,9,33,1930,162
2016,36081033000,"Census Tract 330, Queens County, New York",2116,215,1901,621,2111,48472,1958,2007,1622,35.9,108,0,576,9,29,1901,159
2017,36081033000,"Census Tract 330, Queens County, New York",2094,230,1864,505,1648,51094,1956,2006,1511,33.8,124,0,462,9,25,1864,112
2018,36081033000,"Census Tract 330, Queens County, New York",2163,173,1990,544,1896,59545,1959,2008,1697,30,105,0,503,0,25,1990,140
2019,36081033000,"Census Tract 330, Queens County, New York",2160,154,2006,538,1947,68684,1961,2011,1749,30.3,87,0,525,0,0,2006,118
2020,36081033000,"Census Tract 330, Queens County, New York",2180,145,2035,569,2106,76042,1964,2012,1735,27.8,80,0,519,0,50,2035,107
2012,36081033100,"Census Tract 331, Queens County, New York",0,0,0,0,0,NA,NA,NA,NA,NA,0,0,0,0,0,0,0
2013,36081033100,"Census Tract 331, Queens County, New York",0,0,0,0,0,NA,NA,NA,NA,NA,0,0,0,0,0,0,0
2014,36081033100,"Census Tract 331, Queens County, New York",0,0,0,0,0,NA,NA,NA,NA,NA,0,0,0,0,0,0,0
2015,36081033100,"Census Tract 331, Queens County, New York",0,0,0,0,0,NA,NA,NA,NA,NA,0,0,0,0,0,0,0
2016,36081033100,"Census Tract 331, Queens County, New York",0,0,0,0,0,NA,NA,NA,NA,NA,0,0,0,0,0,0,0
2017,36081033100,"Census Tract 331, Queens County, New York",0,0,0,0,0,NA,NA,NA,NA,NA,0,0,0,0,0,0,0
2018,36081033100,"Census Tract 331, Queens County, New York",0,0,0,0,0,NA,NA,NA,NA,NA,0,0,0,0,0,0,0
2019,36081033100,"Census Tract 331, Queens County, New York",0,0,0,0,0,NA,NA,NA,NA,NA,0,0,0,0,0,0,0
2020,36081033100,"Census Tract 331, Queens County, New York",0,0,0,0,0,NA,NA,NA,NA,NA,0,0,0,0,0,0,0
2012,36081033401,"Census Tract 334.01, Queens County, New York",1065,49,1016,328,1005,32500,2001,2007,1432,50,9,0,297,0,22,1016,95
2013,36081033401,"Census Tract 334.01, Queens County, New York",1082,60,1022,371,1124,33527,2000,2007,1409,42.7,22,0,329,0,34,1022,110
2014,36081033401,"Census Tract 334.01, Queens County, New York",1107,52,1055,411,1260,31893,2000,2007,1403,48.7,29,0,362,4,36,1055,134
2015,36081033401,"Census Tract 334.01, Queens County, New York",1073,70,1003,370,1211,49250,1991,2007,1300,30.6,28,0,322,4,46,1003,110
2016,36081033401,"Census Tract 334.01, Queens County, New York",1093,74,1019,401,1339,57417,1989,2008,1269,28.7,46,0,386,4,22,1019,112
2017,36081033401,"Census Tract 334.01, Queens County, New York",1078,57,1021,412,1330,61250,1991,2009,1317,28.5,54,0,392,4,22,1021,124
2018,36081033401,"Census Tract 334.01, Queens County, New York",1112,71,1041,413,1216,63958,1995,2011,1399,31.2,61,0,387,20,11,1041,97
2019,36081033401,"Census Tract 334.01, Queens County, New York",1221,68,1153,447,1256,65536,1995,2012,1468,31.8,64,0,422,19,14,1153,103
2020,36081033401,"Census Tract 334.01, Queens County, New York",1253,48,1205,464,1120,54145,1995,2013,1481,33.4,69,0,447,17,0,1205,174
2012,36081033402,"Census Tract 334.02, Queens County, New York",6139,265,5874,5143,11385,42744,1964,1994,933,27.1,981,107,4907,0,189,5874,695
2013,36081033402,"Census Tract 334.02, Queens County, New York",6189,292,5897,5010,10811,39911,1964,1993,986,28.9,1099,103,4799,0,274,5897,673
2014,36081033402,"Census Tract 334.02, Queens County, New York",6248,238,6010,5174,11062,36610,1964,1994,1030,32.2,1294,134,4938,0,300,6010,803
2015,36081033402,"Census Tract 334.02, Queens County, New York",6193,216,5977,5267,11630,45598,1965,1996,1079,28.4,1422,115,5109,0,141,5977,810
2016,36081033402,"Census Tract 334.02, Queens County, New York",6264,58,6206,5444,11381,44700,1964,1997,1072,28.8,1613,111,5278,0,156,6206,665
2017,36081033402,"Census Tract 334.02, Queens County, New York",6261,91,6170,5286,11130,46909,1964,2001,1055,26.2,1492,94,4949,42,304,6170,544
2018,36081033402,"Census Tract 334.02, Queens County, New York",6372,40,6332,5557,11206,53631,1964,2002,1050,24.4,1568,118,5243,26,170,6332,644
2019,36081033402,"Census Tract 334.02, Queens County, New York",6434,117,6317,5481,10725,54248,1964,2004,1030,23.5,1526,41,5230,31,179,6317,625
2020,36081033403,"Census Tract 334.03, Queens County, New York",2171,0,2171,1894,3777,46503,NA,2001,988,28.4,548,0,1783,0,111,2171,326
2020,36081033404,"Census Tract 334.04, Queens County, New York",2571,0,2571,2293,4678,39096,1964,2010,1080,31.3,911,0,2293,0,0,2571,382
2020,36081033405,"Census Tract 334.05, Queens County, New York",1657,139,1518,985,1668,60850,1964,1999,943,18.2,387,42,846,45,52,1518,52
2012,36081033700,"Census Tract 337, Queens County, New York",987,70,917,462,1607,35313,1952,2004,1195,40.8,59,0,12,33,396,917,90
2013,36081033700,"Census Tract 337, Queens County, New York",999,71,928,541,2062,38990,1951,2006,1338,42.4,32,0,8,10,501,928,111
2014,36081033700,"Census Tract 337, Queens County, New York",1030,88,942,560,2112,38615,1952,2008,1310,43.1,42,0,10,18,511,942,160
2015,36081033700,"Census Tract 337, Queens County, New York",1075,114,961,506,1888,34236,1947,2011,1373,43.7,34,0,16,32,469,961,184
2016,36081033700,"Census Tract 337, Queens County, New York",1050,127,923,485,1724,33065,1944,2012,1409,49.4,46,0,6,60,425,923,210
2017,36081033700,"Census Tract 337, Queens County, New York",1034,163,871,418,1519,40625,1945,2012,1500,46.2,60,0,0,57,361,871,170
2018,36081033700,"Census Tract 337, Queens County, New York",1067,257,810,313,1199,45208,1943,2012,1666,51,55,0,0,53,260,810,82
2019,36081033700,"Census Tract 337, Queens County, New York",1094,283,811,257,899,37404,0,2012,1826,51,48,0,0,47,210,811,66
2020,36081033700,"Census Tract 337, Queens County, New York",1285,450,835,194,748,55795,1944,2012,2192,49.1,28,0,0,31,163,835,32
2012,36081033900,"Census Tract 339, Queens County, New York",1241,37,1204,505,1936,38702,1952,2004,1353,46.8,92,96,0,50,352,1204,178
2013,36081033900,"Census Tract 339, Queens County, New York",1246,19,1227,521,1640,38110,1955,2005,1162,39.7,123,82,19,86,326,1227,160
2014,36081033900,"Census Tract 339, Queens County, New York",1270,37,1233,442,1252,39196,1954,2006,1354,50,91,36,18,63,318,1233,105
2015,36081033900,"Census Tract 339, Queens County, New York",1213,89,1124,429,1192,38869,1950,2010,1218,50,121,31,19,44,326,1124,80
2016,36081033900,"Census Tract 339, Queens County, New York",1235,117,1118,461,1455,NA,1953,2011,1203,50,103,17,16,73,355,1118,95
2017,36081033900,"Census Tract 339, Queens County, New York",1239,131,1108,439,1297,26932,1950,2011,1182,50,90,15,15,69,340,1108,112
2018,36081033900,"Census Tract 339, Queens County, New York",1254,207,1047,357,1115,26787,1945,2011,1316,51,59,18,7,34,298,1047,162
2019,36081033900,"Census Tract 339, Queens County, New York",1242,212,1030,431,1267,26738,1943,2011,1528,51,60,37,17,34,353,1030,186
2020,36081033900,"Census Tract 339, Queens County, New York",1304,257,1047,358,992,27216,1947,2011,1660,51,25,35,23,40,275,1047,171
2012,36081034700,"Census Tract 347, Queens County, New York",1076,78,998,539,1591,40325,1957,2006,1242,29.9,133,46,69,55,371,998,137
2013,36081034700,"Census Tract 347, Queens County, New York",1117,96,1021,566,1731,38148,1958,2007,1299,36.5,111,41,60,62,410,1021,157
2014,36081034700,"Census Tract 347, Queens County, New York",1135,31,1104,645,1711,31298,1955,2011,1440,47.3,82,129,54,50,424,1104,111
2015,36081034700,"Census Tract 347, Queens County, New York",1118,43,1075,650,1871,41875,1958,2010,1523,42.8,92,80,63,34,468,1075,136
2016,36081034700,"Census Tract 347, Queens County, New York",1094,84,1010,554,1632,29575,1955,2011,1471,43.2,86,37,48,38,436,1010,136
2017,36081034700,"Census Tract 347, Queens County, New York",1113,116,997,556,1791,34524,1953,2011,1614,41.1,103,10,47,51,451,997,151
2018,36081034700,"Census Tract 347, Queens County, New York",1146,152,994,508,1376,44286,1953,2011,1662,37.7,65,16,44,31,421,994,140
2019,36081034700,"Census Tract 347, Queens County, New York",1144,211,933,449,1250,47898,1955,2011,1791,40.6,71,7,38,45,365,933,132
2020,36081034700,"Census Tract 347, Queens County, New York",1223,334,889,490,1342,55192,1952,2011,1883,39.1,132,13,58,52,353,889,101
2012,36081035100,"Census Tract 351, Queens County, New York",1553,100,1453,650,2014,43083,1954,2004,1307,41.1,50,30,32,42,546,1453,170
2013,36081035100,"Census Tract 351, Queens County, New York",1554,165,1389,710,2272,48780,1954,2005,1313,33.8,51,24,41,72,573,1389,136
2014,36081035100,"Census Tract 351, Queens County, New York",1626,203,1423,659,1996,50052,1955,2005,1284,31.7,72,14,41,43,561,1423,143
2015,36081035100,"Census Tract 351, Queens County, New York",1707,170,1537,720,2020,42000,1953,2006,1274,34.4,48,18,45,56,601,1537,190
2016,36081035100,"Census Tract 351, Queens County, New York",1728,192,1536,666,1883,40116,1950,2009,1349,44.7,56,9,25,41,591,1536,174
2017,36081035100,"Census Tract 351, Queens County, New York",1746,224,1522,558,1505,34773,1939,2011,1375,42.1,49,9,41,41,491,1522,131
2018,36081035100,"Census Tract 351, Queens County, New York",1766,162,1604,523,1251,26406,0,2011,1351,51,44,0,35,43,472,1604,183
2019,36081035100,"Census Tract 351, Queens County, New York",1739,209,1530,460,1106,27304,0,2011,1439,51,40,0,33,38,414,1530,180
2020,36081035100,"Census Tract 351, Queens County, New York",1743,362,1381,397,1167,26467,1953,2011,1607,51,48,0,33,36,353,1381,143
2012,36081035200,"Census Tract 352, Queens County, New York",799,0,799,171,548,44519,1948,2003,1547,42.9,15,0,161,0,6,799,40
2013,36081035200,"Census Tract 352, Queens County, New York",785,0,785,194,617,43676,1948,2002,1539,46.5,14,0,182,0,5,785,46
2014,36081035200,"Census Tract 352, Queens County, New York",805,0,805,206,675,35921,1949,2002,1635,50,15,0,197,0,5,805,26
2015,36081035200,"Census Tract 352, Queens County, New York",805,0,805,218,792,37333,1945,2005,1623,45.4,12,0,209,0,5,805,39
2016,36081035200,"Census Tract 352, Queens County, New York",798,12,786,195,680,36927,1942,2005,1519,46.1,0,0,185,0,10,786,58
2017,36081035200,"Census Tract 352, Queens County, New York",810,12,798,212,842,36667,1939,2006,1628,45.4,19,0,201,0,11,798,80
2018,36081035200,"Census Tract 352, Queens County, New York",833,13,820,220,854,41591,0,2007,1566,46,16,0,201,11,8,820,91
2019,36081035200,"Census Tract 352, Queens County, New York",828,13,815,214,850,46618,0,2010,1598,41.2,17,0,186,19,9,815,92
2020,36081035200,"Census Tract 352, Queens County, New York",878,13,865,136,470,75938,0,2007,1644,29.1,18,0,119,11,4,865,73
2012,36081035300,"Census Tract 353, Queens County, New York",830,154,676,405,1348,40927,1948,2004,1220,33.6,30,19,48,42,301,676,118
2013,36081035300,"Census Tract 353, Queens County, New York",837,190,647,350,1043,38864,1949,2005,1363,39.5,32,16,59,43,247,647,131
2014,36081035300,"Census Tract 353, Queens County, New York",837,136,701,448,1322,37879,1948,2005,1305,36.8,37,18,93,48,307,701,190
2015,36081035300,"Census Tract 353, Queens County, New York",859,98,761,428,1154,29375,1946,2006,1348,45.7,59,8,91,23,323,761,200
2016,36081035300,"Census Tract 353, Queens County, New York",861,128,733,370,1023,33000,1945,2006,1545,46.4,40,8,67,9,298,733,171
2017,36081035300,"Census Tract 353, Queens County, New York",852,127,725,383,1270,29792,1939,2008,1516,47.8,49,0,94,8,295,725,164
2018,36081035300,"Census Tract 353, Queens County, New York",848,132,716,391,1352,31750,0,2008,1520,42.4,59,0,94,9,288,716,161
2019,36081035300,"Census Tract 353, Queens County, New York",887,236,651,335,1130,33542,0,2010,1491,43.6,63,0,84,9,242,651,113
2020,36081035300,"Census Tract 353, Queens County, New York",982,322,660,299,1052,47708,0,2011,1415,37.8,70,0,66,10,223,660,87
2012,36081035700,"Census Tract 357, Queens County, New York",1424,121,1303,439,1168,35665,1958,2003,1328,40.5,68,113,143,34,174,1303,207
2013,36081035700,"Census Tract 357, Queens County, New York",1454,122,1332,532,1224,34000,1963,2006,1284,44.5,100,173,121,32,206,1332,277
2014,36081035700,"Census Tract 357, Queens County, New York",1403,169,1234,552,1238,35000,1962,2007,1339,48.2,114,194,163,27,168,1234,260
2015,36081035700,"Census Tract 357, Queens County, New York",1421,169,1252,618,1353,37813,1961,2011,1211,40.3,93,225,158,22,213,1252,239
2016,36081035700,"Census Tract 357, Queens County, New York",1494,265,1229,614,1398,34118,1963,2011,1225,41.2,136,181,209,31,193,1229,248
2017,36081035700,"Census Tract 357, Queens County, New York",1534,357,1177,586,1409,34297,1964,2012,1319,32.8,117,174,193,32,187,1177,278
2018,36081035700,"Census Tract 357, Queens County, New York",1544,497,1047,474,1300,35469,1964,2012,1317,40.1,84,118,156,27,173,1047,209
2019,36081035700,"Census Tract 357, Queens County, New York",1649,661,988,398,1174,36125,1964,2012,1244,42.7,47,84,115,23,176,988,178
2020,36081035700,"Census Tract 357, Queens County, New York",1694,795,899,400,1248,107729,1958,2010,1688,23.1,41,28,101,30,241,899,94
2012,36081035800,"Census Tract 358, Queens County, New York",1353,137,1216,407,1004,48568,1955,2003,1403,35.4,70,0,407,0,0,1216,95
2013,36081035800,"Census Tract 358, Queens County, New York",1376,111,1265,372,891,41739,1959,2005,1400,38.3,86,0,372,0,0,1265,111
2014,36081035800,"Census Tract 358, Queens County, New York",1397,122,1275,410,1045,34423,1957,2008,1414,43.8,80,0,401,0,0,1275,133
2015,36081035800,"Census Tract 358, Queens County, New York",1331,74,1257,449,1257,41098,1956,2010,1446,37.9,107,0,440,0,0,1257,140
2016,36081035800,"Census Tract 358, Queens County, New York",1317,65,1252,506,1381,28026,1955,2010,1376,50,115,0,495,0,17,1252,173
2017,36081035800,"Census Tract 358, Queens County, New York",1326,82,1244,492,1560,NA,1954,2010,1530,40,98,0,482,0,26,1244,175
2018,36081035800,"Census Tract 358, Queens County, New York",1364,91,1273,555,1768,NA,1954,2010,1581,35.8,75,0,543,0,23,1273,181
2019,36081035800,"Census Tract 358, Queens County, New York",1365,73,1292,489,1609,113385,1959,2008,1696,19.4,119,0,489,0,16,1292,110
2020,36081035800,"Census Tract 358, Queens County, New York",1433,116,1317,544,1694,NA,1963,2011,1709,21.7,118,0,544,0,16,1317,100
2012,36081036100,"Census Tract 361, Queens County, New York",788,64,724,467,1734,31474,1949,2005,1168,44,62,3,157,19,301,724,228
2013,36081036100,"Census Tract 361, Queens County, New York",801,36,765,521,1992,30313,1948,2006,1404,50,45,8,114,10,399,765,223
2014,36081036100,"Census Tract 361, Queens County, New York",809,42,767,559,2026,31914,1945,2007,1335,50,56,2,189,11,368,767,193
2015,36081036100,"Census Tract 361, Queens County, New York",814,53,761,542,1986,33654,1942,2007,1346,45.6,85,9,199,11,335,761,200
2016,36081036100,"Census Tract 361, Queens County, New York",815,94,721,523,2119,30809,1939,2009,1405,49.1,60,4,158,12,362,721,207
2017,36081036100,"Census Tract 361, Queens County, New York",816,132,684,498,2011,37051,1939,2010,1464,49,56,14,128,11,345,684,147
2018,36081036100,"Census Tract 361, Queens County, New York",802,147,655,465,1735,39954,0,2009,1418,42.6,36,14,133,13,305,655,121
2019,36081036100,"Census Tract 361, Queens County, New York",818,200,618,402,1445,39853,0,2009,1447,38.4,38,15,91,27,269,618,87
2020,36081036100,"Census Tract 361, Queens County, New York",924,290,634,370,1279,40000,0,2012,1674,40.5,41,15,58,30,267,634,68
2012,36081036300,"Census Tract 363, Queens County, New York",682,59,623,370,1193,61200,1945,2005,1279,29.1,42,0,80,0,281,623,83
2013,36081036300,"Census Tract 363, Queens County, New York",718,61,657,437,1447,58646,1946,2006,1323,31,33,0,116,0,319,657,68
2014,36081036300,"Census Tract 363, Queens County, New York",721,73,648,419,1418,57813,1948,2007,1367,31.2,30,0,84,0,331,648,90
2015,36081036300,"Census Tract 363, Queens County, New York",707,108,599,387,1295,43583,1945,2010,1385,33.4,29,9,67,0,306,599,99
2016,36081036300,"Census Tract 363, Queens County, New York",723,135,588,408,1321,48846,1940,2010,1415,32.9,32,20,56,4,326,588,115
2017,36081036300,"Census Tract 363, Queens County, New York",709,162,547,354,1253,50417,1942,2011,1435,33.8,37,9,58,5,291,547,100
2018,36081036300,"Census Tract 363, Queens County, New York",713,187,526,303,956,51750,0,2011,1534,34,50,12,81,5,194,526,80
2019,36081036300,"Census Tract 363, Queens County, New York",732,235,497,302,1003,52292,0,2011,1570,36.8,38,10,51,4,223,497,92
2020,36081036300,"Census Tract 363, Queens County, New York",719,230,489,281,992,52583,1941,2011,1591,35.6,54,0,60,4,203,489,50
2012,36081036500,"Census Tract 365, Queens County, New York",966,73,893,566,2251,44765,1951,2005,1212,32.2,25,0,109,5,452,893,164
2013,36081036500,"Census Tract 365, Queens County, New York",1021,78,943,654,2515,46755,1948,2006,1126,31.9,24,16,114,4,520,943,168
2014,36081036500,"Census Tract 365, Queens County, New York",1038,51,987,724,2894,56618,1951,2006,1168,32.1,47,14,117,19,574,987,164
2015,36081036500,"Census Tract 365, Queens County, New York",1038,90,948,659,2439,40925,1941,2008,1272,38.4,39,28,122,36,473,948,195
2016,36081036500,"Census Tract 365, Queens County, New York",1016,159,857,611,2056,34712,1939,2010,1342,45.9,42,28,116,43,424,857,146
2017,36081036500,"Census Tract 365, Queens County, New York",1047,198,849,605,2224,40625,1939,2011,1475,44.2,54,25,95,35,445,849,145
2018,36081036500,"Census Tract 365, Queens County, New York",1067,282,785,557,2103,41683,0,2011,1667,47.4,51,15,73,41,423,785,131
2019,36081036500,"Census Tract 365, Queens County, New York",1095,356,739,526,2050,44231,0,2012,1750,45.4,39,17,87,28,399,739,126
2020,36081036500,"Census Tract 365, Queens County, New York",1208,423,785,405,1518,46908,1942,2014,1714,43.8,36,8,68,17,318,785,118
2012,36081036600,"Census Tract 366, Queens County, New York",1019,92,927,344,850,22162,1962,2001,1156,50,20,0,309,0,0,927,187
2013,36081036600,"Census Tract 366, Queens County, New York",1022,94,928,310,878,27857,1964,2003,1418,45,46,0,310,0,0,928,131
2014,36081036600,"Census Tract 366, Queens County, New York",1015,94,921,303,847,22772,1949,2004,1179,39.5,46,0,299,0,0,921,157
2015,36081036600,"Census Tract 366, Queens County, New York",1025,78,947,342,865,24100,1946,2005,1107,37.7,63,0,337,0,10,947,176
2016,36081036600,"Census Tract 366, Queens County, New York",1028,53,975,384,957,35833,1950,2006,1208,36.4,75,0,379,0,14,975,183
2017,36081036600,"Census Tract 366, Queens County, New York",1007,50,957,384,892,NA,1949,2008,1163,35.4,67,0,374,0,22,957,186
2018,36081036600,"Census Tract 366, Queens County, New York",1040,54,986,394,856,20385,1953,2009,1117,38.4,44,0,379,0,25,986,220
2019,36081036600,"Census Tract 366, Queens County, New York",1059,60,999,398,700,NA,1954,2009,1155,29.3,47,0,387,0,26,999,205
2020,36081036600,"Census Tract 366, Queens County, New York",1073,68,1005,386,672,NA,1955,2009,1076,34.1,55,0,367,0,39,1005,173
2012,36081036700,"Census Tract 367, Queens County, New York",879,118,761,351,1135,59432,1952,2006,1700,39.1,110,0,133,11,172,761,62
2013,36081036700,"Census Tract 367, Queens County, New York",892,109,783,350,1188,54444,1953,2006,1660,36.1,63,11,118,16,170,783,81
2014,36081036700,"Census Tract 367, Queens County, New York",882,107,775,373,1262,43625,1953,2007,1517,39.4,48,17,131,38,173,775,115
2015,36081036700,"Census Tract 367, Queens County, New York",888,120,768,376,1340,60714,1939,2007,1457,33.8,47,18,122,41,176,768,106
2016,36081036700,"Census Tract 367, Queens County, New York",895,139,756,357,1347,59375,1939,2008,1570,33,37,17,111,40,183,756,121
2017,36081036700,"Census Tract 367, Queens County, New York",919,170,749,330,985,35000,1939,2009,1599,50,41,18,94,28,182,749,118
2018,36081036700,"Census Tract 367, Queens County, New York",928,192,736,329,853,28719,0,2010,1470,51,39,5,101,28,195,736,145
2019,36081036700,"Census Tract 367, Queens County, New York",933,253,680,282,767,35938,0,2010,1645,51,48,13,105,5,153,680,94
2020,36081036700,"Census Tract 367, Queens County, New York",925,275,650,266,797,36333,0,2011,1664,51,50,14,119,5,133,650,124
2012,36081036800,"Census Tract 368, Queens County, New York",816,58,758,133,282,46125,1955,2007,985,24,13,0,120,0,0,758,76
2013,36081036800,"Census Tract 368, Queens County, New York",831,41,790,185,404,45446,1953,2011,1026,24.9,25,0,153,0,16,790,72
2014,36081036800,"Census Tract 368, Queens County, New York",823,37,786,223,548,50375,1951,2011,1140,24.8,43,0,193,0,15,786,81
2015,36081036800,"Census Tract 368, Queens County, New York",815,51,764,207,534,51202,1953,2011,1209,25.4,47,0,175,0,16,764,72
2016,36081036800,"Census Tract 368, Queens County, New York",821,51,770,255,653,51348,1959,2011,1159,25.5,52,0,220,0,35,770,71
2017,36081036800,"Census Tract 368, Queens County, New York",832,27,805,228,582,51944,1955,2011,1201,27.1,54,0,188,0,35,805,59
2018,36081036800,"Census Tract 368, Queens County, New York",841,13,828,239,598,34732,1955,2011,1252,33.8,47,0,209,0,24,828,111
2019,36081036800,"Census Tract 368, Queens County, New York",844,36,808,221,554,33589,1957,2011,1199,36.3,35,0,186,0,29,808,114
2020,36081036800,"Census Tract 368, Queens County, New York",779,37,742,164,392,32667,1956,2011,1157,37,30,0,134,0,24,742,109
2012,36081037100,"Census Tract 371, Queens County, New York",557,53,504,261,1044,45368,1955,2005,1635,36.3,43,0,76,29,156,504,56
2013,36081037100,"Census Tract 371, Queens County, New York",551,36,515,222,881,36094,1955,2005,1709,44.2,22,0,65,33,124,515,84
2014,36081037100,"Census Tract 371, Queens County, New York",549,32,517,235,866,37054,1955,2006,1694,42.1,20,0,69,37,129,517,81
2015,36081037100,"Census Tract 371, Queens County, New York",581,69,512,210,718,35667,1951,2009,1607,42.6,21,0,56,44,110,512,98
2016,36081037100,"Census Tract 371, Queens County, New York",579,78,501,206,651,45741,1951,2009,1648,38.5,24,0,57,36,113,501,95
2017,36081037100,"Census Tract 371, Queens County, New York",567,114,453,147,422,45703,1939,2011,1664,39.8,6,0,56,21,70,453,84
2018,36081037100,"Census Tract 371, Queens County, New York",579,150,429,115,325,49306,1952,2011,1718,38.4,6,0,30,21,64,429,49
2019,36081037100,"Census Tract 371, Queens County, New York",593,191,402,99,328,61875,1943,2013,1803,32.5,5,0,17,11,71,402,44
2020,36081037100,"Census Tract 371, Queens County, New York",690,223,467,66,156,61591,1948,2013,1817,34.7,5,0,10,5,51,467,29
2012,36081037300,"Census Tract 373, Queens County, New York",828,48,780,573,2101,50208,1957,2004,1532,32.7,78,10,179,27,380,780,156
2013,36081037300,"Census Tract 373, Queens County, New York",786,45,741,533,2107,49850,1955,2005,1681,32.8,57,7,163,33,341,741,141
2014,36081037300,"Census Tract 373, Queens County, New York",761,79,682,438,1470,41389,1955,2005,1520,36.4,79,9,179,9,241,682,117
2015,36081037300,"Census Tract 373, Queens County, New York",788,75,713,417,1410,44013,1947,2007,1402,32.1,54,71,110,9,227,713,100
2016,36081037300,"Census Tract 373, Queens County, New York",786,107,679,367,1517,41151,1951,2009,1550,38.4,44,25,99,5,238,679,77
2017,36081037300,"Census Tract 373, Queens County, New York",795,129,666,361,1479,41542,1946,2011,1551,48.3,67,13,56,36,256,666,62
2018,36081037300,"Census Tract 373, Queens County, New York",811,164,647,357,1162,36620,1941,2011,1488,51,79,12,85,21,239,647,64
2019,36081037300,"Census Tract 373, Queens County, New York",847,201,646,379,1354,45669,1952,2011,1538,33.8,80,11,85,30,253,646,53
2020,36081037300,"Census Tract 373, Queens County, New York",791,240,551,315,1485,49183,1961,2011,1683,35.8,76,11,64,26,214,551,57
2012,36081037500,"Census Tract 375, Queens County, New York",977,94,883,823,3519,41853,1944,2003,1272,37,119,0,22,118,661,883,240
2013,36081037500,"Census Tract 375, Queens County, New York",978,115,863,778,3236,41397,1947,2003,1357,38.9,119,11,28,105,618,863,203
2014,36081037500,"Census Tract 375, Queens County, New York",1020,138,882,778,3212,44462,1946,2003,1369,36.3,104,11,29,68,653,882,191
2015,36081037500,"Census Tract 375, Queens County, New York",1028,128,900,767,3393,44229,1946,2004,1413,37.7,91,12,34,37,677,900,154
2016,36081037500,"Census Tract 375, Queens County, New York",1045,120,925,751,3414,45977,1948,2005,1483,37.8,70,19,38,10,672,925,165
2017,36081037500,"Census Tract 375, Queens County, New York",1015,104,911,716,3402,48523,1949,2007,1635,35.9,64,18,40,15,645,911,143
2018,36081037500,"Census Tract 375, Queens County, New York",1026,93,933,711,3129,53242,1947,2008,1653,34.1,49,9,57,13,639,933,146
2019,36081037500,"Census Tract 375, Queens County, New York",1011,88,923,683,3011,49350,1949,2011,1652,37.3,31,8,64,27,591,923,167
2020,36081037501,"Census Tract 375.01, Queens County, New York",312,27,285,210,1065,56489,1946,2008,1713,37.1,6,0,9,9,201,285,54
2020,36081037502,"Census Tract 375.02, Queens County, New York",664,49,615,463,1912,58229,1948,2009,1631,32,38,3,47,20,393,615,93
2012,36081037600,"Census Tract 376, Queens County, New York",1994,189,1805,387,1182,73625,1955,2005,1175,23.9,90,0,387,0,18,1805,99
2013,36081037600,"Census Tract 376, Queens County, New York",1997,142,1855,370,1063,67194,1951,2005,1274,27.2,61,0,370,0,0,1855,92
2014,36081037600,"Census Tract 376, Queens County, New York",1983,140,1843,514,1490,65288,1952,2007,1322,29.5,68,0,480,0,26,1843,131
2015,36081037600,"Census Tract 376, Queens County, New York",1910,106,1804,436,1104,34760,1953,2008,1320,39.9,86,0,398,0,29,1804,139
2016,36081037600,"Census Tract 376, Queens County, New York",1993,56,1937,588,1550,50192,1955,2009,1406,40.1,116,0,546,0,32,1937,144
2017,36081037600,"Census Tract 376, Queens County, New York",2029,93,1936,566,1438,36016,1953,2010,1428,43.2,84,0,527,0,29,1936,159
2018,36081037600,"Census Tract 376, Queens County, New York",2014,113,1901,573,1440,36019,1955,2010,1478,43.8,95,0,529,0,33,1901,146
2019,36081037600,"Census Tract 376, Queens County, New York",2026,108,1918,504,1351,64000,1951,2011,1524,28.8,61,0,493,0,11,1918,103
2020,36081037600,"Census Tract 376, Queens County, New York",1928,112,1816,547,1535,62917,1952,2010,1617,29.3,121,0,532,0,15,1816,107
2012,36081037700,"Census Tract 377, Queens County, New York",1024,138,886,699,3245,41250,1944,2005,1362,39.9,104,11,173,48,507,886,278
2013,36081037700,"Census Tract 377, Queens County, New York",988,128,860,666,3052,41474,1945,2005,1436,39.3,126,8,147,65,457,860,292
2014,36081037700,"Census Tract 377, Queens County, New York",1006,145,861,665,2753,38789,1944,2007,1441,43.4,93,0,182,33,476,861,239
2015,36081037700,"Census Tract 377, Queens County, New York",984,141,843,645,2750,42390,1941,2007,1436,40.3,75,0,159,6,493,843,181
2016,36081037700,"Census Tract 377, Queens County, New York",933,112,821,614,2703,45682,1941,2008,1460,38.9,23,0,121,6,505,821,150
2017,36081037700,"Census Tract 377, Queens County, New York",877,109,768,500,2361,54615,1939,2010,1606,30.4,25,0,97,7,424,768,55
2018,36081037700,"Census Tract 377, Queens County, New York",915,115,800,553,2571,64063,0,2011,1686,34.5,31,0,102,0,483,800,81
2019,36081037700,"Census Tract 377, Queens County, New York",903,128,775,542,2598,67708,1950,2012,1778,31.4,48,0,49,47,459,775,116
2020,36081037700,"Census Tract 377, Queens County, New York",822,80,742,528,2921,65735,1958,2013,1961,33.7,43,0,49,0,493,742,92
2012,36081037900,"Census Tract 379, Queens County, New York",1466,189,1277,1033,5358,51788,1957,2005,1548,34.2,56,0,62,7,947,1277,329
2013,36081037900,"Census Tract 379, Queens County, New York",1526,169,1357,1143,6123,51058,1959,2006,1601,37.8,108,0,72,44,1006,1357,357
2014,36081037900,"Census Tract 379, Queens County, New York",1526,161,1365,1150,6015,50305,1960,2006,1590,37,106,0,73,59,1049,1365,376
2015,36081037900,"Census Tract 379, Queens County, New York",1536,140,1396,1094,5651,43889,1964,2007,1547,39.6,88,0,76,84,996,1396,320
2016,36081037900,"Census Tract 379, Queens County, New York",1489,100,1389,1087,5536,42346,1967,2009,1648,39.6,89,0,116,99,973,1389,294
2017,36081037900,"Census Tract 379, Queens County, New York",1356,25,1331,1061,5549,54648,1984,2011,1679,36.9,92,0,94,95,997,1331,271
2018,36081037900,"Census Tract 379, Queens County, New York",1366,22,1344,1024,4503,62833,1951,2011,1611,31.8,70,0,108,37,952,1344,194
2019,36081037900,"Census Tract 379, Queens County, New York",1423,40,1383,1035,4900,72536,1949,2012,1597,29.8,57,20,91,18,939,1383,169
2020,36081037900,"Census Tract 379, Queens County, New York",1436,28,1408,1143,4979,68717,1949,2013,1699,29.3,77,16,63,0,1079,1408,202
2012,36081038100,"Census Tract 381, Queens County, New York",1682,171,1511,1061,4626,39627,1959,2004,1240,32.8,68,8,247,44,754,1511,331
2013,36081038100,"Census Tract 381, Queens County, New York",1760,221,1539,1102,5267,42841,1959,2006,1503,38.3,95,10,218,53,835,1539,381
2014,36081038100,"Census Tract 381, Queens County, New York",1898,193,1705,1227,5978,46434,1957,2007,1473,37,69,9,205,46,986,1705,415
2015,36081038100,"Census Tract 381, Queens County, New York",2000,182,1818,1203,5790,43813,1956,2008,1440,37.4,79,9,192,42,984,1818,407
2016,36081038100,"Census Tract 381, Queens County, New York",2003,173,1830,1183,5518,46169,1958,2009,1513,35.7,83,0,210,48,951,1830,394
2017,36081038100,"Census Tract 381, Queens County, New York",1857,182,1675,1029,5019,44792,1958,2010,1600,38.3,63,0,174,29,854,1675,381
2018,36081038100,"Census Tract 381, Queens County, New York",1861,141,1720,1024,4691,48311,1959,2010,1518,36.6,32,0,162,18,825,1720,297
2019,36081038100,"Census Tract 381, Queens County, New York",1883,109,1774,1057,4790,51551,1961,2011,1647,38,38,0,138,38,886,1774,315
2020,36081038100,"Census Tract 381, Queens County, New York",1717,96,1621,1026,4536,54847,1959,2012,1701,38.2,42,8,181,24,817,1621,247
2012,36081038301,"Census Tract 383.01, Queens County, New York",0,0,0,0,0,NA,NA,NA,NA,NA,0,0,0,0,0,0,0
2013,36081038301,"Census Tract 383.01, Queens County, New York",0,0,0,0,0,NA,NA,NA,NA,NA,0,0,0,0,0,0,0
2014,36081038301,"Census Tract 383.01, Queens County, New York",0,0,0,0,0,NA,NA,NA,NA,NA,0,0,0,0,0,0,0
2015,36081038301,"Census Tract 383.01, Queens County, New York",0,0,0,0,0,NA,NA,NA,NA,NA,0,0,0,0,0,0,0
2016,36081038301,"Census Tract 383.01, Queens County, New York",0,0,0,0,0,NA,NA,NA,NA,NA,0,0,0,0,0,0,0
2017,36081038301,"Census Tract 383.01, Queens County, New York",0,0,0,0,0,NA,NA,NA,NA,NA,0,0,0,0,0,0,0
2018,36081038301,"Census Tract 383.01, Queens County, New York",0,0,0,0,0,NA,NA,NA,NA,NA,0,0,0,0,0,0,0
2019,36081038301,"Census Tract 383.01, Queens County, New York",0,0,0,0,0,NA,NA,NA,NA,NA,0,0,0,0,0,0,0
2020,36081038301,"Census Tract 383.01, Queens County, New York",0,0,0,0,0,NA,NA,NA,NA,NA,0,0,0,0,0,0,0
2012,36081038302,"Census Tract 383.02, Queens County, New York",29,11,18,18,61,102500,NA,NA,1625,22.5,9,0,0,18,0,18,0
2013,36081038302,"Census Tract 383.02, Queens County, New York",21,12,9,9,29,NA,NA,NA,NA,NA,0,0,0,9,0,9,0
2014,36081038302,"Census Tract 383.02, Queens County, New York",12,12,0,0,0,NA,NA,NA,NA,NA,0,0,0,0,0,0,0
2015,36081038302,"Census Tract 383.02, Queens County, New York",12,12,0,0,0,NA,NA,NA,NA,NA,0,0,0,0,0,0,0
2016,36081038302,"Census Tract 383.02, Queens County, New York",11,11,0,0,0,NA,NA,NA,NA,NA,0,0,0,0,0,0,0
2017,36081038302,"Census Tract 383.02, Queens County, New York",0,0,0,0,0,NA,NA,NA,NA,NA,0,0,0,0,0,0,0
2018,36081038302,"Census Tract 383.02, Queens County, New York",0,0,0,0,0,NA,NA,NA,NA,NA,0,0,0,0,0,0,0
2019,36081038302,"Census Tract 383.02, Queens County, New York",0,0,0,0,0,NA,NA,NA,NA,NA,0,0,0,0,0,0,0
2020,36081038302,"Census Tract 383.02, Queens County, New York",0,0,0,0,0,NA,NA,NA,NA,NA,0,0,0,0,0,0,0
2012,36081038400,"Census Tract 384, Queens County, New York",791,123,668,167,521,46250,1952,2002,1152,22.5,65,0,150,0,17,668,42
2013,36081038400,"Census Tract 384, Queens County, New York",785,108,677,225,831,56771,1952,2003,1194,25.4,44,0,195,14,16,677,42
2014,36081038400,"Census Tract 384, Queens County, New York",766,39,727,243,825,55913,1954,2005,1298,28.9,27,0,211,14,18,727,47
2015,36081038400,"Census Tract 384, Queens County, New York",760,56,704,297,1006,47159,1954,2006,1347,29.9,27,0,266,13,18,704,60
2016,36081038400,"Census Tract 384, Queens County, New York",756,51,705,285,962,56250,1953,2006,1363,28.5,9,0,254,14,17,705,70
2017,36081038400,"Census Tract 384, Queens County, New York",747,36,711,239,841,59850,1952,2007,1595,28,19,0,225,14,0,711,48
2018,36081038400,"Census Tract 384, Queens County, New York",742,53,689,171,512,51806,1955,2011,1619,40.3,15,0,163,0,8,689,31
2019,36081038400,"Census Tract 384, Queens County, New York",740,56,684,200,708,67656,1954,2011,1608,27.4,30,0,192,0,8,684,32
2020,36081038400,"Census Tract 384, Queens County, New York",743,25,718,161,599,72863,1954,2012,1515,26.8,26,0,155,0,6,718,16
2012,36081039400,"Census Tract 394, Queens County, New York",1030,132,898,308,790,42917,1950,2005,1274,37.4,58,9,287,0,12,898,83
2013,36081039400,"Census Tract 394, Queens County, New York",1018,102,916,342,836,48690,1949,2006,1239,33.6,63,0,323,0,19,916,84
2014,36081039400,"Census Tract 394, Queens County, New York",1014,76,938,397,948,41607,1951,2006,1288,35.6,60,0,373,0,24,938,86
2015,36081039400,"Census Tract 394, Queens County, New York",991,67,924,355,973,39271,1952,2006,1309,34.8,60,0,319,12,24,924,101
2016,36081039400,"Census Tract 394, Queens County, New York",998,65,933,359,1054,39688,1956,2009,1412,38.3,85,0,323,12,25,933,109
2017,36081039400,"Census Tract 394, Queens County, New York",984,39,945,350,1044,40341,1970,2008,1449,38.7,91,0,329,10,12,945,120
2018,36081039400,"Census Tract 394, Queens County, New York",977,48,929,323,1040,40958,1972,2009,1567,42.4,89,0,309,9,6,929,118
2019,36081039400,"Census Tract 394, Queens County, New York",991,54,937,287,892,40647,1973,2011,1557,43.2,72,0,277,10,0,937,125
2020,36081039400,"Census Tract 394, Queens County, New York",902,55,847,258,727,31667,0,2013,1564,51,45,0,258,0,0,847,137
2012,36081039800,"Census Tract 398, Queens County, New York",555,23,532,141,396,35375,1942,2004,959,24.3,72,0,141,0,0,532,42
2013,36081039800,"Census Tract 398, Queens County, New York",558,30,528,173,506,39028,1945,2006,1098,24.3,66,0,146,0,27,528,45
2014,36081039800,"Census Tract 398, Queens County, New York",552,41,511,158,464,42250,1945,2006,1164,24,73,0,140,0,18,511,22
2015,36081039800,"Census Tract 398, Queens County, New York",538,39,499,149,398,45417,1949,2010,1203,26.2,53,14,117,0,18,499,27
2016,36081039800,"Census Tract 398, Queens County, New York",538,29,509,112,291,46111,1965,2012,1286,29.1,23,13,80,0,19,509,14
2017,36081039800,"Census Tract 398, Queens County, New York",535,29,506,100,250,64375,1962,2013,1299,26.5,22,13,69,0,18,506,14
2018,36081039800,"Census Tract 398, Queens County, New York",545,22,523,87,195,44625,1954,2013,1351,29.6,23,9,78,0,0,523,32
2019,36081039800,"Census Tract 398, Queens County, New York",524,19,505,85,251,NA,1953,2013,1482,41.7,17,9,64,0,12,505,41
2020,36081039800,"Census Tract 398, Queens County, New York",504,16,488,81,164,51012,1967,2013,1375,31.1,33,0,71,0,10,488,38
2012,36081039900,"Census Tract 399, Queens County, New York",1122,122,1000,743,2848,45938,1957,2006,1345,33.6,87,0,20,44,679,1000,271
2013,36081039900,"Census Tract 399, Queens County, New York",1065,109,956,697,2766,47243,1960,2007,1376,31.5,87,18,18,41,620,956,290
2014,36081039900,"Census Tract 399, Queens County, New York",1135,69,1066,818,3376,40208,1962,2008,1332,35.2,100,19,38,48,695,1066,284
2015,36081039900,"Census Tract 399, Queens County, New York",1098,101,997,821,3528,45250,1962,2008,1377,33,85,19,28,26,728,997,240
2016,36081039900,"Census Tract 399, Queens County, New York",1020,74,946,720,3307,50469,1962,2009,1424,32.5,86,19,30,28,621,946,142
2017,36081039900,"Census Tract 399, Queens County, New York",967,77,890,734,3462,52000,1963,2009,1421,31.1,83,19,38,10,647,890,134
2018,36081039900,"Census Tract 399, Queens County, New York",1011,79,932,770,3616,64537,1955,2010,1512,30.8,76,0,60,21,664,932,91
2019,36081039900,"Census Tract 399, Queens County, New York",972,77,895,709,3024,65216,1954,2011,1845,32.7,62,0,57,23,629,895,84
2020,36081039901,"Census Tract 399.01, Queens County, New York",557,28,529,370,1896,81354,1950,2012,2084,30.7,57,0,0,27,343,529,0
2020,36081039902,"Census Tract 399.02, Queens County, New York",416,38,378,325,1079,34226,1966,2016,1459,51,26,33,50,5,237,378,110
2012,36081040000,"Census Tract 400, Queens County, New York",445,47,398,84,240,18472,1961,2004,995,43.4,4,0,69,0,0,398,52
2013,36081040000,"Census Tract 400, Queens County, New York",462,59,403,111,364,32695,1964,2005,1125,41.1,16,0,79,0,0,403,57
2014,36081040000,"Census Tract 400, Queens County, New York",464,75,389,99,232,19279,1965,2005,1142,50,20,0,99,0,0,389,82
2015,36081040000,"Census Tract 400, Queens County, New York",471,24,447,90,165,44773,1981,2007,1125,44,24,0,86,0,0,447,27
2016,36081040000,"Census Tract 400, Queens County, New York",453,23,430,98,195,48214,1969,2008,1271,40,30,0,93,0,0,430,28
2017,36081040000,"Census Tract 400, Queens County, New York",451,42,409,114,214,51071,1966,2009,NA,32.8,43,14,95,0,0,409,26
2018,36081040000,"Census Tract 400, Queens County, New York",469,28,441,111,228,NA,1962,2009,1363,31.6,41,13,92,0,0,441,24
2019,36081040000,"Census Tract 400, Queens County, New York",459,26,433,102,243,41250,1951,2011,1358,42.5,40,12,84,0,0,433,34
2020,36081040000,"Census Tract 400, Queens County, New York",516,54,462,81,209,NA,1946,2011,1371,34,46,11,70,0,0,462,29
2012,36081040100,"Census Tract 401, Queens County, New York",1820,123,1697,1398,6169,42536,1954,2004,1417,39.4,37,53,25,194,1126,1697,351
2013,36081040100,"Census Tract 401, Queens County, New York",1841,131,1710,1366,5918,44167,1956,2005,1436,36.7,66,36,72,170,1131,1710,328
2014,36081040100,"Census Tract 401, Queens County, New York",1866,119,1747,1440,6343,42992,1957,2006,1483,37.5,60,32,44,159,1227,1747,390
2015,36081040100,"Census Tract 401, Queens County, New York",1853,114,1739,1491,6907,43323,1950,2007,1487,37.2,56,18,45,162,1287,1739,349
2016,36081040100,"Census Tract 401, Queens County, New York",1767,149,1618,1426,6245,40036,1959,2008,1612,44.6,95,16,41,173,1215,1618,312
2017,36081040100,"Census Tract 401, Queens County, New York",1788,111,1677,1364,6266,45985,1957,2009,1691,40.2,91,0,57,153,1174,1677,297
2018,36081040100,"Census Tract 401, Queens County, New York",1823,123,1700,1410,6659,53864,1957,2011,1739,38.5,98,0,34,105,1284,1700,307
2019,36081040100,"Census Tract 401, Queens County, New York",1867,103,1764,1452,6513,60451,1952,2012,1798,36.2,130,0,46,125,1294,1764,284
2020,36081040101,"Census Tract 401.01, Queens County, New York",716,36,680,452,1831,48598,1952,2012,1937,43.9,49,0,18,17,417,680,72
2020,36081040102,"Census Tract 401.02, Queens County, New York",1263,53,1210,1014,3755,58750,1950,2015,1727,34.6,55,0,41,70,932,1210,203
2012,36081040200,"Census Tract 402, Queens County, New York",476,26,450,102,313,51875,1947,2005,1214,20,14,0,98,0,4,450,0
2013,36081040200,"Census Tract 402, Queens County, New York",475,67,408,138,463,52609,1959,2004,1293,31.6,14,0,134,0,4,408,3
2014,36081040200,"Census Tract 402, Queens County, New York",470,31,439,120,361,48864,1953,2004,1008,19.4,22,0,115,0,5,439,13
2015,36081040200,"Census Tract 402, Queens County, New York",465,25,440,131,427,56625,1961,2004,1121,22.7,21,0,125,0,6,440,33
2016,36081040200,"Census Tract 402, Queens County, New York",466,33,433,100,332,64333,1962,2003,1089,20.3,15,0,93,0,7,433,38
2017,36081040200,"Census Tract 402, Queens County, New York",477,44,433,89,305,NA,1948,2005,1229,27.9,15,0,89,0,0,433,40
2018,36081040200,"Census Tract 402, Queens County, New York",474,27,447,64,218,95769,0,1998,1190,27.5,16,0,64,0,0,447,50
2019,36081040200,"Census Tract 402, Queens County, New York",486,12,474,52,152,NA,0,1998,1513,36.8,19,0,52,0,0,474,35
2020,36081040200,"Census Tract 402, Queens County, New York",495,9,486,34,85,53125,0,1994,1175,37.9,16,0,34,0,0,486,14
2012,36081040300,"Census Tract 403, Queens County, New York",1724,122,1602,1242,4954,51587,1958,2005,1417,32,98,47,25,133,1090,1602,307
2013,36081040300,"Census Tract 403, Queens County, New York",1808,127,1681,1285,5409,51023,1960,2006,1437,32.1,84,47,41,85,1183,1681,349
2014,36081040300,"Census Tract 403, Queens County, New York",1846,128,1718,1374,5751,43991,1966,2007,1464,34.3,74,29,91,69,1279,1718,401
2015,36081040300,"Census Tract 403, Queens County, New York",1819,92,1727,1353,5703,43630,1959,2009,1621,40.9,69,16,80,43,1309,1727,376
2016,36081040300,"Census Tract 403, Queens County, New York",1733,104,1629,1329,5869,43364,1959,2009,1603,38,39,10,60,82,1259,1629,343
2017,36081040300,"Census Tract 403, Queens County, New York",1687,62,1625,1302,6348,44788,1968,2010,1702,40.5,40,10,53,60,1232,1625,361
2018,36081040300,"Census Tract 403, Queens County, New York",1690,62,1628,1327,5842,46995,1970,2011,1715,40.5,41,9,41,76,1242,1628,320
2019,36081040300,"Census Tract 403, Queens County, New York",1706,41,1665,1320,5822,53026,1968,2012,1757,38.1,54,10,0,103,1207,1665,206
2020,36081040301,"Census Tract 403.01, Queens County, New York",726,15,711,637,2827,52853,1959,2012,1570,42.7,17,0,17,76,561,711,53
2020,36081040302,"Census Tract 403.02, Queens County, New York",1022,13,1009,708,3146,58250,1970,2011,1736,35.2,19,0,0,99,609,1009,117
2012,36081040400,"Census Tract 404, Queens County, New York",1318,67,1251,519,1327,34448,1949,2002,1031,36.4,53,7,471,0,82,1251,109
2013,36081040400,"Census Tract 404, Queens County, New York",1328,63,1265,553,1507,34196,1951,2001,1022,37,52,5,509,0,25,1265,159
2014,36081040400,"Census Tract 404, Queens County, New York",1358,67,1291,576,1536,30962,1953,2002,1078,43,59,11,511,0,37,1291,200
2015,36081040400,"Census Tract 404, Queens County, New York",1363,45,1318,589,1661,31958,1955,2005,1143,39.4,70,12,499,0,62,1318,173
2016,36081040400,"Census Tract 404, Queens County, New York",1349,42,1307,558,1670,38400,1956,2007,1296,40.4,60,15,474,0,54,1307,166
2017,36081040400,"Census Tract 404, Queens County, New York",1362,65,1297,579,1641,43618,1955,2005,1340,34.1,22,9,488,0,56,1297,170
2018,36081040400,"Census Tract 404, Queens County, New York",1363,69,1294,584,1359,46310,1956,2008,1395,32.6,24,10,502,0,63,1294,134
2019,36081040400,"Census Tract 404, Queens County, New York",1353,96,1257,496,1187,50071,1956,2011,1363,31.4,73,8,421,0,59,1257,137
2020,36081040400,"Census Tract 404, Queens County, New York",1476,88,1388,563,1129,46986,1953,2011,1347,33.5,46,0,411,0,144,1388,214
2012,36081040500,"Census Tract 405, Queens County, New York",798,0,798,710,3294,49800,1944,2005,1433,31.1,30,14,35,14,672,798,139
2013,36081040500,"Census Tract 405, Queens County, New York",786,0,786,722,3249,50385,1944,2006,1533,35.3,41,15,29,15,680,786,174
2014,36081040500,"Census Tract 405, Queens County, New York",820,0,820,740,3333,45263,1953,2008,1512,38.6,16,6,47,15,719,820,208
2015,36081040500,"Census Tract 405, Queens County, New York",818,9,809,686,2926,38846,1955,2007,1388,41.6,17,11,43,28,659,809,199
2016,36081040500,"Census Tract 405, Queens County, New York",803,20,783,691,2987,45938,1955,2007,1392,41.3,29,6,53,20,666,783,195
2017,36081040500,"Census Tract 405, Queens County, New York",793,27,766,701,3117,48617,1964,2009,1490,41.2,44,5,77,18,668,766,155
2018,36081040500,"Census Tract 405, Queens County, New York",778,31,747,673,2956,52104,1967,2011,1563,39.2,48,6,70,56,632,747,151
2019,36081040500,"Census Tract 405, Queens County, New York",785,43,742,677,3119,60313,1964,2010,1723,33.2,50,5,63,81,609,742,124
2020,36081040501,"Census Tract 405.01, Queens County, New York",250,10,240,215,976,83456,1964,2008,1923,27.7,17,0,17,13,215,240,35
2020,36081040502,"Census Tract 405.02, Queens County, New York",482,14,468,418,1909,95938,1956,2011,1655,28.1,40,50,26,51,311,468,38
2012,36081040700,"Census Tract 407, Queens County, New York",1771,45,1726,1544,6114,45667,1949,2005,1226,30.2,31,38,112,63,1384,1726,278
2013,36081040700,"Census Tract 407, Queens County, New York",1863,80,1783,1534,5974,42786,1948,2006,1240,32.7,71,30,114,83,1347,1783,355
2014,36081040700,"Census Tract 407, Queens County, New York",1981,75,1906,1640,6420,36609,1951,2007,1299,34.2,67,24,134,80,1433,1906,361
2015,36081040700,"Census Tract 407, Queens County, New York",1989,74,1915,1580,6447,37500,1950,2009,1393,34.1,52,9,143,60,1422,1915,298
2016,36081040700,"Census Tract 407, Queens County, New York",2034,112,1922,1568,6968,42019,1949,2010,1434,34.3,91,31,101,69,1407,1922,345
2017,36081040700,"Census Tract 407, Queens County, New York",2071,104,1967,1618,7695,45129,1948,2009,1541,35.3,98,34,116,81,1427,1967,414
2018,36081040700,"Census Tract 407, Queens County, New York",2050,88,1962,1694,8273,50205,1948,2009,1602,34.9,66,27,103,84,1533,1962,366
2019,36081040700,"Census Tract 407, Queens County, New York",2070,80,1990,1711,8179,52599,1951,2010,1655,33.7,81,28,68,114,1523,1990,381
2020,36081040701,"Census Tract 407.01, Queens County, New York",904,14,890,878,3694,53144,1945,2010,1655,37.6,43,39,0,75,764,890,172
2020,36081040702,"Census Tract 407.02, Queens County, New York",1001,94,907,695,3762,83385,1950,2009,1846,28.9,65,0,43,39,602,907,137
2012,36081040900,"Census Tract 409, Queens County, New York",1292,139,1153,900,3752,43686,1953,2005,1261,38.1,63,9,88,64,789,1153,324
2013,36081040900,"Census Tract 409, Queens County, New York",1299,90,1209,947,3882,44940,1955,2005,1306,37.9,82,21,58,49,852,1209,321
2014,36081040900,"Census Tract 409, Queens County, New York",1326,100,1226,936,3872,45694,1956,2006,1332,37.1,73,25,62,69,826,1226,299
2015,36081040900,"Census Tract 409, Queens County, New York",1345,46,1299,990,4345,49830,1958,2006,1356,35.6,73,40,84,54,858,1299,252
2016,36081040900,"Census Tract 409, Queens County, New York",1364,103,1261,968,4336,50141,1954,2006,1440,38,67,51,66,51,844,1261,264
2017,36081040900,"Census Tract 409, Queens County, New York",1333,138,1195,929,3978,48527,1949,2006,1419,38.7,75,53,61,26,808,1195,281
2018,36081040900,"Census Tract 409, Queens County, New York",1343,132,1211,1016,4720,54423,1950,2006,1479,33.9,44,40,61,31,905,1211,307
2019,36081040900,"Census Tract 409, Queens County, New York",1319,148,1171,973,4703,54647,1950,2009,1727,33.5,52,50,56,54,813,1171,258
2020,36081040901,"Census Tract 409.01, Queens County, New York",396,72,324,210,1037,114196,0,2004,2023,23,9,29,0,38,143,324,54
2020,36081040902,"Census Tract 409.02, Queens County, New York",844,186,658,609,2917,66815,1958,2014,1840,30.1,32,0,19,0,590,658,103
2012,36081041100,"Census Tract 411, Queens County, New York",965,107,858,621,2435,37117,1956,2005,1404,41.9,54,0,31,73,531,858,253
2013,36081041100,"Census Tract 411, Queens County, New York",1000,112,888,631,2702,41314,1952,2005,1433,41.6,30,0,32,62,552,888,266
2014,36081041100,"Census Tract 411, Queens County, New York",1028,104,924,650,2942,41458,1953,2006,1414,40.4,59,0,43,46,582,924,294
2015,36081041100,"Census Tract 411, Queens County, New York",988,90,898,654,2962,45313,1952,2006,1395,34.2,55,0,39,84,552,898,204
2016,36081041100,"Census Tract 411, Queens County, New York",961,64,897,634,2919,46184,1949,2007,1432,34.3,46,0,58,89,533,897,181
2017,36081041100,"Census Tract 411, Queens County, New York",958,68,890,557,2830,48080,1951,2008,1626,41.1,31,0,32,81,476,890,174
2018,36081041100,"Census Tract 411, Queens County, New York",956,71,885,568,2680,51630,1948,2009,1673,35.5,42,0,32,105,463,885,139
2019,36081041100,"Census Tract 411, Queens County, New York",941,71,870,594,2663,59375,1943,2011,1788,31.1,14,0,32,104,490,870,119
2020,36081041100,"Census Tract 411, Queens County, New York",1137,57,1080,665,2283,46016,1962,2015,1841,34.4,17,0,34,72,593,1080,264
2012,36081041300,"Census Tract 413, Queens County, New York",1213,166,1047,708,3182,45625,1948,2006,1407,37.3,60,70,0,37,601,1047,214
2013,36081041300,"Census Tract 413, Queens County, New York",1131,112,1019,722,3240,43556,1947,2006,1425,40.5,83,60,0,62,600,1019,254
2014,36081041300,"Census Tract 413, Queens County, New York",1110,126,984,714,3586,50882,1948,2007,1568,37.8,64,38,0,54,622,984,214
2015,36081041300,"Census Tract 413, Queens County, New York",1112,121,991,693,3473,46612,1947,2009,1614,43.6,74,17,0,47,629,991,241
2016,36081041300,"Census Tract 413, Queens County, New York",1046,104,942,585,3096,45017,1946,2008,1632,47,40,9,0,54,522,942,287
2017,36081041300,"Census Tract 413, Queens County, New York",1015,69,946,592,3208,49028,1948,2009,1704,45.9,42,9,0,75,508,946,198
2018,36081041300,"Census Tract 413, Queens County, New York",1052,66,986,616,3415,52623,1954,2011,1804,44.9,21,0,0,58,558,986,172
2019,36081041300,"Census Tract 413, Queens County, New York",1026,25,1001,681,3420,51921,1962,2012,1715,44.9,51,6,0,69,606,1001,188
2020,36081041300,"Census Tract 413, Queens County, New York",1003,34,969,703,3637,55154,1983,2013,1833,45.1,77,7,29,54,613,969,185
2012,36081041400,"Census Tract 414, Queens County, New York",1338,234,1104,607,2037,37098,1956,2004,1277,43.6,76,20,550,0,68,1104,135
2013,36081041400,"Census Tract 414, Queens County, New York",1374,241,1133,637,1980,36264,1958,2005,1260,42.8,116,22,569,0,67,1133,183
2014,36081041400,"Census Tract 414, Queens County, New York",1409,210,1199,728,2090,36853,1956,2007,1319,44.1,163,24,635,0,91,1199,198
2015,36081041400,"Census Tract 414, Queens County, New York",1389,133,1256,738,1807,37071,1959,2010,1317,45.2,182,33,627,0,88,1256,219
2016,36081041400,"Census Tract 414, Queens County, New York",1432,127,1305,695,1771,41463,1957,2010,1331,35.6,233,31,540,0,128,1305,213
2017,36081041400,"Census Tract 414, Queens County, New York",1392,80,1312,713,1794,43218,1958,2011,1335,36.3,221,8,558,9,108,1312,262
2018,36081041400,"Census Tract 414, Queens County, New York",1430,75,1355,678,1632,46809,1957,2012,1409,37.3,180,4,488,16,165,1355,292
2019,36081041400,"Census Tract 414, Queens County, New York",1432,91,1341,563,1514,49526,1961,2012,1394,34.1,157,5,392,17,146,1341,255
2020,36081041400,"Census Tract 414, Queens County, New York",1470,87,1383,670,1984,75166,1952,2013,1409,24.8,295,0,524,20,76,1383,168
2012,36081041500,"Census Tract 415, Queens County, New York",1118,51,1067,816,2821,36102,1962,2004,1456,42.3,73,20,32,139,657,1067,253
2013,36081041500,"Census Tract 415, Queens County, New York",1149,75,1074,835,2637,33533,1956,2004,1421,50,48,58,31,131,646,1074,286
2014,36081041500,"Census Tract 415, Queens County, New York",1179,128,1051,709,2365,35293,1959,2005,1386,50,48,72,59,125,490,1051,199
2015,36081041500,"Census Tract 415, Queens County, New York",1157,109,1048,708,2452,35326,1971,2007,1410,46.7,64,68,37,95,524,1048,180
2016,36081041500,"Census Tract 415, Queens County, New York",1198,103,1095,806,3021,33750,1964,2008,1376,42.5,59,65,40,89,630,1095,236
2017,36081041500,"Census Tract 415, Queens County, New York",1189,100,1089,848,3330,40000,1961,2009,1454,41.1,67,89,39,84,655,1089,232
2018,36081041500,"Census Tract 415, Queens County, New York",1161,122,1039,717,2913,45365,1961,2009,1535,39.3,51,41,27,95,562,1039,180
2019,36081041500,"Census Tract 415, Queens County, New York",1154,78,1076,836,3554,50411,1965,2010,1611,38.1,65,34,19,96,706,1076,177
2020,36081041500,"Census Tract 415, Queens County, New York",1316,77,1239,893,3441,51250,1962,2011,1672,38.5,46,37,156,105,794,1239,152
2012,36081042400,"Census Tract 424, Queens County, New York",745,70,675,100,183,38929,1952,2002,979,45.9,25,0,100,0,0,675,40
2013,36081042400,"Census Tract 424, Queens County, New York",776,52,724,96,198,37763,1951,2002,982,50,21,0,96,0,0,724,60
2014,36081042400,"Census Tract 424, Queens County, New York",792,57,735,126,262,27500,1948,2001,1237,45.6,27,0,121,0,0,735,82
2015,36081042400,"Census Tract 424, Queens County, New York",796,25,771,113,272,17448,1944,2000,1304,50,16,0,107,0,0,771,80
2016,36081042400,"Census Tract 424, Queens County, New York",792,66,726,137,343,NA,1939,2006,1436,50,38,0,124,0,6,726,81
2017,36081042400,"Census Tract 424, Queens County, New York",798,96,702,81,174,38750,1939,2011,1416,29,38,0,68,0,6,702,53
2018,36081042400,"Census Tract 424, Queens County, New York",790,64,726,118,259,41750,1942,2007,1457,24.8,47,0,99,0,6,726,48
2019,36081042400,"Census Tract 424, Queens County, New York",821,78,743,113,307,40292,0,2011,1608,48.5,36,0,103,0,6,743,99
2020,36081042400,"Census Tract 424, Queens County, New York",878,75,803,152,420,42419,1947,2010,1339,40.3,50,0,136,0,5,803,115
2012,36081042600,"Census Tract 426, Queens County, New York",0,0,0,0,0,NA,NA,NA,NA,NA,0,0,0,0,0,0,0
2013,36081042600,"Census Tract 426, Queens County, New York",0,0,0,0,0,NA,NA,NA,NA,NA,0,0,0,0,0,0,0
2014,36081042600,"Census Tract 426, Queens County, New York",0,0,0,0,0,NA,NA,NA,NA,NA,0,0,0,0,0,0,0
2015,36081042600,"Census Tract 426, Queens County, New York",0,0,0,0,0,NA,NA,NA,NA,NA,0,0,0,0,0,0,0
2016,36081042600,"Census Tract 426, Queens County, New York",0,0,0,0,0,NA,NA,NA,NA,NA,0,0,0,0,0,0,0
2017,36081042600,"Census Tract 426, Queens County, New York",0,0,0,0,0,NA,NA,NA,NA,NA,0,0,0,0,0,0,0
2018,36081042600,"Census Tract 426, Queens County, New York",0,0,0,0,0,NA,NA,NA,NA,NA,0,0,0,0,0,0,0
2019,36081042600,"Census Tract 426, Queens County, New York",0,0,0,0,0,NA,NA,NA,NA,NA,0,0,0,0,0,0,0
2020,36081042600,"Census Tract 426, Queens County, New York",0,0,0,0,0,NA,NA,NA,NA,NA,0,0,0,0,0,0,0
2012,36081042700,"Census Tract 427, Queens County, New York",1231,48,1183,858,3384,41250,1951,2004,1405,37.9,62,84,51,78,696,1183,200
2013,36081042700,"Census Tract 427, Queens County, New York",1264,26,1238,930,3550,45500,1954,2005,1427,35.6,82,83,48,54,793,1238,264
2014,36081042700,"Census Tract 427, Queens County, New York",1292,29,1263,965,3757,41166,1954,2006,1465,41.6,93,85,40,85,795,1263,311
2015,36081042700,"Census Tract 427, Queens County, New York",1263,42,1221,938,3779,39087,1958,2008,1414,41,58,9,16,85,844,1221,329
2016,36081042700,"Census Tract 427, Queens County, New York",1318,62,1256,949,3808,41922,1958,2009,1504,38.6,40,16,15,32,901,1256,289
2017,36081042700,"Census Tract 427, Queens County, New York",1291,45,1246,901,3733,40938,1957,2010,1492,38.4,33,35,0,17,849,1246,303
2018,36081042700,"Census Tract 427, Queens County, New York",1279,62,1217,939,3987,44406,1958,2010,1632,39,21,37,19,25,877,1217,262
2019,36081042700,"Census Tract 427, Queens County, New York",1333,92,1241,991,4088,56339,1967,2010,1582,34.2,57,41,26,6,944,1241,206
2020,36081042700,"Census Tract 427, Queens County, New York",1428,56,1372,1095,3868,39779,1964,2015,1635,30.3,125,78,263,70,870,1372,344
2012,36081043200,"Census Tract 432, Queens County, New York",419,23,396,39,143,21250,1946,NA,1319,50,0,0,27,0,12,396,27
2013,36081043200,"Census Tract 432, Queens County, New York",433,21,412,48,192,51667,1949,2006,1375,30.4,12,0,38,0,10,412,10
2014,36081043200,"Census Tract 432, Queens County, New York",431,17,414,62,250,52273,1946,2007,1445,24.5,20,0,50,0,12,414,17
2015,36081043200,"Census Tract 432, Queens County, New York",426,27,399,65,233,52171,1953,2010,1550,25,29,0,65,0,0,399,5
2016,36081043200,"Census Tract 432, Queens County, New York",423,25,398,79,304,54875,1939,2011,1550,30.3,34,0,70,9,0,398,14
2017,36081043200,"Census Tract 432, Queens County, New York",433,35,398,89,319,51641,1944,2011,1413,30.8,32,0,70,9,0,398,18
2018,36081043200,"Census Tract 432, Queens County, New York",437,44,393,85,212,47083,0,2012,1351,29.8,24,0,68,8,0,393,25
2019,36081043200,"Census Tract 432, Queens County, New York",432,37,395,75,195,46875,0,2012,1446,31.3,17,0,57,8,0,395,20
2020,36081043200,"Census Tract 432, Queens County, New York",417,45,372,93,267,52708,0,2014,1673,33.4,23,0,67,8,0,372,25
2012,36081043400,"Census Tract 434, Queens County, New York",532,119,413,39,138,102212,1939,1996,1481,19.6,20,0,39,0,0,413,15
2013,36081043400,"Census Tract 434, Queens County, New York",553,96,457,84,174,30217,1944,2004,1795,50,6,0,75,0,0,457,21
2014,36081043400,"Census Tract 434, Queens County, New York",547,66,481,78,185,33056,1943,2004,1802,50,8,0,72,0,0,481,16
2015,36081043400,"Census Tract 434, Queens County, New York",528,46,482,87,151,24750,1946,2004,1678,50,6,0,82,0,0,482,24
2016,36081043400,"Census Tract 434, Queens County, New York",537,39,498,79,139,23750,1947,2005,1736,50,0,0,74,0,0,498,30
2017,36081043400,"Census Tract 434, Queens County, New York",527,51,476,73,116,30563,1949,2008,1671,50,5,0,59,0,0,476,31
2018,36081043400,"Census Tract 434, Queens County, New York",534,51,483,54,137,NA,1951,2014,1594,42.4,5,0,45,0,0,483,24
2019,36081043400,"Census Tract 434, Queens County, New York",548,45,503,73,164,NA,1954,2013,1500,41.7,6,0,61,0,0,503,36
2020,36081043400,"Census Tract 434, Queens County, New York",592,37,555,67,216,NA,1960,2009,1212,41.5,7,0,59,0,0,555,97
2012,36081043701,"Census Tract 437.01, Queens County, New York",843,71,772,433,1697,41114,1958,2007,1418,41,143,32,52,42,346,772,141
2013,36081043701,"Census Tract 437.01, Queens County, New York",893,59,834,545,2167,36577,1962,2007,1490,47.4,189,28,50,76,419,834,177
2014,36081043701,"Census Tract 437.01, Queens County, New York",903,7,896,615,2363,42962,1963,2009,1449,46.7,110,34,84,59,464,896,177
2015,36081043701,"Census Tract 437.01, Queens County, New York",893,16,877,592,2369,43250,1964,2009,1444,45.2,69,33,112,5,488,877,219
2016,36081043701,"Census Tract 437.01, Queens County, New York",866,41,825,605,2170,50750,1969,2009,1365,37.5,112,30,65,11,494,825,162
2017,36081043701,"Census Tract 437.01, Queens County, New York",810,43,767,581,2147,44243,1970,2009,1432,39.5,79,39,69,12,453,767,144
2018,36081043701,"Census Tract 437.01, Queens County, New York",794,58,736,547,1889,60481,1972,2010,1461,30.7,81,26,61,10,440,736,133
2019,36081043701,"Census Tract 437.01, Queens County, New York",767,76,691,491,1622,50625,1970,2010,1468,35.1,89,28,36,13,401,691,133
2020,36081043701,"Census Tract 437.01, Queens County, New York",767,65,702,547,2032,48264,1973,2012,1636,37.6,121,44,33,15,449,702,122
2012,36081043702,"Census Tract 437.02, Queens County, New York",2155,84,2071,1100,3526,40824,1958,2005,1413,50,129,55,223,141,700,2071,408
2013,36081043702,"Census Tract 437.02, Queens County, New York",2114,38,2076,1143,4175,43883,1957,2005,1451,44,153,100,137,107,820,2076,334
2014,36081043702,"Census Tract 437.02, Queens County, New York",2124,69,2055,989,3693,32314,1958,2006,1477,47.6,163,55,169,88,724,2055,365
2015,36081043702,"Census Tract 437.02, Queens County, New York",2237,63,2174,1094,4079,32031,1959,2007,1443,46.2,228,53,217,180,691,2174,420
2016,36081043702,"Census Tract 437.02, Queens County, New York",2329,90,2239,1101,3736,31145,1959,2006,1408,43.8,274,60,167,144,779,2239,427
2017,36081043702,"Census Tract 437.02, Queens County, New York",2305,91,2214,1340,4568,34125,1959,2008,1403,42,266,61,301,197,952,2214,382
2018,36081043702,"Census Tract 437.02, Queens County, New York",2437,152,2285,1384,4599,34915,1963,2009,1462,46.7,221,22,327,146,1083,2285,471
2019,36081043702,"Census Tract 437.02, Queens County, New York",2409,110,2299,1370,4873,36043,1965,2008,1459,42.3,162,88,218,121,1092,2299,433
2020,36081043702,"Census Tract 437.02, Queens County, New York",2319,210,2109,1284,4653,43349,1965,2008,1644,40.4,189,149,182,83,1022,2109,335
2012,36081043900,"Census Tract 439, Queens County, New York",1176,104,1072,831,3233,26728,1965,2006,1432,50,49,79,128,27,664,1072,392
2013,36081043900,"Census Tract 439, Queens County, New York",1195,86,1109,879,3517,26076,1967,2006,1496,50,55,135,65,9,705,1109,429
2014,36081043900,"Census Tract 439, Queens County, New York",1257,40,1217,910,3368,25000,1968,2007,1554,50,53,102,75,9,753,1217,453
2015,36081043900,"Census Tract 439, Queens County, New York",1280,44,1236,953,3668,30094,1962,2008,1440,50,37,53,71,22,878,1236,448
2016,36081043900,"Census Tract 439, Queens County, New York",1245,58,1187,822,3282,35938,1964,2009,1488,50,37,43,16,18,761,1187,266
2017,36081043900,"Census Tract 439, Queens County, New York",1230,76,1154,747,2853,33098,1967,2011,1466,50,64,44,29,42,650,1154,318
2018,36081043900,"Census Tract 439, Queens County, New York",1230,86,1144,727,2518,33430,1967,2012,1448,51,43,32,30,40,644,1144,284
2019,36081043900,"Census Tract 439, Queens County, New York",1219,110,1109,810,2704,31094,1971,2012,1485,51,40,46,33,46,704,1109,355
2020,36081043900,"Census Tract 439, Queens County, New York",1101,94,1007,774,2678,35931,1965,2012,1674,51,49,55,32,32,670,1007,253
2012,36081044000,"Census Tract 440, Queens County, New York",1328,259,1069,564,2074,43056,1947,2005,1390,44.2,60,0,434,25,48,1069,201
2013,36081044000,"Census Tract 440, Queens County, New York",1317,244,1073,527,2054,44028,1944,2006,1358,32.8,59,0,409,29,21,1073,165
2014,36081044000,"Census Tract 440, Queens County, New York",1325,271,1054,492,1838,39722,1945,2006,1327,33.9,19,0,411,17,19,1054,179
2015,36081044000,"Census Tract 440, Queens County, New York",1321,273,1048,417,1545,38750,1969,2008,1397,37.7,45,0,344,19,30,1048,171
2016,36081044000,"Census Tract 440, Queens County, New York",1285,218,1067,393,1413,41513,1939,2009,1440,34.2,64,0,336,18,26,1067,142
2017,36081044000,"Census Tract 440, Queens County, New York",1273,171,1102,429,1600,45083,1951,2010,1547,33.9,55,0,383,0,28,1102,157
2018,36081044000,"Census Tract 440, Queens County, New York",1235,138,1097,414,1473,53088,1963,2013,1554,33.3,40,16,333,17,31,1097,127
2019,36081044000,"Census Tract 440, Queens County, New York",1227,113,1114,527,1950,68594,1960,2013,1546,28.9,64,19,420,35,33,1114,116
2020,36081044000,"Census Tract 440, Queens County, New York",1203,75,1128,685,2649,53897,1955,2014,1678,30.9,90,15,461,95,97,1128,100
2012,36081044301,"Census Tract 443.01, Queens County, New York",1561,155,1406,1289,3070,19767,1981,2001,920,37.9,285,115,191,355,684,1406,563
2013,36081044301,"Census Tract 443.01, Queens County, New York",1592,187,1405,1245,3138,22462,1983,2002,919,41.3,211,102,205,281,729,1405,634
2014,36081044301,"Census Tract 443.01, Queens County, New York",1594,175,1419,1230,2954,17704,1981,2005,681,38.2,157,62,175,292,738,1419,691
2015,36081044301,"Census Tract 443.01, Queens County, New York",1522,181,1341,1171,3066,18324,1985,2007,673,43.9,99,65,164,266,732,1341,669
2016,36081044301,"Census Tract 443.01, Queens County, New York",1496,219,1277,1043,2539,18407,1983,2007,767,37.6,144,74,115,242,627,1277,527
2017,36081044301,"Census Tract 443.01, Queens County, New York",1463,223,1240,1017,2676,21321,1983,2009,881,37.3,83,37,117,187,682,1240,511
2018,36081044301,"Census Tract 443.01, Queens County, New York",1457,216,1241,1056,2896,19110,1985,2010,783,34,105,51,157,175,680,1241,513
2019,36081044301,"Census Tract 443.01, Queens County, New York",1465,196,1269,1180,3274,20000,1983,2011,931,34.8,102,91,182,89,832,1269,556
2020,36081044301,"Census Tract 443.01, Queens County, New York",1399,155,1244,1166,3378,22000,1986,2012,935,31.8,152,72,166,217,769,1244,497
2012,36081044302,"Census Tract 443.02, Queens County, New York",1394,117,1277,790,2806,37643,1967,2004,1362,36.9,65,15,138,353,296,1277,246
2013,36081044302,"Census Tract 443.02, Queens County, New York",1446,118,1328,864,3046,45500,1967,2004,1378,33.5,84,13,153,327,371,1328,256
2014,36081044302,"Census Tract 443.02, Queens County, New York",1489,203,1286,833,3009,44978,1966,2004,1369,31.7,82,33,168,241,391,1286,228
2015,36081044302,"Census Tract 443.02, Queens County, New York",1460,164,1296,873,3220,49125,1966,2004,1432,31.5,105,19,192,217,445,1296,245
2016,36081044302,"Census Tract 443.02, Queens County, New York",1513,156,1357,927,3209,46434,1961,2006,1422,32.3,133,45,152,245,527,1357,310
2017,36081044302,"Census Tract 443.02, Queens County, New York",1485,203,1282,787,2587,46694,1962,2006,1294,30.6,130,45,164,185,412,1282,275
2018,36081044302,"Census Tract 443.02, Queens County, New York",1507,247,1260,771,2427,43207,1966,2007,1304,31.4,119,61,139,204,393,1260,287
2019,36081044302,"Census Tract 443.02, Queens County, New York",1471,204,1267,802,2297,40000,1967,2010,1339,33.3,178,41,182,246,400,1267,320
2020,36081044302,"Census Tract 443.02, Queens County, New York",1429,207,1222,805,2541,47104,1961,2012,1465,32,192,47,131,233,462,1222,247
2012,36081044400,"Census Tract 444, Queens County, New York",930,76,854,600,1511,17188,1952,2005,1063,43.5,33,3,238,117,179,854,255
2013,36081044400,"Census Tract 444, Queens County, New York",952,82,870,601,1623,19036,1946,2006,1064,39.6,42,3,210,134,197,870,210
2014,36081044400,"Census Tract 444, Queens County, New York",1055,107,948,700,1869,17802,1964,2007,1050,37.6,77,26,188,140,300,948,270
2015,36081044400,"Census Tract 444, Queens County, New York",1045,79,966,736,1971,19842,1970,2007,1088,35.1,99,27,198,95,364,966,216
2016,36081044400,"Census Tract 444, Queens County, New York",1047,75,972,710,1946,25114,1959,2008,1247,34,122,28,203,93,322,972,212
2017,36081044400,"Census Tract 444, Queens County, New York",1058,78,980,680,1872,33750,1949,2009,1141,33,161,24,190,75,322,980,189
2018,36081044400,"Census Tract 444, Queens County, New York",1015,72,943,688,2079,35078,1972,2011,1411,34.4,162,25,148,132,311,943,236
2019,36081044400,"Census Tract 444, Queens County, New York",1019,84,935,677,2092,36178,1971,2010,1461,31.1,167,0,200,167,247,935,228
2020,36081044400,"Census Tract 444, Queens County, New York",1056,66,990,667,1933,35320,1951,2012,1109,30.7,116,0,267,187,160,990,237
2012,36081044601,"Census Tract 446.01, Queens County, New York",1245,62,1183,992,2517,34375,1956,2002,1116,35.7,219,20,368,161,463,1183,290
2013,36081044601,"Census Tract 446.01, Queens County, New York",1241,86,1155,949,2768,38036,1958,2003,1132,30.8,190,9,310,175,458,1155,210
2014,36081044601,"Census Tract 446.01, Queens County, New York",1248,55,1193,995,2847,35987,1957,2005,1140,32.8,119,26,349,171,460,1193,280
2015,36081044601,"Census Tract 446.01, Queens County, New York",1242,88,1154,956,2707,35259,1958,2006,1182,33.9,166,27,280,170,464,1154,266
2016,36081044601,"Census Tract 446.01, Queens County, New York",1273,70,1203,967,2730,31803,1962,2006,1164,35,170,48,238,194,453,1203,292
2017,36081044601,"Census Tract 446.01, Queens County, New York",1288,67,1221,1057,3340,38368,1958,2005,1219,32.2,236,40,364,153,474,1221,253
2018,36081044601,"Census Tract 446.01, Queens County, New York",1317,61,1256,1028,2604,34449,1961,2006,1312,34.4,210,42,446,144,371,1256,251
2019,36081044601,"Census Tract 446.01, Queens County, New York",1344,105,1239,999,2767,36250,1963,2006,1351,35.1,255,23,414,121,399,1239,195
2020,36081044601,"Census Tract 446.01, Queens County, New York",1287,109,1178,943,2896,38807,1961,2005,1382,34.3,201,25,381,139,359,1178,142
2012,36081044602,"Census Tract 446.02, Queens County, New York",1403,45,1358,1175,3414,34250,1953,2004,1125,44.9,271,27,475,272,337,1358,380
2013,36081044602,"Census Tract 446.02, Queens County, New York",1409,46,1363,1162,3663,38141,1955,2004,1177,39,285,28,432,252,394,1363,422
2014,36081044602,"Census Tract 446.02, Queens County, New York",1470,66,1404,1237,3994,37257,1958,2005,1208,42,300,10,449,338,394,1404,491
2015,36081044602,"Census Tract 446.02, Queens County, New York",1472,68,1404,1209,3840,38221,1958,2004,1212,37.6,283,0,411,343,416,1404,486
2016,36081044602,"Census Tract 446.02, Queens County, New York",1463,98,1365,1163,3483,37788,1963,2005,1206,36.1,311,0,429,333,364,1365,471
2017,36081044602,"Census Tract 446.02, Queens County, New York",1463,117,1346,1161,3474,38176,1961,2006,1283,39.3,354,19,329,397,337,1346,421
2018,36081044602,"Census Tract 446.02, Queens County, New York",1441,94,1347,1171,3562,36901,1961,2007,1313,42.3,329,15,261,468,359,1347,415
2019,36081044602,"Census Tract 446.02, Queens County, New York",1436,45,1391,1199,3806,36017,1958,2009,1393,42.7,427,17,297,555,274,1391,387
2020,36081044602,"Census Tract 446.02, Queens County, New York",1408,40,1368,1172,3940,37692,1960,2011,1434,43.8,451,14,241,604,255,1368,382
2012,36081044800,"Census Tract 448, Queens County, New York",801,53,748,412,1225,48182,1948,2004,1281,35.7,131,19,101,139,127,748,103
2013,36081044800,"Census Tract 448, Queens County, New York",827,32,795,461,1463,43009,1939,2005,1293,37.5,103,21,87,177,149,795,143
2014,36081044800,"Census Tract 448, Queens County, New York",824,50,774,507,1492,43150,1942,2005,1336,40.2,180,9,123,222,131,774,138
2015,36081044800,"Census Tract 448, Queens County, New York",808,90,718,418,1398,49914,1946,2007,1419,43.7,205,0,99,196,76,718,131
2016,36081044800,"Census Tract 448, Queens County, New York",837,75,762,401,1562,63229,1939,2009,1395,31.4,216,5,76,188,106,762,109
2017,36081044800,"Census Tract 448, Queens County, New York",823,93,730,429,1722,49006,1940,2011,1481,33.8,194,7,64,193,108,730,136
2018,36081044800,"Census Tract 448, Queens County, New York",823,82,741,438,1769,51466,1955,2011,1609,38.1,172,7,61,200,104,741,142
2019,36081044800,"Census Tract 448, Queens County, New York",803,73,730,416,1693,50600,1961,2012,1589,34.3,129,15,45,197,88,730,122
2020,36081044800,"Census Tract 448, Queens County, New York",889,48,841,554,1729,48542,1962,2012,1783,37.8,121,14,155,232,110,841,115
2012,36081045000,"Census Tract 450, Queens County, New York",553,33,520,196,514,36852,1941,2004,1333,44.6,106,42,9,63,42,520,72
2013,36081045000,"Census Tract 450, Queens County, New York",570,23,547,191,566,40139,1942,2004,1373,43,83,55,0,56,43,547,77
2014,36081045000,"Census Tract 450, Queens County, New York",574,46,528,211,639,39464,1939,2005,1366,45.4,79,62,0,76,54,528,56
2015,36081045000,"Census Tract 450, Queens County, New York",579,44,535,197,604,50670,1939,2006,1291,33.5,58,59,0,78,64,535,35
2016,36081045000,"Census Tract 450, Queens County, New York",598,20,578,238,848,51042,1939,2009,1426,34.4,80,49,0,89,99,578,53
2017,36081045000,"Census Tract 450, Queens County, New York",592,30,562,220,819,60962,1939,2011,1622,25.6,57,55,9,63,105,562,38
2018,36081045000,"Census Tract 450, Queens County, New York",565,32,533,174,657,64615,1942,2012,1602,24.9,42,28,12,71,75,533,24
2019,36081045000,"Census Tract 450, Queens County, New York",571,11,560,170,636,73409,1943,2013,1652,24.6,54,33,14,50,73,560,32
2020,36081045000,"Census Tract 450, Queens County, New York",575,11,564,215,815,69875,1957,2014,1530,26.9,56,29,70,65,51,564,36
2012,36081045200,"Census Tract 452, Queens County, New York",265,27,238,151,518,42188,1950,2003,1220,28.5,27,17,24,59,41,238,63
2013,36081045200,"Census Tract 452, Queens County, New York",188,9,179,153,564,24659,1954,2003,1310,31.9,32,8,25,63,46,179,69
2014,36081045200,"Census Tract 452, Queens County, New York",167,9,158,103,374,41750,1965,2004,1293,36.6,59,7,26,60,10,158,29
2015,36081045200,"Census Tract 452, Queens County, New York",172,9,163,106,399,NA,1964,2003,1250,36.8,58,12,20,65,9,163,29
2016,36081045200,"Census Tract 452, Queens County, New York",194,10,184,117,447,46932,1964,2007,1455,35.2,92,12,21,61,10,184,26
2017,36081045200,"Census Tract 452, Queens County, New York",154,0,154,100,384,46750,1965,2009,1435,39.5,81,8,16,59,5,154,25
2018,36081045200,"Census Tract 452, Queens County, New York",197,0,197,91,324,54688,1964,2011,1478,36.3,79,8,4,64,5,197,14
2019,36081045200,"Census Tract 452, Queens County, New York",218,0,218,88,369,64500,1964,2010,1536,31.8,70,9,5,59,5,218,28
2020,36081045200,"Census Tract 452, Queens County, New York",187,0,187,74,343,93500,1965,2010,1773,31,62,4,0,54,6,187,26
2012,36081045400,"Census Tract 454, Queens County, New York",1525,0,1525,847,2415,34661,1955,2005,1335,42,448,73,190,416,160,1525,236
2013,36081045400,"Census Tract 454, Queens County, New York",1482,0,1482,759,2265,55179,1951,2005,1382,40.3,376,55,144,352,111,1482,210
2014,36081045400,"Census Tract 454, Queens County, New York",1521,22,1499,920,2799,53226,1953,2006,1280,39.4,440,34,177,539,84,1499,231
2015,36081045400,"Census Tract 454, Queens County, New York",1498,23,1475,849,2531,43550,1953,2008,1490,42.2,340,16,199,515,92,1475,181
2016,36081045400,"Census Tract 454, Queens County, New York",1512,59,1453,811,2557,48542,1954,2009,1616,45.4,356,18,167,514,104,1453,181
2017,36081045400,"Census Tract 454, Queens County, New York",1557,103,1454,814,2592,37500,1954,2010,1622,46.6,288,34,161,477,80,1454,170
2018,36081045400,"Census Tract 454, Queens County, New York",1594,123,1471,821,2669,38906,1958,2012,1609,46.3,275,37,169,505,62,1471,216
2019,36081045400,"Census Tract 454, Queens County, New York",1538,125,1413,771,2845,44963,1959,2014,1701,44.9,311,39,129,505,59,1413,188
2020,36081045400,"Census Tract 454, Queens County, New York",1570,139,1431,765,2948,52768,1962,2015,1776,36.2,395,23,106,462,23,1431,174
2012,36081045500,"Census Tract 455, Queens County, New York",4620,120,4500,4479,12400,49713,1964,1999,1229,30.6,888,917,2318,58,1131,4500,655
2013,36081045500,"Census Tract 455, Queens County, New York",4683,109,4574,4550,13026,50161,1963,2001,1329,31.5,794,903,2387,42,1190,4574,839
2014,36081045500,"Census Tract 455, Queens County, New York",4721,97,4624,4598,12882,48481,1963,2001,1387,33.6,798,790,2703,73,1014,4624,761
2015,36081045500,"Census Tract 455, Queens County, New York",4769,176,4593,4564,12898,46417,1962,2001,1398,34.2,790,842,2692,139,860,4593,832
2016,36081045500,"Census Tract 455, Queens County, New York",4894,272,4622,4622,14196,47620,1964,2005,1451,34.2,908,711,2415,197,1297,4622,782
2017,36081045500,"Census Tract 455, Queens County, New York",4887,226,4661,4661,15041,48625,1964,2006,1530,32.9,1173,624,2350,540,1212,4661,688
2018,36081045500,"Census Tract 455, Queens County, New York",4977,251,4726,4726,14908,48620,1963,2006,1560,32.3,1192,501,1893,720,1638,4726,838
2019,36081045500,"Census Tract 455, Queens County, New York",4965,265,4700,4700,14275,48889,1963,2005,1583,31,1156,548,1864,687,1628,4700,938
2020,36081045500,"Census Tract 455, Queens County, New York",4712,201,4511,4511,14211,58984,1964,2007,1665,29.4,1427,497,1727,771,1567,4511,813
2012,36081045600,"Census Tract 456, Queens County, New York",375,7,368,105,297,45216,1953,2005,1484,50,60,39,5,34,2,368,45
2013,36081045600,"Census Tract 456, Queens County, New York",384,8,376,111,375,46615,1950,2006,1598,45.7,66,33,19,56,7,376,34
2014,36081045600,"Census Tract 456, Queens County, New York",368,16,352,94,347,51250,1939,2008,1589,46.3,37,3,20,67,8,352,40
2015,36081045600,"Census Tract 456, Queens County, New York",347,20,327,106,381,35938,1943,2011,1634,47.1,30,3,24,60,24,327,49
2016,36081045600,"Census Tract 456, Queens County, New York",328,12,316,124,492,39286,1951,2011,1694,48.3,37,5,31,65,30,316,46
2017,36081045600,"Census Tract 456, Queens County, New York",364,23,341,130,517,52000,1948,2010,1646,41.4,50,5,18,80,21,341,51
2018,36081045600,"Census Tract 456, Queens County, New York",355,22,333,93,378,59688,1944,2010,1612,32.8,39,5,0,54,20,333,44
2019,36081045600,"Census Tract 456, Queens County, New York",360,10,350,97,416,73021,1944,2009,1631,29.9,51,4,0,59,19,350,45
2020,36081045600,"Census Tract 456, Queens County, New York",461,19,442,50,229,NA,1944,2009,1583,28.9,28,4,0,31,1,442,40
2012,36081045700,"Census Tract 457, Queens County, New York",1176,148,1028,507,1565,45592,1963,2004,1254,32.2,184,113,0,250,115,1028,133
2013,36081045700,"Census Tract 457, Queens County, New York",1163,172,991,424,1248,41000,1959,2006,1315,33.8,132,107,0,215,93,991,162
2014,36081045700,"Census Tract 457, Queens County, New York",1161,195,966,389,1034,39932,1964,2006,1365,41.6,112,73,0,211,95,966,145
2015,36081045700,"Census Tract 457, Queens County, New York",1177,217,960,438,1166,43421,1969,2007,1413,42.8,118,59,0,242,126,960,164
2016,36081045700,"Census Tract 457, Queens County, New York",1169,213,956,521,1478,40813,1970,2008,1314,46.3,111,34,0,316,154,956,190
2017,36081045700,"Census Tract 457, Queens County, New York",1190,239,951,474,1553,48643,1970,2009,1541,44.6,74,43,0,264,167,951,154
2018,36081045700,"Census Tract 457, Queens County, New York",1187,253,934,477,1461,50489,1970,2009,1602,42.4,147,50,0,268,159,934,131
2019,36081045700,"Census Tract 457, Queens County, New York",1245,247,998,553,1850,56250,1966,2011,1572,29.6,169,48,0,292,213,998,102
2020,36081045700,"Census Tract 457, Queens County, New York",1209,154,1055,617,2181,65938,1962,2012,1627,26,202,59,0,307,224,1055,104
2012,36081045800,"Census Tract 458, Queens County, New York",709,56,653,409,1494,46406,1955,2004,1250,29.4,185,32,79,184,86,653,113
2013,36081045800,"Census Tract 458, Queens County, New York",718,51,667,425,1526,36583,1951,2004,1217,36.9,223,39,42,255,63,667,121
2014,36081045800,"Census Tract 458, Queens County, New York",720,60,660,425,1357,34023,1950,2005,1184,36.6,223,51,54,207,64,660,107
2015,36081045800,"Census Tract 458, Queens County, New York",709,55,654,433,1412,34094,1955,2009,1246,39.4,259,41,48,261,42,654,84
2016,36081045800,"Census Tract 458, Queens County, New York",722,59,663,388,1324,44405,1956,2011,1378,35.6,218,28,49,235,36,663,50
2017,36081045800,"Census Tract 458, Queens County, New York",727,27,700,425,1311,42772,1957,2012,1402,38.2,260,61,59,250,28,700,58
2018,36081045800,"Census Tract 458, Queens County, New York",733,29,704,421,1264,44375,1957,2012,1395,37.5,230,56,69,226,38,704,46
2019,36081045800,"Census Tract 458, Queens County, New York",733,40,693,374,1161,43636,1959,2012,1485,40.4,208,46,72,216,46,693,32
2020,36081045800,"Census Tract 458, Queens County, New York",719,54,665,363,1092,45673,1955,2014,1485,40.4,213,33,112,199,19,665,26
2012,36081045900,"Census Tract 459, Queens County, New York",1230,81,1149,824,2852,57095,1961,2005,1414,29.3,281,42,0,386,374,1149,154
2013,36081045900,"Census Tract 459, Queens County, New York",1245,105,1140,806,2694,46622,1957,2005,1408,31,257,38,0,410,330,1140,230
2014,36081045900,"Census Tract 459, Queens County, New York",1272,140,1132,789,2734,48973,1953,2007,1418,32,293,19,0,370,373,1132,220
2015,36081045900,"Census Tract 459, Queens County, New York",1275,174,1101,770,2623,51284,1950,2007,1475,30,343,35,0,346,363,1101,225
2016,36081045900,"Census Tract 459, Queens County, New York",1261,209,1052,669,2139,50607,1951,2007,1533,35.8,286,35,5,337,279,1052,193
2017,36081045900,"Census Tract 459, Queens County, New York",1258,258,1000,647,2327,55048,1948,2010,1613,32.2,286,36,9,323,282,1000,190
2018,36081045900,"Census Tract 459, Queens County, New York",1214,237,977,605,2080,54160,1947,2011,1728,35.8,273,27,10,283,289,977,129
2019,36081045900,"Census Tract 459, Queens County, New York",1164,188,976,554,1916,60375,1952,2013,1785,32.4,234,28,9,266,252,976,110
2020,36081045900,"Census Tract 459, Queens County, New York",1149,150,999,587,2279,70917,1959,2015,1974,30.5,260,19,10,311,248,999,124
2012,36081046000,"Census Tract 460, Queens County, New York",2068,135,1933,1687,5077,27105,1951,2004,1134,46.6,414,28,464,535,581,1933,569
2013,36081046000,"Census Tract 460, Queens County, New York",2079,156,1923,1638,5187,25847,1952,2004,1150,50,362,37,424,458,575,1923,737
2014,36081046000,"Census Tract 460, Queens County, New York",2092,133,1959,1665,5026,25291,1956,2005,1163,50,365,37,493,410,595,1959,655
2015,36081046000,"Census Tract 460, Queens County, New York",2077,172,1905,1624,4848,27215,1959,2006,1176,50,364,21,539,502,514,1905,603
2016,36081046000,"Census Tract 460, Queens County, New York",2079,188,1891,1640,5006,27632,1957,2007,1220,50,393,26,551,499,529,1891,584
2017,36081046000,"Census Tract 460, Queens County, New York",2093,247,1846,1618,5304,30851,1953,2008,1311,43.7,327,26,474,480,622,1846,482
2018,36081046000,"Census Tract 460, Queens County, New York",2091,180,1911,1680,5354,37905,1955,2010,1361,38.8,392,27,515,527,639,1911,345
2019,36081046000,"Census Tract 460, Queens County, New York",2077,164,1913,1686,5286,43977,1956,2011,1408,36.6,411,28,484,599,576,1913,321
2020,36081046000,"Census Tract 460, Queens County, New York",2055,116,1939,1622,5182,49167,1960,2012,1452,34.6,519,8,411,605,550,1939,200
2012,36081046100,"Census Tract 461, Queens County, New York",916,79,837,559,1912,47179,1958,2005,1385,36.8,123,12,12,184,351,837,157
2013,36081046100,"Census Tract 461, Queens County, New York",914,62,852,614,2223,46570,1960,2006,1478,37,129,12,0,219,383,852,134
2014,36081046100,"Census Tract 461, Queens County, New York",887,66,821,602,2363,43013,1956,2006,1602,40.3,139,32,0,278,292,821,166
2015,36081046100,"Census Tract 461, Queens County, New York",845,70,775,563,2114,41688,1957,2007,1544,41.9,80,27,0,246,290,775,189
2016,36081046100,"Census Tract 461, Queens County, New York",816,97,719,521,1896,42629,1955,2008,1595,38.3,77,44,0,244,240,719,171
2017,36081046100,"Census Tract 461, Queens County, New York",810,105,705,496,1923,50909,1958,2010,1638,38.3,62,41,0,200,262,705,143
2018,36081046100,"Census Tract 461, Queens County, New York",819,115,704,488,1757,51905,1958,2010,1701,39,59,46,0,187,262,704,143
2019,36081046100,"Census Tract 461, Queens County, New York",803,113,690,487,1746,61528,1960,2012,1766,35.7,48,41,0,163,285,690,91
2020,36081046100,"Census Tract 461, Queens County, New York",798,87,711,538,1961,58594,1959,2013,1828,36.3,57,41,0,147,341,711,68
2012,36081046200,"Census Tract 462, Queens County, New York",2173,94,2079,1273,4294,40223,1956,2004,1323,40.4,132,21,264,420,517,2079,585
2013,36081046200,"Census Tract 462, Queens County, New York",2210,91,2119,1305,5190,42849,1961,2005,1332,39.8,211,26,225,383,617,2119,586
2014,36081046200,"Census Tract 462, Queens County, New York",2225,68,2157,1512,5995,43929,1965,2006,1328,41.4,220,49,237,471,585,2157,521
2015,36081046200,"Census Tract 462, Queens County, New York",2166,71,2095,1501,6137,45758,1964,2007,1323,41,255,38,165,571,574,2095,303
2016,36081046200,"Census Tract 462, Queens County, New York",2199,65,2134,1602,6618,45192,1963,2008,1388,40,318,73,173,595,574,2134,319
2017,36081046200,"Census Tract 462, Queens County, New York",2171,130,2041,1631,6432,48538,1965,2011,1496,39,333,72,228,592,544,2041,286
2018,36081046200,"Census Tract 462, Queens County, New York",2170,126,2044,1587,5179,49085,1965,2010,1524,36.1,330,70,219,531,548,2044,257
2019,36081046200,"Census Tract 462, Queens County, New York",2245,166,2079,1523,4946,49329,1965,2010,1641,36.2,389,53,182,550,616,2079,260
2020,36081046200,"Census Tract 462, Queens County, New York",2384,240,2144,1527,4314,59923,1965,2011,1772,44,294,69,249,696,383,2144,267
2012,36081046300,"Census Tract 463, Queens County, New York",1211,248,963,801,2796,37468,1954,2004,1331,41.7,143,0,11,319,477,963,273
2013,36081046300,"Census Tract 463, Queens County, New York",1206,187,1019,794,2666,28750,1953,2004,1350,48,139,0,11,309,481,1019,325
2014,36081046300,"Census Tract 463, Queens County, New York",1221,187,1034,834,2857,36512,1951,2005,1376,43.8,112,0,10,268,553,1034,276
2015,36081046300,"Census Tract 463, Queens County, New York",1232,169,1063,770,2771,36207,1953,2006,1437,47.1,87,0,0,262,492,1063,276
2016,36081046300,"Census Tract 463, Queens County, New York",1228,219,1009,693,2555,37406,1953,2007,1466,47.8,70,0,0,218,467,1009,234
2017,36081046300,"Census Tract 463, Queens County, New York",1207,133,1074,687,2594,37757,1952,2009,1490,49,78,14,0,192,470,1074,248
2018,36081046300,"Census Tract 463, Queens County, New York",1191,158,1033,684,2279,50060,1950,2009,1622,39.7,88,15,0,179,481,1033,148
2019,36081046300,"Census Tract 463, Queens County, New York",1190,154,1036,629,2091,54180,1954,2011,1720,42.2,76,10,0,195,409,1036,126
2020,36081046300,"Census Tract 463, Queens County, New York",1185,165,1020,648,2101,55333,1951,2012,1726,43,40,33,0,117,485,1020,125
2012,36081046400,"Census Tract 464, Queens County, New York",595,14,581,170,331,68611,1962,2001,1342,20.2,128,40,6,43,49,581,12
2013,36081046400,"Census Tract 464, Queens County, New York",604,53,551,204,434,63986,1957,2003,1347,22.6,110,30,38,38,81,551,23
2014,36081046400,"Census Tract 464, Queens County, New York",570,85,485,175,416,58558,1950,2007,1320,20.6,86,29,37,37,78,485,32
2015,36081046400,"Census Tract 464, Queens County, New York",576,95,481,175,450,60750,1948,2010,1360,23.3,85,44,21,29,80,481,43
2016,36081046400,"Census Tract 464, Queens County, New York",553,104,449,218,567,46000,1950,2011,1420,35.7,77,48,43,38,90,449,41
2017,36081046400,"Census Tract 464, Queens County, New York",534,99,435,230,617,45789,1949,2011,1424,40,93,40,58,43,96,435,49
2018,36081046400,"Census Tract 464, Queens County, New York",515,72,443,261,711,57604,1952,2012,1680,34.3,129,73,70,40,69,443,56
2019,36081046400,"Census Tract 464, Queens County, New York",571,43,528,310,895,63824,1956,2013,1791,32.1,117,61,79,80,91,528,52
2020,36081046400,"Census Tract 464, Queens County, New York",563,26,537,292,826,59091,1963,2015,1767,42,92,42,90,63,80,537,57
2012,36081046500,"Census Tract 465, Queens County, New York",1098,43,1055,883,2967,39904,1945,2004,1343,40.5,45,69,0,69,745,1055,163
2013,36081046500,"Census Tract 465, Queens County, New York",1104,69,1035,865,3053,37768,1946,2005,1336,41.1,50,75,0,53,737,1035,168
2014,36081046500,"Census Tract 465, Queens County, New York",1053,50,1003,803,2847,35066,1948,2007,1421,42.6,111,77,0,59,667,1003,140
2015,36081046500,"Census Tract 465, Queens County, New York",1006,81,925,755,2849,39414,1942,2008,1431,40.1,78,44,0,75,636,925,183
2016,36081046500,"Census Tract 465, Queens County, New York",1015,109,906,731,2404,28708,1939,2010,1375,46,96,29,0,64,638,906,249
2017,36081046500,"Census Tract 465, Queens County, New York",934,111,823,651,2333,31397,1939,2011,1481,46.3,72,28,0,65,558,823,213
2018,36081046500,"Census Tract 465, Queens County, New York",960,84,876,661,2419,43912,0,2012,1548,40.5,86,12,0,104,545,876,172
2019,36081046500,"Census Tract 465, Queens County, New York",1055,83,972,738,2950,52857,1944,2012,1659,35.3,46,13,0,78,647,972,176
2020,36081046500,"Census Tract 465, Queens County, New York",1029,53,976,701,2786,57202,1952,2014,1651,33.1,68,0,0,55,639,976,89
2012,36081046600,"Census Tract 466, Queens County, New York",1410,116,1294,827,1917,53988,1956,2004,1428,31.5,429,213,236,201,135,1294,140
2013,36081046600,"Census Tract 466, Queens County, New York",1461,89,1372,953,2534,45164,1956,2005,1451,39.4,446,212,321,210,169,1372,167
2014,36081046600,"Census Tract 466, Queens County, New York",1458,56,1402,1028,2638,45078,1956,2007,1510,39.4,465,188,394,216,236,1402,148
2015,36081046600,"Census Tract 466, Queens County, New York",1446,55,1391,1059,2758,46835,1958,2007,1553,36.9,498,176,363,314,212,1391,163
2016,36081046600,"Census Tract 466, Queens County, New York",1483,69,1414,1010,2638,50805,1957,2009,1567,36.3,547,130,392,314,196,1414,118
2017,36081046600,"Census Tract 466, Queens County, New York",1473,89,1384,932,2644,48929,1957,2008,1617,39,423,103,349,269,224,1384,97
2018,36081046600,"Census Tract 466, Queens County, New York",1489,132,1357,910,2265,53627,1957,2010,1627,34,422,136,345,272,162,1357,58
2019,36081046600,"Census Tract 466, Queens County, New York",1501,145,1356,853,2547,60298,1956,2013,1705,35.4,364,95,270,303,157,1356,121
2020,36081046600,"Census Tract 466, Queens County, New York",1489,181,1308,857,2776,62522,1962,2015,1799,35.2,360,77,326,285,131,1308,125
2012,36081046700,"Census Tract 467, Queens County, New York",2252,142,2110,1832,5480,50250,1950,2003,1214,33.1,349,132,41,422,1242,2110,528
2013,36081046700,"Census Tract 467, Queens County, New York",2257,213,2044,1784,5550,44688,1948,2004,1301,36.4,322,129,72,401,1200,2044,545
2014,36081046700,"Census Tract 467, Queens County, New York",2292,162,2130,1887,6138,36182,1947,2005,1298,41.2,308,133,67,358,1355,2130,552
2015,36081046700,"Census Tract 467, Queens County, New York",2232,169,2063,1890,6131,32702,1948,2005,1283,41.8,328,103,82,404,1329,2063,513
2016,36081046700,"Census Tract 467, Queens County, New York",2233,152,2081,1852,5793,31022,1945,2007,1241,46.9,297,70,56,406,1339,2081,565
2017,36081046700,"Census Tract 467, Queens County, New York",2129,229,1900,1655,5332,32059,1950,2007,1294,45.8,195,42,55,396,1180,1900,445
2018,36081046700,"Census Tract 467, Queens County, New York",2121,172,1949,1784,5306,36167,1950,2006,1303,43.1,305,37,15,419,1416,1949,355
2019,36081046700,"Census Tract 467, Queens County, New York",2148,176,1972,1799,5302,39989,1951,2009,1391,41.2,387,24,12,519,1356,1972,273
2020,36081046700,"Census Tract 467, Queens County, New York",2092,222,1870,1700,5329,53452,1953,2012,1503,38.9,422,11,0,543,1271,1870,192
2012,36081046800,"Census Tract 468, Queens County, New York",1218,68,1150,605,1728,33555,1945,2004,1203,43.5,64,16,98,219,222,1150,149
2013,36081046800,"Census Tract 468, Queens County, New York",1218,51,1167,672,1848,37557,1948,2003,1306,43.2,78,14,126,237,190,1167,138
2014,36081046800,"Census Tract 468, Queens County, New York",1214,73,1141,756,2163,34841,1945,2004,1345,44.8,149,6,130,317,196,1141,156
2015,36081046800,"Census Tract 468, Queens County, New York",1152,141,1011,652,1886,37692,1944,2005,1349,40.2,199,6,70,320,175,1011,158
2016,36081046800,"Census Tract 468, Queens County, New York",1125,138,987,602,1817,39500,1948,2009,1375,41.8,232,0,92,246,189,987,180
2017,36081046800,"Census Tract 468, Queens County, New York",1110,140,970,574,1700,40259,1960,2009,1365,37.9,190,0,63,245,139,970,161
2018,36081046800,"Census Tract 468, Queens County, New York",1102,137,965,516,1566,37105,1952,2011,1458,36.7,186,0,38,266,126,965,157
2019,36081046800,"Census Tract 468, Queens County, New York",1076,108,968,460,1298,38100,1953,2012,1459,36.9,167,0,54,227,105,968,159
2020,36081046800,"Census Tract 468, Queens County, New York",1016,38,978,530,1728,63750,0,2013,1370,27.3,140,0,102,262,103,978,139
2012,36081046900,"Census Tract 469, Queens County, New York",2781,144,2637,2229,7316,38188,1950,2002,1284,37.3,378,116,89,716,1308,2637,520
2013,36081046900,"Census Tract 469, Queens County, New York",2777,98,2679,2315,7644,37938,1948,2003,1313,39.5,440,142,133,767,1192,2679,690
2014,36081046900,"Census Tract 469, Queens County, New York",2805,136,2669,2267,7349,42773,1949,2004,1315,36.5,502,140,100,632,1329,2669,596
2015,36081046900,"Census Tract 469, Queens County, New York",2889,132,2757,2348,6963,42903,1950,2003,1250,36.2,569,183,83,702,1242,2757,695
2016,36081046900,"Census Tract 469, Queens County, New York",2931,227,2704,2265,6609,39052,1951,2004,1200,37.6,526,149,141,556,1304,2704,645
2017,36081046900,"Census Tract 469, Queens County, New York",2941,312,2629,2209,6691,40341,1952,2004,1204,36.5,521,104,127,501,1355,2629,609
2018,36081046900,"Census Tract 469, Queens County, New York",2959,278,2681,2226,6919,49677,1953,2005,1292,35.3,496,55,123,548,1458,2681,538
2019,36081046900,"Census Tract 469, Queens County, New York",2941,259,2682,2223,6858,44556,1954,2007,1350,35.8,488,40,94,603,1414,2682,510
2020,36081046901,"Census Tract 469.01, Queens County, New York",1661,227,1434,844,2516,50417,1954,2012,1422,35,138,10,7,179,574,1434,175
2020,36081046902,"Census Tract 469.02, Queens County, New York",1177,14,1163,1009,3437,60726,1954,2005,1403,35.2,193,0,109,171,744,1163,230
2012,36081047000,"Census Tract 470, Queens County, New York",948,51,897,320,1052,45851,1939,2004,1482,37.2,40,13,40,127,35,897,110
2013,36081047000,"Census Tract 470, Queens County, New York",940,49,891,247,840,46366,1939,2006,1574,32,35,25,26,123,41,891,96
2014,36081047000,"Census Tract 470, Queens County, New York",949,44,905,298,971,44097,1939,2009,1395,37.4,19,36,26,126,45,905,121
2015,36081047000,"Census Tract 470, Queens County, New York",934,32,902,305,1011,48050,1941,2010,1375,33.5,40,34,34,133,65,902,128
2016,36081047000,"Census Tract 470, Queens County, New York",899,60,839,387,1307,43375,1939,2011,1320,32.6,53,32,80,169,57,839,162
2017,36081047000,"Census Tract 470, Queens County, New York",906,31,875,353,1182,39375,1945,2010,1318,37.4,34,25,32,150,88,875,140
2018,36081047000,"Census Tract 470, Queens County, New York",920,30,890,408,1411,46087,1945,2008,1404,34.6,36,14,46,161,115,890,154
2019,36081047000,"Census Tract 470, Queens County, New York",898,34,864,387,1247,46477,1942,2008,1471,32.9,26,0,53,123,158,864,152
2020,36081047000,"Census Tract 470, Queens County, New York",907,32,875,356,1201,37176,1940,2007,1578,39.4,18,0,39,129,142,875,162
2012,36081047100,"Census Tract 471, Queens County, New York",1438,39,1399,1081,2912,22201,1956,2003,1288,50,192,136,0,794,162,1399,483
2013,36081047100,"Census Tract 471, Queens County, New York",1444,24,1420,1135,2945,30581,1952,2004,1325,44.7,212,103,0,779,253,1420,367
2014,36081047100,"Census Tract 471, Queens County, New York",1465,24,1441,1164,3400,31713,1954,2006,1358,44.2,322,123,7,814,227,1441,366
2015,36081047100,"Census Tract 471, Queens County, New York",1432,40,1392,1127,3315,40040,1956,2008,1376,39.2,313,107,11,771,249,1392,287
2016,36081047100,"Census Tract 471, Queens County, New York",1423,88,1335,1020,3411,43750,1958,2008,1425,39.2,288,84,12,666,270,1335,286
2017,36081047100,"Census Tract 471, Queens County, New York",1432,112,1320,991,3488,45873,1958,2009,1458,40.3,284,45,26,657,279,1320,269
2018,36081047100,"Census Tract 471, Queens County, New York",1430,115,1315,971,3436,41568,1960,2010,1624,48.2,297,60,25,639,260,1315,286
2019,36081047100,"Census Tract 471, Queens County, New York",1461,122,1339,1011,3417,44846,1958,2011,1594,42.6,254,35,11,693,272,1339,219
2020,36081047100,"Census Tract 471, Queens County, New York",1544,127,1417,1139,3586,50759,1957,2012,1514,35.9,428,42,20,759,328,1417,189
2012,36081047200,"Census Tract 472, Queens County, New York",1375,42,1333,700,1483,52667,1959,2004,1296,28.5,210,61,243,198,200,1333,36
2013,36081047200,"Census Tract 472, Queens County, New York",1363,58,1305,678,1460,52500,1961,2004,1294,29.8,230,99,275,127,177,1305,81
2014,36081047200,"Census Tract 472, Queens County, New York",1365,58,1307,730,1630,44528,1961,2004,1288,29.8,254,137,263,167,139,1307,84
2015,36081047200,"Census Tract 472, Queens County, New York",1383,62,1321,754,1698,43434,1963,2004,1270,36.4,267,150,233,178,175,1321,121
2016,36081047200,"Census Tract 472, Queens County, New York",1391,59,1332,699,1589,41278,1963,2003,1301,44,278,172,201,191,117,1332,133
2017,36081047200,"Census Tract 472, Queens County, New York",1420,82,1338,755,1592,41887,1964,2004,1302,40.6,306,140,233,201,146,1338,143
2018,36081047200,"Census Tract 472, Queens County, New York",1434,51,1383,765,1605,47163,1964,2007,1425,33.3,331,103,239,218,157,1383,116
2019,36081047200,"Census Tract 472, Queens County, New York",1434,72,1362,677,1409,51676,1964,2010,1543,29.9,328,77,192,217,162,1362,95
2020,36081047200,"Census Tract 472, Queens County, New York",1369,63,1306,645,1474,57644,1964,2012,1614,29,284,63,197,228,124,1306,37
2012,36081047300,"Census Tract 473, Queens County, New York",1564,147,1417,869,2265,51913,1963,2004,1406,33.6,258,134,53,454,216,1417,229
2013,36081047300,"Census Tract 473, Queens County, New York",1588,149,1439,864,2229,53904,1963,2004,1458,33.3,290,114,56,459,227,1439,243
2014,36081047300,"Census Tract 473, Queens County, New York",1648,122,1526,922,2519,61026,1963,2005,1563,32.1,379,112,36,509,257,1526,224
2015,36081047300,"Census Tract 473, Queens County, New York",1652,160,1492,857,2370,53583,1963,2006,1546,34.9,334,80,36,486,248,1492,206
2016,36081047300,"Census Tract 473, Queens County, New York",1706,143,1563,915,2515,53684,1964,2009,1592,34.1,388,116,37,496,259,1563,188
2017,36081047300,"Census Tract 473, Queens County, New York",1732,128,1604,925,2703,58665,1964,2011,1631,32.5,441,138,9,523,255,1604,150
2018,36081047300,"Census Tract 473, Queens County, New York",1764,117,1647,1011,2837,57263,1965,2012,1678,34.6,461,151,9,589,262,1647,144
2019,36081047300,"Census Tract 473, Queens County, New York",1765,128,1637,1012,2740,55049,1965,2014,1599,36.9,510,159,29,626,198,1637,157
2020,36081047300,"Census Tract 473, Queens County, New York",1805,124,1681,1099,2945,60706,1964,2015,1702,37.5,524,157,25,738,179,1681,170
2012,36081047500,"Census Tract 475, Queens County, New York",1643,98,1545,885,2358,42031,1958,2006,1280,33.7,363,98,22,440,302,1545,184
2013,36081047500,"Census Tract 475, Queens County, New York",1687,118,1569,915,2552,40216,1956,2006,1331,36.9,365,89,23,418,351,1569,206
2014,36081047500,"Census Tract 475, Queens County, New York",1700,142,1558,1019,2869,42227,1958,2008,1384,31.6,402,130,25,490,348,1558,225
2015,36081047500,"Census Tract 475, Queens County, New York",1696,200,1496,1094,3040,40174,1958,2008,1414,35,412,120,35,517,375,1496,314
2016,36081047500,"Census Tract 475, Queens County, New York",1695,257,1438,1068,2968,51667,1962,2010,1504,30.7,369,124,18,554,296,1438,260
2017,36081047500,"Census Tract 475, Queens County, New York",1688,338,1350,941,2757,50781,1959,2010,1659,35.2,340,88,17,478,287,1350,267
2018,36081047500,"Census Tract 475, Queens County, New York",1685,305,1380,965,2726,55380,1962,2012,1760,36.9,339,103,14,507,276,1380,236
2019,36081047500,"Census Tract 475, Queens County, New York",1746,319,1427,973,2908,56585,1964,2014,1809,36.9,368,105,15,520,290,1427,214
2020,36081047500,"Census Tract 475, Queens County, New York",1707,256,1451,975,3139,70841,1962,2015,1791,35.2,308,105,7,457,413,1451,132
2012,36081047600,"Census Tract 476, Queens County, New York",472,0,472,47,79,44023,1947,2005,1332,31.6,0,47,0,0,0,472,32
2013,36081047600,"Census Tract 476, Queens County, New York",475,0,475,70,179,46714,1943,2007,1411,34.1,26,44,20,6,0,475,27
2014,36081047600,"Census Tract 476, Queens County, New York",474,0,474,74,162,45926,1946,2007,1421,34.2,34,48,17,9,0,474,19
2015,36081047600,"Census Tract 476, Queens County, New York",481,0,481,66,188,38214,1951,2009,3501,50,50,29,23,14,0,481,25
2016,36081047600,"Census Tract 476, Queens County, New York",473,14,459,110,313,55109,1939,2009,3501,50,70,29,43,14,24,459,26
2017,36081047600,"Census Tract 476, Queens County, New York",474,18,456,103,319,41964,1939,2010,3501,50,73,20,46,13,24,456,13
2018,36081047600,"Census Tract 476, Queens County, New York",479,17,462,109,235,NA,0,2007,3501,51,62,26,42,9,32,462,30
2019,36081047600,"Census Tract 476, Queens County, New York",478,24,454,83,222,60893,0,2008,3501,51,43,0,50,0,33,454,16
2020,36081047600,"Census Tract 476, Queens County, New York",526,21,505,103,248,78750,1940,2012,3501,51,72,0,42,36,25,505,13
2012,36081047800,"Census Tract 478, Queens County, New York",2308,109,2199,474,929,44884,1953,1999,1021,28,197,123,123,64,135,2199,159
2013,36081047800,"Census Tract 478, Queens County, New York",2334,85,2249,496,1143,48750,1956,2004,1254,37.1,194,88,199,86,107,2249,153
2014,36081047800,"Census Tract 478, Queens County, New York",2309,125,2184,456,1292,51897,1953,2002,1133,27.1,150,64,128,112,137,2184,198
2015,36081047800,"Census Tract 478, Queens County, New York",2279,192,2087,516,1300,56207,1950,2002,1268,23.9,206,101,145,68,186,2087,154
2016,36081047800,"Census Tract 478, Queens County, New York",2260,100,2160,597,1224,68723,1952,2007,1335,24,334,76,309,69,127,2160,81
2017,36081047800,"Census Tract 478, Queens County, New York",2283,97,2186,623,1293,70483,1953,2010,1438,25,316,40,356,20,144,2186,70
2018,36081047800,"Census Tract 478, Queens County, New York",2310,186,2124,561,1208,74446,1952,2010,1391,24.2,273,22,287,35,158,2124,75
2019,36081047800,"Census Tract 478, Queens County, New York",2347,268,2079,671,1366,74951,1953,2011,1547,27.1,352,24,400,56,107,2079,79
2020,36081047801,"Census Tract 478.01, Queens County, New York",1986,191,1795,445,846,NA,1955,2009,1458,23.7,373,0,222,15,190,1795,250
2020,36081047802,"Census Tract 478.02, Queens County, New York",401,0,401,314,825,81370,1946,2015,1435,51,102,0,140,74,41,401,29
2012,36081047900,"Census Tract 479, Queens County, New York",2031,123,1908,1076,3043,50000,1954,2004,1357,32.8,559,155,5,668,248,1908,205
2013,36081047900,"Census Tract 479, Queens County, New York",1995,118,1877,980,2934,44533,1950,2004,1397,32.1,369,158,15,546,261,1877,247
2014,36081047900,"Census Tract 479, Queens County, New York",1968,138,1830,1008,3093,44397,1952,2005,1422,33.5,355,100,24,670,214,1830,324
2015,36081047900,"Census Tract 479, Queens County, New York",1880,203,1677,991,2978,44504,1951,2005,1436,33.8,312,91,19,678,203,1677,349
2016,36081047900,"Census Tract 479, Queens County, New York",1827,166,1661,942,2728,43016,1955,2007,1456,36.6,323,67,15,691,169,1661,356
2017,36081047900,"Census Tract 479, Queens County, New York",1822,204,1618,872,2672,43662,1961,2006,1426,33.9,293,100,26,613,133,1618,392
2018,36081047900,"Census Tract 479, Queens County, New York",1877,202,1675,936,2956,48348,1961,2010,1556,36.9,316,90,30,600,209,1675,353
2019,36081047900,"Census Tract 479, Queens County, New York",1895,240,1655,984,3057,51518,1958,2009,1552,40.9,304,117,24,577,250,1655,289
2020,36081047900,"Census Tract 479, Queens County, New York",1921,170,1751,1093,3521,63236,1958,2012,1743,36.3,377,70,18,732,257,1751,261
2012,36081048000,"Census Tract 480, Queens County, New York",731,59,672,216,666,35848,1942,2008,1007,42.8,38,0,43,38,66,672,41
2013,36081048000,"Census Tract 480, Queens County, New York",750,62,688,192,601,37625,1942,2007,1063,34.6,45,11,35,46,79,688,59
2014,36081048000,"Census Tract 480, Queens County, New York",715,48,667,244,832,41818,1944,2011,1201,40.1,61,12,59,75,70,667,63
2015,36081048000,"Census Tract 480, Queens County, New York",726,36,690,188,623,27500,1939,2010,1138,45.4,33,14,26,55,70,690,72
2016,36081048000,"Census Tract 480, Queens County, New York",682,42,640,207,687,33984,1939,2011,1506,47.1,39,14,34,52,76,640,66
2017,36081048000,"Census Tract 480, Queens County, New York",671,35,636,178,625,35357,1939,2011,1512,48.8,40,15,33,53,39,636,58
2018,36081048000,"Census Tract 480, Queens County, New York",678,44,634,165,588,43795,0,2011,1521,36.1,39,0,32,52,38,634,35
2019,36081048000,"Census Tract 480, Queens County, New York",672,38,634,137,449,36458,0,2004,1617,51,26,0,19,27,39,634,56
2020,36081048000,"Census Tract 480, Queens County, New York",664,8,656,162,536,54470,0,2012,1638,36.8,27,0,23,95,22,656,40
2012,36081048100,"Census Tract 481, Queens County, New York",2280,153,2127,1807,5287,30156,1943,2004,1335,46.9,485,190,137,685,817,2127,607
2013,36081048100,"Census Tract 481, Queens County, New York",2371,206,2165,1796,5270,29722,1943,2004,1341,44.4,495,228,259,539,792,2165,513
2014,36081048100,"Census Tract 481, Queens County, New York",2415,232,2183,1892,5514,35711,1942,2005,1327,44.1,426,284,259,631,737,2183,419
2015,36081048100,"Census Tract 481, Queens County, New York",2352,250,2102,1867,5609,30425,1944,2006,1383,49,363,239,246,636,703,2102,439
2016,36081048100,"Census Tract 481, Queens County, New York",2317,232,2085,1839,5366,30463,1944,2006,1389,50,367,296,264,667,565,2085,484
2017,36081048100,"Census Tract 481, Queens County, New York",2266,174,2092,1702,5078,32194,1953,2005,1363,47.1,319,301,164,624,590,2092,366
2018,36081048100,"Census Tract 481, Queens County, New York",2175,165,2010,1614,5095,33239,1952,2007,1439,46.9,266,247,54,693,610,2010,305
2019,36081048100,"Census Tract 481, Queens County, New York",2025,117,1908,1379,4601,34063,1954,2007,1551,49.7,255,173,57,561,570,1908,276
2020,36081048100,"Census Tract 481, Queens County, New York",2235,147,2088,1383,4778,49926,1952,2009,1550,38.5,212,154,39,564,626,2088,270
2012,36081048200,"Census Tract 482, Queens County, New York",458,48,410,171,597,50938,1939,2004,1104,35,4,32,98,10,18,410,24
2013,36081048200,"Census Tract 482, Queens County, New York",432,27,405,165,483,33953,1939,2002,1156,42,31,6,116,17,40,405,43
2014,36081048200,"Census Tract 482, Queens County, New York",433,25,408,148,374,33300,1939,2003,1176,43,40,13,87,13,34,408,44
2015,36081048200,"Census Tract 482, Queens County, New York",420,32,388,130,344,36618,1939,2006,1324,43.7,38,0,69,13,45,388,33
2016,36081048200,"Census Tract 482, Queens County, New York",415,44,371,128,318,35667,1939,2009,1353,43,42,4,51,30,32,371,43
2017,36081048200,"Census Tract 482, Queens County, New York",428,25,403,162,410,36364,1951,2009,1345,30.8,69,4,65,42,36,403,54
2018,36081048200,"Census Tract 482, Queens County, New York",428,17,411,142,428,43846,1956,2010,1360,29.4,44,5,65,33,24,411,50
2019,36081048200,"Census Tract 482, Queens County, New York",401,17,384,135,388,43125,1961,2011,1353,34.1,48,4,49,46,17,384,46
2020,36081048200,"Census Tract 482, Queens County, New York",440,18,422,189,467,62852,1948,2010,1233,25.2,88,46,49,66,5,422,30
2012,36081048300,"Census Tract 483, Queens County, New York",1276,58,1218,735,2346,48526,1957,2005,1477,37.8,344,61,10,325,340,1218,194
2013,36081048300,"Census Tract 483, Queens County, New York",1246,67,1179,747,2339,47589,1957,2005,1539,40.1,312,66,13,318,354,1179,231
2014,36081048300,"Census Tract 483, Queens County, New York",1291,57,1234,788,2556,47647,1959,2006,1548,38.9,287,82,9,360,336,1234,232
2015,36081048300,"Census Tract 483, Queens County, New York",1364,86,1278,770,2584,42783,1960,2008,1504,43.4,199,43,12,365,350,1278,224
2016,36081048300,"Census Tract 483, Queens County, New York",1334,91,1243,784,2866,44865,1960,2009,1612,39.8,214,46,6,513,212,1243,199
2017,36081048300,"Census Tract 483, Queens County, New York",1308,91,1217,732,2580,48000,1950,2011,1645,38.3,153,58,10,460,197,1217,133
2018,36081048300,"Census Tract 483, Queens County, New York",1283,108,1175,712,2389,52969,1960,2012,1695,34.7,167,38,17,421,229,1175,121
2019,36081048300,"Census Tract 483, Queens County, New York",1303,136,1167,763,2586,61385,1960,2014,1736,32.8,241,58,26,463,206,1167,161
2020,36081048301,"Census Tract 483.01, Queens County, New York",663,34,629,362,1171,62794,1962,2013,1761,33,158,50,8,230,74,629,117
2020,36081048302,"Census Tract 483.02, Queens County, New York",616,68,548,431,1630,68482,1961,2016,2051,32.7,116,30,0,269,121,548,36
2012,36081048400,"Census Tract 484, Queens County, New York",1705,172,1533,564,1514,37031,1939,2005,1109,36.1,118,21,341,88,97,1533,157
2013,36081048400,"Census Tract 484, Queens County, New York",1645,115,1530,581,1328,35547,1945,2005,1121,38.6,117,18,314,152,79,1530,166
2014,36081048400,"Census Tract 484, Queens County, New York",1622,61,1561,616,1306,33036,1947,2005,1141,38.5,103,52,324,162,46,1561,167
2015,36081048400,"Census Tract 484, Queens County, New York",1581,33,1548,560,1256,37929,1953,2007,1153,34.5,109,59,235,166,47,1548,138
2016,36081048400,"Census Tract 484, Queens County, New York",1576,55,1521,571,1432,39663,1952,2009,1296,35.2,80,53,241,167,42,1521,172
2017,36081048400,"Census Tract 484, Queens County, New York",1609,89,1520,522,1220,40000,1951,2008,1388,34,92,43,262,109,42,1520,149
2018,36081048400,"Census Tract 484, Queens County, New York",1647,143,1504,502,1254,61750,0,2010,1523,30.8,122,42,263,46,86,1504,122
2019,36081048400,"Census Tract 484, Queens County, New York",1622,161,1461,470,1283,64392,0,2012,1573,29.4,129,12,265,24,88,1461,132
2020,36081048400,"Census Tract 484, Queens County, New York",1553,166,1387,440,1107,61875,0,2015,1461,31.3,132,9,249,42,65,1387,119
2012,36081048500,"Census Tract 485, Queens County, New York",1628,143,1485,827,2813,47067,1958,2004,1595,37.2,266,125,13,491,198,1485,225
2013,36081048500,"Census Tract 485, Queens County, New York",1628,120,1508,818,2955,57845,1960,2005,1596,32.9,288,131,11,484,182,1508,185
2014,36081048500,"Census Tract 485, Queens County, New York",1640,154,1486,811,2546,58977,1960,2007,1591,33.6,353,91,14,543,133,1486,162
2015,36081048500,"Census Tract 485, Queens County, New York",1611,149,1462,748,2295,52250,1962,2010,1613,35.1,338,82,0,509,130,1462,212
2016,36081048500,"Census Tract 485, Queens County, New York",1623,144,1479,775,2373,60766,1959,2010,1776,32.9,369,80,0,516,150,1479,233
2017,36081048500,"Census Tract 485, Queens County, New York",1632,204,1428,718,2047,65147,1958,2011,1805,26.6,319,117,0,407,166,1428,200
2018,36081048500,"Census Tract 485, Queens County, New York",1634,214,1420,797,2320,67375,1957,2012,1894,26.2,321,103,0,449,230,1420,191
2019,36081048500,"Census Tract 485, Queens County, New York",1635,202,1433,809,2428,66307,1957,2013,2018,24.6,215,109,0,416,277,1433,159
2020,36081048500,"Census Tract 485, Queens County, New York",1583,133,1450,808,2403,77955,1958,2013,2022,24.9,224,131,0,428,243,1450,184
2012,36081048900,"Census Tract 489, Queens County, New York",488,19,469,248,550,44574,1965,2006,1256,32.1,93,71,3,79,95,469,34
2013,36081048900,"Census Tract 489, Queens County, New York",479,0,479,241,688,44023,1966,2007,1316,34,33,51,5,84,101,479,34
2014,36081048900,"Census Tract 489, Queens County, New York",457,0,457,211,568,51250,1969,2007,1416,28.6,34,63,6,73,69,457,48
2015,36081048900,"Census Tract 489, Queens County, New York",450,10,440,182,584,51964,1967,2010,1616,27.3,7,32,4,81,65,440,55
2016,36081048900,"Census Tract 489, Queens County, New York",454,24,430,159,580,51691,1965,2011,1632,28.2,12,5,6,77,71,430,52
2017,36081048900,"Census Tract 489, Queens County, New York",467,33,434,211,867,62161,1973,2012,1709,27.6,19,5,0,79,127,434,65
2018,36081048900,"Census Tract 489, Queens County, New York",466,44,422,226,774,64241,1972,2012,1690,28.6,19,6,0,103,117,422,73
2019,36081048900,"Census Tract 489, Queens County, New York",482,42,440,251,878,64495,1970,2014,1642,28.3,17,6,0,89,156,440,59
2020,36081048900,"Census Tract 489, Queens County, New York",457,36,421,233,821,66820,1973,2015,1718,28.8,44,8,0,68,157,421,48
2012,36081049200,"Census Tract 492, Queens County, New York",1899,74,1825,1299,2779,44514,1954,2002,1108,31,258,100,904,112,206,1825,170
2013,36081049200,"Census Tract 492, Queens County, New York",1890,128,1762,1246,2465,46250,1954,2003,1115,31.7,304,127,880,79,163,1762,193
2014,36081049200,"Census Tract 492, Queens County, New York",1866,122,1744,1251,2419,45672,1954,2004,1165,33.8,286,110,897,56,231,1744,170
2015,36081049200,"Census Tract 492, Queens County, New York",1869,130,1739,1268,2501,46846,1953,2004,1164,32.4,344,91,940,73,235,1739,90
2016,36081049200,"Census Tract 492, Queens County, New York",1857,134,1723,1192,2348,47636,1954,2005,1221,35.4,276,98,809,64,306,1723,134
2017,36081049200,"Census Tract 492, Queens County, New York",1882,107,1775,1232,2500,52105,1952,2009,1245,31.1,246,153,885,28,202,1775,152
2018,36081049200,"Census Tract 492, Queens County, New York",1898,83,1815,1296,2878,51402,1952,2010,1328,32.1,251,92,903,45,237,1815,114
2019,36081049200,"Census Tract 492, Queens County, New York",1917,86,1831,1350,3302,61667,1952,2011,1340,28.7,293,106,931,95,184,1831,100
2020,36081049201,"Census Tract 492.01, Queens County, New York",1220,0,1220,1145,2801,72125,1952,2011,1373,27,261,64,781,38,209,1220,41
2020,36081049202,"Census Tract 492.02, Queens County, New York",608,18,590,141,449,80547,0,2014,1762,28.2,22,26,83,32,0,590,104
2012,36081049301,"Census Tract 493.01, Queens County, New York",792,110,682,301,574,64141,1964,2003,1213,22.9,141,195,0,46,60,682,61
2013,36081049301,"Census Tract 493.01, Queens County, New York",795,65,730,256,508,56250,1969,2005,1197,27.7,66,164,0,27,65,730,97
2014,36081049301,"Census Tract 493.01, Queens County, New York",787,45,742,282,595,53125,1971,2006,1270,35.5,44,140,0,51,91,742,89
2015,36081049301,"Census Tract 493.01, Queens County, New York",773,79,694,260,574,54423,1967,2007,1341,33.3,25,112,0,39,109,694,77
2016,36081049301,"Census Tract 493.01, Queens County, New York",775,96,679,283,690,40847,1955,2009,1605,44.6,45,82,0,64,137,679,112
2017,36081049301,"Census Tract 493.01, Queens County, New York",776,97,679,283,816,56250,1957,2009,1508,37.8,52,85,0,85,113,679,89
2018,36081049301,"Census Tract 493.01, Queens County, New York",776,119,657,296,911,61688,1954,2010,1639,31.8,69,66,0,101,129,657,61
2019,36081049301,"Census Tract 493.01, Queens County, New York",780,94,686,280,919,63631,1955,2010,1706,31,67,81,0,92,107,686,77
2020,36081049301,"Census Tract 493.01, Queens County, New York",773,83,690,273,905,62188,1953,2011,1594,33,78,84,0,85,104,690,95
2012,36081049302,"Census Tract 493.02, Queens County, New York",942,146,796,401,855,28125,1949,2004,1310,39.4,47,267,13,17,112,796,151
2013,36081049302,"Census Tract 493.02, Queens County, New York",952,137,815,380,906,27167,1948,2004,1367,34.1,35,307,5,15,53,815,168
2014,36081049302,"Census Tract 493.02, Queens County, New York",942,120,822,427,964,32750,1947,2005,1390,33.8,63,304,18,16,89,822,147
2015,36081049302,"Census Tract 493.02, Queens County, New York",902,92,810,447,1114,48625,1939,2005,1415,32.8,86,267,41,30,109,810,127
2016,36081049302,"Census Tract 493.02, Queens County, New York",973,90,883,527,1540,53702,1939,2008,1434,31.9,102,251,28,43,205,883,117
2017,36081049302,"Census Tract 493.02, Queens County, New York",1005,85,920,532,1712,63500,1945,2010,1560,30.5,103,247,22,26,228,920,83
2018,36081049302,"Census Tract 493.02, Queens County, New York",1011,106,905,511,1646,74271,1951,2011,1708,28.4,116,208,23,47,220,905,42
2019,36081049302,"Census Tract 493.02, Queens County, New York",976,83,893,520,1756,68906,1950,2012,1717,26.9,137,189,10,51,257,893,43
2020,36081049302,"Census Tract 493.02, Queens County, New York",1069,100,969,457,1706,67875,1952,2013,1681,28.5,141,156,0,74,215,969,78
2012,36081049500,"Census Tract 495, Queens County, New York",549,19,530,287,866,43631,1953,2005,1633,41.4,58,124,0,8,155,530,70
2013,36081049500,"Census Tract 495, Queens County, New York",558,30,528,289,866,39960,1953,2006,1550,41.4,42,114,0,14,161,528,81
2014,36081049500,"Census Tract 495, Queens County, New York",530,35,495,262,645,46250,1955,2008,1433,37.2,49,143,0,13,106,495,83
2015,36081049500,"Census Tract 495, Queens County, New York",524,25,499,294,745,47292,1956,2009,1440,40.3,58,159,0,14,121,499,109
2016,36081049500,"Census Tract 495, Queens County, New York",516,33,483,262,688,60114,1953,2009,1526,37.7,74,166,0,13,83,483,69
2017,36081049500,"Census Tract 495, Queens County, New York",541,42,499,259,740,68250,1956,2008,1411,26.4,80,191,0,5,51,499,62
2018,36081049500,"Census Tract 495, Queens County, New York",526,27,499,283,910,64805,1962,2009,1484,28.2,90,228,15,17,21,499,58
2019,36081049500,"Census Tract 495, Queens County, New York",515,33,482,266,878,70000,1964,2009,1473,27.5,76,216,10,18,13,482,57
2020,36081049500,"Census Tract 495, Queens County, New York",532,24,508,293,895,101563,1966,2015,1754,22.4,109,208,11,18,48,508,36
2012,36081049600,"Census Tract 496, Queens County, New York",941,83,858,199,483,31750,1939,2005,1003,50,38,0,41,89,57,858,81
2013,36081049600,"Census Tract 496, Queens County, New York",928,43,885,221,653,43009,1939,2006,1090,50,48,0,63,75,34,885,111
2014,36081049600,"Census Tract 496, Queens County, New York",923,45,878,254,744,32083,1944,2006,1334,50,68,0,58,96,39,878,97
2015,36081049600,"Census Tract 496, Queens County, New York",904,30,874,292,798,32059,1939,2010,1339,50,56,0,54,113,50,874,119
2016,36081049600,"Census Tract 496, Queens County, New York",922,23,899,282,750,34583,1939,2010,1379,47.8,23,0,55,86,72,899,110
2017,36081049600,"Census Tract 496, Queens County, New York",905,28,877,243,669,51488,1939,2011,1443,42.4,45,12,46,68,60,877,70
2018,36081049600,"Census Tract 496, Queens County, New York",898,28,870,232,602,51875,0,2012,1547,42.3,49,13,56,66,59,870,53
2019,36081049600,"Census Tract 496, Queens County, New York",898,33,865,194,531,53929,0,2013,1524,42.8,41,14,40,76,37,865,61
2020,36081049600,"Census Tract 496, Queens County, New York",902,13,889,147,417,67431,0,2013,1704,37.6,20,15,39,54,27,889,52
2012,36081049700,"Census Tract 497, Queens County, New York",1038,55,983,457,1316,48778,1962,2004,1370,35.8,41,197,0,115,145,983,81
2013,36081049700,"Census Tract 497, Queens County, New York",1038,40,998,420,1122,45000,1964,2005,1444,35.3,36,144,0,110,166,998,80
2014,36081049700,"Census Tract 497, Queens County, New York",1061,82,979,467,1120,42188,1973,2006,1523,38.6,78,150,0,86,187,979,99
2015,36081049700,"Census Tract 497, Queens County, New York",1047,77,970,399,948,35179,1968,2009,1535,48.9,81,137,8,80,133,970,121
2016,36081049700,"Census Tract 497, Queens County, New York",1069,82,987,464,1245,46053,1962,2011,1529,29.1,121,131,9,137,144,987,115
2017,36081049700,"Census Tract 497, Queens County, New York",1080,105,975,448,1264,73750,1956,2011,1590,26.6,155,158,8,125,112,975,83
2018,36081049700,"Census Tract 497, Queens County, New York",1074,101,973,450,1237,69167,1953,2012,1497,25,159,208,11,100,74,973,63
2019,36081049700,"Census Tract 497, Queens County, New York",1036,77,959,433,1205,90598,1955,2012,1651,22.2,136,212,11,126,73,959,65
2020,36081049700,"Census Tract 497, Queens County, New York",1034,119,915,442,1370,71477,1969,2012,1904,31.6,107,167,0,125,127,915,38
2012,36081049900,"Census Tract 499, Queens County, New York",1725,111,1614,825,2359,42639,1954,2005,1409,29.6,258,131,0,432,262,1614,136
2013,36081049900,"Census Tract 499, Queens County, New York",1748,122,1626,718,2181,49167,1953,2005,1426,29.7,225,107,0,389,222,1626,167
2014,36081049900,"Census Tract 499, Queens County, New York",1701,131,1570,739,2191,44120,1955,2006,1481,29.4,244,100,0,409,230,1570,204
2015,36081049900,"Census Tract 499, Queens County, New York",1657,109,1548,809,2331,48594,1954,2007,1503,30.8,261,143,0,439,227,1548,211
2016,36081049900,"Census Tract 499, Queens County, New York",1691,120,1571,818,2439,44628,1953,2008,1423,36.6,212,132,0,450,236,1571,205
2017,36081049900,"Census Tract 499, Queens County, New York",1695,118,1577,726,2407,51500,1957,2011,1498,34.1,170,135,9,389,193,1577,161
2018,36081049900,"Census Tract 499, Queens County, New York",1778,141,1637,894,2577,52311,1958,2011,1599,35.9,221,159,8,327,310,1637,145
2019,36081049900,"Census Tract 499, Queens County, New York",1750,137,1613,865,2492,54788,1959,2012,1647,36.7,273,178,9,332,304,1613,89
2020,36081049900,"Census Tract 499, Queens County, New York",1759,137,1622,858,2790,54215,1965,2013,1685,39.8,269,123,22,305,334,1622,69
2012,36081050000,"Census Tract 500, Queens County, New York",1589,129,1460,1273,3279,36250,1952,2004,1182,36.9,152,9,967,22,283,1460,289
2013,36081050000,"Census Tract 500, Queens County, New York",1562,163,1399,1241,3322,40240,1954,2005,1205,34.7,168,9,949,94,165,1399,382
2014,36081050000,"Census Tract 500, Queens County, New York",1586,118,1468,1265,3440,35847,1953,2006,1221,37.7,117,10,944,104,164,1468,407
2015,36081050000,"Census Tract 500, Queens County, New York",1613,171,1442,1179,3175,36534,1959,2008,1229,41.2,127,10,826,112,161,1442,419
2016,36081050000,"Census Tract 500, Queens County, New York",1589,131,1458,1205,3035,38835,1962,2011,1254,41.3,168,10,836,123,166,1458,367
2017,36081050000,"Census Tract 500, Queens County, New York",1612,114,1498,1269,3231,41292,1960,2011,1229,39.7,176,0,876,117,216,1498,361
2018,36081050000,"Census Tract 500, Queens County, New York",1688,138,1550,1304,3309,50244,1959,2012,1290,34.9,223,0,981,38,215,1550,279
2019,36081050000,"Census Tract 500, Queens County, New York",1659,156,1503,1326,3181,54000,1956,2013,1297,29.9,276,0,1036,45,220,1503,217
2020,36081050000,"Census Tract 500, Queens County, New York",1612,99,1513,1374,3373,57083,1956,2012,1322,28.9,261,0,1073,63,222,1513,190
2012,36081050201,"Census Tract 502.01, Queens County, New York",459,15,444,139,543,27072,1941,2002,1377,50,14,0,95,33,0,444,67
2013,36081050201,"Census Tract 502.01, Queens County, New York",441,18,423,161,377,36607,1947,2003,1522,28.6,19,0,154,0,0,423,28
2014,36081050201,"Census Tract 502.01, Queens County, New York",441,27,414,147,423,61083,1951,2005,1582,28.1,26,0,141,0,0,414,22
2015,36081050201,"Census Tract 502.01, Queens County, New York",444,37,407,149,423,62266,1955,2006,1572,27.6,12,0,126,0,17,407,3
2016,36081050201,"Census Tract 502.01, Queens County, New York",428,74,354,128,353,72738,1962,2008,1573,28.1,10,0,110,0,13,354,5
2017,36081050201,"Census Tract 502.01, Queens County, New York",433,55,378,124,354,74265,1958,2009,1726,28.5,35,0,94,0,26,378,11
2018,36081050201,"Census Tract 502.01, Queens County, New York",457,75,382,115,421,NA,1969,2011,1934,33.5,31,0,90,0,25,382,22
2019,36081050201,"Census Tract 502.01, Queens County, New York",449,77,372,105,328,38661,1960,2011,2000,34,31,0,78,0,27,372,17
2020,36081050201,"Census Tract 502.01, Queens County, New York",478,67,411,110,369,NA,1955,2012,1620,33.5,27,0,97,0,13,411,30
2012,36081050202,"Census Tract 502.02, Queens County, New York",382,6,376,48,156,32200,1942,2003,896,31.1,4,0,46,0,0,376,37
2013,36081050202,"Census Tract 502.02, Queens County, New York",380,7,373,52,147,37857,1939,2003,1125,31.3,9,0,43,7,0,373,32
2014,36081050202,"Census Tract 502.02, Queens County, New York",399,26,373,59,214,39625,1946,2006,1304,30.8,13,0,46,10,0,373,10
2015,36081050202,"Census Tract 502.02, Queens County, New York",410,30,380,74,156,37727,1939,2011,1321,49.4,13,0,46,11,0,380,12
2016,36081050202,"Census Tract 502.02, Queens County, New York",412,37,375,95,271,38295,1942,2010,1380,47.7,17,0,62,15,0,375,19
2017,36081050202,"Census Tract 502.02, Queens County, New York",415,36,379,88,268,40750,1944,2011,1384,48,12,0,65,14,0,379,23
2018,36081050202,"Census Tract 502.02, Queens County, New York",413,35,378,87,286,45469,1945,2012,1521,49.2,4,0,71,4,0,378,33
2019,36081050202,"Census Tract 502.02, Queens County, New York",406,19,387,74,221,49038,1949,2012,1633,46.4,4,0,57,4,0,387,31
2020,36081050202,"Census Tract 502.02, Queens County, New York",412,18,394,76,237,53750,1972,2012,1708,37.5,13,0,63,13,0,394,36
2012,36081050400,"Census Tract 504, Queens County, New York",569,0,569,165,420,37583,1939,2003,1066,33.1,40,0,148,0,17,569,42
2013,36081050400,"Census Tract 504, Queens County, New York",567,0,567,166,438,28750,1941,2002,1128,50,39,0,154,0,12,567,50
2014,36081050400,"Census Tract 504, Queens County, New York",589,0,589,144,448,32115,1939,2002,1090,44.3,20,0,144,0,0,589,60
2015,36081050400,"Census Tract 504, Queens County, New York",585,3,582,170,485,35781,1939,2003,1117,37.9,25,0,170,0,0,582,50
2016,36081050400,"Census Tract 504, Queens County, New York",582,30,552,184,613,36471,1940,2005,1292,37.2,43,0,184,0,0,552,47
2017,36081050400,"Census Tract 504, Queens County, New York",590,49,541,185,641,39044,1939,2006,1382,37.5,48,0,185,0,0,541,47
2018,36081050400,"Census Tract 504, Queens County, New York",580,48,532,183,598,47375,0,2006,1482,37.3,44,10,173,0,0,532,34
2019,36081050400,"Census Tract 504, Queens County, New York",567,59,508,166,536,50625,0,2008,1443,34.2,37,12,154,0,0,508,43
2020,36081050400,"Census Tract 504, Queens County, New York",577,54,523,182,539,NA,1945,2015,1735,31.8,23,8,174,0,0,523,57
2012,36081050500,"Census Tract 505, Queens County, New York",703,76,627,289,825,49940,1965,2005,1431,29.1,115,143,15,58,73,627,55
2013,36081050500,"Census Tract 505, Queens County, New York",702,104,598,331,893,66023,1967,2007,1400,27,113,149,20,68,94,598,71
2014,36081050500,"Census Tract 505, Queens County, New York",683,91,592,356,888,55625,1968,2008,1410,27.8,115,168,18,81,89,592,79
2015,36081050500,"Census Tract 505, Queens County, New York",667,78,589,412,941,NA,1966,2011,1406,28.1,156,184,19,86,123,589,86
2016,36081050500,"Census Tract 505, Queens County, New York",665,86,579,395,923,55324,1966,2011,1433,30,144,152,19,92,132,579,84
2017,36081050500,"Census Tract 505, Queens County, New York",663,93,570,342,812,57407,1967,2012,1464,28.2,123,131,19,79,113,570,58
2018,36081050500,"Census Tract 505, Queens County, New York",648,75,573,296,664,57609,1966,2012,1667,29.2,101,131,28,57,80,573,45
2019,36081050500,"Census Tract 505, Queens County, New York",651,89,562,298,713,57500,1966,2012,1796,31.3,117,140,27,66,65,562,40
2020,36081050500,"Census Tract 505, Queens County, New York",596,71,525,214,632,53500,1961,2014,2031,37.9,51,94,26,50,36,525,45
2012,36081050600,"Census Tract 506, Queens County, New York",497,0,497,78,168,26574,1944,2005,1333,50,22,0,56,22,0,497,85
2013,36081050600,"Census Tract 506, Queens County, New York",500,14,486,37,134,50848,1939,2006,1798,38.3,3,0,34,0,3,486,74
2014,36081050600,"Census Tract 506, Queens County, New York",477,12,465,57,239,50625,1939,2006,1837,42,15,0,42,0,15,465,61
2015,36081050600,"Census Tract 506, Queens County, New York",443,13,430,73,302,50929,1939,2005,1692,40.2,15,0,52,6,15,430,17
2016,36081050600,"Census Tract 506, Queens County, New York",428,13,415,81,366,50391,1948,2011,1236,44.7,16,0,30,19,32,415,30
2017,36081050600,"Census Tract 506, Queens County, New York",445,18,427,99,440,50083,1949,2011,1356,45.4,15,0,49,20,30,427,26
2018,36081050600,"Census Tract 506, Queens County, New York",439,6,433,96,365,NA,1950,2011,1321,49.2,0,0,64,18,14,433,30
2019,36081050600,"Census Tract 506, Queens County, New York",452,6,446,94,348,NA,1948,2011,1385,51,0,0,57,20,17,446,29
2020,36081050600,"Census Tract 506, Queens County, New York",470,24,446,87,353,90662,1943,2015,1414,22.7,0,0,50,13,17,446,22
2012,36081050700,"Census Tract 507, Queens County, New York",1388,85,1303,667,1632,46023,1963,2006,1460,29.7,128,463,11,72,132,1303,136
2013,36081050700,"Census Tract 507, Queens County, New York",1443,81,1362,621,1507,44375,1968,2008,1525,36,143,445,10,82,94,1362,128
2014,36081050700,"Census Tract 507, Queens County, New York",1412,46,1366,662,1738,71205,1970,2011,1525,27.8,151,419,11,77,166,1366,161
2015,36081050700,"Census Tract 507, Queens County, New York",1375,62,1313,571,1511,44139,1963,2010,1453,35.1,140,334,11,87,150,1313,174
2016,36081050700,"Census Tract 507, Queens County, New York",1429,57,1372,615,1742,41156,1968,2010,1702,40.7,127,320,11,77,218,1372,203
2017,36081050700,"Census Tract 507, Queens County, New York",1447,77,1370,546,1670,52000,1966,2011,1895,30.5,135,216,0,64,266,1370,175
2018,36081050700,"Census Tract 507, Queens County, New York",1422,87,1335,576,1935,55313,1968,2011,1971,31.4,140,211,0,75,290,1335,157
2019,36081050700,"Census Tract 507, Queens County, New York",1413,89,1324,589,1806,48344,1967,2011,1856,34.7,167,243,0,115,231,1324,143
2020,36081050700,"Census Tract 507, Queens County, New York",1371,61,1310,687,1845,57344,1973,2009,2048,37.8,272,342,0,130,215,1310,149
2012,36081050800,"Census Tract 508, Queens County, New York",690,137,553,193,497,27625,1942,2002,1009,39.2,55,0,193,0,0,553,90
2013,36081050800,"Census Tract 508, Queens County, New York",648,109,539,178,539,44375,1945,2004,1313,29.2,42,0,173,0,5,539,74
2014,36081050800,"Census Tract 508, Queens County, New York",623,88,535,183,481,19926,1947,2002,1297,39.3,41,4,150,0,6,535,84
2015,36081050800,"Census Tract 508, Queens County, New York",597,85,512,163,517,28125,1947,2004,983,39.7,14,6,123,0,6,512,70
2016,36081050800,"Census Tract 508, Queens County, New York",608,98,510,191,588,NA,1951,2010,988,35,0,22,115,0,24,510,66
2017,36081050800,"Census Tract 508, Queens County, New York",617,63,554,195,625,NA,1958,2013,1125,31.7,4,29,95,0,40,554,89
2018,36081050800,"Census Tract 508, Queens County, New York",678,55,623,245,604,20060,1949,2012,1308,51,11,28,152,0,40,623,130
2019,36081050800,"Census Tract 508, Queens County, New York",682,41,641,274,554,23036,1959,2015,1257,41.8,11,22,210,0,48,641,145
2020,36081050800,"Census Tract 508, Queens County, New York",708,28,680,292,619,23333,1956,2015,1299,44.4,16,20,235,0,42,680,144
2012,36081051000,"Census Tract 510, Queens County, New York",494,63,431,37,88,11595,1946,2006,1091,50,0,0,37,0,0,431,68
2013,36081051000,"Census Tract 510, Queens County, New York",477,38,439,41,78,27560,1950,2003,924,47.6,6,0,33,0,8,439,35
2014,36081051000,"Census Tract 510, Queens County, New York",471,19,452,55,124,18646,1950,2003,1028,46.3,6,0,40,0,15,452,19
2015,36081051000,"Census Tract 510, Queens County, New York",507,16,491,56,144,19318,1948,2004,1065,45.2,6,0,42,0,14,491,18
2016,36081051000,"Census Tract 510, Queens County, New York",495,21,474,78,194,30104,1950,2004,1092,43.5,14,0,53,0,25,474,22
2017,36081051000,"Census Tract 510, Queens County, New York",488,21,467,91,304,30240,1952,2006,1202,44.6,14,0,66,0,25,467,38
2018,36081051000,"Census Tract 510, Queens County, New York",507,22,485,72,347,NA,1954,2011,1737,32.8,9,7,50,0,15,485,49
2019,36081051000,"Census Tract 510, Queens County, New York",503,0,503,91,398,NA,1953,2009,1642,27.8,8,7,59,17,8,503,48
2020,36081051000,"Census Tract 510, Queens County, New York",470,19,451,73,340,NA,1955,2011,1632,24.1,6,5,47,15,6,451,58
2012,36081051100,"Census Tract 511, Queens County, New York",831,47,784,239,449,44950,1952,2005,1342,32.3,68,153,0,0,86,784,41
2013,36081051100,"Census Tract 511, Queens County, New York",862,49,813,279,535,44323,1956,2005,1331,34.5,60,163,0,0,116,813,48
2014,36081051100,"Census Tract 511, Queens County, New York",825,38,787,272,475,41462,1965,2005,1360,43,56,154,0,0,118,787,52
2015,36081051100,"Census Tract 511, Queens County, New York",808,45,763,238,429,45893,1944,2007,1284,32.9,52,162,0,0,76,763,49
2016,36081051100,"Census Tract 511, Queens County, New York",803,37,766,242,521,48750,1948,2008,1455,31.1,62,163,0,6,73,766,42
2017,36081051100,"Census Tract 511, Queens County, New York",819,77,742,265,713,55043,1952,2011,1581,33.9,95,171,0,14,80,742,5
2018,36081051100,"Census Tract 511, Queens County, New York",804,60,744,304,842,61250,1948,2008,1574,31.5,89,165,0,13,120,744,10
2019,36081051100,"Census Tract 511, Queens County, New York",819,59,760,375,1097,59909,1950,2009,1602,31.3,133,190,0,25,156,760,30
2020,36081051100,"Census Tract 511, Queens County, New York",781,65,716,265,765,73250,1954,2009,1690,30.8,104,119,0,24,110,716,29
2012,36081051200,"Census Tract 512, Queens County, New York",826,41,785,174,523,42917,1950,2003,1355,42.6,36,0,169,0,1,785,68
2013,36081051200,"Census Tract 512, Queens County, New York",820,27,793,163,486,56083,1939,2005,1403,23.9,79,0,147,0,9,793,66
2014,36081051200,"Census Tract 512, Queens County, New York",820,26,794,193,617,34926,1939,2007,1381,23.8,76,0,146,0,39,794,100
2015,36081051200,"Census Tract 512, Queens County, New York",775,36,739,141,427,28558,1939,2007,1364,26.3,53,0,94,0,43,739,89
2016,36081051200,"Census Tract 512, Queens County, New York",760,48,712,152,498,NA,1939,2008,1332,20.7,51,0,94,0,45,712,79
2017,36081051200,"Census Tract 512, Queens County, New York",745,36,709,190,566,44000,1939,2010,1380,22.9,33,0,140,0,36,709,80
2018,36081051200,"Census Tract 512, Queens County, New York",699,34,665,165,507,44345,0,2010,1435,23.1,20,0,106,0,40,665,59
2019,36081051200,"Census Tract 512, Queens County, New York",685,49,636,158,386,60500,0,2010,1435,24.5,6,0,96,0,26,636,27
2020,36081051200,"Census Tract 512, Queens County, New York",702,53,649,152,371,54643,0,2010,1410,22.5,14,0,84,0,26,649,52
2012,36081051300,"Census Tract 513, Queens County, New York",860,111,749,382,864,49038,1964,2005,1280,32.5,55,188,0,89,105,749,74
2013,36081051300,"Census Tract 513, Queens County, New York",874,105,769,404,850,44924,1968,2006,1326,32.7,101,195,0,99,110,769,91
2014,36081051300,"Census Tract 513, Queens County, New York",873,77,796,410,776,43782,1964,2007,1401,36.9,137,173,0,123,114,796,71
2015,36081051300,"Census Tract 513, Queens County, New York",870,71,799,447,892,42250,1969,2008,1364,41.1,132,190,0,138,119,799,73
2016,36081051300,"Census Tract 513, Queens County, New York",863,86,777,444,1066,44394,1968,2010,1494,39.9,124,200,0,131,113,777,82
2017,36081051300,"Census Tract 513, Queens County, New York",860,89,771,366,915,52344,1964,2011,1539,38.1,101,127,0,130,109,771,69
2018,36081051300,"Census Tract 513, Queens County, New York",840,93,747,329,917,52917,1963,2011,1626,39.9,65,154,0,102,73,747,59
2019,36081051300,"Census Tract 513, Queens County, New York",855,109,746,316,979,66310,1969,2015,1952,35.5,50,175,9,38,94,746,44
2020,36081051300,"Census Tract 513, Queens County, New York",890,96,794,257,806,55313,1963,2016,2117,38.3,45,113,6,41,97,794,87
2012,36081051500,"Census Tract 515, Queens County, New York",1203,81,1122,396,927,39688,1951,2004,1305,37,79,273,8,19,96,1122,143
2013,36081051500,"Census Tract 515, Queens County, New York",1208,109,1099,299,654,37438,1952,2004,1346,39.2,50,182,7,24,86,1099,148
2014,36081051500,"Census Tract 515, Queens County, New York",1219,95,1124,331,717,50216,1953,2003,1378,37.4,57,216,6,12,97,1124,154
2015,36081051500,"Census Tract 515, Queens County, New York",1274,65,1209,402,897,52031,1952,2006,1440,29,134,228,6,8,160,1209,123
2016,36081051500,"Census Tract 515, Queens County, New York",1262,86,1176,317,742,54607,1954,2005,1406,27.6,100,154,7,8,148,1176,100
2017,36081051500,"Census Tract 515, Queens County, New York",1250,87,1163,302,769,68049,1951,2011,1569,28.6,150,125,0,8,169,1163,101
2018,36081051500,"Census Tract 515, Queens County, New York",1243,81,1162,365,1036,71314,1948,2011,1667,25,174,164,0,0,201,1162,97
2019,36081051500,"Census Tract 515, Queens County, New York",1245,62,1183,398,1322,81071,0,2011,1789,25.4,146,145,0,23,230,1183,66
2020,36081051500,"Census Tract 515, Queens County, New York",1239,86,1153,318,1093,81071,1946,2010,1745,26.6,62,144,0,20,154,1153,50
2012,36081051600,"Census Tract 516, Queens County, New York",618,87,531,155,479,55966,1953,2003,1203,26.9,22,8,129,0,18,531,7
2013,36081051600,"Census Tract 516, Queens County, New York",619,92,527,136,481,26724,1948,2003,1280,50,9,9,102,0,25,527,29
2014,36081051600,"Census Tract 516, Queens County, New York",616,62,554,168,553,25714,1951,2006,1339,50,8,0,143,0,25,554,57
2015,36081051600,"Census Tract 516, Queens County, New York",610,45,565,185,592,24813,1950,2007,1332,50,12,0,142,0,43,565,73
2016,36081051600,"Census Tract 516, Queens County, New York",622,44,578,167,530,32663,1950,2009,1321,47.4,13,0,124,0,49,578,72
2017,36081051600,"Census Tract 516, Queens County, New York",634,53,581,226,815,NA,1953,2012,1279,39.3,32,0,180,0,52,581,88
2018,36081051600,"Census Tract 516, Queens County, New York",610,38,572,236,808,NA,1960,2011,1216,39.6,46,0,190,0,52,572,80
2019,36081051600,"Census Tract 516, Queens County, New York",602,19,583,182,662,44022,1962,2011,1172,37.3,44,0,138,0,49,583,64
2020,36081051600,"Census Tract 516, Queens County, New York",584,31,553,119,473,43266,1966,2011,1061,38.5,33,0,100,0,24,553,51
2012,36081051700,"Census Tract 517, Queens County, New York",809,81,728,437,904,44704,1943,2005,1357,43,134,254,15,15,153,728,107
2013,36081051700,"Census Tract 517, Queens County, New York",800,52,748,463,1021,43320,1944,2006,1417,43.4,140,269,14,13,167,748,90
2014,36081051700,"Census Tract 517, Queens County, New York",797,72,725,470,1026,45781,1943,2007,1431,37.5,128,246,13,12,199,725,75
2015,36081051700,"Census Tract 517, Queens County, New York",797,91,706,465,1185,49886,1940,2009,1464,34.1,119,229,13,11,212,706,86
2016,36081051700,"Census Tract 517, Queens County, New York",802,75,727,482,1314,50625,1939,2010,1487,34.1,125,243,12,6,221,727,86
2017,36081051700,"Census Tract 517, Queens County, New York",786,89,697,422,1183,57500,1939,2011,1566,32.9,93,250,0,5,167,697,79
2018,36081051700,"Census Tract 517, Queens County, New York",805,102,703,392,1185,64474,1945,2011,1524,28.4,91,219,0,5,168,703,72
2019,36081051700,"Census Tract 517, Queens County, New York",847,114,733,361,1093,91161,0,2011,1588,27.2,107,217,0,6,138,733,71
2020,36081051700,"Census Tract 517, Queens County, New York",875,135,740,342,939,70000,0,2012,1465,23.2,114,226,0,7,109,740,82
2012,36081051800,"Census Tract 518, Queens County, New York",664,44,620,96,256,39409,1939,2005,794,22.9,33,0,41,0,0,620,29
2013,36081051800,"Census Tract 518, Queens County, New York",647,24,623,55,346,71705,1955,2011,1821,27.9,31,0,40,0,15,623,46
2014,36081051800,"Census Tract 518, Queens County, New York",644,33,611,62,404,74167,1955,2011,1833,27.8,35,0,44,0,18,611,46
2015,36081051800,"Census Tract 518, Queens County, New York",636,39,597,89,509,NA,1953,2011,1802,26.9,33,0,58,0,31,597,51
2016,36081051800,"Census Tract 518, Queens County, New York",651,31,620,105,540,NA,1954,2012,1779,27.6,38,0,75,0,30,620,90
2017,36081051800,"Census Tract 518, Queens County, New York",655,34,621,112,597,NA,1955,2012,1754,27,29,0,77,0,35,621,88
2018,36081051800,"Census Tract 518, Queens County, New York",657,39,618,111,339,NA,1954,2012,1650,43.7,26,0,91,0,20,618,86
2019,36081051800,"Census Tract 518, Queens County, New York",659,28,631,114,331,NA,1954,2013,1649,44,30,0,94,0,20,631,87
2020,36081051800,"Census Tract 518, Queens County, New York",646,28,618,127,291,28542,1960,2010,1660,51,49,0,127,0,0,618,64
2012,36081052000,"Census Tract 520, Queens County, New York",492,0,492,93,374,107625,1953,2006,1496,18.2,28,0,93,0,0,492,7
2013,36081052000,"Census Tract 520, Queens County, New York",503,0,503,82,260,88913,1953,2007,1447,18.5,10,0,82,0,0,503,6
2014,36081052000,"Census Tract 520, Queens County, New York",485,0,485,77,225,103417,1939,2008,1519,18.4,12,0,77,0,0,485,10
2015,36081052000,"Census Tract 520, Queens County, New York",474,12,462,104,324,NA,1939,2010,1422,22.2,10,0,104,0,0,462,11
2016,36081052000,"Census Tract 520, Queens County, New York",468,13,455,105,315,47411,1939,2011,1431,35.4,25,0,105,0,0,455,16
2017,36081052000,"Census Tract 520, Queens County, New York",480,33,447,84,252,47727,1941,2008,1517,44,8,0,77,0,0,447,23
2018,36081052000,"Census Tract 520, Queens County, New York",461,30,431,124,336,39615,0,2007,1684,49,9,0,114,0,0,431,55
2019,36081052000,"Census Tract 520, Queens County, New York",476,29,447,106,263,45000,1944,2007,1829,51,9,0,97,0,0,447,50
2020,36081052000,"Census Tract 520, Queens County, New York",447,19,428,135,376,46411,0,2010,1738,41.3,9,0,124,0,0,428,48
2012,36081052100,"Census Tract 521, Queens County, New York",743,140,603,282,516,40984,1950,2006,1207,27.6,69,231,20,0,21,603,69
2013,36081052100,"Census Tract 521, Queens County, New York",738,85,653,338,626,40877,1951,2006,1162,28.9,76,256,19,0,35,653,93
2014,36081052100,"Census Tract 521, Queens County, New York",713,78,635,310,662,31333,1943,2006,1272,43,61,213,34,3,36,635,98
2015,36081052100,"Census Tract 521, Queens County, New York",735,74,661,313,750,40583,1939,2006,1288,34.4,55,201,32,4,60,661,106
2016,36081052100,"Census Tract 521, Queens County, New York",722,28,694,305,767,41016,1939,2005,1263,35.8,56,189,35,6,58,694,114
2017,36081052100,"Census Tract 521, Queens County, New York",753,49,704,299,881,52443,1939,2006,1321,29.8,48,181,15,9,78,704,76
2018,36081052100,"Census Tract 521, Queens County, New York",782,66,716,292,896,70909,0,2006,1561,27,52,176,16,15,85,716,61
2019,36081052100,"Census Tract 521, Queens County, New York",783,89,694,224,656,77813,0,2009,1547,25,43,151,0,6,67,694,74
2020,36081052100,"Census Tract 521, Queens County, New York",722,75,647,224,645,46786,0,2011,1762,39.4,41,145,0,15,64,647,65
2012,36081052200,"Census Tract 522, Queens County, New York",547,0,547,85,247,22443,1956,2003,1148,38.9,0,5,70,10,12,547,62
2013,36081052200,"Census Tract 522, Queens County, New York",568,13,555,104,294,21417,1955,2004,1217,50,0,6,98,0,14,555,82
2014,36081052200,"Census Tract 522, Queens County, New York",574,30,544,129,373,22708,1954,2002,1265,50,22,5,124,0,12,544,64
2015,36081052200,"Census Tract 522, Queens County, New York",557,39,518,119,379,NA,1949,2002,1450,43.3,29,5,114,0,14,518,41
2016,36081052200,"Census Tract 522, Queens County, New York",557,47,510,80,215,NA,1944,2004,1281,37.5,26,4,76,0,0,510,36
2017,36081052200,"Census Tract 522, Queens County, New York",544,35,509,57,155,NA,1943,2003,NA,34.8,22,0,57,0,0,509,34
2018,36081052200,"Census Tract 522, Queens County, New York",529,37,492,36,109,91500,1942,1989,2700,35,30,0,36,0,0,492,24
2019,36081052200,"Census Tract 522, Queens County, New York",512,17,495,29,168,109875,1945,2013,1825,25.9,13,0,29,0,10,495,29
2020,36081052200,"Census Tract 522, Queens County, New York",491,12,479,31,182,NA,1961,2016,1861,47.2,4,0,31,0,9,479,38
2012,36081052400,"Census Tract 524, Queens County, New York",621,40,581,78,186,83056,1953,2003,1222,19.2,11,0,65,0,13,581,29
2013,36081052400,"Census Tract 524, Queens County, New York",618,14,604,84,222,85000,1951,2002,1250,21.2,17,0,56,0,28,604,48
2014,36081052400,"Census Tract 524, Queens County, New York",611,14,597,82,212,71000,1957,1998,1125,26,40,0,52,0,30,597,46
2015,36081052400,"Census Tract 524, Queens County, New York",585,26,559,97,237,85089,1956,2000,1163,25.8,48,0,67,0,30,559,50
2016,36081052400,"Census Tract 524, Queens County, New York",594,51,543,54,111,NA,1955,1994,1140,50,25,0,40,0,14,543,45
2017,36081052400,"Census Tract 524, Queens County, New York",578,44,534,76,175,NA,1953,1999,1184,34.2,26,0,47,0,25,534,53
2018,36081052400,"Census Tract 524, Queens County, New York",569,53,516,86,237,NA,0,2006,1356,30.8,25,0,62,0,21,516,46
2019,36081052400,"Census Tract 524, Queens County, New York",568,27,541,75,222,NA,0,2010,1391,51,3,0,50,0,21,541,51
2020,36081052400,"Census Tract 524, Queens County, New York",594,57,537,126,358,NA,0,2011,1310,50,30,0,103,0,20,537,73
2012,36081052500,"Census Tract 525, Queens County, New York",788,75,713,371,934,61827,1942,2005,1351,30.2,34,250,0,14,107,713,60
2013,36081052500,"Census Tract 525, Queens County, New York",777,76,701,349,822,62792,1947,2006,1448,31.3,39,234,0,19,96,701,75
2014,36081052500,"Census Tract 525, Queens County, New York",765,82,683,355,827,53009,1951,2007,1502,34.4,65,235,11,20,94,683,106
2015,36081052500,"Census Tract 525, Queens County, New York",750,66,684,311,760,43646,1944,2010,1500,41.6,56,218,11,19,68,684,137
2016,36081052500,"Census Tract 525, Queens County, New York",766,55,711,335,733,41875,1943,2011,1517,42.2,75,239,13,19,69,711,132
2017,36081052500,"Census Tract 525, Queens County, New York",765,35,730,315,734,49417,1944,2012,1533,33.6,81,233,15,10,62,730,131
2018,36081052500,"Census Tract 525, Queens County, New York",788,40,748,317,750,57386,1943,2012,1554,31.9,87,219,17,3,78,748,133
2019,36081052500,"Census Tract 525, Queens County, New York",806,16,790,304,733,50417,1941,2013,1537,33.6,74,203,0,4,91,790,103
2020,36081052500,"Census Tract 525, Queens County, New York",843,30,813,325,733,51146,1946,2015,1563,30.3,108,232,0,5,75,813,71
2012,36081052600,"Census Tract 526, Queens County, New York",595,99,496,122,381,22250,1947,2004,1637,50,16,12,85,0,27,496,59
2013,36081052600,"Census Tract 526, Queens County, New York",593,85,508,149,463,23365,1945,2005,1456,50,24,23,100,0,20,508,69
2014,36081052600,"Census Tract 526, Queens County, New York",585,56,529,156,578,26500,1945,2007,1476,50,36,24,102,0,21,529,85
2015,36081052600,"Census Tract 526, Queens County, New York",574,29,545,180,635,24911,1945,2008,1485,50,53,29,119,0,22,545,105
2016,36081052600,"Census Tract 526, Queens County, New York",572,30,542,178,608,35242,1944,2007,1549,50,64,25,119,0,10,542,87
2017,36081052600,"Census Tract 526, Queens County, New York",565,31,534,165,567,26473,1946,2008,1553,47.5,50,20,134,0,0,534,88
2018,36081052600,"Census Tract 526, Queens County, New York",575,32,543,134,365,32500,1945,2007,1529,51,41,9,125,0,0,543,73
2019,36081052600,"Census Tract 526, Queens County, New York",596,32,564,137,377,38487,1948,2009,1452,50,29,21,116,0,0,564,58
2020,36081052600,"Census Tract 526, Queens County, New York",744,29,715,206,397,NA,1954,2011,1180,19.7,12,19,187,0,0,715,43
2012,36081052800,"Census Tract 528, Queens County, New York",500,76,424,169,472,33603,1947,2003,1085,40.6,56,0,154,0,15,424,45
2013,36081052800,"Census Tract 528, Queens County, New York",494,67,427,138,446,28958,1956,2005,1400,34.1,49,0,123,0,15,427,66
2014,36081052800,"Census Tract 528, Queens County, New York",503,56,447,188,525,32292,1947,2005,1523,33.4,67,0,188,0,0,447,56
2015,36081052800,"Census Tract 528, Queens County, New York",498,50,448,181,491,29205,1950,2008,1589,34.5,36,0,181,0,0,448,69
2016,36081052800,"Census Tract 528, Queens County, New York",497,67,430,170,401,27250,1948,2009,1455,33.4,39,0,170,0,0,430,52
2017,36081052800,"Census Tract 528, Queens County, New York",504,76,428,148,342,26125,1946,2006,1364,36.3,37,0,148,0,0,428,73
2018,36081052800,"Census Tract 528, Queens County, New York",507,81,426,162,324,26484,1946,2007,1500,39.7,37,0,151,11,0,426,69
2019,36081052800,"Census Tract 528, Queens County, New York",511,86,425,120,285,29063,1949,2006,1275,39,18,0,111,9,0,425,50
2020,36081052800,"Census Tract 528, Queens County, New York",543,81,462,152,419,NA,1958,2006,1155,13.1,26,0,119,7,0,462,48
2012,36081053000,"Census Tract 530, Queens County, New York",716,47,669,146,347,31354,1939,2006,1191,39.7,30,0,128,0,0,669,87
2013,36081053000,"Census Tract 530, Queens County, New York",732,35,697,193,460,37784,1956,2008,1137,36.3,74,0,161,0,0,697,53
2014,36081053000,"Census Tract 530, Queens County, New York",724,29,695,193,449,34934,1962,2007,1178,36.4,72,0,167,0,0,695,43
2015,36081053000,"Census Tract 530, Queens County, New York",721,39,682,175,413,33523,1962,2008,1150,29.2,78,0,146,0,0,682,41
2016,36081053000,"Census Tract 530, Queens County, New York",722,35,687,201,480,41985,1963,2008,1317,26.3,71,0,171,0,0,687,35
2017,36081053000,"Census Tract 530, Queens County, New York",691,54,637,184,589,57917,1964,2006,1559,29.2,40,0,184,0,0,637,17
2018,36081053000,"Census Tract 530, Queens County, New York",690,42,648,140,454,61667,1963,2005,1673,28.1,16,0,140,0,0,648,17
2019,36081053000,"Census Tract 530, Queens County, New York",695,55,640,123,400,65234,1962,2006,1674,30.2,14,0,123,0,0,640,28
2020,36081053000,"Census Tract 530, Queens County, New York",627,55,572,107,366,65859,1948,2010,1829,33.3,0,0,107,0,0,572,10
2012,36081053100,"Census Tract 531, Queens County, New York",1419,187,1232,784,1807,38278,1939,2005,1242,29.8,195,434,25,0,300,1232,131
2013,36081053100,"Census Tract 531, Queens County, New York",1394,159,1235,789,1798,34511,1939,2006,1249,34.7,165,405,26,0,331,1235,198
2014,36081053100,"Census Tract 531, Queens County, New York",1348,151,1197,739,1277,39266,1939,2007,1310,34.4,190,412,27,0,300,1197,230
2015,36081053100,"Census Tract 531, Queens County, New York",1303,127,1176,642,1188,NA,1939,2007,1348,50,246,302,0,16,324,1176,256
2016,36081053100,"Census Tract 531, Queens County, New York",1324,113,1211,724,1427,43611,1939,2010,1311,28,199,344,18,7,312,1211,208
2017,36081053100,"Census Tract 531, Queens County, New York",1347,97,1250,722,1555,54100,1939,2012,1360,24.9,183,346,20,14,293,1250,145
2018,36081053100,"Census Tract 531, Queens County, New York",1335,113,1222,732,1789,62386,1944,2012,1459,26.9,247,383,18,24,269,1222,95
2019,36081053100,"Census Tract 531, Queens County, New York",1407,126,1281,788,1860,48277,1954,2012,1446,33.3,178,306,21,35,308,1281,130
2020,36081053100,"Census Tract 531, Queens County, New York",1512,96,1416,847,2142,55478,1951,2012,1443,31.8,140,369,20,44,322,1416,59
2012,36081053200,"Census Tract 532, Queens County, New York",566,51,515,68,104,40962,1944,2005,1067,28.7,0,0,68,0,0,515,21
2013,36081053200,"Census Tract 532, Queens County, New York",589,38,551,60,136,24706,1945,2004,1263,36.3,0,0,52,0,8,551,20
2014,36081053200,"Census Tract 532, Queens County, New York",617,58,559,47,141,72019,1956,2004,1404,21.9,0,0,39,0,8,559,27
2015,36081053200,"Census Tract 532, Queens County, New York",599,66,533,65,215,87361,1957,2007,1484,21.3,12,0,58,0,7,533,33
2016,36081053200,"Census Tract 532, Queens County, New York",617,36,581,129,424,82946,1953,2011,1534,24.9,27,0,107,0,8,581,71
2017,36081053200,"Census Tract 532, Queens County, New York",633,79,554,126,473,87833,1948,2012,1627,26.5,24,0,106,0,8,554,73
2018,36081053200,"Census Tract 532, Queens County, New York",628,67,561,158,579,NA,1946,2012,1798,48,62,0,107,0,0,561,74
2019,36081053200,"Census Tract 532, Queens County, New York",631,64,567,163,619,NA,1945,2012,1914,41,62,0,113,0,0,567,76
2020,36081053200,"Census Tract 532, Queens County, New York",635,45,590,162,555,NA,1945,2012,1880,51,60,0,102,0,0,590,70
2012,36081053401,"Census Tract 534.01, Queens County, New York",652,0,652,156,441,42900,1944,2002,1049,31,18,0,156,0,12,652,15
2013,36081053401,"Census Tract 534.01, Queens County, New York",654,0,654,152,423,41591,1946,2003,1092,36,29,0,152,0,11,654,20
2014,36081053401,"Census Tract 534.01, Queens County, New York",651,11,640,150,460,43581,1945,2003,1090,32,42,0,150,0,13,640,21
2015,36081053401,"Census Tract 534.01, Queens County, New York",642,25,617,150,346,43036,1953,2007,1034,30.3,50,0,150,0,14,617,25
2016,36081053401,"Census Tract 534.01, Queens County, New York",648,22,626,132,305,50313,1952,2007,1012,21.3,55,0,127,0,0,626,26
2017,36081053401,"Census Tract 534.01, Queens County, New York",651,23,628,122,272,51625,1953,2007,1174,17.9,72,0,116,0,0,628,27
2018,36081053401,"Census Tract 534.01, Queens County, New York",660,25,635,155,472,63257,1954,2010,1234,22.3,62,0,117,0,32,635,25
2019,36081053401,"Census Tract 534.01, Queens County, New York",647,42,605,129,343,56016,1957,2011,1125,23.9,35,0,108,0,16,605,25
2020,36081053401,"Census Tract 534.01, Queens County, New York",610,39,571,110,382,61167,1957,2015,1533,30.2,22,0,89,0,16,571,12
2012,36081053500,"Census Tract 535, Queens County, New York",419,67,352,265,981,49375,1939,2004,1246,31.9,24,51,0,0,214,352,70
2013,36081053500,"Census Tract 535, Queens County, New York",413,55,358,282,1049,41250,1939,2006,1280,36.5,38,59,0,0,223,358,51
2014,36081053500,"Census Tract 535, Queens County, New York",431,63,368,279,1014,50347,1939,2007,1364,37.9,54,63,0,0,216,368,56
2015,36081053500,"Census Tract 535, Queens County, New York",452,57,395,283,934,41023,1939,2011,1406,44.1,29,59,0,0,224,395,66
2016,36081053500,"Census Tract 535, Queens County, New York",463,53,410,262,941,53750,1939,2011,1473,37.8,18,57,0,0,205,410,49
2017,36081053500,"Census Tract 535, Queens County, New York",471,52,419,285,1038,56125,1939,2010,1513,38.7,14,45,0,0,240,419,51
2018,36081053500,"Census Tract 535, Queens County, New York",464,48,416,277,948,54792,0,2011,1590,36.7,18,68,0,0,209,416,69
2019,36081053500,"Census Tract 535, Queens County, New York",463,49,414,294,1119,64375,0,2012,1707,35.4,20,80,0,0,214,414,52
2020,36081053501,"Census Tract 535.01, Queens County, New York",533,70,463,248,838,68500,0,2012,1500,27.5,17,83,0,0,165,463,38
2020,36081053502,"Census Tract 535.02, Queens County, New York",0,0,0,0,0,NA,NA,NA,NA,NA,0,0,0,0,0,0,0
2012,36081053601,"Census Tract 536.01, Queens County, New York",546,31,515,163,571,58563,1939,2005,1367,25.3,0,0,93,42,10,515,33
2013,36081053601,"Census Tract 536.01, Queens County, New York",544,8,536,172,521,58889,1942,2005,1267,25.3,0,0,78,38,26,536,71
2014,36081053601,"Census Tract 536.01, Queens County, New York",535,8,527,140,482,60778,1951,2005,1157,22.9,0,0,97,31,12,527,61
2015,36081053601,"Census Tract 536.01, Queens County, New York",511,10,501,83,272,NA,1944,2009,1109,22.9,0,0,49,13,21,501,47
2016,36081053601,"Census Tract 536.01, Queens County, New York",522,10,512,98,253,42500,1939,2006,1260,29.8,11,0,54,13,31,512,66
2017,36081053601,"Census Tract 536.01, Queens County, New York",517,0,517,84,289,NA,1939,2011,1361,27,10,0,54,0,30,517,62
2018,36081053601,"Census Tract 536.01, Queens County, New York",514,0,514,112,414,68393,0,2011,1450,26.4,29,4,73,11,24,514,40
2019,36081053601,"Census Tract 536.01, Queens County, New York",528,0,528,124,450,93929,0,2012,1674,23,30,7,56,12,49,528,41
2020,36081053601,"Census Tract 536.01, Queens County, New York",773,0,773,418,823,11659,1944,1989,482,43.1,50,8,56,23,331,773,321
2012,36081053800,"Census Tract 538, Queens County, New York",533,67,466,158,566,44569,1939,1978,1300,29.7,0,0,146,0,12,466,23
2013,36081053800,"Census Tract 538, Queens County, New York",504,75,429,111,432,26917,1939,1990,955,29.1,8,0,100,0,11,429,40
2014,36081053800,"Census Tract 538, Queens County, New York",495,56,439,89,311,26023,1939,1976,1161,45.2,14,0,89,0,0,439,44
2015,36081053800,"Census Tract 538, Queens County, New York",473,38,435,86,344,42692,1939,1983,907,28.6,23,0,86,0,7,435,40
2016,36081053800,"Census Tract 538, Queens County, New York",470,28,442,79,237,NA,1939,2002,1094,41.4,29,0,79,0,10,442,35
2017,36081053800,"Census Tract 538, Queens County, New York",447,37,410,77,279,NA,1946,2008,1335,19.9,29,0,77,0,9,410,42
2018,36081053800,"Census Tract 538, Queens County, New York",462,10,452,100,333,98421,1948,2010,1161,18.7,30,0,100,0,19,452,69
2019,36081053800,"Census Tract 538, Queens County, New York",456,9,447,106,385,101053,1945,2011,1231,18.5,32,0,106,0,19,447,67
2020,36081053800,"Census Tract 538, Queens County, New York",445,8,437,64,220,NA,0,2015,1500,39.3,0,0,64,0,0,437,57
2012,36081053900,"Census Tract 539, Queens County, New York",1507,61,1446,706,1743,49491,1939,2004,1315,35.5,151,206,0,73,402,1446,209
2013,36081053900,"Census Tract 539, Queens County, New York",1499,42,1457,780,1876,45900,1939,2005,1302,42.4,181,237,20,38,451,1457,274
2014,36081053900,"Census Tract 539, Queens County, New York",1530,55,1475,857,2154,39125,1939,2007,1365,42.9,200,295,25,46,437,1475,311
2015,36081053900,"Census Tract 539, Queens County, New York",1471,71,1400,764,1874,46515,1939,2010,1307,38.9,198,358,22,33,328,1400,317
2016,36081053900,"Census Tract 539, Queens County, New York",1503,123,1380,791,2120,45858,1939,2010,1383,41,200,335,28,54,344,1380,332
2017,36081053900,"Census Tract 539, Queens County, New York",1500,145,1355,793,2171,49958,1939,2011,1431,33.6,200,379,25,54,304,1355,247
2018,36081053900,"Census Tract 539, Queens County, New York",1536,119,1417,821,2425,63783,1944,2011,1502,29.1,208,379,19,57,343,1417,192
2019,36081053900,"Census Tract 539, Queens County, New York",1531,143,1388,765,2269,67061,1948,2012,1630,29.2,227,344,31,57,346,1388,153
2020,36081053901,"Census Tract 539.01, Queens County, New York",1590,137,1453,834,2213,66413,1945,2015,1801,29.5,336,297,25,85,411,1453,160
2020,36081053902,"Census Tract 539.02, Queens County, New York",73,0,73,0,0,NA,NA,NA,NA,NA,0,0,0,0,0,73,0
2012,36081054000,"Census Tract 540, Queens County, New York",1276,141,1135,551,1870,26432,1939,2006,1203,50,49,64,344,26,111,1135,273
2013,36081054000,"Census Tract 540, Queens County, New York",1342,146,1196,541,1729,25625,1939,2008,1285,50,50,67,310,25,123,1196,285
2014,36081054000,"Census Tract 540, Queens County, New York",1365,165,1200,536,1566,26940,1939,2009,1230,50,43,57,350,22,77,1200,223
2015,36081054000,"Census Tract 540, Queens County, New York",1326,133,1193,527,1648,31597,1939,2011,1318,45.5,26,51,384,0,60,1193,199
2016,36081054000,"Census Tract 540, Queens County, New York",1343,124,1219,503,1686,28470,1949,2011,1406,49.7,15,22,314,6,76,1219,242
2017,36081054000,"Census Tract 540, Queens County, New York",1317,112,1205,460,1539,34896,1956,2012,1530,43,16,22,282,7,95,1205,193
2018,36081054000,"Census Tract 540, Queens County, New York",1313,98,1215,464,1543,42500,1958,2012,1472,39.5,41,15,275,6,104,1215,163
2019,36081054000,"Census Tract 540, Queens County, New York",1256,75,1181,461,1404,39851,1953,2013,1583,34.1,53,10,256,8,124,1181,173
2020,36081054000,"Census Tract 540, Queens County, New York",1421,93,1328,431,1384,51708,1952,2014,1557,34.1,39,0,202,9,168,1328,306
2012,36081054200,"Census Tract 542, Queens County, New York",1494,37,1457,249,763,36513,1939,2007,1170,33.3,61,8,89,15,48,1457,168
2013,36081054200,"Census Tract 542, Queens County, New York",1470,18,1452,284,1065,35511,1941,2009,1179,33.9,66,39,94,23,0,1452,217
2014,36081054200,"Census Tract 542, Queens County, New York",1499,8,1491,345,1222,31964,1939,2009,1417,50,51,47,111,22,42,1491,216
2015,36081054200,"Census Tract 542, Queens County, New York",1539,69,1470,407,1274,37681,1942,2009,1351,43.6,55,50,116,43,40,1470,246
2016,36081054200,"Census Tract 542, Queens County, New York",1528,109,1419,362,1199,39722,1941,2010,1417,41.4,27,57,149,62,44,1419,158
2017,36081054200,"Census Tract 542, Queens County, New York",1524,125,1399,337,1116,38063,1940,2010,1418,46.1,29,51,115,81,42,1399,109
2018,36081054200,"Census Tract 542, Queens County, New York",1554,133,1421,370,1027,27813,0,2009,1374,45.8,32,53,172,72,44,1421,149
2019,36081054200,"Census Tract 542, Queens County, New York",1543,149,1394,355,1059,39464,0,2008,1351,32.3,38,56,180,77,0,1394,152
2020,36081054200,"Census Tract 542, Queens County, New York",1729,77,1652,292,919,34500,0,2008,1375,33.8,13,44,158,39,17,1652,158
2012,36081054500,"Census Tract 545, Queens County, New York",1373,33,1340,1253,3771,48051,1939,2003,1208,33.1,201,354,27,98,775,1340,331
2013,36081054500,"Census Tract 545, Queens County, New York",1344,64,1280,1165,3535,47813,1939,2004,1234,32.8,232,343,17,93,692,1280,247
2014,36081054500,"Census Tract 545, Queens County, New York",1333,104,1229,1114,3352,45278,1939,2005,1240,30.6,271,354,18,84,637,1229,237
2015,36081054500,"Census Tract 545, Queens County, New York",1346,107,1239,1098,3296,50677,1939,2006,1287,28.7,260,398,8,68,611,1239,240
2016,36081054500,"Census Tract 545, Queens County, New York",1351,86,1265,1106,3364,49559,1939,2009,1334,28.4,238,356,9,66,660,1265,232
2017,36081054500,"Census Tract 545, Queens County, New York",1365,136,1229,1069,3222,48255,1939,2010,1391,31.3,164,335,19,56,644,1229,259
2018,36081054500,"Census Tract 545, Queens County, New York",1386,97,1289,1155,3650,58044,0,2011,1464,29.5,189,352,15,52,713,1289,231
2019,36081054500,"Census Tract 545, Queens County, New York",1420,97,1323,1210,3617,58889,0,2011,1558,28.2,250,425,26,33,702,1323,251
2020,36081054500,"Census Tract 545, Queens County, New York",1445,126,1319,1133,3173,62670,0,2013,1693,30.7,291,466,39,30,569,1319,156
2012,36081054700,"Census Tract 547, Queens County, New York",1452,155,1297,1163,4168,46739,1942,2005,1302,31.5,214,227,76,143,705,1297,335
2013,36081054700,"Census Tract 547, Queens County, New York",1489,182,1307,1161,4136,49787,1943,2005,1274,30.3,178,202,58,160,727,1307,350
2014,36081054700,"Census Tract 547, Queens County, New York",1510,163,1347,1160,4400,56250,1944,2006,1343,28.6,208,240,68,112,748,1347,331
2015,36081054700,"Census Tract 547, Queens County, New York",1547,89,1458,1208,4556,54386,1943,2007,1398,29.6,216,228,73,112,802,1458,334
2016,36081054700,"Census Tract 547, Queens County, New York",1522,112,1410,1070,3870,53088,1939,2008,1364,32.5,269,280,39,121,630,1410,252
2017,36081054700,"Census Tract 547, Queens County, New York",1556,99,1457,1029,4033,60257,1940,2009,1472,32.3,236,252,29,121,627,1457,196
2018,36081054700,"Census Tract 547, Queens County, New York",1570,130,1440,1026,3802,59265,0,2010,1557,34.7,286,265,28,87,633,1440,155
2019,36081054700,"Census Tract 547, Queens County, New York",1590,127,1463,1109,3655,64632,0,2011,1655,30.3,386,361,50,66,624,1463,170
2020,36081054700,"Census Tract 547, Queens County, New York",1617,138,1479,1064,3348,61368,0,2013,1656,28.9,387,391,37,110,517,1479,154
2012,36081054800,"Census Tract 548, Queens County, New York",672,21,651,116,463,57167,1943,2003,1436,32.2,12,0,54,28,28,651,58
2013,36081054800,"Census Tract 548, Queens County, New York",667,20,647,113,393,56477,1948,2004,1368,32.9,19,0,64,10,30,647,41
2014,36081054800,"Census Tract 548, Queens County, New York",629,22,607,117,385,56250,1949,2004,1329,33.3,19,0,69,10,30,607,47
2015,36081054800,"Census Tract 548, Queens County, New York",650,29,621,91,299,42750,1939,2007,1273,43,22,0,21,38,27,621,39
2016,36081054800,"Census Tract 548, Queens County, New York",656,37,619,99,298,40208,1939,2008,1328,48,23,0,37,38,18,619,45
2017,36081054800,"Census Tract 548, Queens County, New York",666,20,646,91,291,NA,1939,2009,1388,50,16,0,26,42,16,646,68
2018,36081054800,"Census Tract 548, Queens County, New York",661,15,646,93,324,44875,0,2013,1646,38.8,28,0,14,73,0,646,55
2019,36081054800,"Census Tract 548, Queens County, New York",681,43,638,89,301,52875,0,2013,1676,38.2,23,0,15,68,0,638,62
2020,36081054800,"Census Tract 548, Queens County, New York",752,53,699,114,304,NA,1941,2016,1554,18.8,21,0,42,56,0,699,66
2012,36081054900,"Census Tract 549, Queens County, New York",1783,75,1708,1590,5237,44960,1939,2004,1288,30,322,413,95,164,961,1708,379
2013,36081054900,"Census Tract 549, Queens County, New York",1774,73,1701,1620,5512,42632,1939,2005,1311,32.7,264,385,96,151,1029,1701,399
2014,36081054900,"Census Tract 549, Queens County, New York",1767,121,1646,1566,5130,40756,1939,2006,1316,34.8,220,440,77,172,926,1646,453
2015,36081054900,"Census Tract 549, Queens County, New York",1791,144,1647,1601,5299,41266,1939,2007,1332,36.5,299,418,72,124,1034,1647,454
2016,36081054900,"Census Tract 549, Queens County, New York",1819,146,1673,1617,5608,50786,1939,2009,1403,31.9,431,437,58,103,1036,1673,397
2017,36081054900,"Census Tract 549, Queens County, New York",1830,132,1698,1573,5690,59698,1939,2009,1433,28.9,482,379,24,167,1013,1698,318
2018,36081054900,"Census Tract 549, Queens County, New York",1829,137,1692,1548,5480,72333,0,2009,1515,28.1,507,382,25,223,918,1692,299
2019,36081054900,"Census Tract 549, Queens County, New York",1828,96,1732,1602,5933,76500,0,2010,1645,28.4,596,479,29,218,876,1732,240
2020,36081054900,"Census Tract 549, Queens County, New York",1747,83,1664,1529,5813,78482,0,2012,1688,28.8,571,414,70,213,832,1664,216
2012,36081055100,"Census Tract 551, Queens County, New York",1728,78,1650,1508,4388,38256,1939,2003,1135,32.9,256,648,52,71,717,1650,330
2013,36081055100,"Census Tract 551, Queens County, New York",1783,114,1669,1537,4400,36989,1939,2004,1163,34.5,331,655,52,89,733,1669,341
2014,36081055100,"Census Tract 551, Queens County, New York",1822,157,1665,1530,4640,40375,1939,2005,1204,32.6,342,679,32,85,724,1665,370
2015,36081055100,"Census Tract 551, Queens County, New York",1819,162,1657,1511,4442,NA,1939,2006,1255,32,411,686,44,109,651,1657,363
2016,36081055100,"Census Tract 551, Queens County, New York",1777,223,1554,1395,4223,57566,1939,2010,1318,26.6,395,672,41,156,492,1554,347
2017,36081055100,"Census Tract 551, Queens County, New York",1775,216,1559,1405,4229,59732,1939,2011,1365,27.6,464,746,44,147,474,1559,334
2018,36081055100,"Census Tract 551, Queens County, New York",1809,259,1550,1384,3942,61250,0,2011,1440,24.7,398,678,85,119,526,1550,296
2019,36081055100,"Census Tract 551, Queens County, New York",1783,228,1555,1413,3951,75280,0,2012,1589,24.5,524,665,102,145,526,1555,236
2020,36081055100,"Census Tract 551, Queens County, New York",1642,186,1456,1362,4072,82000,0,2013,1658,25,499,617,96,112,575,1456,181
2012,36081055200,"Census Tract 552, Queens County, New York",1090,0,1090,588,1662,45313,1954,2004,1278,32.1,147,50,268,132,145,1090,113
2013,36081055200,"Census Tract 552, Queens County, New York",1086,19,1067,561,1391,41298,1954,2005,1367,34.1,74,40,231,90,187,1067,139
2014,36081055200,"Census Tract 552, Queens County, New York",1074,26,1048,566,1478,38225,1955,2006,1403,42.9,93,31,269,84,172,1048,157
2015,36081055200,"Census Tract 552, Queens County, New York",1065,30,1035,621,1507,38632,1954,2007,1351,38.8,118,0,325,45,234,1035,141
2016,36081055200,"Census Tract 552, Queens County, New York",1067,46,1021,583,1310,36420,1954,2009,1354,40.9,107,8,259,57,178,1021,163
2017,36081055200,"Census Tract 552, Queens County, New York",1084,68,1016,587,1311,40524,1955,2007,1378,39.7,141,21,240,50,191,1016,129
2018,36081055200,"Census Tract 552, Queens County, New York",1059,51,1008,638,1494,37115,1953,2010,1455,39.3,183,22,242,71,195,1008,112
2019,36081055200,"Census Tract 552, Queens County, New York",1063,43,1020,631,1372,45481,1949,2011,1443,36.2,186,24,238,67,210,1020,77
2020,36081055200,"Census Tract 552, Queens County, New York",1014,41,973,641,1490,37782,1957,2012,1426,38.9,129,27,208,112,174,973,86
2012,36081055300,"Census Tract 553, Queens County, New York",878,71,807,719,2073,37724,1939,2004,1191,41.6,111,74,58,81,508,807,203
2013,36081055300,"Census Tract 553, Queens County, New York",890,85,805,728,1948,34375,1939,2004,1203,40.5,122,123,45,77,485,805,212
2014,36081055300,"Census Tract 553, Queens County, New York",863,94,769,681,2118,40868,1939,2006,1245,33.3,132,164,18,53,441,769,191
2015,36081055300,"Census Tract 553, Queens County, New York",878,113,765,652,2099,46477,1939,2009,1300,30.2,144,191,20,66,359,765,208
2016,36081055300,"Census Tract 553, Queens County, New York",920,97,823,701,2191,46027,1939,2010,1371,30.1,182,198,26,91,370,823,186
2017,36081055300,"Census Tract 553, Queens County, New York",912,73,839,706,2267,44783,1939,2011,1426,32,236,189,31,102,366,839,184
2018,36081055300,"Census Tract 553, Queens County, New York",937,75,862,733,2285,51875,0,2012,1524,31.6,291,173,36,111,396,862,185
2019,36081055300,"Census Tract 553, Queens County, New York",997,59,938,808,2367,60000,0,2013,1622,31.5,355,168,32,137,457,938,168
2020,36081055300,"Census Tract 553, Queens County, New York",1021,94,927,844,2507,61731,0,2013,1782,30.4,393,141,33,134,534,927,127
2012,36081055400,"Census Tract 554, Queens County, New York",833,4,829,331,1026,64250,1946,2003,1409,31.2,53,34,35,62,155,829,26
2013,36081055400,"Census Tract 554, Queens County, New York",796,5,791,315,914,70813,1944,2003,1330,26.3,57,51,31,56,135,791,27
2014,36081055400,"Census Tract 554, Queens County, New York",780,6,774,411,1144,51938,1945,2006,1544,34.9,52,59,62,98,152,774,25
2015,36081055400,"Census Tract 554, Queens County, New York",769,15,754,336,967,37361,1946,2008,1521,44.9,40,42,64,93,103,754,61
2016,36081055400,"Census Tract 554, Queens County, New York",766,28,738,308,773,35000,1945,2009,1540,50,32,58,59,86,101,738,64
2017,36081055400,"Census Tract 554, Queens County, New York",777,24,753,329,882,35903,1943,2010,1585,50,26,67,55,79,111,753,69
2018,36081055400,"Census Tract 554, Queens County, New York",781,25,756,352,1049,36375,1941,2011,1577,51,50,57,61,127,91,756,79
2019,36081055400,"Census Tract 554, Queens County, New York",770,29,741,323,1029,44750,1943,2013,1654,51,67,62,35,134,78,741,85
2020,36081055400,"Census Tract 554, Queens County, New York",771,15,756,353,1231,70703,1944,2012,1672,28.6,108,81,80,112,69,756,61
2012,36081055500,"Census Tract 555, Queens County, New York",752,69,683,489,1451,39427,1939,2003,1169,31.8,67,74,30,16,361,683,110
2013,36081055500,"Census Tract 555, Queens County, New York",728,47,681,545,1611,42702,1939,2006,1206,33.4,97,106,42,0,388,681,154
2014,36081055500,"Census Tract 555, Queens County, New York",692,28,664,545,1805,45268,1939,2006,1263,30.5,73,108,28,6,397,664,135
2015,36081055500,"Census Tract 555, Queens County, New York",705,34,671,548,1875,43000,1939,2006,1245,31.3,49,136,27,16,379,671,156
2016,36081055500,"Census Tract 555, Queens County, New York",711,31,680,534,1737,50227,1939,2007,1312,30.9,69,140,25,21,354,680,146
2017,36081055500,"Census Tract 555, Queens County, New York",714,18,696,505,1797,54814,1939,2009,1434,27.4,86,137,10,21,342,696,146
2018,36081055500,"Census Tract 555, Queens County, New York",714,37,677,484,1663,62727,0,2010,1491,27.1,108,141,7,21,313,677,138
2019,36081055500,"Census Tract 555, Queens County, New York",732,44,688,461,1585,55807,1941,2010,1491,31,118,123,6,23,309,688,130
2020,36081055500,"Census Tract 555, Queens County, New York",787,53,734,517,1692,65268,1941,2009,1622,27.2,138,110,7,9,387,734,131
2012,36081055600,"Census Tract 556, Queens County, New York",662,0,662,59,219,59107,1939,2000,1681,33.9,17,0,0,6,22,662,31
2013,36081055600,"Census Tract 556, Queens County, New York",690,5,685,53,200,48750,1939,2000,1511,46.6,28,4,0,17,11,685,42
2014,36081055600,"Census Tract 556, Queens County, New York",680,6,674,77,259,61458,1939,2001,1477,41.4,32,4,0,32,17,674,45
2015,36081055600,"Census Tract 556, Queens County, New York",667,5,662,75,242,61094,1939,2001,1443,42.5,17,5,0,16,18,662,31
2016,36081055600,"Census Tract 556, Queens County, New York",642,14,628,104,283,47000,1947,2006,1514,44.7,38,4,4,48,17,628,33
2017,36081055600,"Census Tract 556, Queens County, New York",666,14,652,108,261,65125,1945,2002,1243,42.4,15,4,9,31,54,652,43
2018,36081055600,"Census Tract 556, Queens County, New York",661,10,651,150,370,NA,1944,2001,1520,41,16,0,10,64,54,651,75
2019,36081055600,"Census Tract 556, Queens County, New York",665,8,657,137,357,48603,1944,2003,1601,45,17,0,11,51,44,657,75
2020,36081055600,"Census Tract 556, Queens County, New York",703,22,681,137,414,48021,1946,2003,1685,43.6,31,0,12,66,38,681,76
2012,36081055700,"Census Tract 557, Queens County, New York",1400,66,1334,1074,3410,38750,1939,2004,1328,33.4,122,291,89,98,655,1334,265
2013,36081055700,"Census Tract 557, Queens County, New York",1395,114,1281,985,3205,35223,1942,2004,1294,34.7,151,309,33,110,539,1281,284
2014,36081055700,"Census Tract 557, Queens County, New York",1380,81,1299,1039,3242,42049,1939,2005,1317,33,160,431,46,71,507,1299,245
2015,36081055700,"Census Tract 557, Queens County, New York",1395,127,1268,959,2879,NA,1939,2006,1279,34.6,121,351,33,69,516,1268,188
2016,36081055700,"Census Tract 557, Queens County, New York",1399,141,1258,957,2558,45959,1939,2009,1306,29.7,220,397,20,64,480,1258,139
2017,36081055700,"Census Tract 557, Queens County, New York",1424,150,1274,1004,2686,53646,1939,2011,1375,29,214,383,26,60,547,1274,147
2018,36081055700,"Census Tract 557, Queens County, New York",1484,81,1403,1100,3143,60444,0,2010,1335,27.2,267,456,33,56,564,1403,132
2019,36081055700,"Census Tract 557, Queens County, New York",1491,136,1355,1104,3174,64487,0,2011,1431,27.3,350,426,58,34,597,1355,154
2020,36081055700,"Census Tract 557, Queens County, New York",1452,144,1308,1123,3300,74044,0,2013,1577,25.5,472,458,52,36,598,1308,130
2012,36081055800,"Census Tract 558, Queens County, New York",574,20,554,49,129,39896,1946,2002,898,30.3,6,5,12,6,26,554,0
2013,36081055800,"Census Tract 558, Queens County, New York",561,17,544,78,245,79000,1939,2010,1547,22,0,4,14,33,32,544,2
2014,36081055800,"Census Tract 558, Queens County, New York",564,18,546,57,155,80208,1939,2006,1525,24.6,0,5,6,24,28,546,17
2015,36081055800,"Census Tract 558, Queens County, New York",538,20,518,68,184,NA,1939,2004,1375,30.8,0,5,8,30,33,518,23
2016,36081055800,"Census Tract 558, Queens County, New York",505,0,505,98,310,NA,1939,2008,1648,29.4,15,6,22,41,36,505,44
2017,36081055800,"Census Tract 558, Queens County, New York",521,19,502,85,299,NA,1939,2010,1807,27.1,17,6,25,42,20,502,46
2018,36081055800,"Census Tract 558, Queens County, New York",519,20,499,85,280,NA,1947,2010,2239,27.8,18,15,40,24,6,499,46
2019,36081055800,"Census Tract 558, Queens County, New York",529,35,494,80,266,NA,1947,2008,2200,28.2,18,15,43,18,4,494,49
2020,36081055800,"Census Tract 558, Queens County, New York",560,22,538,150,444,51146,0,2014,1804,51,11,13,53,36,48,538,66
2012,36081055900,"Census Tract 559, Queens County, New York",430,54,376,297,719,23508,1956,2005,1097,47.4,90,41,39,37,180,376,94
2013,36081055900,"Census Tract 559, Queens County, New York",456,20,436,331,1023,29792,1950,2007,1113,39.1,91,33,19,36,243,436,127
2014,36081055900,"Census Tract 559, Queens County, New York",459,37,422,307,970,40694,1959,2009,1192,33.8,90,41,10,34,222,422,134
2015,36081055900,"Census Tract 559, Queens County, New York",439,39,400,313,1062,58558,1960,2010,1287,31.2,88,51,9,27,226,400,113
2016,36081055900,"Census Tract 559, Queens County, New York",448,39,409,325,1087,59276,1963,2011,1359,30.5,119,44,14,37,230,409,111
2017,36081055900,"Census Tract 559, Queens County, New York",447,52,395,300,1036,50278,1971,2012,1322,30.9,123,73,15,24,188,395,97
2018,36081055900,"Census Tract 559, Queens County, New York",413,54,359,260,823,46579,1979,2013,1444,34.7,113,59,15,31,155,359,82
2019,36081055900,"Census Tract 559, Queens County, New York",401,31,370,280,904,65833,1975,2015,1708,35,112,84,6,16,174,370,59
2020,36081055900,"Census Tract 559, Queens County, New York",382,32,350,257,889,68079,1964,2016,1842,42.2,113,95,9,16,137,350,79
2012,36081056000,"Census Tract 560, Queens County, New York",523,22,501,193,551,39103,1948,2005,1343,39,60,11,93,42,36,501,84
2013,36081056000,"Census Tract 560, Queens County, New York",518,32,486,168,500,40938,1944,2005,1467,50,53,10,85,42,41,486,81
2014,36081056000,"Census Tract 560, Queens County, New York",515,49,466,199,472,26932,1971,2005,1375,50,54,16,75,38,41,466,100
2015,36081056000,"Census Tract 560, Queens County, New York",511,37,474,160,498,41406,1954,2006,1442,50,34,25,60,44,28,474,58
2016,36081056000,"Census Tract 560, Queens County, New York",496,33,463,148,443,50606,1952,2007,1363,43.2,15,22,55,44,14,463,49
2017,36081056000,"Census Tract 560, Queens County, New York",495,33,462,96,318,50357,1951,2010,1449,48.9,0,12,42,17,25,462,26
2018,36081056000,"Census Tract 560, Queens County, New York",499,34,465,80,228,85313,1953,2013,1461,32.1,12,16,25,7,32,465,16
2019,36081056000,"Census Tract 560, Queens County, New York",510,27,483,68,259,88864,0,2014,1464,42.3,10,4,22,5,42,483,3
2020,36081056000,"Census Tract 560, Queens County, New York",499,48,451,70,230,81667,0,2016,1778,37.5,24,0,18,21,33,451,5
2012,36081056100,"Census Tract 561, Queens County, New York",49,0,49,30,103,113750,1939,2005,1750,18.8,20,0,0,0,20,49,0
2013,36081056100,"Census Tract 561, Queens County, New York",52,0,52,30,103,116250,1939,2005,1750,18.8,20,0,0,0,20,52,0
2014,36081056100,"Census Tract 561, Queens County, New York",55,0,55,29,105,116125,1939,2005,1750,18.8,19,0,0,0,19,55,0
2015,36081056100,"Census Tract 561, Queens County, New York",43,0,43,15,60,NA,NA,NA,NA,NA,4,0,0,0,4,43,0
2016,36081056100,"Census Tract 561, Queens County, New York",33,0,33,15,62,NA,NA,NA,NA,NA,4,0,0,0,4,33,0
2017,36081056100,"Census Tract 561, Queens County, New York",27,0,27,4,8,NA,NA,NA,NA,NA,4,0,0,0,4,27,0
2018,36081056100,"Census Tract 561, Queens County, New York",24,0,24,4,8,NA,NA,NA,NA,NA,4,0,0,0,4,24,0
2019,36081056100,"Census Tract 561, Queens County, New York",8,0,8,4,9,NA,NA,NA,NA,NA,4,0,0,0,4,8,0
2020,36081056100,"Census Tract 561, Queens County, New York",4,0,4,0,0,NA,NA,NA,NA,NA,0,0,0,0,0,4,0
2012,36081056200,"Census Tract 562, Queens County, New York",466,0,466,86,390,44531,1939,2003,1451,45,8,12,13,4,70,466,68
2013,36081056200,"Census Tract 562, Queens County, New York",462,0,462,130,565,47278,1939,2003,1656,42.6,7,14,29,3,101,462,85
2014,36081056200,"Census Tract 562, Queens County, New York",468,0,468,166,681,47237,1939,2003,1653,46.5,9,25,31,4,116,468,62
2015,36081056200,"Census Tract 562, Queens County, New York",455,16,439,98,393,46447,1939,2002,1395,41.9,0,17,40,5,52,439,44
2016,36081056200,"Census Tract 562, Queens County, New York",451,17,434,72,290,60119,1939,1999,1390,29.8,0,13,26,5,28,434,38
2017,36081056200,"Census Tract 562, Queens County, New York",485,18,467,61,111,47054,1939,1999,1344,31.3,20,12,35,14,0,467,23
2018,36081056200,"Census Tract 562, Queens County, New York",482,18,464,27,63,NA,1958,2003,1458,51,7,6,14,7,0,464,21
2019,36081056200,"Census Tract 562, Queens County, New York",457,21,436,23,39,NA,1950,NA,NA,NA,20,0,8,15,0,436,20
2020,36081056200,"Census Tract 562, Queens County, New York",556,26,530,36,100,NA,1952,NA,NA,NA,21,0,6,30,0,530,15
2012,36081056400,"Census Tract 564, Queens County, New York",615,68,547,364,1163,51094,1939,2006,1353,33.8,101,90,27,127,113,547,14
2013,36081056400,"Census Tract 564, Queens County, New York",603,46,557,360,1164,47100,1942,2006,1392,40.6,76,96,40,100,118,557,13
2014,36081056400,"Census Tract 564, Queens County, New York",605,58,547,369,1170,40994,1940,2006,1498,46.4,41,110,57,85,111,547,23
2015,36081056400,"Census Tract 564, Queens County, New York",592,95,497,331,1080,41845,1945,2007,1488,44,44,73,57,93,72,497,24
2016,36081056400,"Census Tract 564, Queens County, New York",586,109,477,317,898,32022,1943,2007,1464,42.5,50,61,71,73,90,477,46
2017,36081056400,"Census Tract 564, Queens County, New York",595,81,514,309,847,35179,1943,2007,1469,38.3,24,69,55,43,103,514,27
2018,36081056400,"Census Tract 564, Queens County, New York",561,96,465,266,679,31204,1942,2007,1472,46,25,73,39,38,76,465,30
2019,36081056400,"Census Tract 564, Queens County, New York",569,152,417,208,532,46111,1943,2010,1451,34.8,19,44,20,40,68,417,26
2020,36081056400,"Census Tract 564, Queens County, New York",575,120,455,199,388,32750,1944,2008,1522,40,17,86,17,38,58,455,36
2012,36081056500,"Census Tract 565, Queens County, New York",492,112,380,228,860,22400,1952,2006,1490,49.4,30,5,10,25,188,380,145
2013,36081056500,"Census Tract 565, Queens County, New York",522,90,432,297,1188,35438,1949,2007,1433,46.9,44,17,8,35,237,432,153
2014,36081056500,"Census Tract 565, Queens County, New York",520,66,454,272,1039,37300,1944,2011,1380,40.1,31,32,10,20,210,454,132
2015,36081056500,"Census Tract 565, Queens County, New York",502,53,449,259,825,45893,1943,2010,1383,34.3,13,34,8,0,217,449,96
2016,36081056500,"Census Tract 565, Queens County, New York",509,0,509,289,905,62019,1946,2011,1473,26.1,25,82,0,0,207,509,84
2017,36081056500,"Census Tract 565, Queens County, New York",516,9,507,340,1140,62115,1947,2011,1576,27.2,27,92,0,0,245,507,61
2018,36081056500,"Census Tract 565, Queens County, New York",516,9,507,292,855,54904,1953,2011,1675,28,29,81,8,0,202,507,54
2019,36081056500,"Census Tract 565, Queens County, New York",527,9,518,292,970,80227,1959,2011,1904,28,60,65,23,0,200,518,43
2020,36081056500,"Census Tract 565, Queens County, New York",574,23,551,348,995,103409,1948,2014,1647,19.2,51,93,25,0,224,551,37
2012,36081056600,"Census Tract 566, Queens County, New York",503,0,503,267,1010,65560,1939,2004,1531,32.1,52,42,12,77,126,503,0
2013,36081056600,"Census Tract 566, Queens County, New York",489,46,443,186,775,69706,1939,2005,1663,35.7,39,24,6,26,122,443,23
2014,36081056600,"Census Tract 566, Queens County, New York",483,39,444,171,742,69526,1939,2005,1676,35.4,33,21,5,34,104,444,22
2015,36081056600,"Census Tract 566, Queens County, New York",472,54,418,99,410,51250,1962,2011,1420,37.6,17,0,26,20,53,418,47
2016,36081056600,"Census Tract 566, Queens County, New York",472,62,410,173,656,48472,1961,2012,1299,37.5,30,0,65,29,79,410,39
2017,36081056600,"Census Tract 566, Queens County, New York",471,77,394,128,457,NA,1947,2013,1269,33.1,40,0,59,25,44,394,42
2018,36081056600,"Census Tract 566, Queens County, New York",487,46,441,145,478,NA,1947,2013,1372,40.3,45,4,67,24,45,441,53
2019,36081056600,"Census Tract 566, Queens County, New York",493,47,446,155,435,NA,1952,2013,1396,24.9,61,21,69,15,46,446,55
2020,36081056600,"Census Tract 566, Queens County, New York",527,38,489,241,546,NA,1953,2010,1203,51,55,22,42,8,63,489,169
2012,36081056700,"Census Tract 567, Queens County, New York",1633,108,1525,651,1698,42171,1939,2005,1387,35.1,124,225,37,0,389,1525,134
2013,36081056700,"Census Tract 567, Queens County, New York",1580,127,1453,567,1471,56033,1939,2006,1405,28,134,172,12,9,374,1453,114
2014,36081056700,"Census Tract 567, Queens County, New York",1593,157,1436,561,1546,46607,1939,2008,1472,32.5,147,160,37,33,331,1436,120
2015,36081056700,"Census Tract 567, Queens County, New York",1628,211,1417,518,1483,57115,1939,2010,1467,27.7,152,147,45,46,280,1417,68
2016,36081056700,"Census Tract 567, Queens County, New York",1681,192,1489,498,1466,60833,1939,2011,1449,27.4,141,161,27,65,245,1489,57
2017,36081056700,"Census Tract 567, Queens County, New York",1670,168,1502,474,1573,88194,1939,2012,1598,23.9,119,110,23,75,266,1502,46
2018,36081056700,"Census Tract 567, Queens County, New York",1682,164,1518,567,1972,90580,0,2011,1674,26,115,98,51,64,354,1518,42
2019,36081056700,"Census Tract 567, Queens County, New York",1656,138,1518,563,2004,93940,1941,2012,1753,25.9,92,87,38,40,398,1518,22
2020,36081056700,"Census Tract 567, Queens County, New York",1608,76,1532,580,2100,105425,0,2010,1683,20.7,57,75,26,29,450,1532,33
2012,36081056800,"Census Tract 568, Queens County, New York",1518,60,1458,675,1849,55250,1946,2004,1183,30.5,161,63,432,0,154,1458,173
2013,36081056800,"Census Tract 568, Queens County, New York",1503,41,1462,693,2004,49550,1943,2004,1249,32.1,135,33,494,0,160,1462,134
2014,36081056800,"Census Tract 568, Queens County, New York",1511,81,1430,657,1826,39673,1942,2005,1271,36.6,90,25,466,0,147,1430,189
2015,36081056800,"Census Tract 568, Queens County, New York",1481,76,1405,572,1389,38547,1944,2006,1208,36.4,75,22,332,0,202,1405,159
2016,36081056800,"Census Tract 568, Queens County, New York",1510,85,1425,670,1710,33511,1945,2009,1302,37.2,39,26,412,0,202,1425,130
2017,36081056800,"Census Tract 568, Queens County, New York",1526,88,1438,657,1806,42270,1947,2011,1388,36.5,46,11,374,10,215,1438,88
2018,36081056800,"Census Tract 568, Queens County, New York",1482,93,1389,540,1531,53095,1946,2012,1419,28.8,45,12,327,13,144,1389,104
2019,36081056800,"Census Tract 568, Queens County, New York",1496,61,1435,585,1559,53576,1947,2012,1509,28.7,79,10,352,14,159,1435,119
2020,36081056800,"Census Tract 568, Queens County, New York",1669,68,1601,533,1453,70625,1952,2012,1587,29.5,95,10,359,12,92,1601,54
2012,36081057700,"Census Tract 577, Queens County, New York",1500,54,1446,1015,2938,37269,1939,2004,1139,32.1,237,522,33,39,413,1446,210
2013,36081057700,"Census Tract 577, Queens County, New York",1443,61,1382,1004,2830,36559,1939,2004,1111,32.7,238,585,33,41,337,1382,245
2014,36081057700,"Census Tract 577, Queens County, New York",1416,86,1330,942,2827,42404,1939,2005,1180,30.6,266,536,0,31,358,1330,164
2015,36081057700,"Census Tract 577, Queens County, New York",1368,66,1302,897,2504,58456,1939,2006,1189,24.7,199,536,0,21,314,1302,123
2016,36081057700,"Census Tract 577, Queens County, New York",1415,73,1342,961,2579,51118,1939,2007,1208,29.5,261,550,10,26,346,1342,130
2017,36081057700,"Census Tract 577, Queens County, New York",1445,99,1346,899,2693,59805,1939,2007,1258,27.8,247,466,19,19,376,1346,116
2018,36081057700,"Census Tract 577, Queens County, New York",1469,116,1353,817,2486,67171,0,2009,1323,24.9,294,439,29,13,329,1353,93
2019,36081057700,"Census Tract 577, Queens County, New York",1529,80,1449,954,2669,60938,0,2010,1335,31.7,295,502,30,21,403,1449,181
2020,36081057700,"Census Tract 577, Queens County, New York",1535,77,1458,963,2426,55156,0,2012,1433,31.5,256,598,22,4,346,1458,198
2012,36081057900,"Census Tract 579, Queens County, New York",604,72,532,392,918,20278,1939,1998,1082,50,42,270,0,0,108,532,203
2013,36081057900,"Census Tract 579, Queens County, New York",624,61,563,414,947,21364,1939,1999,1250,50,47,286,0,0,115,563,173
2014,36081057900,"Census Tract 579, Queens County, New York",664,63,601,435,1200,26343,1939,2002,1342,47,77,292,0,0,131,601,180
2015,36081057900,"Census Tract 579, Queens County, New York",684,93,591,415,1064,48068,1939,2005,1302,33.3,80,271,0,0,125,591,87
2016,36081057900,"Census Tract 579, Queens County, New York",682,67,615,431,1133,48083,1939,2008,1321,33.2,104,255,6,4,149,615,105
2017,36081057900,"Census Tract 579, Queens County, New York",697,67,630,464,1383,54500,1939,2011,1378,30.7,158,263,5,5,191,630,73
2018,36081057900,"Census Tract 579, Queens County, New York",689,52,637,492,1402,57109,0,2012,1481,31.9,216,292,6,19,175,637,68
2019,36081057900,"Census Tract 579, Queens County, New York",668,74,594,481,1300,57743,0,2012,1573,32.6,212,278,13,20,177,594,67
2020,36081057900,"Census Tract 579, Queens County, New York",686,60,626,498,1257,58152,0,2012,1565,29.6,140,240,31,24,218,626,88
2012,36081058000,"Census Tract 580, Queens County, New York",1145,12,1133,324,1180,71389,1946,2002,1714,31.2,74,11,298,0,23,1133,55
2013,36081058000,"Census Tract 580, Queens County, New York",1122,13,1109,382,1241,71806,1945,2002,1586,30.1,63,7,337,0,48,1109,49
2014,36081058000,"Census Tract 580, Queens County, New York",1133,54,1079,377,1202,74276,1943,2002,1592,31.9,31,7,301,0,67,1079,99
2015,36081058000,"Census Tract 580, Queens County, New York",1134,61,1073,349,1056,64744,1942,2002,1613,32.9,22,7,272,0,80,1073,79
2016,36081058000,"Census Tract 580, Queens County, New York",1156,49,1107,352,895,65139,1945,2003,1421,31.3,28,18,262,0,64,1107,89
2017,36081058000,"Census Tract 580, Queens County, New York",1129,47,1082,376,994,42400,1944,2006,1332,31.7,64,9,285,0,65,1082,122
2018,36081058000,"Census Tract 580, Queens County, New York",1121,46,1075,296,882,42400,1945,2012,1341,30.2,70,10,239,0,32,1075,124
2019,36081058000,"Census Tract 580, Queens County, New York",1136,9,1127,345,989,41743,0,2013,1343,29.4,116,18,301,0,13,1127,87
2020,36081058000,"Census Tract 580, Queens County, New York",1098,0,1098,287,825,60436,1943,2014,1207,27.4,103,16,248,0,0,1098,79
2012,36081058100,"Census Tract 581, Queens County, New York",1073,87,986,597,1353,35938,1939,2003,1204,32.4,137,348,25,0,249,986,150
2013,36081058100,"Census Tract 581, Queens County, New York",1104,77,1027,619,1573,46063,1942,2004,1267,30,178,351,18,0,259,1027,176
2014,36081058100,"Census Tract 581, Queens County, New York",1107,37,1070,683,1675,48682,1939,2006,1297,31.1,122,364,18,0,310,1070,152
2015,36081058100,"Census Tract 581, Queens County, New York",1123,45,1078,698,1751,39300,1939,2007,1279,34.5,143,364,19,0,324,1078,131
2016,36081058100,"Census Tract 581, Queens County, New York",1135,50,1085,695,1715,38150,1939,2009,1342,39,154,346,19,0,340,1085,134
2017,36081058100,"Census Tract 581, Queens County, New York",1144,60,1084,701,2018,39365,1939,2011,1383,38.8,162,308,9,20,364,1084,111
2018,36081058100,"Census Tract 581, Queens County, New York",1162,62,1100,709,1977,60417,0,2011,1441,29.2,137,338,18,21,312,1100,120
2019,36081058100,"Census Tract 581, Queens County, New York",1154,67,1087,652,1891,64583,0,2012,1498,28.5,171,307,22,23,284,1087,112
2020,36081058100,"Census Tract 581, Queens County, New York",1226,103,1123,740,1946,61691,0,2011,1425,24.1,133,257,22,23,423,1123,100
2012,36081058200,"Census Tract 582, Queens County, New York",1425,33,1392,518,1837,31698,1944,2003,1052,40.2,22,0,453,0,44,1392,262
2013,36081058200,"Census Tract 582, Queens County, New York",1452,25,1427,432,1634,53883,1943,2003,1204,28.7,30,0,371,0,39,1427,183
2014,36081058200,"Census Tract 582, Queens County, New York",1453,37,1416,393,1582,40417,1947,2006,1306,29.3,68,0,331,0,32,1416,185
2015,36081058200,"Census Tract 582, Queens County, New York",1408,62,1346,353,1411,40625,1943,2006,1356,29.4,61,0,311,0,42,1346,200
2016,36081058200,"Census Tract 582, Queens County, New York",1430,81,1349,360,1432,39375,1943,2006,1548,32.9,61,0,319,0,41,1349,202
2017,36081058200,"Census Tract 582, Queens County, New York",1398,76,1322,275,989,57014,1939,2009,1338,28.1,61,0,257,0,18,1322,78
2018,36081058200,"Census Tract 582, Queens County, New York",1395,96,1299,266,868,42273,0,2006,1298,32.6,52,0,247,0,19,1299,98
2019,36081058200,"Census Tract 582, Queens County, New York",1408,71,1337,249,695,41534,0,2003,1362,34.4,40,0,212,0,17,1337,63
2020,36081058200,"Census Tract 582, Queens County, New York",1474,63,1411,232,621,51912,0,1999,1432,31.9,45,0,199,0,17,1411,69
2012,36081058300,"Census Tract 583, Queens County, New York",1350,143,1207,849,2524,57938,1939,2004,1308,26.7,258,527,27,36,276,1207,246
2013,36081058300,"Census Tract 583, Queens County, New York",1362,227,1135,842,2362,61136,1939,2005,1403,25.3,228,522,42,34,255,1135,198
2014,36081058300,"Census Tract 583, Queens County, New York",1414,198,1216,918,2630,54918,1939,2004,1314,27.6,243,404,92,29,420,1216,180
2015,36081058300,"Census Tract 583, Queens County, New York",1420,158,1262,843,2306,53906,1939,2005,1341,28.1,191,362,108,25,381,1262,154
2016,36081058300,"Census Tract 583, Queens County, New York",1401,161,1240,856,2529,76000,1939,2007,1381,24.8,204,389,103,26,366,1240,126
2017,36081058300,"Census Tract 583, Queens County, New York",1376,187,1189,861,2435,76528,1939,2010,1575,26,230,407,90,28,349,1189,65
2018,36081058300,"Census Tract 583, Queens County, New York",1389,159,1230,872,2519,79943,0,2011,1630,26.6,210,428,57,45,325,1230,72
2019,36081058300,"Census Tract 583, Queens County, New York",1389,160,1229,863,2535,76985,0,2012,1724,26.4,160,458,20,72,290,1229,27
2020,36081058300,"Census Tract 583, Queens County, New York",1412,164,1248,908,2639,90329,0,2013,1819,27.7,239,503,0,65,280,1248,20
2012,36081058500,"Census Tract 585, Queens County, New York",1558,170,1388,1003,3008,42063,1939,2004,1327,36,130,483,0,42,478,1388,232
2013,36081058500,"Census Tract 585, Queens County, New York",1605,160,1445,1059,3152,49861,1939,2004,1316,30.9,173,568,0,62,429,1445,244
2014,36081058500,"Census Tract 585, Queens County, New York",1605,147,1458,1003,3074,49450,1939,2006,1375,32.6,187,479,12,37,475,1458,215
2015,36081058500,"Census Tract 585, Queens County, New York",1600,170,1430,947,2907,49792,1939,2007,1328,34,223,425,7,34,481,1430,188
2016,36081058500,"Census Tract 585, Queens County, New York",1593,85,1508,1094,3282,55000,1939,2009,1404,28,318,519,11,41,503,1508,155
2017,36081058500,"Census Tract 585, Queens County, New York",1552,87,1465,1063,3069,61855,1939,2009,1410,27.1,314,551,40,47,416,1465,107
2018,36081058500,"Census Tract 585, Queens County, New York",1554,123,1431,1029,3023,74531,0,2010,1537,29.9,371,586,56,26,369,1431,84
2019,36081058500,"Census Tract 585, Queens County, New York",1553,110,1443,1145,3566,77048,0,2011,1666,27.2,482,628,63,55,416,1443,111
2020,36081058500,"Census Tract 585, Queens County, New York",1643,42,1601,1322,3801,80805,0,2014,1718,24.4,683,799,58,48,407,1601,230
2012,36081058700,"Census Tract 587, Queens County, New York",1323,60,1263,1080,2484,42067,1939,2004,1137,29.3,285,746,27,46,247,1263,225
2013,36081058700,"Census Tract 587, Queens County, New York",1337,36,1301,1101,2408,42201,1939,2004,1130,28.6,311,750,35,67,240,1301,208
2014,36081058700,"Census Tract 587, Queens County, New York",1319,36,1283,1023,2408,46653,1939,2004,1139,27.7,286,711,33,61,209,1283,198
2015,36081058700,"Census Tract 587, Queens County, New York",1401,38,1363,1059,2631,48355,1939,2006,1184,28.9,290,704,18,38,309,1363,182
2016,36081058700,"Census Tract 587, Queens County, New York",1387,59,1328,1034,2684,55519,1939,2009,1302,30,316,658,18,38,330,1328,112
2017,36081058700,"Census Tract 587, Queens County, New York",1402,67,1335,980,2694,58651,1939,2007,1341,29.5,254,641,18,21,311,1335,83
2018,36081058700,"Census Tract 587, Queens County, New York",1360,124,1236,917,2687,64271,0,2009,1465,29.7,292,618,22,9,268,1236,110
2019,36081058700,"Census Tract 587, Queens County, New York",1380,161,1219,884,2557,83081,0,2011,1618,27.9,282,529,39,24,292,1219,78
2020,36081058700,"Census Tract 587, Queens County, New York",1441,173,1268,903,2440,85150,0,2014,1603,26.6,256,607,37,51,208,1268,72
2012,36081058900,"Census Tract 589, Queens County, New York",1707,154,1553,1366,3842,45000,1939,2004,1171,30.4,283,779,8,20,541,1553,314
2013,36081058900,"Census Tract 589, Queens County, New York",1687,127,1560,1409,3708,40163,1939,2005,1191,32.1,287,842,15,17,524,1560,367
2014,36081058900,"Census Tract 589, Queens County, New York",1714,182,1532,1342,3583,45417,1939,2006,1266,30,319,761,23,42,516,1532,306
2015,36081058900,"Census Tract 589, Queens County, New York",1727,195,1532,1347,3693,36425,1942,2008,1294,37.6,335,755,32,64,496,1532,358
2016,36081058900,"Census Tract 589, Queens County, New York",1740,189,1551,1293,3794,36375,1945,2009,1331,37.5,336,743,30,49,486,1551,400
2017,36081058900,"Census Tract 589, Queens County, New York",1710,153,1557,1274,3768,42870,1943,2010,1378,32.6,371,726,34,48,490,1557,343
2018,36081058900,"Census Tract 589, Queens County, New York",1718,157,1561,1265,3999,58844,0,2011,1435,27.6,411,644,34,61,560,1561,233
2019,36081058900,"Census Tract 589, Queens County, New York",1724,110,1614,1346,4197,60833,0,2013,1477,30.4,522,698,16,67,581,1614,300
2020,36081058900,"Census Tract 589, Queens County, New York",1823,89,1734,1504,4192,66768,0,2014,1471,29,763,829,14,93,582,1734,292
2012,36081059000,"Census Tract 590, Queens County, New York",422,0,422,48,120,9722,1957,NA,1313,50,0,0,37,11,0,422,55
2013,36081059000,"Census Tract 590, Queens County, New York",409,0,409,59,158,67765,1939,NA,1368,29.5,0,0,59,0,0,409,62
2014,36081059000,"Census Tract 590, Queens County, New York",409,0,409,37,198,18438,1959,NA,1389,50,0,0,37,0,0,409,49
2015,36081059000,"Census Tract 590, Queens County, New York",400,0,400,56,245,NA,1948,2007,1381,50,0,0,53,0,0,400,58
2016,36081059000,"Census Tract 590, Queens County, New York",396,0,396,55,266,38750,1942,2009,1383,43.3,0,0,52,0,0,396,41
2017,36081059000,"Census Tract 590, Queens County, New York",393,0,393,93,407,50040,1939,2007,1898,50,31,0,59,0,0,393,27
2018,36081059000,"Census Tract 590, Queens County, New York",422,0,422,98,390,53041,0,2008,2000,46.4,37,0,52,6,0,422,4
2019,36081059000,"Census Tract 590, Queens County, New York",434,0,434,100,323,52821,0,2009,2150,47.1,39,0,51,6,0,434,11
2020,36081059000,"Census Tract 590, Queens County, New York",400,0,400,61,193,55850,0,2007,NA,14.8,25,0,30,6,0,400,24
2012,36081059100,"Census Tract 591, Queens County, New York",2123,209,1914,1687,4936,45586,1939,2004,1220,32.5,253,657,34,28,929,1914,372
2013,36081059100,"Census Tract 591, Queens County, New York",2152,245,1907,1672,4610,34276,1939,2005,1200,38.5,322,680,9,16,939,1907,358
2014,36081059100,"Census Tract 591, Queens County, New York",2138,278,1860,1619,3998,34908,1939,2005,1164,28.9,453,679,20,88,806,1860,325
2015,36081059100,"Census Tract 591, Queens County, New York",2201,226,1975,1760,4480,NA,1939,2006,1171,25.4,464,725,30,84,926,1975,299
2016,36081059100,"Census Tract 591, Queens County, New York",2187,253,1934,1731,4496,52034,1939,2007,1213,28.6,458,799,37,92,840,1934,277
2017,36081059100,"Census Tract 591, Queens County, New York",2168,186,1982,1733,4489,59561,1939,2009,1327,29.7,541,854,76,93,741,1982,271
2018,36081059100,"Census Tract 591, Queens County, New York",2182,165,2017,1737,4629,68723,0,2009,1383,26.4,540,877,88,102,705,2017,212
2019,36081059100,"Census Tract 591, Queens County, New York",2219,134,2085,1737,4618,70514,0,2011,1479,27.3,517,926,115,31,700,2085,106
2020,36081059100,"Census Tract 591, Queens County, New York",2317,164,2153,1724,4140,65387,0,2012,1581,30.5,551,771,85,21,847,2153,185
2012,36081059200,"Census Tract 592, Queens County, New York",431,15,416,83,184,31220,1948,2000,1037,27.6,4,0,83,0,0,416,15
2013,36081059200,"Census Tract 592, Queens County, New York",433,16,417,92,192,30889,1948,2003,736,29,4,0,92,0,0,417,9
2014,36081059200,"Census Tract 592, Queens County, New York",387,16,371,64,143,34015,1948,2006,700,26.6,4,0,64,0,0,371,17
2015,36081059200,"Census Tract 592, Queens County, New York",372,14,358,45,114,NA,1951,2004,695,26.3,4,0,45,0,0,358,10
2016,36081059200,"Census Tract 592, Queens County, New York",374,0,374,36,96,59231,1954,2001,NA,19.2,4,0,36,0,0,374,21
2017,36081059200,"Census Tract 592, Queens County, New York",396,0,396,30,85,61923,1958,2002,NA,17,3,0,30,0,0,396,22
2018,36081059200,"Census Tract 592, Queens County, New York",396,0,396,16,39,NA,1951,1992,1875,27.9,3,0,16,0,0,396,22
2019,36081059200,"Census Tract 592, Queens County, New York",405,0,405,30,94,115714,1953,2008,2174,23.6,4,0,30,0,0,405,17
2020,36081059200,"Census Tract 592, Queens County, New York",481,0,481,51,130,NA,1947,1989,2060,25.6,4,0,51,0,0,481,112
2012,36081059300,"Census Tract 593, Queens County, New York",1598,173,1425,989,2425,47332,1943,2004,1192,28.5,361,602,66,44,320,1425,243
2013,36081059300,"Census Tract 593, Queens County, New York",1599,139,1460,1015,2438,45139,1951,2005,1214,31.3,351,645,54,42,304,1460,218
2014,36081059300,"Census Tract 593, Queens County, New York",1586,147,1439,988,2662,51389,1946,2006,1260,29.6,336,660,53,29,265,1439,202
2015,36081059300,"Census Tract 593, Queens County, New York",1608,105,1503,991,2885,52791,1939,2008,1290,30.1,351,677,43,14,263,1503,203
2016,36081059300,"Census Tract 593, Queens County, New York",1580,87,1493,994,2941,54655,1939,2010,1344,27.6,333,692,43,8,259,1493,189
2017,36081059300,"Census Tract 593, Queens County, New York",1580,83,1497,950,2831,60455,1939,2011,1415,27.6,317,680,7,16,247,1497,168
2018,36081059300,"Census Tract 593, Queens County, New York",1595,97,1498,994,2941,68036,0,2011,1489,29.7,321,658,9,48,279,1498,137
2019,36081059300,"Census Tract 593, Queens County, New York",1641,103,1538,1015,2842,69458,0,2012,1612,31.8,330,661,0,50,304,1538,133
2020,36081059300,"Census Tract 593, Queens County, New York",1583,99,1484,959,2496,71344,0,2012,1600,27.5,331,601,0,53,305,1484,153
2012,36081059400,"Census Tract 594, Queens County, New York",566,49,517,58,126,54722,1952,2007,2001,23.6,13,0,54,0,0,517,39
2013,36081059400,"Census Tract 594, Queens County, New York",567,52,515,90,213,62059,1954,2005,1200,22.8,32,0,85,0,0,515,24
2014,36081059400,"Census Tract 594, Queens County, New York",560,52,508,109,295,86490,1953,2004,1583,22.1,50,0,104,0,0,508,25
2015,36081059400,"Census Tract 594, Queens County, New York",544,64,480,95,286,85458,1950,2004,1155,21.6,56,0,83,0,6,480,24
2016,36081059400,"Census Tract 594, Queens County, New York",532,40,492,71,258,86205,1953,2002,1211,18.3,53,0,60,0,5,492,42
2017,36081059400,"Census Tract 594, Queens County, New York",541,12,529,87,338,102734,1950,2003,1635,18.1,70,0,83,0,4,529,36
2018,36081059400,"Census Tract 594, Queens County, New York",548,11,537,62,240,106607,1946,2002,1813,22.1,47,4,47,0,6,537,32
2019,36081059400,"Census Tract 594, Queens County, New York",539,19,520,36,160,116607,NA,2003,2696,26.4,22,4,22,0,5,520,18
2020,36081059400,"Census Tract 594, Queens County, New York",532,4,528,33,123,118977,NA,2003,NA,NA,23,4,23,0,0,528,16
2012,36081059500,"Census Tract 595, Queens County, New York",1746,141,1605,952,2424,59196,1939,2003,1307,30.8,158,433,7,9,503,1605,173
2013,36081059500,"Census Tract 595, Queens County, New York",1753,160,1593,1005,2582,54083,1939,2004,1304,30,202,457,40,20,503,1593,203
2014,36081059500,"Census Tract 595, Queens County, New York",1719,161,1558,941,2451,52148,1939,2005,1286,29.7,217,511,46,19,375,1558,296
2015,36081059500,"Census Tract 595, Queens County, New York",1730,157,1573,824,2033,36620,1939,2008,1261,32.3,224,422,40,16,354,1573,331
2016,36081059500,"Census Tract 595, Queens County, New York",1754,162,1592,921,2549,51708,1939,2010,1309,29.2,299,491,45,24,352,1592,277
2017,36081059500,"Census Tract 595, Queens County, New York",1757,105,1652,976,2961,57019,1939,2010,1457,29,287,540,36,22,376,1652,268
2018,36081059500,"Census Tract 595, Queens County, New York",1766,136,1630,1009,3038,56360,0,2011,1537,33.4,322,567,10,12,402,1630,252
2019,36081059500,"Census Tract 595, Queens County, New York",1782,138,1644,1044,3449,59185,0,2011,1605,27.3,328,632,20,14,377,1644,301
2020,36081059501,"Census Tract 595.01, Queens County, New York",764,84,680,494,1442,85303,0,2011,1582,23.5,166,459,0,7,28,680,111
2020,36081059502,"Census Tract 595.02, Queens County, New York",939,101,838,570,2067,51500,0,2011,1615,30.9,149,134,37,0,407,838,146
2012,36081059600,"Census Tract 596, Queens County, New York",515,27,488,116,206,76000,1979,2005,983,19.1,33,0,116,0,0,488,25
2013,36081059600,"Census Tract 596, Queens County, New York",500,0,500,135,235,78412,1980,2005,977,18.9,38,0,135,0,0,500,26
2014,36081059600,"Census Tract 596, Queens County, New York",484,0,484,73,137,30083,1940,2004,879,37,8,0,73,0,0,484,34
2015,36081059600,"Census Tract 596, Queens County, New York",484,17,467,43,56,31991,1944,2004,1162,44.5,4,0,43,0,12,467,16
2016,36081059600,"Census Tract 596, Queens County, New York",467,42,425,35,47,NA,NA,NA,NA,NA,0,0,35,0,10,425,19
2017,36081059600,"Census Tract 596, Queens County, New York",477,38,439,63,239,38125,1939,2012,1781,47.5,31,0,63,0,10,439,17
2018,36081059600,"Census Tract 596, Queens County, New York",488,35,453,63,234,32260,1953,2012,1786,51,29,0,63,0,8,453,46
2019,36081059600,"Census Tract 596, Queens County, New York",485,33,452,85,308,70515,0,2011,2125,45,37,0,85,0,10,452,61
2020,36081059600,"Census Tract 596, Queens County, New York",541,17,524,59,216,70917,0,2012,2164,46.3,28,0,59,0,0,524,61
2012,36081059800,"Census Tract 598, Queens County, New York",588,28,560,129,388,44432,1945,2004,1245,34.6,16,11,111,7,0,560,25
2013,36081059800,"Census Tract 598, Queens County, New York",588,40,548,163,538,65223,1943,2008,1472,32.3,23,13,142,8,0,548,23
2014,36081059800,"Census Tract 598, Queens County, New York",598,42,556,156,466,46607,1941,2011,1364,32.9,31,12,136,8,0,556,26
2015,36081059800,"Census Tract 598, Queens County, New York",588,33,555,119,371,73750,1948,2011,1430,26.2,38,12,100,7,0,555,27
2016,36081059800,"Census Tract 598, Queens County, New York",581,32,549,125,348,58438,1943,2011,1476,28.3,35,11,107,7,0,549,20
2017,36081059800,"Census Tract 598, Queens County, New York",573,22,551,123,314,59034,1950,2011,1479,28,30,0,117,0,0,551,44
2018,36081059800,"Census Tract 598, Queens County, New York",585,16,569,115,190,51181,0,2006,1369,34.1,23,0,109,0,8,569,42
2019,36081059800,"Census Tract 598, Queens County, New York",598,25,573,146,298,52386,0,2010,1452,33.1,32,0,140,0,9,573,36
2020,36081059800,"Census Tract 598, Queens County, New York",551,22,529,165,549,61917,0,2009,1488,30.9,33,0,157,0,6,529,23
2012,36081059900,"Census Tract 599, Queens County, New York",618,50,568,91,167,40781,1940,2006,1345,38.9,49,42,0,32,17,568,21
2013,36081059900,"Census Tract 599, Queens County, New York",617,7,610,145,218,29632,1939,2005,1393,50,65,82,0,37,26,610,39
2014,36081059900,"Census Tract 599, Queens County, New York",598,21,577,167,292,29539,1939,2002,1470,50,55,109,5,34,19,577,40
2015,36081059900,"Census Tract 599, Queens County, New York",596,55,541,190,370,34167,1939,2003,1449,50,64,123,5,34,28,541,39
2016,36081059900,"Census Tract 599, Queens County, New York",593,66,527,188,361,28804,1939,2005,1584,50,54,125,5,33,25,527,43
2017,36081059900,"Census Tract 599, Queens County, New York",604,72,532,163,362,46250,1939,2007,1591,47.6,45,132,5,6,20,532,62
2018,36081059900,"Census Tract 599, Queens County, New York",601,81,520,167,428,51513,1941,2010,1689,45.8,56,126,12,6,23,520,64
2019,36081059900,"Census Tract 599, Queens County, New York",602,58,544,179,403,58750,0,2015,1772,43.2,75,92,6,26,55,544,53
2020,36081059900,"Census Tract 599, Queens County, New York",588,81,507,181,430,41103,0,2016,1809,51,78,78,6,19,78,507,78
2012,36081060000,"Census Tract 600, Queens County, New York",396,12,384,9,24,122750,1981,2011,NA,14.5,9,0,9,0,0,384,32
2013,36081060000,"Census Tract 600, Queens County, New York",395,12,383,21,44,29792,1939,2011,1313,16.9,10,0,21,0,0,383,7
2014,36081060000,"Census Tract 600, Queens County, New York",383,11,372,33,71,61750,1939,2007,1375,17.5,15,0,33,0,0,372,10
2015,36081060000,"Census Tract 600, Queens County, New York",377,11,366,37,78,NA,1939,2007,1375,17.5,17,0,37,0,0,366,11
2016,36081060000,"Census Tract 600, Queens County, New York",385,10,375,52,140,128500,1942,2010,1550,17.4,16,0,52,0,0,375,12
2017,36081060000,"Census Tract 600, Queens County, New York",392,12,380,43,125,NA,1942,2008,NA,17.6,12,0,43,0,0,380,18
2018,36081060000,"Census Tract 600, Queens County, New York",398,20,378,30,91,146364,1944,2007,2045,16.5,11,0,30,0,0,378,8
2019,36081060000,"Census Tract 600, Queens County, New York",399,29,370,27,89,148068,1945,2008,2103,17.7,11,0,27,0,0,370,10
2020,36081060000,"Census Tract 600, Queens County, New York",385,25,360,34,96,NA,1945,2004,1750,18.8,19,0,34,0,0,360,8
2012,36081060100,"Census Tract 601, Queens County, New York",798,11,787,479,1124,51250,1939,2004,1315,27.8,108,292,0,0,187,787,81
2013,36081060100,"Census Tract 601, Queens County, New York",812,9,803,487,1053,51198,1939,2005,1358,30,121,267,6,17,197,803,99
2014,36081060100,"Census Tract 601, Queens County, New York",782,13,769,392,834,63077,1942,2006,1350,29.3,117,234,6,17,135,769,95
2015,36081060100,"Census Tract 601, Queens County, New York",800,17,783,446,989,63864,1939,2006,1402,29.6,94,228,5,17,184,783,66
2016,36081060100,"Census Tract 601, Queens County, New York",834,27,807,453,990,51103,1939,2007,1410,32.4,80,210,17,16,210,807,100
2017,36081060100,"Census Tract 601, Queens County, New York",867,91,776,408,1027,52449,1939,2008,1410,33.8,50,169,23,16,200,776,53
2018,36081060100,"Census Tract 601, Queens County, New York",833,77,756,439,1262,62841,0,2011,1630,30.2,97,179,23,0,214,756,90
2019,36081060100,"Census Tract 601, Queens County, New York",843,65,778,486,1372,64375,0,2011,1667,30.2,95,205,21,0,237,778,89
2020,36081060100,"Census Tract 601, Queens County, New York",872,67,805,416,1287,77875,0,2012,1727,28.3,93,201,21,0,184,805,97
2012,36081060300,"Census Tract 603, Queens County, New York",755,10,745,321,796,53664,1957,2003,1378,33.2,134,212,0,10,99,745,26
2013,36081060300,"Census Tract 603, Queens County, New York",729,9,720,288,726,54250,1953,2004,1520,33.3,133,210,0,16,62,720,43
2014,36081060300,"Census Tract 603, Queens County, New York",743,26,717,290,760,60714,1950,2005,1602,35.3,121,170,6,17,97,717,54
2015,36081060300,"Census Tract 603, Queens County, New York",742,15,727,288,801,77500,1951,2007,1513,27.7,90,154,7,6,121,727,59
2016,36081060300,"Census Tract 603, Queens County, New York",732,31,701,226,575,83000,1948,2010,1540,25,35,92,7,6,121,701,57
2017,36081060300,"Census Tract 603, Queens County, New York",748,63,685,235,600,87292,1944,2010,1402,23,49,80,7,6,142,685,58
2018,36081060300,"Census Tract 603, Queens County, New York",721,67,654,244,735,66667,1944,2012,1451,29,71,141,7,5,91,654,76
2019,36081060300,"Census Tract 603, Queens County, New York",710,74,636,252,786,69821,1945,2013,1543,28.2,87,171,0,6,75,636,68
2020,36081060300,"Census Tract 603, Queens County, New York",752,90,662,298,908,69073,1946,2015,1769,30.6,105,228,0,5,65,662,70
2012,36081060600,"Census Tract 606, Queens County, New York",455,13,442,72,207,70500,1955,2003,1131,30.7,0,0,61,0,11,442,11
2013,36081060600,"Census Tract 606, Queens County, New York",472,13,459,54,114,40192,1953,2011,1531,32.9,0,0,45,0,9,459,14
2014,36081060600,"Census Tract 606, Queens County, New York",473,13,460,51,130,53125,NA,2011,1750,32.3,0,0,37,0,14,460,8
2015,36081060600,"Census Tract 606, Queens County, New York",479,15,464,93,307,65250,1953,2011,1734,32.5,16,0,76,0,17,464,5
2016,36081060600,"Census Tract 606, Queens County, New York",481,0,481,81,250,56797,1953,2011,1726,32.4,5,0,65,0,16,481,10
2017,36081060600,"Census Tract 606, Queens County, New York",467,0,467,61,236,68304,1953,2010,1879,32.3,4,0,45,0,16,467,30
2018,36081060600,"Census Tract 606, Queens County, New York",479,0,479,46,224,70263,1949,2009,NA,NA,6,0,25,0,21,479,41
2019,36081060600,"Census Tract 606, Queens County, New York",474,0,474,30,150,71136,1944,2003,NA,NA,3,0,30,0,0,474,46
2020,36081060600,"Census Tract 606, Queens County, New York",473,0,473,64,95,36379,1983,2006,NA,NA,0,0,64,0,0,473,74
2012,36081060701,"Census Tract 607.01, Queens County, New York",0,0,0,0,0,NA,NA,NA,NA,NA,0,0,0,0,0,0,0
2013,36081060701,"Census Tract 607.01, Queens County, New York",0,0,0,0,0,NA,NA,NA,NA,NA,0,0,0,0,0,0,0
2014,36081060701,"Census Tract 607.01, Queens County, New York",10,0,10,10,10,NA,NA,NA,NA,NA,10,0,0,0,10,10,0
2015,36081060701,"Census Tract 607.01, Queens County, New York",16,0,16,16,16,NA,NA,NA,NA,NA,16,0,0,0,16,16,0
2016,36081060701,"Census Tract 607.01, Queens County, New York",15,0,15,15,15,NA,NA,NA,NA,NA,15,0,0,0,15,15,0
2017,36081060701,"Census Tract 607.01, Queens County, New York",17,0,17,13,13,NA,NA,NA,NA,NA,13,0,0,0,13,17,0
2018,36081060701,"Census Tract 607.01, Queens County, New York",32,0,32,15,15,NA,NA,NA,NA,NA,15,0,0,0,15,32,0
2019,36081060701,"Census Tract 607.01, Queens County, New York",14,0,14,0,0,NA,NA,NA,NA,NA,0,0,0,0,0,14,0
2020,36081060701,"Census Tract 607.01, Queens County, New York",14,0,14,0,0,NA,NA,NA,NA,NA,0,0,0,0,0,14,0
2012,36081060800,"Census Tract 608, Queens County, New York",516,35,481,84,183,51000,1946,2005,1125,43.2,36,0,84,0,0,481,16
2013,36081060800,"Census Tract 608, Queens County, New York",512,54,458,93,191,50250,1945,2004,870,40,41,0,93,0,0,458,20
2014,36081060800,"Census Tract 608, Queens County, New York",504,53,451,95,196,50694,1945,2004,1011,38.8,39,0,95,0,0,451,18
2015,36081060800,"Census Tract 608, Queens County, New York",487,42,445,51,151,28365,1943,2002,1104,50,9,0,51,0,0,445,23
2016,36081060800,"Census Tract 608, Queens County, New York",491,40,451,33,95,NA,1950,2011,1375,50,0,0,33,0,0,451,10
2017,36081060800,"Census Tract 608, Queens County, New York",488,43,445,34,124,NA,1942,2012,NA,40,10,0,34,0,0,445,9
2018,36081060800,"Census Tract 608, Queens County, New York",484,31,453,48,146,NA,1946,2011,1302,51,13,0,48,0,0,453,11
2019,36081060800,"Census Tract 608, Queens County, New York",477,41,436,48,143,NA,1946,2011,1313,51,12,0,48,0,0,436,12
2020,36081060800,"Census Tract 608, Queens County, New York",497,32,465,77,172,NA,1950,2001,925,51,10,0,77,0,0,465,41
2012,36081061000,"Census Tract 610, Queens County, New York",451,0,451,122,429,71667,1944,2002,1722,28.3,11,0,122,0,0,451,38
2013,36081061000,"Census Tract 610, Queens County, New York",450,17,433,145,520,69840,1945,2004,1750,28.2,36,0,145,0,0,433,0
2014,36081061000,"Census Tract 610, Queens County, New York",443,16,427,156,603,71250,1944,2004,1860,28.3,41,0,156,0,0,427,0
2015,36081061000,"Census Tract 610, Queens County, New York",437,16,421,70,234,46111,1949,2004,1972,37.8,27,0,70,0,0,421,12
2016,36081061000,"Census Tract 610, Queens County, New York",417,15,402,65,224,NA,1951,2004,1956,36.3,29,0,65,0,0,402,11
2017,36081061000,"Census Tract 610, Queens County, New York",435,13,422,23,75,NA,1955,2004,1732,35.9,18,0,23,0,0,422,22
2018,36081061000,"Census Tract 610, Queens County, New York",450,0,450,5,16,NA,NA,NA,NA,NA,5,0,5,0,0,450,25
2019,36081061000,"Census Tract 610, Queens County, New York",442,0,442,5,15,NA,NA,NA,NA,NA,5,0,5,0,0,442,21
2020,36081061000,"Census Tract 610, Queens County, New York",437,0,437,11,45,NA,NA,NA,NA,NA,0,0,11,0,0,437,22
2012,36081061200,"Census Tract 612, Queens County, New York",506,14,492,24,72,63214,1961,2001,1429,33.6,14,0,14,0,10,492,10
2013,36081061200,"Census Tract 612, Queens County, New York",523,17,506,25,90,44250,1948,2004,NA,41.1,11,0,9,0,16,506,22
2014,36081061200,"Census Tract 612, Queens County, New York",523,17,506,28,100,125441,1945,2011,2001,24.1,0,0,24,0,4,506,21
2015,36081061200,"Census Tract 612, Queens County, New York",519,17,502,34,121,125833,1944,2010,2198,24,0,0,29,0,5,502,38
2016,36081061200,"Census Tract 612, Queens County, New York",525,14,511,25,83,128672,1944,2011,NA,NA,0,0,25,0,0,511,24
2017,36081061200,"Census Tract 612, Queens County, New York",522,11,511,20,68,131346,1944,2011,NA,NA,0,0,20,0,0,511,19
2018,36081061200,"Census Tract 612, Queens County, New York",528,12,516,35,156,132981,1946,1994,2404,23.3,0,0,35,0,0,516,21
2019,36081061200,"Census Tract 612, Queens County, New York",521,12,509,20,100,107083,1952,1989,NA,NA,0,0,20,0,0,509,21
2020,36081061200,"Census Tract 612, Queens County, New York",515,12,503,13,74,NA,NA,NA,NA,NA,0,0,13,0,0,503,5
2012,36081061301,"Census Tract 613.01, Queens County, New York",2052,74,1978,1447,3879,63845,1939,2003,1215,24.5,310,1016,31,44,369,1978,243
2013,36081061301,"Census Tract 613.01, Queens County, New York",2078,52,2026,1559,4222,50804,1939,2004,1243,27.7,324,1000,39,43,493,2026,313
2014,36081061301,"Census Tract 613.01, Queens County, New York",2105,59,2046,1624,4479,47185,1939,2005,1315,27.9,363,1123,19,27,433,2046,362
2015,36081061301,"Census Tract 613.01, Queens County, New York",2168,84,2084,1635,4794,51131,1939,2006,1349,27.3,402,1019,19,29,565,2084,374
2016,36081061301,"Census Tract 613.01, Queens County, New York",2120,112,2008,1569,4394,68523,1939,2007,1351,25.1,430,894,19,33,610,2008,320
2017,36081061301,"Census Tract 613.01, Queens County, New York",2101,115,1986,1551,4567,76379,1939,2009,1372,24.4,517,907,17,38,570,1986,268
2018,36081061301,"Census Tract 613.01, Queens County, New York",2107,177,1930,1480,4476,78224,0,2010,1455,24.2,509,911,9,45,479,1930,242
2019,36081061301,"Census Tract 613.01, Queens County, New York",2074,191,1883,1439,4166,72483,0,2011,1531,30,513,809,0,62,568,1883,226
2020,36081061301,"Census Tract 613.01, Queens County, New York",2002,167,1835,1442,4237,73984,0,2012,1648,32.9,437,683,8,59,691,1835,183
2012,36081061302,"Census Tract 613.02, Queens County, New York",3,0,3,0,0,NA,NA,NA,NA,NA,0,0,0,0,0,3,0
2013,36081061302,"Census Tract 613.02, Queens County, New York",3,0,3,0,0,NA,NA,NA,NA,NA,0,0,0,0,0,3,0
2014,36081061302,"Census Tract 613.02, Queens County, New York",7,0,7,0,0,NA,NA,NA,NA,NA,0,0,0,0,0,7,0
2015,36081061302,"Census Tract 613.02, Queens County, New York",7,0,7,0,0,NA,NA,NA,NA,NA,0,0,0,0,0,7,0
2016,36081061302,"Census Tract 613.02, Queens County, New York",7,0,7,0,0,NA,NA,NA,NA,NA,0,0,0,0,0,7,0
2017,36081061302,"Census Tract 613.02, Queens County, New York",8,0,8,4,8,NA,NA,NA,NA,NA,4,0,0,0,4,8,0
2018,36081061302,"Census Tract 613.02, Queens County, New York",0,0,0,0,0,NA,NA,NA,NA,NA,0,0,0,0,0,0,0
2019,36081061302,"Census Tract 613.02, Queens County, New York",0,0,0,0,0,NA,NA,NA,NA,NA,0,0,0,0,0,0,0
2020,36081061302,"Census Tract 613.02, Queens County, New York",0,0,0,0,0,NA,NA,NA,NA,NA,0,0,0,0,0,0,0
2012,36081061400,"Census Tract 614, Queens County, New York",408,37,371,16,55,105682,1939,2005,2001,28.6,0,0,5,0,11,371,8
2013,36081061400,"Census Tract 614, Queens County, New York",405,35,370,22,62,NA,NA,NA,NA,NA,0,0,15,0,7,370,12
2014,36081061400,"Census Tract 614, Queens County, New York",395,35,360,38,109,41979,1953,NA,1784,50,10,0,29,0,4,360,11
2015,36081061400,"Census Tract 614, Queens County, New York",390,49,341,31,112,NA,1949,2002,NA,26.9,20,0,27,0,12,341,10
2016,36081061400,"Census Tract 614, Queens County, New York",395,21,374,34,113,NA,1950,2002,NA,28.1,20,0,31,0,13,374,17
2017,36081061400,"Census Tract 614, Queens County, New York",387,9,378,34,113,NA,1943,2003,1533,19.7,31,0,28,0,12,378,30
2018,36081061400,"Census Tract 614, Queens County, New York",402,8,394,60,181,116324,1942,2000,1469,18.3,58,0,55,0,11,394,29
2019,36081061400,"Census Tract 614, Queens County, New York",402,9,393,56,164,118750,1942,2000,1454,18.4,53,0,53,0,9,393,31
2020,36081061400,"Census Tract 614, Queens County, New York",410,0,410,47,127,120515,1944,2004,1391,18.3,45,0,45,0,0,410,30
2012,36081061601,"Census Tract 616.01, Queens County, New York",679,39,640,46,153,42222,1962,2004,772,26.3,0,6,33,7,0,640,13
2013,36081061601,"Census Tract 616.01, Queens County, New York",682,9,673,40,115,41944,1959,2004,860,26.1,0,8,28,4,0,673,14
2014,36081061601,"Census Tract 616.01, Queens County, New York",703,10,693,33,112,75074,1960,2006,1515,26.3,0,0,30,3,0,693,14
2015,36081061601,"Census Tract 616.01, Queens County, New York",703,9,694,54,237,71250,1960,2006,NA,14.5,10,0,49,5,0,694,22
2016,36081061601,"Census Tract 616.01, Queens County, New York",693,9,684,54,189,51750,1956,2007,1556,25.4,21,0,54,0,0,684,20
2017,36081061601,"Census Tract 616.01, Queens County, New York",720,0,720,62,256,NA,1953,2008,2000,23.2,24,0,62,0,0,720,36
2018,36081061601,"Census Tract 616.01, Queens County, New York",738,0,738,70,297,NA,1953,2006,2214,23.2,30,0,70,0,0,738,40
2019,36081061601,"Census Tract 616.01, Queens County, New York",735,0,735,104,406,94125,1953,2011,1900,20.4,35,0,104,0,0,735,51
2020,36081061601,"Census Tract 616.01, Queens County, New York",790,0,790,100,343,56806,1953,1989,1618,22.5,39,0,100,0,0,790,59
2012,36081061602,"Census Tract 616.02, Queens County, New York",424,0,424,90,232,43712,1952,2003,1908,50,0,1,86,0,8,424,30
2013,36081061602,"Census Tract 616.02, Queens County, New York",407,9,398,76,137,43900,1953,2003,2001,50,0,5,53,0,22,398,24
2014,36081061602,"Census Tract 616.02, Queens County, New York",398,9,389,46,88,43462,1952,2006,2001,50,0,3,43,0,4,389,30
2015,36081061602,"Census Tract 616.02, Queens County, New York",395,28,367,23,65,35938,1948,2009,1205,37.5,0,0,23,0,5,367,25
2016,36081061602,"Census Tract 616.02, Queens County, New York",395,43,352,42,126,52750,1951,2010,1155,35.5,3,4,38,0,5,352,18
2017,36081061602,"Census Tract 616.02, Queens County, New York",396,52,344,39,102,37344,1951,2011,1125,24.7,5,4,35,0,0,344,14
2018,36081061602,"Census Tract 616.02, Queens County, New York",396,46,350,50,107,44375,1949,2012,1109,24.9,5,5,45,0,0,350,16
2019,36081061602,"Census Tract 616.02, Queens County, New York",395,53,342,44,105,55167,1952,2012,1079,23,3,6,33,0,5,342,23
2020,36081061602,"Census Tract 616.02, Queens County, New York",362,18,344,66,133,53864,1948,2008,1089,24.6,4,30,30,0,6,344,23
2012,36081061800,"Census Tract 618, Queens County, New York",731,33,698,85,97,39875,1959,2003,1038,28.1,14,29,50,0,11,698,6
2013,36081061800,"Census Tract 618, Queens County, New York",753,29,724,130,145,39107,1954,2001,1077,28.5,27,28,95,0,15,724,15
2014,36081061800,"Census Tract 618, Queens County, New York",743,44,699,146,214,55278,1954,2001,1151,30.3,63,29,109,0,15,699,16
2015,36081061800,"Census Tract 618, Queens County, New York",730,52,678,168,290,56447,1953,2002,1172,28.5,78,31,131,0,13,678,18
2016,36081061800,"Census Tract 618, Queens County, New York",723,47,676,185,347,58681,1953,2006,1218,30.9,88,24,155,0,6,676,20
2017,36081061800,"Census Tract 618, Queens County, New York",708,50,658,188,389,74821,1954,2004,1247,22.4,82,21,151,0,16,658,15
2018,36081061800,"Census Tract 618, Queens County, New York",736,51,685,165,330,61161,1952,2009,1321,24.5,52,20,132,0,13,685,41
2019,36081061800,"Census Tract 618, Queens County, New York",734,25,709,176,326,47500,1954,2013,1240,31.9,49,10,125,19,22,709,41
2020,36081061800,"Census Tract 618, Queens County, New York",682,21,661,170,273,43125,1955,2014,1290,40.3,36,9,117,16,28,661,59
2012,36081061900,"Census Tract 619, Queens County, New York",1177,76,1101,691,1827,56530,1945,2004,1213,28.1,210,455,17,0,229,1101,160
2013,36081061900,"Census Tract 619, Queens County, New York",1139,125,1014,628,1576,55184,1939,2004,1239,29.4,132,409,11,0,219,1014,102
2014,36081061900,"Census Tract 619, Queens County, New York",1148,130,1018,570,1581,55994,1939,2006,1220,29.1,156,305,12,0,265,1018,95
2015,36081061900,"Census Tract 619, Queens County, New York",1103,158,945,532,1359,46667,1939,2003,1139,27.1,93,354,0,0,178,945,94
2016,36081061900,"Census Tract 619, Queens County, New York",1122,178,944,483,1226,73867,1939,2008,1178,19.6,91,359,0,18,106,944,67
2017,36081061900,"Census Tract 619, Queens County, New York",1155,178,977,518,1333,75139,1942,2011,1201,19.6,130,376,0,16,126,977,73
2018,36081061900,"Census Tract 619, Queens County, New York",1192,144,1048,542,1377,74722,1944,2011,1257,18.9,163,360,8,13,150,1048,86
2019,36081061900,"Census Tract 619, Queens County, New York",1144,126,1018,564,1375,78243,1945,2012,1408,19.9,160,430,22,16,104,1018,58
2020,36081061900,"Census Tract 619, Queens County, New York",1220,107,1113,687,2000,100817,1961,2014,1732,19.5,173,470,40,16,188,1113,58
2012,36081062000,"Census Tract 620, Queens County, New York",519,71,448,60,154,11923,1946,1996,1420,50,21,0,60,0,0,448,46
2013,36081062000,"Census Tract 620, Queens County, New York",516,65,451,44,90,NA,NA,NA,NA,NA,9,0,44,0,0,451,42
2014,36081062000,"Census Tract 620, Queens County, New York",512,58,454,6,11,NA,NA,NA,NA,NA,6,0,6,0,0,454,14
2015,36081062000,"Census Tract 620, Queens County, New York",508,0,508,5,10,NA,NA,NA,NA,NA,5,0,5,0,0,508,14
2016,36081062000,"Census Tract 620, Queens County, New York",517,3,514,9,13,NA,NA,NA,NA,NA,4,0,9,0,0,514,10
2017,36081062000,"Census Tract 620, Queens County, New York",514,26,488,8,26,NA,NA,NA,NA,NA,0,0,8,0,0,488,14
2018,36081062000,"Census Tract 620, Queens County, New York",505,24,481,10,38,NA,NA,NA,NA,NA,0,0,10,0,0,481,35
2019,36081062000,"Census Tract 620, Queens County, New York",525,29,496,27,87,50750,1953,2011,1833,38.3,0,0,12,0,15,496,16
2020,36081062000,"Census Tract 620, Queens County, New York",511,29,482,40,143,NA,1944,2010,2250,51,5,0,34,0,6,482,30
2012,36081062100,"Census Tract 621, Queens County, New York",1130,120,1010,452,1158,44722,1939,2004,1329,28.6,105,201,0,19,232,1010,155
2013,36081062100,"Census Tract 621, Queens County, New York",1107,105,1002,491,1208,42736,1939,2005,1290,31.7,103,280,0,8,203,1002,181
2014,36081062100,"Census Tract 621, Queens County, New York",1095,136,959,443,1039,36806,1939,2006,1314,33.8,98,254,0,8,181,959,187
2015,36081062100,"Census Tract 621, Queens County, New York",1102,158,944,472,1052,42386,1939,2007,1315,32.6,101,266,16,16,174,944,187
2016,36081062100,"Census Tract 621, Queens County, New York",1068,119,949,486,1038,51500,1939,2010,1477,32.6,106,292,11,8,175,949,165
2017,36081062100,"Census Tract 621, Queens County, New York",1079,121,958,524,1162,47500,1939,2011,1533,35.6,134,320,20,8,176,958,173
2018,36081062100,"Census Tract 621, Queens County, New York",1068,112,956,575,1313,58233,1949,2011,1605,34,180,320,10,9,220,956,179
2019,36081062100,"Census Tract 621, Queens County, New York",1104,85,1019,655,1599,60250,1948,2011,1621,32.5,208,342,48,9,279,1019,154
2020,36081062100,"Census Tract 621, Queens County, New York",1071,78,993,608,1590,65833,1955,2012,1670,30.8,205,299,31,0,297,993,90
2012,36081062200,"Census Tract 622, Queens County, New York",692,31,661,111,389,67250,1941,2004,1238,23.7,14,0,86,0,25,661,29
2013,36081062200,"Census Tract 622, Queens County, New York",684,40,644,89,309,67431,1943,2004,1420,23.3,27,0,89,0,0,644,49
2014,36081062200,"Census Tract 622, Queens County, New York",678,44,634,68,227,68571,1943,2003,1375,23.8,22,0,63,0,0,634,63
2015,36081062200,"Census Tract 622, Queens County, New York",680,52,628,63,170,NA,1948,2002,1232,24.6,12,4,47,0,7,628,62
2016,36081062200,"Census Tract 622, Queens County, New York",680,55,625,75,194,NA,1952,1998,1163,41.5,11,6,57,0,7,625,69
2017,36081062200,"Census Tract 622, Queens County, New York",677,26,651,78,191,NA,1952,1996,1099,24.2,27,5,60,0,15,651,75
2018,36081062200,"Census Tract 622, Queens County, New York",679,25,654,82,198,81818,1952,1993,1125,21.9,21,5,65,0,14,654,62
2019,36081062200,"Census Tract 622, Queens County, New York",683,32,651,111,334,83173,1952,1998,1218,23.4,16,6,90,0,23,651,46
2020,36081062200,"Census Tract 622, Queens County, New York",669,33,636,107,323,83173,1948,2003,1224,18.7,19,0,93,0,23,636,42
2012,36081062300,"Census Tract 623, Queens County, New York",796,41,755,467,958,31274,1939,2005,1226,41.9,79,331,0,0,136,755,73
2013,36081062300,"Census Tract 623, Queens County, New York",801,30,771,464,1047,31900,1939,2006,1242,43.1,82,315,0,0,149,771,65
2014,36081062300,"Census Tract 623, Queens County, New York",797,29,768,443,994,34282,1939,2007,1275,40.8,101,323,6,0,120,768,93
2015,36081062300,"Census Tract 623, Queens County, New York",829,48,781,486,1086,37656,1939,2010,1287,28.6,159,333,6,0,153,781,129
2016,36081062300,"Census Tract 623, Queens County, New York",813,33,780,495,1135,56964,1943,2011,1339,23.3,139,343,25,0,152,780,122
2017,36081062300,"Census Tract 623, Queens County, New York",808,24,784,474,1163,71413,1946,2010,1313,23.4,123,304,22,0,170,784,91
2018,36081062300,"Census Tract 623, Queens County, New York",816,39,777,466,1165,74211,1953,2011,1388,23.7,132,311,25,0,155,777,71
2019,36081062300,"Census Tract 623, Queens County, New York",832,36,796,498,1338,82500,1956,2011,1423,25.1,138,300,38,0,177,796,47
2020,36081062300,"Census Tract 623, Queens County, New York",826,21,805,456,1261,70000,1952,2011,1439,26.8,112,284,46,0,143,805,114
2012,36081062400,"Census Tract 624, Queens County, New York",0,0,0,0,0,NA,NA,NA,NA,NA,0,0,0,0,0,0,0
2013,36081062400,"Census Tract 624, Queens County, New York",0,0,0,0,0,NA,NA,NA,NA,NA,0,0,0,0,0,0,0
2014,36081062400,"Census Tract 624, Queens County, New York",0,0,0,0,0,NA,NA,NA,NA,NA,0,0,0,0,0,0,0
2015,36081062400,"Census Tract 624, Queens County, New York",0,0,0,0,0,NA,NA,NA,NA,NA,0,0,0,0,0,0,0
2016,36081062400,"Census Tract 624, Queens County, New York",0,0,0,0,0,NA,NA,NA,NA,NA,0,0,0,0,0,0,0
2017,36081062400,"Census Tract 624, Queens County, New York",0,0,0,0,0,NA,NA,NA,NA,NA,0,0,0,0,0,0,0
2018,36081062400,"Census Tract 624, Queens County, New York",0,0,0,0,0,NA,NA,NA,NA,NA,0,0,0,0,0,0,0
2019,36081062400,"Census Tract 624, Queens County, New York",0,0,0,0,0,NA,NA,NA,NA,NA,0,0,0,0,0,0,0
2020,36081062400,"Census Tract 624, Queens County, New York",0,0,0,0,0,NA,NA,NA,NA,NA,0,0,0,0,0,0,0
2012,36081062500,"Census Tract 625, Queens County, New York",958,27,931,514,1073,65577,1939,2004,1203,25.9,86,338,0,20,156,931,57
2013,36081062500,"Census Tract 625, Queens County, New York",1008,31,977,570,1164,66585,1939,2004,1191,25.4,112,348,5,28,189,977,70
2014,36081062500,"Census Tract 625, Queens County, New York",995,64,931,493,1106,64063,1939,2005,1215,26.1,145,309,11,43,130,931,82
2015,36081062500,"Census Tract 625, Queens County, New York",995,62,933,472,1173,59500,1939,2006,1284,26.3,142,310,10,33,119,933,48
2016,36081062500,"Census Tract 625, Queens County, New York",986,50,936,461,1282,60464,1939,2007,1303,24.7,125,270,10,19,162,936,50
2017,36081062500,"Census Tract 625, Queens County, New York",960,62,898,447,1363,64926,1939,2007,1391,23.6,123,264,13,18,152,898,42
2018,36081062500,"Census Tract 625, Queens County, New York",949,77,872,488,1520,64135,0,2009,1550,25,131,298,11,15,164,872,47
2019,36081062500,"Census Tract 625, Queens County, New York",958,70,888,490,1426,70333,0,2008,1579,24.7,133,298,7,0,185,888,38
2020,36081062500,"Census Tract 625, Queens County, New York",887,79,808,387,1161,86250,0,2007,1536,23.3,111,242,8,0,140,808,31
2012,36081062600,"Census Tract 626, Queens County, New York",954,38,916,139,540,20375,1946,2003,1359,50,13,0,101,0,38,916,119
2013,36081062600,"Census Tract 626, Queens County, New York",931,12,919,155,585,24063,1945,2008,1314,50,9,0,116,0,39,919,114
2014,36081062600,"Census Tract 626, Queens County, New York",923,40,883,119,435,60268,1947,2011,1234,19.7,8,0,112,0,7,883,72
2015,36081062600,"Census Tract 626, Queens County, New York",917,47,870,126,442,NA,1950,2011,1242,50,6,0,101,0,25,870,76
2016,36081062600,"Census Tract 626, Queens County, New York",910,56,854,80,208,29464,1955,2012,1146,50,0,0,57,0,23,854,69
2017,36081062600,"Census Tract 626, Queens County, New York",916,48,868,95,425,24901,1939,2012,1410,50,0,0,71,0,24,868,76
2018,36081062600,"Census Tract 626, Queens County, New York",935,71,864,65,294,25083,0,2012,2036,51,0,0,39,0,26,864,80
2019,36081062600,"Census Tract 626, Queens County, New York",926,48,878,77,327,29327,0,2014,1803,51,0,0,40,0,37,878,69
2020,36081062600,"Census Tract 626, Queens County, New York",864,41,823,81,424,41691,0,2017,2006,51,9,0,54,0,26,823,54
2012,36081062700,"Census Tract 627, Queens County, New York",1003,27,976,621,1863,64180,1939,2005,1507,25.2,77,363,0,0,242,976,116
2013,36081062700,"Census Tract 627, Queens County, New York",990,77,913,624,1907,56750,1939,2005,1504,28.8,76,343,0,0,266,913,146
2014,36081062700,"Census Tract 627, Queens County, New York",1043,97,946,631,1868,59821,1939,2006,1429,29.6,90,321,0,8,288,946,148
2015,36081062700,"Census Tract 627, Queens County, New York",1059,120,939,621,1867,61016,1939,2007,1440,28.1,108,323,0,7,277,939,59
2016,36081062700,"Census Tract 627, Queens County, New York",1127,142,985,649,1944,61838,1939,2008,1397,28,75,288,0,7,339,985,140
2017,36081062700,"Census Tract 627, Queens County, New York",1090,147,943,627,1897,61125,1939,2010,1461,29.6,78,286,0,23,318,943,150
2018,36081062700,"Census Tract 627, Queens County, New York",1084,106,978,615,1905,71128,0,2010,1545,28,116,296,0,24,295,978,120
2019,36081062700,"Census Tract 627, Queens County, New York",1078,92,986,638,2036,70938,0,2011,1607,28.5,100,307,0,17,314,986,123
2020,36081062700,"Census Tract 627, Queens County, New York",1062,40,1022,562,1772,74545,0,2013,1547,27.4,81,224,0,16,322,1022,121
2012,36081062900,"Census Tract 629, Queens County, New York",1106,55,1051,647,1719,44738,1939,2004,1211,28.7,176,437,29,21,150,1051,135
2013,36081062900,"Census Tract 629, Queens County, New York",1103,55,1048,706,1874,43846,1939,2004,1226,31.9,132,457,24,37,185,1048,164
2014,36081062900,"Census Tract 629, Queens County, New York",1149,73,1076,742,1969,52500,1939,2005,1262,27.9,202,453,32,41,207,1076,149
2015,36081062900,"Census Tract 629, Queens County, New York",1145,95,1050,724,2099,60188,1939,2006,1301,28.1,240,470,27,39,173,1050,116
2016,36081062900,"Census Tract 629, Queens County, New York",1137,151,986,656,1925,61528,1939,2006,1332,27.2,191,458,10,29,169,986,93
2017,36081062900,"Census Tract 629, Queens County, New York",1158,139,1019,643,1919,70903,1939,2008,1406,24.5,178,396,12,25,222,1019,120
2018,36081062900,"Census Tract 629, Queens County, New York",1172,162,1010,695,2026,72534,0,2011,1444,25.2,226,366,0,7,322,1010,70
2019,36081062900,"Census Tract 629, Queens County, New York",1179,157,1022,673,1927,78623,0,2011,1447,23.2,214,361,0,1,311,1022,69
2020,36081062900,"Census Tract 629, Queens County, New York",1108,99,1009,726,2156,78906,0,2012,1522,23.9,222,331,0,78,345,1009,51
2012,36081063000,"Census Tract 630, Queens County, New York",552,56,496,25,63,4904,1946,2005,2001,50,7,0,25,0,0,496,13
2013,36081063000,"Census Tract 630, Queens County, New York",553,28,525,23,60,30250,1946,2006,2001,50,7,0,23,0,0,525,11
2014,36081063000,"Census Tract 630, Queens County, New York",549,29,520,48,127,155417,1942,2004,2001,18.7,12,0,48,0,0,520,11
2015,36081063000,"Census Tract 630, Queens County, New York",551,17,534,51,125,NA,1943,2005,2188,19.2,14,0,51,0,0,534,16
2016,36081063000,"Census Tract 630, Queens County, New York",543,49,494,59,136,NA,1943,2006,2125,50,13,0,53,0,0,494,20
2017,36081063000,"Census Tract 630, Queens County, New York",544,50,494,54,91,41618,1939,2005,1868,50,7,0,48,0,0,494,12
2018,36081063000,"Census Tract 630, Queens County, New York",559,68,491,83,177,NA,0,2008,2101,18.4,7,0,77,0,0,491,21
2019,36081063000,"Census Tract 630, Queens County, New York",564,71,493,68,162,NA,1941,2011,2033,9,0,0,62,0,0,493,15
2020,36081063000,"Census Tract 630, Queens County, New York",569,51,518,48,122,NA,1943,2010,2000,9,0,0,42,0,0,518,25
2012,36081063200,"Census Tract 632, Queens County, New York",695,67,628,19,54,30521,1939,1988,1198,47.9,0,0,19,0,0,628,46
2013,36081063200,"Census Tract 632, Queens County, New York",683,68,615,64,133,32333,1939,2003,1152,40.7,23,0,59,0,5,615,35
2014,36081063200,"Census Tract 632, Queens County, New York",701,46,655,80,190,34219,1939,2004,1231,45,26,0,73,0,7,655,48
2015,36081063200,"Census Tract 632, Queens County, New York",704,20,684,85,296,NA,1939,2006,1276,23.2,24,0,63,0,22,684,59
2016,36081063200,"Census Tract 632, Queens County, New York",714,29,685,114,351,68214,1948,2005,1452,24.3,28,0,95,0,19,685,47
2017,36081063200,"Census Tract 632, Queens County, New York",720,29,691,128,410,61250,1945,2004,1510,24.8,31,0,110,0,18,691,46
2018,36081063200,"Census Tract 632, Queens County, New York",738,39,699,92,329,75625,1950,2006,1688,25.1,11,0,81,0,11,699,31
2019,36081063200,"Census Tract 632, Queens County, New York",723,53,670,104,334,75192,1948,2004,1693,23.5,12,0,92,0,12,670,36
2020,36081063200,"Census Tract 632, Queens County, New York",768,57,711,96,223,77917,1949,2005,1818,26.7,28,0,96,0,0,711,35
2012,36081063301,"Census Tract 633.01, Queens County, New York",596,83,513,247,414,51797,1951,2004,1358,28.1,48,201,0,0,46,513,35
2013,36081063301,"Census Tract 633.01, Queens County, New York",573,93,480,222,397,51000,1953,2004,1391,28.7,36,169,0,0,53,480,55
2014,36081063301,"Census Tract 633.01, Queens County, New York",570,41,529,173,378,52837,1948,2007,1355,30.5,9,137,0,0,36,529,62
2015,36081063301,"Census Tract 633.01, Queens County, New York",589,12,577,235,532,53102,1942,2010,1336,27.5,38,182,0,0,53,577,67
2016,36081063301,"Census Tract 633.01, Queens County, New York",573,11,562,195,525,59659,1939,2011,1313,23,42,144,0,0,51,562,50
2017,36081063301,"Census Tract 633.01, Queens County, New York",584,16,568,229,517,60341,1939,2012,1347,25.6,61,153,0,0,76,568,72
2018,36081063301,"Census Tract 633.01, Queens County, New York",599,16,583,233,513,58750,0,2013,1418,28.3,58,143,0,0,90,583,53
2019,36081063301,"Census Tract 633.01, Queens County, New York",597,10,587,284,746,58333,0,2013,1477,31.4,83,178,0,0,106,587,43
2020,36081063301,"Census Tract 633.01, Queens County, New York",562,29,533,260,738,57188,0,2015,1596,34.8,89,138,0,0,122,533,40
2012,36081063302,"Census Tract 633.02, Queens County, New York",636,55,581,197,400,41719,1939,1999,1395,34.6,9,139,0,0,58,581,13
2013,36081063302,"Census Tract 633.02, Queens County, New York",640,55,585,189,460,57422,1939,2000,1571,30.5,8,107,0,0,82,585,16
2014,36081063302,"Census Tract 633.02, Queens County, New York",618,89,529,161,437,61484,1939,2002,1579,26.9,10,90,0,0,71,529,20
2015,36081063302,"Census Tract 633.02, Queens County, New York",606,80,526,178,484,57273,1939,2005,1548,31.7,19,105,0,0,73,526,24
2016,36081063302,"Census Tract 633.02, Queens County, New York",606,91,515,170,447,62647,1939,2005,1592,30.8,23,109,0,0,61,515,35
2017,36081063302,"Census Tract 633.02, Queens County, New York",606,71,535,191,490,58750,1939,2007,1628,35.9,56,123,14,0,55,535,46
2018,36081063302,"Census Tract 633.02, Queens County, New York",606,77,529,198,490,75227,0,2011,1787,31.3,62,153,8,0,32,529,52
2019,36081063302,"Census Tract 633.02, Queens County, New York",617,63,554,223,517,76736,0,2011,1750,29.8,58,160,7,0,48,554,50
2020,36081063302,"Census Tract 633.02, Queens County, New York",590,48,542,227,663,101544,1950,2013,1984,25.9,49,125,7,0,87,542,45
2012,36081063500,"Census Tract 635, Queens County, New York",921,144,777,360,974,44074,1939,2004,1323,35.5,123,222,0,0,138,777,81
2013,36081063500,"Census Tract 635, Queens County, New York",949,146,803,338,905,46500,1939,2006,1347,34.5,168,212,0,0,115,803,28
2014,36081063500,"Census Tract 635, Queens County, New York",1025,137,888,389,1018,48967,1939,2006,1408,35.7,191,213,0,0,164,888,39
2015,36081063500,"Census Tract 635, Queens County, New York",996,125,871,358,924,51471,1941,2009,1384,34.4,189,239,0,0,105,871,45
2016,36081063500,"Census Tract 635, Queens County, New York",1010,79,931,395,1033,50142,1939,2008,1417,34.4,179,243,0,6,133,931,115
2017,36081063500,"Census Tract 635, Queens County, New York",1000,78,922,419,1005,46738,1939,2009,1564,36.8,168,244,0,5,140,922,154
2018,36081063500,"Census Tract 635, Queens County, New York",1014,44,970,442,1132,49875,0,2009,1692,36.2,125,246,0,22,159,970,193
2019,36081063500,"Census Tract 635, Queens County, New York",1012,95,917,383,939,48750,0,2010,1766,35.6,89,205,0,22,141,917,194
2020,36081063500,"Census Tract 635, Queens County, New York",1014,105,909,383,979,48681,0,2011,1811,36.1,83,195,0,19,155,909,185
2012,36081063700,"Census Tract 637, Queens County, New York",1237,157,1080,256,670,49255,1939,2004,1594,43.1,26,128,0,8,120,1080,67
2013,36081063700,"Census Tract 637, Queens County, New York",1241,153,1088,258,646,49257,1939,2002,1478,38.8,28,149,0,8,101,1088,60
2014,36081063700,"Census Tract 637, Queens County, New York",1250,158,1092,281,740,49101,1944,2005,1582,24.6,52,152,0,15,114,1092,48
2015,36081063700,"Census Tract 637, Queens County, New York",1274,119,1155,360,1010,63750,1945,2004,1668,23.7,67,205,0,15,140,1155,105
2016,36081063700,"Census Tract 637, Queens County, New York",1260,142,1118,322,981,107803,1939,2004,1566,20.4,35,206,24,0,92,1118,73
2017,36081063700,"Census Tract 637, Queens County, New York",1266,128,1138,330,1068,107589,1940,2005,1612,22.2,40,177,31,0,132,1138,81
2018,36081063700,"Census Tract 637, Queens County, New York",1272,136,1136,294,1004,112989,1945,2006,1708,22,51,150,29,0,123,1136,94
2019,36081063700,"Census Tract 637, Queens County, New York",1248,123,1125,265,866,99219,1943,2003,1801,23.4,31,140,25,0,107,1125,89
2020,36081063700,"Census Tract 637, Queens County, New York",1237,92,1145,202,655,NA,1954,2003,1890,44.8,42,83,22,0,72,1145,101
2012,36081063800,"Census Tract 638, Queens County, New York",1109,26,1083,146,436,26250,1939,2004,1476,50,33,10,136,0,11,1083,116
2013,36081063800,"Census Tract 638, Queens County, New York",1110,21,1089,146,461,44712,1939,2004,1345,36.3,25,12,117,0,28,1089,49
2014,36081063800,"Census Tract 638, Queens County, New York",1095,21,1074,168,527,50658,1939,2005,1337,35,9,10,136,0,31,1074,50
2015,36081063800,"Census Tract 638, Queens County, New York",1066,33,1033,186,612,74500,1958,2006,1460,23.8,8,11,130,0,53,1033,54
2016,36081063800,"Census Tract 638, Queens County, New York",1074,32,1042,189,667,84453,1958,2002,1466,22.8,20,11,124,0,52,1042,54
2017,36081063800,"Census Tract 638, Queens County, New York",1087,32,1055,208,697,82833,1952,2003,1425,24.1,9,11,144,0,44,1055,26
2018,36081063800,"Census Tract 638, Queens County, New York",1064,56,1008,193,644,NA,1948,2007,1623,44.3,13,0,130,0,50,1008,58
2019,36081063800,"Census Tract 638, Queens County, New York",1053,23,1030,185,604,NA,1943,2007,1629,47.3,9,0,120,9,47,1030,67
2020,36081063800,"Census Tract 638, Queens County, New York",1054,38,1016,132,415,NA,0,2011,1568,46.3,8,0,92,9,23,1016,52
2012,36081063900,"Census Tract 639, Queens County, New York",1064,50,1014,532,1052,55455,1951,2000,1191,26.1,117,324,0,20,156,1014,87
2013,36081063900,"Census Tract 639, Queens County, New York",1045,52,993,568,1171,61458,1950,2002,1160,25.2,143,404,0,24,112,993,119
2014,36081063900,"Census Tract 639, Queens County, New York",1074,68,1006,540,1227,56071,1948,2002,1227,27,147,328,0,27,133,1006,150
2015,36081063900,"Census Tract 639, Queens County, New York",1100,75,1025,512,1268,60809,1960,2004,1232,27.1,148,320,0,25,123,1025,128
2016,36081063900,"Census Tract 639, Queens County, New York",1137,85,1052,457,1153,56950,1955,2006,1191,27.7,99,277,0,20,126,1052,118
2017,36081063900,"Census Tract 639, Queens County, New York",1166,71,1095,465,1172,54479,1958,2010,1326,35.2,132,329,0,10,121,1095,128
2018,36081063900,"Census Tract 639, Queens County, New York",1184,69,1115,453,1109,49330,1954,2012,1468,41.8,124,242,0,14,183,1115,144
2019,36081063900,"Census Tract 639, Queens County, New York",1177,54,1123,428,916,46796,1954,2013,1421,43.3,100,237,0,9,182,1123,109
2020,36081063900,"Census Tract 639, Queens County, New York",1079,46,1033,439,981,49760,0,2014,1574,44.4,87,194,0,9,236,1033,111
2012,36081064101,"Census Tract 641.01, Queens County, New York",987,116,871,229,643,40417,1953,2002,808,26.2,39,110,0,16,103,871,68
2013,36081064101,"Census Tract 641.01, Queens County, New York",993,110,883,180,561,80833,1954,2003,1075,19.9,36,98,0,12,70,883,45
2014,36081064101,"Census Tract 641.01, Queens County, New York",992,96,896,135,448,90875,1954,2004,1523,19.1,16,70,0,6,59,896,70
2015,36081064101,"Census Tract 641.01, Queens County, New York",999,72,927,120,359,55263,1954,2001,1336,28.3,17,69,0,10,41,927,86
2016,36081064101,"Census Tract 641.01, Queens County, New York",997,60,937,128,326,46250,1955,1998,1354,47.5,17,60,0,30,38,937,109
2017,36081064101,"Census Tract 641.01, Queens County, New York",1066,95,971,114,229,59022,1959,1995,1173,19.2,24,66,0,22,26,971,80
2018,36081064101,"Census Tract 641.01, Queens County, New York",1059,107,952,106,220,59853,1959,1997,1250,18.6,27,61,0,22,23,952,80
2019,36081064101,"Census Tract 641.01, Queens County, New York",1059,103,956,123,232,60809,1958,2003,1316,18.7,47,42,0,18,63,956,70
2020,36081064101,"Census Tract 641.01, Queens County, New York",1046,123,923,95,182,47132,1959,2010,1351,41.3,32,39,0,13,43,923,75
2012,36081064102,"Census Tract 641.02, Queens County, New York",61,0,61,10,10,NA,NA,NA,NA,50,10,10,0,0,0,61,0
2013,36081064102,"Census Tract 641.02, Queens County, New York",86,13,73,10,10,NA,NA,NA,NA,NA,10,10,0,0,0,73,0
2014,36081064102,"Census Tract 641.02, Queens County, New York",90,13,77,18,22,14750,1964,1981,910,50,10,18,0,0,0,77,0
2015,36081064102,"Census Tract 641.02, Queens County, New York",97,14,83,8,12,NA,NA,NA,NA,NA,0,8,0,0,0,83,0
2016,36081064102,"Census Tract 641.02, Queens County, New York",80,14,66,7,10,NA,NA,NA,NA,NA,0,7,0,0,0,66,13
2017,36081064102,"Census Tract 641.02, Queens County, New York",0,0,0,0,0,NA,NA,NA,NA,NA,0,0,0,0,0,0,0
2018,36081064102,"Census Tract 641.02, Queens County, New York",0,0,0,0,0,NA,NA,NA,NA,NA,0,0,0,0,0,0,0
2019,36081064102,"Census Tract 641.02, Queens County, New York",0,0,0,0,0,NA,NA,NA,NA,NA,0,0,0,0,0,0,0
2020,36081064102,"Census Tract 641.02, Queens County, New York",0,0,0,0,0,NA,NA,NA,NA,NA,0,0,0,0,0,0,0
2012,36081064500,"Census Tract 645, Queens County, New York",816,33,783,270,679,67500,1954,2005,1483,23.9,124,156,8,69,20,783,50
2013,36081064500,"Census Tract 645, Queens County, New York",795,38,757,255,599,58672,1955,2005,1510,26.2,119,145,5,72,15,757,44
2014,36081064500,"Census Tract 645, Queens County, New York",801,47,754,289,738,70536,1955,2006,1559,26.1,126,180,5,86,5,754,61
2015,36081064500,"Census Tract 645, Queens County, New York",781,73,708,221,531,58988,1957,2011,1571,24.6,105,132,7,45,37,708,35
2016,36081064500,"Census Tract 645, Queens County, New York",783,95,688,262,660,39038,1953,2012,1612,40,144,125,12,45,80,688,58
2017,36081064500,"Census Tract 645, Queens County, New York",773,85,688,310,768,52857,1952,2012,1707,37,180,150,22,60,85,688,83
2018,36081064500,"Census Tract 645, Queens County, New York",814,75,739,303,801,64750,1951,2012,1675,35.8,184,149,17,35,109,739,73
2019,36081064500,"Census Tract 645, Queens County, New York",797,71,726,314,843,50000,0,2012,1662,37.3,184,152,12,23,135,726,76
2020,36081064500,"Census Tract 645, Queens County, New York",780,69,711,300,815,NA,0,2011,2047,51,104,214,0,7,86,711,151
2012,36081064600,"Census Tract 646, Queens County, New York",973,53,920,159,445,50694,1947,2005,1399,33.6,33,6,153,0,0,920,83
2013,36081064600,"Census Tract 646, Queens County, New York",965,50,915,187,512,49410,1948,2007,1398,36.2,41,5,166,0,16,915,87
2014,36081064600,"Census Tract 646, Queens County, New York",988,53,935,200,643,83021,1952,2008,1457,23.2,58,6,178,0,16,935,51
2015,36081064600,"Census Tract 646, Queens County, New York",1013,70,943,242,773,NA,1952,2007,1425,24.5,64,7,218,0,17,943,73
2016,36081064600,"Census Tract 646, Queens County, New York",1017,38,979,233,739,66750,1949,2009,1410,25,64,6,206,0,17,979,58
2017,36081064600,"Census Tract 646, Queens County, New York",1011,35,976,208,756,64167,1949,2009,1387,26.7,31,0,185,0,19,976,76
2018,36081064600,"Census Tract 646, Queens County, New York",1026,47,979,163,569,75521,1952,2006,1379,23.4,35,0,140,0,6,979,58
2019,36081064600,"Census Tract 646, Queens County, New York",1031,53,978,135,391,65809,1945,2006,1603,26.7,18,0,111,0,6,978,60
2020,36081064600,"Census Tract 646, Queens County, New York",1133,76,1057,135,461,66953,1943,2008,1629,24.3,31,0,113,0,5,1057,36
2012,36081065000,"Census Tract 650, Queens County, New York",896,14,882,158,475,63000,1954,2005,1059,26.1,56,0,158,0,0,882,56
2013,36081065000,"Census Tract 650, Queens County, New York",909,15,894,144,474,62500,1939,2005,1110,27,21,0,144,0,0,894,63
2014,36081065000,"Census Tract 650, Queens County, New York",892,14,878,159,529,62566,1939,2004,1290,35.5,22,0,159,0,0,878,68
2015,36081065000,"Census Tract 650, Queens County, New York",893,44,849,171,553,61016,1939,2004,1238,29.3,35,0,171,0,0,849,40
2016,36081065000,"Census Tract 650, Queens County, New York",928,49,879,139,418,50885,1939,2005,1367,38.4,32,0,139,0,0,879,47
2017,36081065000,"Census Tract 650, Queens County, New York",907,47,860,108,360,61607,1945,2004,1754,24.1,32,0,108,0,0,860,36
2018,36081065000,"Census Tract 650, Queens County, New York",926,72,854,124,317,64286,1946,2005,1709,24.2,35,0,124,0,0,854,49
2019,36081065000,"Census Tract 650, Queens County, New York",918,90,828,132,395,63365,1945,2009,1654,25.1,42,0,132,0,0,828,75
2020,36081065000,"Census Tract 650, Queens County, New York",934,108,826,116,352,64773,1944,2012,1704,24.8,32,0,116,0,0,826,56
2012,36081065400,"Census Tract 654, Queens County, New York",930,59,871,191,477,69531,1971,2006,1391,24.5,65,14,159,0,23,871,17
2013,36081065400,"Census Tract 654, Queens County, New York",951,54,897,225,622,54625,1974,2010,1633,30.3,82,5,197,0,29,897,25
2014,36081065400,"Census Tract 654, Queens County, New York",950,49,901,289,803,51058,1977,2009,1403,32,81,6,234,0,56,901,69
2015,36081065400,"Census Tract 654, Queens County, New York",934,56,878,335,1027,49141,1968,2010,1517,32.9,84,5,239,0,98,878,87
2016,36081065400,"Census Tract 654, Queens County, New York",940,55,885,344,925,50061,1958,2009,1239,33.7,55,6,280,0,66,885,105
2017,36081065400,"Census Tract 654, Queens County, New York",938,59,879,294,800,48839,1958,2009,1205,33,63,0,254,0,40,879,111
2018,36081065400,"Census Tract 654, Queens County, New York",962,43,919,320,875,52292,1960,2010,1448,33.8,54,0,255,3,77,919,127
2019,36081065400,"Census Tract 654, Queens County, New York",966,31,935,319,870,54896,1960,2011,1724,34.2,48,0,277,6,52,935,76
2020,36081065401,"Census Tract 654.01, Queens County, New York",991,17,974,371,1040,58750,1962,2012,1761,28.5,76,0,321,8,42,974,56
2020,36081065402,"Census Tract 654.02, Queens County, New York",6,0,6,0,0,NA,NA,NA,NA,NA,0,0,0,0,0,6,0
2012,36081065501,"Census Tract 655.01, Queens County, New York",0,0,0,0,0,NA,NA,NA,NA,NA,0,0,0,0,0,0,0
2013,36081065501,"Census Tract 655.01, Queens County, New York",0,0,0,0,0,NA,NA,NA,NA,NA,0,0,0,0,0,0,0
2014,36081065501,"Census Tract 655.01, Queens County, New York",0,0,0,0,0,NA,NA,NA,NA,NA,0,0,0,0,0,0,0
2015,36081065501,"Census Tract 655.01, Queens County, New York",0,0,0,0,0,NA,NA,NA,NA,NA,0,0,0,0,0,0,0
2016,36081065501,"Census Tract 655.01, Queens County, New York",0,0,0,0,0,NA,NA,NA,NA,NA,0,0,0,0,0,0,0
2017,36081065501,"Census Tract 655.01, Queens County, New York",0,0,0,0,0,NA,NA,NA,NA,NA,0,0,0,0,0,0,0
2018,36081065501,"Census Tract 655.01, Queens County, New York",0,0,0,0,0,NA,NA,NA,NA,NA,0,0,0,0,0,0,0
2019,36081065501,"Census Tract 655.01, Queens County, New York",0,0,0,0,0,NA,NA,NA,NA,NA,0,0,0,0,0,0,0
2020,36081065501,"Census Tract 655.01, Queens County, New York",0,0,0,0,0,NA,NA,NA,NA,NA,0,0,0,0,0,0,0
2012,36081065600,"Census Tract 656, Queens County, New York",1461,69,1392,506,1903,47100,1986,2008,1766,42.5,143,6,477,14,9,1392,84
2013,36081065600,"Census Tract 656, Queens County, New York",1487,38,1449,574,2147,55880,1987,2008,1740,37.9,194,5,540,15,14,1449,79
2014,36081065600,"Census Tract 656, Queens County, New York",1519,38,1481,586,2074,57500,1995,2011,1814,38.3,248,7,541,20,28,1481,128
2015,36081065600,"Census Tract 656, Queens County, New York",1565,50,1515,652,2432,52167,1991,2010,1769,38.2,235,6,587,18,51,1515,141
2016,36081065600,"Census Tract 656, Queens County, New York",1619,70,1549,669,2461,65329,1976,2011,1708,30.8,226,36,576,10,47,1549,101
2017,36081065600,"Census Tract 656, Queens County, New York",1665,73,1592,702,2376,51667,1967,2011,1766,45.4,201,32,649,10,28,1592,122
2018,36081065600,"Census Tract 656, Queens County, New York",1653,201,1452,577,1720,34034,1990,2012,1794,49.4,134,34,532,0,23,1452,133
2019,36081065600,"Census Tract 656, Queens County, New York",1683,191,1492,704,2109,45044,1958,2011,1780,45.1,92,34,652,6,25,1492,134
2020,36081065600,"Census Tract 656, Queens County, New York",1654,180,1474,610,1454,49439,1992,2013,1759,36.7,190,36,558,6,37,1474,109
2012,36081065702,"Census Tract 657.02, Queens County, New York",736,88,648,319,618,46442,1952,2003,1232,36,72,240,4,5,74,648,88
2013,36081065702,"Census Tract 657.02, Queens County, New York",755,73,682,274,606,60972,1966,2005,1245,27.9,56,195,27,5,51,682,43
2014,36081065702,"Census Tract 657.02, Queens County, New York",766,47,719,290,590,61087,1960,2006,1337,28.8,50,200,21,9,64,719,37
2015,36081065702,"Census Tract 657.02, Queens County, New York",772,42,730,339,808,44961,1965,2007,1438,36.3,80,213,26,15,89,730,57
2016,36081065702,"Census Tract 657.02, Queens County, New York",759,46,713,277,652,41250,1957,2010,1427,38.4,60,159,21,7,90,713,69
2017,36081065702,"Census Tract 657.02, Queens County, New York",764,27,737,361,895,49306,1965,2010,1477,33.3,117,199,22,10,130,737,70
2018,36081065702,"Census Tract 657.02, Queens County, New York",786,42,744,356,803,55714,1963,2010,1629,29.9,130,204,0,12,140,744,65
2019,36081065702,"Census Tract 657.02, Queens County, New York",772,37,735,360,846,56000,1966,2010,1571,31.4,126,200,0,5,155,735,59
2020,36081065702,"Census Tract 657.02, Queens County, New York",681,71,610,295,713,58958,1967,2010,1550,28.8,117,166,0,0,129,610,36
2012,36081065703,"Census Tract 657.03, Queens County, New York",1036,39,997,400,840,44257,1951,2005,1318,40.1,24,348,0,0,52,997,33
2013,36081065703,"Census Tract 657.03, Queens County, New York",1105,64,1041,410,869,52602,1952,2004,1339,40.2,68,331,0,0,79,1041,51
2014,36081065703,"Census Tract 657.03, Queens County, New York",1114,28,1086,416,842,49500,1952,2004,1292,41,82,326,0,0,90,1086,88
2015,36081065703,"Census Tract 657.03, Queens County, New York",1138,51,1087,361,718,53875,1952,2004,1330,32.6,98,275,0,0,86,1087,58
2016,36081065703,"Census Tract 657.03, Queens County, New York",1142,63,1079,409,743,56321,1951,2003,1313,32.4,136,333,0,0,76,1079,72
2017,36081065703,"Census Tract 657.03, Queens County, New York",1160,99,1061,376,760,63952,1959,2004,1391,29.6,170,269,0,10,97,1061,67
2018,36081065703,"Census Tract 657.03, Queens County, New York",1165,132,1033,395,965,69886,1957,2005,1419,26.5,189,346,0,10,39,1033,65
2019,36081065703,"Census Tract 657.03, Queens County, New York",1171,170,1001,414,1075,82292,1958,2005,1551,24.5,233,350,0,12,52,1001,71
2020,36081065703,"Census Tract 657.03, Queens County, New York",1265,141,1124,366,907,84265,1959,2008,1717,24.7,196,304,0,25,37,1124,72
2012,36081065900,"Census Tract 659, Queens County, New York",744,55,689,185,442,101597,1939,2003,1245,15.5,93,140,36,0,9,689,16
2013,36081065900,"Census Tract 659, Queens County, New York",785,52,733,182,448,103906,1949,2005,1362,17.6,123,141,0,0,41,733,26
2014,36081065900,"Census Tract 659, Queens County, New York",765,62,703,195,517,106971,1948,2006,1391,16.3,130,161,0,0,34,703,51
2015,36081065900,"Census Tract 659, Queens County, New York",771,87,684,179,489,110234,1945,2009,1408,17.7,133,146,0,0,33,684,51
2016,36081065900,"Census Tract 659, Queens County, New York",759,89,670,186,482,113500,1944,2010,1568,18,134,148,0,0,38,670,61
2017,36081065900,"Census Tract 659, Queens County, New York",748,74,674,186,497,96111,1952,2012,1669,17.5,113,141,0,0,45,674,64
2018,36081065900,"Census Tract 659, Queens County, New York",711,52,659,144,348,97000,1942,2012,1733,19.2,76,124,0,0,20,659,58
2019,36081065900,"Census Tract 659, Queens County, New York",733,34,699,137,298,68750,1951,2015,1791,26.7,76,101,0,8,28,699,41
2020,36081065900,"Census Tract 659, Queens County, New York",694,34,660,116,325,81786,1954,2013,1856,20,50,97,0,3,16,660,29
2012,36081066000,"Census Tract 660, Queens County, New York",1035,12,1023,358,1322,98984,1948,2005,1722,21.5,99,0,340,0,18,1023,45
2013,36081066000,"Census Tract 660, Queens County, New York",1036,32,1004,369,1394,103487,1948,2005,1723,22.7,109,0,352,0,17,1004,36
2014,36081066000,"Census Tract 660, Queens County, New York",1046,44,1002,337,1329,91250,1948,2006,1624,26.9,85,0,316,0,21,1002,50
2015,36081066000,"Census Tract 660, Queens County, New York",1020,29,991,358,1295,71071,1953,2009,1654,31.2,65,0,339,0,19,991,42
2016,36081066000,"Census Tract 660, Queens County, New York",1047,64,983,301,1023,70048,1951,2010,1613,31.1,70,0,293,0,8,983,32
2017,36081066000,"Census Tract 660, Queens County, New York",1061,66,995,199,631,59625,1955,2011,1448,30.8,36,0,199,0,0,995,35
2018,36081066000,"Census Tract 660, Queens County, New York",1092,68,1024,227,614,44153,1957,2012,1759,33.8,42,0,186,5,36,1024,52
2019,36081066000,"Census Tract 660, Queens County, New York",1074,65,1009,268,726,58409,1958,2012,1796,42.3,71,0,228,0,40,1009,65
2020,36081066000,"Census Tract 660, Queens County, New York",1223,70,1153,331,724,41652,1948,2012,2019,51,94,0,322,0,9,1153,50
2012,36081066100,"Census Tract 661, Queens County, New York",688,80,608,278,562,49423,1961,2004,1381,37.7,63,267,0,0,11,608,23
2013,36081066100,"Census Tract 661, Queens County, New York",688,86,602,237,420,51042,1957,2005,1343,27.2,67,225,0,0,12,602,29
2014,36081066100,"Census Tract 661, Queens County, New York",678,41,637,223,409,71458,1961,2005,1417,25.4,77,211,0,0,12,637,34
2015,36081066100,"Census Tract 661, Queens County, New York",655,30,625,221,413,52279,1960,2006,1361,27,70,208,0,0,13,625,53
2016,36081066100,"Census Tract 661, Queens County, New York",647,26,621,204,396,71333,1962,2008,1422,27.4,87,193,0,0,11,621,35
2017,36081066100,"Census Tract 661, Queens County, New York",649,26,623,172,338,71833,1964,2008,1650,28.9,79,165,0,0,7,623,30
2018,36081066100,"Census Tract 661, Queens County, New York",635,33,602,150,324,59565,1965,2007,1685,31.9,51,143,0,0,7,602,28
2019,36081066100,"Census Tract 661, Queens County, New York",660,42,618,141,317,59185,1965,2007,1732,31.9,51,134,0,0,7,618,35
2020,36081066100,"Census Tract 661, Queens County, New York",695,83,612,98,217,49500,1963,2005,1665,38.5,27,92,0,0,6,612,16
2012,36081066300,"Census Tract 663, Queens County, New York",982,54,928,78,184,31333,1941,2002,2001,42,20,63,0,0,15,928,88
2013,36081066300,"Census Tract 663, Queens County, New York",978,28,950,84,225,63333,1944,2002,2001,29.3,23,75,0,9,0,950,84
2014,36081066300,"Census Tract 663, Queens County, New York",1024,58,966,119,290,49792,1947,2004,1451,30.5,48,86,0,9,24,966,111
2015,36081066300,"Census Tract 663, Queens County, New York",1030,64,966,143,313,48563,1948,2005,1463,31.6,50,104,0,12,27,966,76
2016,36081066300,"Census Tract 663, Queens County, New York",1011,60,951,135,348,NA,1948,2010,1667,29.2,72,75,0,25,35,951,70
2017,36081066300,"Census Tract 663, Queens County, New York",1012,48,964,155,347,48693,1952,2010,1459,30.8,78,93,0,27,35,964,60
2018,36081066300,"Census Tract 663, Queens County, New York",1020,38,982,148,320,73750,1949,2012,1729,31,85,103,0,14,31,982,53
2019,36081066300,"Census Tract 663, Queens County, New York",977,5,972,120,282,97750,1946,2011,2065,23.9,62,100,0,14,6,972,35
2020,36081066301,"Census Tract 663.01, Queens County, New York",1030,5,1025,126,316,100357,1945,2007,1954,21.3,79,93,0,27,6,1025,21
2020,36081066302,"Census Tract 663.02, Queens County, New York",0,0,0,0,0,NA,NA,NA,NA,NA,0,0,0,0,0,0,0
2012,36081066400,"Census Tract 664, Queens County, New York",3218,115,3103,1157,3692,55795,1962,2004,1584,29.4,371,44,1023,62,16,3103,201
2013,36081066400,"Census Tract 664, Queens County, New York",3232,85,3147,1379,4466,50091,1964,2005,1617,32.1,390,69,1187,51,42,3147,197
2014,36081066400,"Census Tract 664, Queens County, New York",3117,120,2997,1385,4333,53398,1960,2006,1596,30.7,393,73,1170,73,38,2997,272
2015,36081066400,"Census Tract 664, Queens County, New York",3049,157,2892,1326,4181,62760,1959,2010,1567,27.7,372,64,1142,78,19,2892,271
2016,36081066400,"Census Tract 664, Queens County, New York",3029,221,2808,1420,4480,66865,1960,2010,1626,28.1,307,47,1253,38,52,2808,284
2017,36081066400,"Census Tract 664, Queens County, New York",2988,210,2778,1528,4740,73882,1962,2010,1676,27.7,318,49,1366,36,40,2778,276
2018,36081066400,"Census Tract 664, Queens County, New York",3035,159,2876,1465,4103,78281,1961,2011,1743,26.9,307,39,1340,36,16,2876,293
2019,36081066400,"Census Tract 664, Queens County, New York",3168,114,3054,1384,3982,81148,1963,2011,1859,26.2,262,43,1291,0,21,3054,221
2020,36081066401,"Census Tract 664.01, Queens County, New York",424,46,378,104,357,NA,1964,2011,1587,25.9,20,0,104,0,0,378,30
2020,36081066402,"Census Tract 664.02, Queens County, New York",1017,0,1017,287,869,83350,1958,2006,1815,25.1,109,0,234,0,53,1017,42
2020,36081066403,"Census Tract 664.03, Queens County, New York",1578,52,1526,860,3015,78851,1967,2015,2120,32,202,0,860,0,0,1526,206
2020,36081066404,"Census Tract 664.04, Queens County, New York",0,0,0,0,0,NA,NA,NA,NA,NA,0,0,0,0,0,0,0
2012,36081066501,"Census Tract 665.01, Queens County, New York",1534,122,1412,509,1308,76875,1960,2004,1549,20.4,128,472,0,0,37,1412,82
2013,36081066501,"Census Tract 665.01, Queens County, New York",1540,133,1407,618,1476,61250,1962,2006,1625,23,192,567,0,0,51,1407,90
2014,36081066501,"Census Tract 665.01, Queens County, New York",1546,167,1379,527,1174,77159,1963,2008,1618,21.4,165,473,0,10,44,1379,104
2015,36081066501,"Census Tract 665.01, Queens County, New York",1529,171,1358,465,973,71458,1961,2011,1619,23.2,162,421,0,11,33,1358,64
2016,36081066501,"Census Tract 665.01, Queens County, New York",1474,143,1331,471,1001,81875,1963,2012,1573,21.5,190,439,0,10,22,1331,61
2017,36081066501,"Census Tract 665.01, Queens County, New York",1487,151,1336,424,927,67917,1963,2012,1637,31.1,212,361,0,9,54,1336,56
2018,36081066501,"Census Tract 665.01, Queens County, New York",1502,144,1358,484,1084,66818,1962,2014,1599,33.1,203,388,0,9,87,1358,73
2019,36081066501,"Census Tract 665.01, Queens County, New York",1493,108,1385,587,1401,70292,1960,2013,1639,31.4,209,421,7,0,159,1385,116
2020,36081066501,"Census Tract 665.01, Queens County, New York",1583,97,1486,616,1474,73558,1960,2015,1728,30.2,269,376,10,0,230,1486,126
2012,36081066701,"Census Tract 667.01, Queens County, New York",1083,66,1017,309,646,78466,1959,2005,1422,26.4,88,270,0,0,39,1017,80
2013,36081066701,"Census Tract 667.01, Queens County, New York",1111,86,1025,325,683,67644,1954,2005,1344,28.3,98,249,0,0,76,1025,73
2014,36081066701,"Census Tract 667.01, Queens County, New York",1126,70,1056,390,761,50682,1960,2005,1415,30.5,131,257,8,23,102,1056,85
2015,36081066701,"Census Tract 667.01, Queens County, New York",1108,112,996,408,788,37500,1955,2007,1435,38.7,125,282,9,22,95,996,114
2016,36081066701,"Census Tract 667.01, Queens County, New York",1101,122,979,407,797,36813,1954,2007,1406,41.1,105,257,9,23,118,979,89
2017,36081066701,"Census Tract 667.01, Queens County, New York",1099,90,1009,394,761,35833,1954,2007,1480,45.2,96,227,10,25,132,1009,107
2018,36081066701,"Census Tract 667.01, Queens County, New York",1107,98,1009,418,913,33611,1956,2008,1593,49.6,84,219,11,31,157,1009,95
2019,36081066701,"Census Tract 667.01, Queens County, New York",1108,90,1018,354,834,35789,1955,2011,1557,44.8,55,223,0,0,131,1018,103
2020,36081066701,"Census Tract 667.01, Queens County, New York",1055,61,994,331,1015,59567,1959,2012,1827,34.5,100,133,0,20,178,994,92
2012,36081066900,"Census Tract 669, Queens County, New York",709,41,668,203,484,68438,1959,2003,1370,25.9,74,191,0,12,0,668,27
2013,36081066900,"Census Tract 669, Queens County, New York",700,41,659,202,497,59756,1961,2004,1345,27.6,93,190,0,12,0,659,21
2014,36081066900,"Census Tract 669, Queens County, New York",704,59,645,226,474,59545,1959,2004,1379,26.5,124,221,0,5,0,645,46
2015,36081066900,"Census Tract 669, Queens County, New York",726,106,620,203,434,51250,1957,2004,1229,35.8,101,177,0,17,9,620,49
2016,36081066900,"Census Tract 669, Queens County, New York",730,121,609,199,428,50917,1958,2004,1356,38.2,96,176,0,16,7,609,51
2017,36081066900,"Census Tract 669, Queens County, New York",719,134,585,208,455,51875,1960,2007,1544,38.4,104,164,0,27,17,585,55
2018,36081066900,"Census Tract 669, Queens County, New York",744,134,610,272,654,61833,1958,2012,1634,33.6,99,208,0,30,34,610,63
2019,36081066900,"Census Tract 669, Queens County, New York",717,137,580,261,705,65938,1960,2014,1719,33.5,67,187,0,24,50,580,38
2020,36081066900,"Census Tract 669, Queens County, New York",718,141,577,289,845,70574,1959,2014,1714,31,103,216,0,11,62,577,29
2012,36081067100,"Census Tract 671, Queens County, New York",882,29,853,57,94,32009,1940,2004,746,26.3,18,45,0,0,12,853,64
2013,36081067100,"Census Tract 671, Queens County, New York",865,46,819,77,163,48250,1945,2003,1525,26.6,25,62,0,5,10,819,74
2014,36081067100,"Census Tract 671, Queens County, New York",863,45,818,59,151,53125,1951,2002,1922,36.3,19,52,0,7,0,818,89
2015,36081067100,"Census Tract 671, Queens County, New York",857,46,811,71,178,53393,1951,2002,1963,36.8,23,64,0,7,0,811,53
2016,36081067100,"Census Tract 671, Queens County, New York",850,39,811,52,156,50750,1952,2004,1738,38.3,13,40,0,12,0,811,61
2017,36081067100,"Census Tract 671, Queens County, New York",862,26,836,60,210,51042,1951,2005,1719,41,11,42,0,18,0,836,50
2018,36081067100,"Census Tract 671, Queens County, New York",876,7,869,66,201,115781,1954,2015,2236,29.8,10,49,0,12,5,869,51
2019,36081067100,"Census Tract 671, Queens County, New York",881,7,874,76,200,119821,1952,2017,2250,17.5,37,64,0,11,1,874,48
2020,36081067100,"Census Tract 671, Queens County, New York",957,6,951,80,209,156250,1952,2017,2255,18,43,68,0,10,2,951,31
2012,36081067700,"Census Tract 677, Queens County, New York",744,68,676,163,243,63906,1943,2004,1373,23.1,61,139,0,19,5,676,34
2013,36081067700,"Census Tract 677, Queens County, New York",749,37,712,119,195,47813,1942,2004,1292,21.9,51,98,0,17,4,712,31
2014,36081067700,"Census Tract 677, Queens County, New York",734,46,688,168,292,47917,1944,2004,1359,22.9,73,133,0,23,12,688,32
2015,36081067700,"Census Tract 677, Queens County, New York",731,28,703,175,294,48438,1946,2005,1407,21.1,78,138,0,23,14,703,25
2016,36081067700,"Census Tract 677, Queens County, New York",714,52,662,148,325,81528,1952,2005,1462,18.6,83,116,0,17,15,662,21
2017,36081067700,"Census Tract 677, Queens County, New York",727,39,688,140,309,83750,1950,2007,1589,21.1,64,111,0,13,16,688,15
2018,36081067700,"Census Tract 677, Queens County, New York",715,43,672,116,250,83654,0,2009,1926,26.9,44,88,0,13,15,672,23
2019,36081067700,"Census Tract 677, Queens County, New York",701,37,664,109,225,85724,0,2012,1826,25.9,50,83,0,20,6,664,25
2020,36081067700,"Census Tract 677, Queens County, New York",719,71,648,132,310,86923,0,2009,1986,25.4,64,98,0,18,16,648,26
2012,36081067900,"Census Tract 679, Queens County, New York",1712,95,1617,1203,2418,38108,1954,2000,1111,32.8,488,723,78,44,383,1617,282
2013,36081067900,"Census Tract 679, Queens County, New York",1720,85,1635,1225,2383,37111,1954,2001,1121,38.4,439,673,85,72,412,1635,244
2014,36081067900,"Census Tract 679, Queens County, New York",1748,110,1638,1230,2297,38182,1954,2003,1184,36.4,398,719,66,35,401,1638,239
2015,36081067900,"Census Tract 679, Queens County, New York",1760,73,1687,1272,2374,36579,1956,2004,1193,36.8,394,683,57,21,489,1687,216
2016,36081067900,"Census Tract 679, Queens County, New York",1702,57,1645,1198,2211,35833,1955,2004,1223,34.7,296,644,12,19,462,1645,261
2017,36081067900,"Census Tract 679, Queens County, New York",1719,58,1661,1220,2466,42181,1954,2007,1291,30.9,316,599,13,18,513,1661,194
2018,36081067900,"Census Tract 679, Queens County, New York",1724,46,1678,1267,2627,42261,1954,2009,1371,30.6,309,536,9,34,619,1678,224
2019,36081067900,"Census Tract 679, Queens County, New York",1737,64,1673,1289,2935,44720,1954,2010,1393,29.9,325,467,7,37,717,1673,234
2020,36081067900,"Census Tract 679, Queens County, New York",1765,122,1643,1224,2935,51500,1952,2010,1443,30.1,403,446,10,52,710,1643,203
2012,36081068000,"Census Tract 680, Queens County, New York",1561,129,1432,353,1274,55795,1975,2005,1702,32.5,28,0,291,9,25,1432,80
2013,36081068000,"Census Tract 680, Queens County, New York",1607,119,1488,425,1357,54391,1974,2005,1650,31.6,56,0,334,46,24,1488,74
2014,36081068000,"Census Tract 680, Queens County, New York",1626,105,1521,449,1319,56755,1973,2004,1656,31.3,64,0,389,41,0,1521,66
2015,36081068000,"Census Tract 680, Queens County, New York",1589,113,1476,390,1025,57368,1977,2006,1637,30.9,77,0,332,34,0,1476,41
2016,36081068000,"Census Tract 680, Queens County, New York",1589,81,1508,447,1372,59344,1975,2009,1698,31.8,75,0,385,37,0,1508,33
2017,36081068000,"Census Tract 680, Queens County, New York",1531,31,1500,416,1326,66848,1972,2011,1666,27.7,109,0,372,44,0,1500,34
2018,36081068000,"Census Tract 680, Queens County, New York",1514,49,1465,410,1425,75538,1959,2011,1727,28.9,131,0,399,11,0,1465,49
2019,36081068000,"Census Tract 680, Queens County, New York",1493,31,1462,435,1532,84659,1958,2014,1726,27.4,171,0,411,12,18,1462,64
2020,36081068000,"Census Tract 680, Queens County, New York",1582,31,1551,393,1356,79944,1959,2015,1992,27.7,149,0,370,12,17,1551,76
2012,36081068200,"Census Tract 682, Queens County, New York",396,25,371,147,390,47011,1956,2011,1637,41.6,18,0,131,0,13,371,31
2013,36081068200,"Census Tract 682, Queens County, New York",415,27,388,125,361,46875,1957,2011,1663,41.4,11,0,125,0,8,388,16
2014,36081068200,"Census Tract 682, Queens County, New York",412,39,373,138,405,49545,1958,2009,1673,41.4,17,0,138,0,8,373,23
2015,36081068200,"Census Tract 682, Queens County, New York",412,30,382,140,413,48523,1953,2010,1569,44.5,28,0,133,0,15,382,35
2016,36081068200,"Census Tract 682, Queens County, New York",425,42,383,119,317,48594,1951,2010,1438,33.4,27,0,111,0,13,383,35
2017,36081068200,"Census Tract 682, Queens County, New York",403,46,357,107,299,42422,1950,2010,1431,37.8,25,0,99,0,12,357,39
2018,36081068200,"Census Tract 682, Queens County, New York",384,41,343,113,303,52656,1942,2010,1354,32.8,40,0,103,0,14,343,42
2019,36081068200,"Census Tract 682, Queens County, New York",379,37,342,104,271,42361,1943,2012,1379,34.5,33,0,95,0,13,342,35
2020,36081068200,"Census Tract 682, Queens County, New York",393,38,355,84,224,42778,1950,2011,1444,43,21,0,84,0,4,355,21
2012,36081068300,"Census Tract 683, Queens County, New York",1680,75,1605,1078,2878,51466,1955,2002,1308,31.7,252,50,80,298,634,1605,252
2013,36081068300,"Census Tract 683, Queens County, New York",1665,74,1591,1071,2912,56098,1954,2002,1364,32.1,301,72,61,346,592,1591,237
2014,36081068300,"Census Tract 683, Queens County, New York",1669,83,1586,1011,2942,56576,1952,2003,1487,34.3,334,64,52,349,522,1586,262
2015,36081068300,"Census Tract 683, Queens County, New York",1680,89,1591,971,2626,57958,1959,2004,1484,33.8,447,65,76,309,526,1591,282
2016,36081068300,"Census Tract 683, Queens County, New York",1690,103,1587,978,2340,47500,1961,2005,1537,38.6,439,124,102,271,490,1587,321
2017,36081068300,"Census Tract 683, Queens County, New York",1693,71,1622,951,1991,45274,1963,2007,1380,41.2,434,179,151,242,409,1622,237
2018,36081068300,"Census Tract 683, Queens County, New York",1713,71,1642,908,1950,34375,1963,2007,1370,48.5,357,169,136,197,423,1642,242
2019,36081068300,"Census Tract 683, Queens County, New York",1749,61,1688,960,1950,36019,1963,2009,1467,46.8,345,153,134,227,475,1688,285
2020,36081068300,"Census Tract 683, Queens County, New York",1792,122,1670,850,1764,37578,1961,2010,1501,47.3,297,220,78,219,352,1670,285
2012,36081068700,"Census Tract 687, Queens County, New York",2025,47,1978,1110,2465,56500,1945,2004,1387,29.2,603,643,23,282,162,1978,227
2013,36081068700,"Census Tract 687, Queens County, New York",2007,69,1938,1085,2380,55598,1947,2004,1371,29.4,586,625,22,283,155,1938,277
2014,36081068700,"Census Tract 687, Queens County, New York",2049,119,1930,1127,2496,56042,1947,2004,1363,31.2,582,600,34,334,159,1930,268
2015,36081068700,"Census Tract 687, Queens County, New York",2006,120,1886,1139,2878,58867,1945,2006,1383,28.8,600,492,59,449,139,1886,316
2016,36081068700,"Census Tract 687, Queens County, New York",2014,193,1821,1132,2755,60343,1947,2009,1399,29.2,575,503,61,384,174,1821,288
2017,36081068700,"Census Tract 687, Queens County, New York",2023,249,1774,1087,2615,60643,1947,2010,1434,29.7,528,459,33,395,190,1774,266
2018,36081068700,"Census Tract 687, Queens County, New York",2000,206,1794,1027,2613,63451,1948,2010,1472,29.2,552,421,45,366,187,1794,222
2019,36081068700,"Census Tract 687, Queens County, New York",1931,170,1761,966,2265,53864,1951,2010,1518,36.2,482,485,30,254,187,1761,273
2020,36081068700,"Census Tract 687, Queens County, New York",2052,146,1906,1085,2008,50040,1950,2010,1650,39.7,630,395,0,415,263,1906,243
2012,36081069000,"Census Tract 690, Queens County, New York",1076,11,1065,332,1266,71324,1957,2005,1665,23.6,75,0,332,0,0,1065,47
2013,36081069000,"Census Tract 690, Queens County, New York",1095,32,1063,381,1539,63110,1963,2005,1581,26.8,76,0,381,0,0,1063,111
2014,36081069000,"Census Tract 690, Queens County, New York",1081,42,1039,354,1437,60588,1960,2006,1550,29.7,62,0,354,0,0,1039,128
2015,36081069000,"Census Tract 690, Queens County, New York",1063,63,1000,455,1689,54375,1955,2008,1633,30.4,99,0,455,0,0,1000,115
2016,36081069000,"Census Tract 690, Queens County, New York",1084,78,1006,479,1730,50677,1958,2010,1659,34.1,118,0,479,0,0,1006,117
2017,36081069000,"Census Tract 690, Queens County, New York",1085,127,958,526,1824,51638,1960,2010,1685,34.7,124,0,526,0,0,958,112
2018,36081069000,"Census Tract 690, Queens County, New York",1080,103,977,486,1641,57024,1957,2011,1811,34.1,119,8,478,0,0,977,69
2019,36081069000,"Census Tract 690, Queens County, New York",1091,113,978,461,1708,94063,1960,2012,1930,30,88,9,452,0,0,978,45
2020,36081069000,"Census Tract 690, Queens County, New York",1097,119,978,376,1595,91250,1966,2011,2088,32.4,53,9,367,0,0,978,56
2012,36081069300,"Census Tract 693, Queens County, New York",1174,31,1143,896,1836,43537,1949,2003,1254,32.8,438,456,31,227,169,1143,134
2013,36081069300,"Census Tract 693, Queens County, New York",1219,34,1185,906,1960,45756,1951,2005,1386,34.1,425,360,44,243,257,1185,115
2014,36081069300,"Census Tract 693, Queens County, New York",1273,64,1209,982,2000,43690,1950,2005,1436,40.5,464,365,50,287,272,1209,152
2015,36081069300,"Census Tract 693, Queens County, New York",1283,81,1202,950,2239,39767,1947,2006,1426,43.2,454,344,66,268,239,1202,220
2016,36081069300,"Census Tract 693, Queens County, New York",1305,66,1239,939,2312,39861,1947,2009,1488,44.4,460,360,75,284,206,1239,252
2017,36081069300,"Census Tract 693, Queens County, New York",1326,87,1239,928,2262,44318,1945,2010,1557,41.6,509,428,60,238,201,1239,193
2018,36081069300,"Census Tract 693, Queens County, New York",1349,84,1265,999,2455,60245,1945,2011,1639,33.8,496,457,101,247,196,1265,239
2019,36081069300,"Census Tract 693, Queens County, New York",1339,76,1263,978,2498,62264,1945,2012,1680,32.6,483,402,109,279,185,1263,203
2020,36081069300,"Census Tract 693, Queens County, New York",1260,99,1161,912,2187,71250,1949,2014,1750,32.5,532,344,97,272,208,1161,136
2012,36081069400,"Census Tract 694, Queens County, New York",999,83,916,399,974,54632,1971,2005,1550,35.5,91,0,368,0,31,916,112
2013,36081069400,"Census Tract 694, Queens County, New York",1028,0,1028,411,996,55221,1971,2006,1540,36.8,110,0,381,0,30,1028,151
2014,36081069400,"Census Tract 694, Queens County, New York",1082,0,1082,412,1208,56471,1969,2006,1636,34.7,105,0,380,0,32,1082,143
2015,36081069400,"Census Tract 694, Queens County, New York",1104,0,1104,400,1390,67576,1968,2007,1660,32.8,127,16,349,0,35,1104,187
2016,36081069400,"Census Tract 694, Queens County, New York",1140,12,1128,400,1370,69817,1968,2008,1675,29,103,16,350,0,15,1128,141
2017,36081069400,"Census Tract 694, Queens County, New York",1118,13,1105,444,1525,77019,1963,2010,1696,27.5,141,17,382,0,37,1105,149
2018,36081069400,"Census Tract 694, Queens County, New York",1146,28,1118,515,1759,83512,1961,2010,1822,27,139,23,456,0,37,1118,156
2019,36081069400,"Census Tract 694, Queens County, New York",1123,44,1079,474,1521,83150,1962,2012,1802,27.3,109,21,414,0,36,1079,152
2020,36081069400,"Census Tract 694, Queens County, New York",1157,41,1116,568,1514,86741,1958,2015,1816,24.3,223,10,460,0,31,1116,94
2012,36081069500,"Census Tract 695, Queens County, New York",931,34,897,494,1068,47979,1952,2003,1438,32.7,291,205,0,38,191,897,91
2013,36081069500,"Census Tract 695, Queens County, New York",914,23,891,530,1063,46667,1953,2003,1413,36.7,302,248,0,34,192,891,74
2014,36081069500,"Census Tract 695, Queens County, New York",912,41,871,500,951,43684,1952,2005,1436,39.2,268,241,0,42,163,871,99
2015,36081069500,"Census Tract 695, Queens County, New York",915,70,845,471,836,46719,1947,2005,1455,36.4,214,216,0,49,152,845,91
2016,36081069500,"Census Tract 695, Queens County, New York",904,49,855,487,976,43583,1948,2009,1441,38.3,203,263,6,51,148,855,96
2017,36081069500,"Census Tract 695, Queens County, New York",926,57,869,476,905,44773,1947,2011,1452,37.4,185,286,5,31,139,869,115
2018,36081069500,"Census Tract 695, Queens County, New York",896,79,817,429,933,55699,1946,2011,1530,37.3,167,239,5,30,133,817,112
2019,36081069500,"Census Tract 695, Queens County, New York",989,114,875,425,933,59102,1948,2011,1629,34.8,190,230,6,49,116,875,101
2020,36081069500,"Census Tract 695, Queens County, New York",982,124,858,408,935,85143,1950,2010,1655,27.8,161,195,6,44,140,858,105
2012,36081069701,"Census Tract 697.01, Queens County, New York",1792,102,1690,1374,2854,47969,1955,2003,1350,37,651,758,111,231,279,1690,207
2013,36081069701,"Census Tract 697.01, Queens County, New York",1806,132,1674,1335,2968,48430,1955,2005,1401,33.7,645,611,99,305,316,1674,149
2014,36081069701,"Census Tract 697.01, Queens County, New York",1833,132,1701,1417,3051,47468,1954,2006,1389,34.4,691,596,86,438,283,1701,201
2015,36081069701,"Census Tract 697.01, Queens County, New York",1892,125,1767,1474,3290,48580,1955,2009,1450,33.4,757,609,112,515,264,1767,245
2016,36081069701,"Census Tract 697.01, Queens County, New York",1890,124,1766,1500,3255,56382,1955,2010,1451,29.3,890,543,101,567,319,1766,251
2017,36081069701,"Census Tract 697.01, Queens County, New York",1898,117,1781,1511,3177,56806,1956,2010,1492,28.3,996,514,93,603,346,1781,317
2018,36081069701,"Census Tract 697.01, Queens County, New York",1902,72,1830,1571,3287,75057,1955,2011,1592,24.8,1058,678,144,541,238,1830,318
2019,36081069701,"Census Tract 697.01, Queens County, New York",1913,50,1863,1564,3655,89844,1957,2012,1676,23,1014,750,131,386,309,1863,268
2020,36081069701,"Census Tract 697.01, Queens County, New York",1919,153,1766,1500,3519,91298,1959,2012,1767,23.9,1066,656,111,411,308,1766,185
2012,36081069702,"Census Tract 697.02, Queens County, New York",1651,23,1628,809,1708,59194,1949,2002,1401,32.8,350,463,16,186,144,1628,78
2013,36081069702,"Census Tract 697.02, Queens County, New York",1646,31,1615,834,1587,50417,1949,2001,1435,37.1,383,533,0,179,122,1615,110
2014,36081069702,"Census Tract 697.02, Queens County, New York",1664,74,1590,822,1429,50078,1948,2002,1429,37.9,415,492,0,193,137,1590,111
2015,36081069702,"Census Tract 697.02, Queens County, New York",1640,87,1553,657,1153,43583,1949,2006,1460,41.8,372,332,0,223,102,1553,91
2016,36081069702,"Census Tract 697.02, Queens County, New York",1601,129,1472,599,1118,49306,1952,2005,1412,40.2,300,280,0,208,95,1472,88
2017,36081069702,"Census Tract 697.02, Queens County, New York",1630,199,1431,518,964,52688,1951,2007,1736,42.7,240,282,0,186,31,1431,84
2018,36081069702,"Census Tract 697.02, Queens County, New York",1628,189,1439,396,780,59417,1953,2008,1763,33.6,177,173,0,185,7,1439,107
2019,36081069702,"Census Tract 697.02, Queens County, New York",1529,128,1401,446,1066,95500,1944,2010,1846,25.2,194,195,0,190,40,1401,102
2020,36081069702,"Census Tract 697.02, Queens County, New York",1440,99,1341,391,950,66806,1943,2010,1779,32.1,186,187,0,176,7,1341,114
2012,36081070300,"Census Tract 703, Queens County, New York",849,106,743,209,490,65750,1959,2004,1368,25.8,135,84,0,9,94,743,32
2013,36081070300,"Census Tract 703, Queens County, New York",849,141,708,215,524,59774,1962,2006,1298,26.2,118,70,0,19,100,708,66
2014,36081070300,"Census Tract 703, Queens County, New York",830,152,678,235,631,60759,1963,2005,1338,26.7,112,80,0,16,118,678,43
2015,36081070300,"Census Tract 703, Queens County, New York",860,126,734,212,642,53750,1958,2007,1196,23.4,94,82,6,18,66,734,54
2016,36081070300,"Census Tract 703, Queens County, New York",835,129,706,209,596,50091,1966,2010,1576,41.1,58,77,6,45,72,706,41
2017,36081070300,"Census Tract 703, Queens County, New York",831,84,747,206,583,53882,1967,2010,1612,39.6,47,79,12,48,74,747,36
2018,36081070300,"Census Tract 703, Queens County, New York",818,76,742,200,512,58750,1958,2011,1659,25.6,71,65,12,32,88,742,36
2019,36081070300,"Census Tract 703, Queens County, New York",879,57,822,224,526,73382,1957,2013,1711,26.5,87,58,14,48,98,822,37
2020,36081070300,"Census Tract 703, Queens County, New York",981,97,884,271,639,87452,1956,2011,1600,23.5,65,124,7,58,78,884,60
2012,36081070700,"Census Tract 707, Queens County, New York",969,19,950,170,374,43300,1946,2004,1238,50,85,54,0,25,91,950,32
2013,36081070700,"Census Tract 707, Queens County, New York",961,35,926,164,356,33750,1946,2004,1160,50,60,74,0,15,75,926,48
2014,36081070700,"Census Tract 707, Queens County, New York",939,49,890,175,378,41776,1952,2005,1148,33.7,48,75,0,19,81,890,63
2015,36081070700,"Census Tract 707, Queens County, New York",992,79,913,187,422,47802,1948,2007,1200,27.6,61,90,0,26,71,913,66
2016,36081070700,"Census Tract 707, Queens County, New York",978,75,903,199,447,47933,1950,2010,1224,28.2,74,102,0,41,56,903,96
2017,36081070700,"Census Tract 707, Queens County, New York",1009,54,955,217,544,49313,1952,2011,1229,28.6,94,115,0,52,50,955,121
2018,36081070700,"Census Tract 707, Queens County, New York",1018,51,967,263,664,82438,1950,2009,1344,26.5,104,117,0,75,71,967,85
2019,36081070700,"Census Tract 707, Queens County, New York",1031,51,980,239,636,91328,1949,2008,1414,25.4,92,101,0,72,66,980,65
2020,36081070700,"Census Tract 707, Queens County, New York",1025,22,1003,232,628,94271,1953,2010,1421,29.2,121,119,0,75,38,1003,59
2012,36081070900,"Census Tract 709, Queens County, New York",1173,167,1006,340,737,101111,1958,2005,1559,21.1,260,229,0,67,35,1006,36
2013,36081070900,"Census Tract 709, Queens County, New York",1167,170,997,339,786,104943,1953,2004,1896,22.2,263,238,0,65,36,997,27
2014,36081070900,"Census Tract 709, Queens County, New York",1158,181,977,338,794,105952,1956,2005,1750,23.8,239,224,0,89,25,977,45
2015,36081070900,"Census Tract 709, Queens County, New York",1148,155,993,395,910,69622,1957,2006,1811,23,298,243,0,121,31,993,73
2016,36081070900,"Census Tract 709, Queens County, New York",1137,134,1003,404,949,70000,1958,2008,1702,23.9,315,235,12,97,60,1003,72
2017,36081070900,"Census Tract 709, Queens County, New York",1141,117,1024,403,895,70781,1958,2008,1758,26.5,295,184,11,109,74,1024,97
2018,36081070900,"Census Tract 709, Queens County, New York",1136,91,1045,402,878,73250,1958,2011,1832,27.3,240,165,14,77,113,1045,104
2019,36081070900,"Census Tract 709, Queens County, New York",1099,64,1035,462,1121,74907,1958,2012,1876,25.7,277,213,14,93,97,1035,78
2020,36081070900,"Census Tract 709, Queens County, New York",1128,57,1071,503,1312,76375,1955,2016,1832,31.8,318,192,10,70,185,1071,39
2012,36081071100,"Census Tract 711, Queens County, New York",2898,163,2735,1119,2139,54583,1952,2004,1416,39.1,655,770,0,154,195,2735,274
2013,36081071100,"Census Tract 711, Queens County, New York",2887,119,2768,1238,2433,42873,1954,2004,1450,50,646,912,0,113,213,2768,320
2014,36081071100,"Census Tract 711, Queens County, New York",2884,180,2704,1107,2238,41696,1954,2005,1458,50,550,793,0,92,222,2704,274
2015,36081071100,"Census Tract 711, Queens County, New York",2898,132,2766,1047,2044,37193,1948,2006,1446,48.4,481,761,56,87,143,2766,254
2016,36081071100,"Census Tract 711, Queens County, New York",2977,163,2814,1127,2353,36854,1948,2003,1463,47.8,527,705,69,108,245,2814,336
2017,36081071100,"Census Tract 711, Queens County, New York",3003,253,2750,1156,2672,56324,1950,2008,1651,33.2,597,687,61,144,264,2750,240
2018,36081071100,"Census Tract 711, Queens County, New York",2996,262,2734,1056,2253,75833,1951,2009,1672,27.7,613,626,88,155,187,2734,197
2019,36081071100,"Census Tract 711, Queens County, New York",3010,222,2788,1211,2560,80542,1953,2011,1761,27.4,743,766,95,179,171,2788,234
2020,36081071100,"Census Tract 711, Queens County, New York",3113,210,2903,1134,2371,99662,1956,2011,1995,25.7,767,687,39,189,187,2903,186
2012,36081071303,"Census Tract 713.03, Queens County, New York",2754,170,2584,1835,3440,68536,1952,2000,1433,23.1,1079,1305,33,253,215,2584,208
2013,36081071303,"Census Tract 713.03, Queens County, New York",2755,162,2593,1790,3472,72033,1952,2001,1580,23.9,1000,1264,38,205,261,2593,187
2014,36081071303,"Census Tract 713.03, Queens County, New York",2806,157,2649,1839,3625,74004,1950,2003,1621,23.3,1007,1190,35,225,384,2649,150
2015,36081071303,"Census Tract 713.03, Queens County, New York",2828,77,2751,1887,3667,84313,1951,2005,1642,21.8,1169,1297,49,190,350,2751,169
2016,36081071303,"Census Tract 713.03, Queens County, New York",2850,101,2749,1861,3618,87096,1950,2007,1720,22.6,1240,1283,86,154,338,2749,182
2017,36081071303,"Census Tract 713.03, Queens County, New York",2839,124,2715,1809,3894,88463,1949,2009,1752,23.8,1293,1256,60,184,319,2715,131
2018,36081071303,"Census Tract 713.03, Queens County, New York",2838,156,2682,1791,3632,86858,1950,2011,1762,24.5,1367,1213,73,189,291,2682,148
2019,36081071303,"Census Tract 713.03, Queens County, New York",2783,148,2635,1744,3577,86167,1952,2010,1761,25.6,1296,1156,74,208,275,2635,150
2020,36081071303,"Census Tract 713.03, Queens County, New York",2763,157,2606,1770,3649,85791,1950,2011,1774,27.8,1245,1034,124,205,377,2606,191
2012,36081071304,"Census Tract 713.04, Queens County, New York",3163,205,2958,1691,3770,34126,1946,2001,1191,34.8,783,1423,0,99,142,2958,435
2013,36081071304,"Census Tract 713.04, Queens County, New York",3166,205,2961,1747,3876,45960,1947,1999,1193,34.8,802,1276,56,154,197,2961,414
2014,36081071304,"Census Tract 713.04, Queens County, New York",3177,161,3016,1893,4201,46081,1950,2001,1305,35.2,759,1394,112,136,189,3016,555
2015,36081071304,"Census Tract 713.04, Queens County, New York",3216,178,3038,2029,4552,42292,1953,2002,1302,34.3,867,1457,137,236,150,3038,630
2016,36081071304,"Census Tract 713.04, Queens County, New York",3242,228,3014,2069,4852,50204,1948,2003,1339,32.1,911,1376,139,260,236,3014,645
2017,36081071304,"Census Tract 713.04, Queens County, New York",3283,252,3031,2126,4625,45234,1949,2003,1365,34.1,920,1430,132,274,181,3031,713
2018,36081071304,"Census Tract 713.04, Queens County, New York",3279,236,3043,2045,4230,45653,1951,2006,1629,34.2,943,1431,66,224,160,3043,687
2019,36081071304,"Census Tract 713.04, Queens County, New York",3302,207,3095,2044,4077,46885,1951,2008,1698,34.5,1030,1422,19,249,194,3095,594
2020,36081071304,"Census Tract 713.04, Queens County, New York",3089,258,2831,1594,3066,43929,1952,2008,1714,33.9,826,1118,0,131,191,2831,480
2012,36081071305,"Census Tract 713.05, Queens County, New York",2516,156,2360,1917,3938,74441,1962,2004,1730,29,1369,1098,83,473,217,2360,383
2013,36081071305,"Census Tract 713.05, Queens County, New York",2532,259,2273,1810,3834,70000,1962,2006,1822,31.1,1234,959,60,464,267,2273,435
2014,36081071305,"Census Tract 713.05, Queens County, New York",2513,222,2291,1823,4012,68886,1962,2008,1819,30,1237,938,28,454,359,2291,390
2015,36081071305,"Census Tract 713.05, Queens County, New York",2534,152,2382,1948,3953,68795,1962,2010,1800,30.6,1282,986,27,467,361,2382,337
2016,36081071305,"Census Tract 713.05, Queens County, New York",2521,146,2375,1914,4040,69866,1962,2011,1831,32.4,1270,1069,13,427,339,2375,289
2017,36081071305,"Census Tract 713.05, Queens County, New York",2560,173,2387,1918,4174,76474,1961,2011,1899,34.3,1309,985,32,458,409,2387,240
2018,36081071305,"Census Tract 713.05, Queens County, New York",2563,88,2475,1955,4153,81354,1961,2012,2060,33.7,1356,977,52,455,448,2475,170
2019,36081071305,"Census Tract 713.05, Queens County, New York",2591,143,2448,1970,3995,84722,1962,2013,2143,33,1450,1044,78,475,347,2448,179
2020,36081071305,"Census Tract 713.05, Queens County, New York",2541,122,2419,1973,4147,92621,1963,2015,2297,29.8,1607,1126,80,556,230,2419,111
2012,36081071306,"Census Tract 713.06, Queens County, New York",2897,153,2744,1907,4076,49032,1955,2003,1333,36.1,924,1244,36,323,287,2744,416
2013,36081071306,"Census Tract 713.06, Queens County, New York",2862,217,2645,1944,4170,49955,1953,2003,1330,36.2,961,1292,52,293,293,2645,398
2014,36081071306,"Census Tract 713.06, Queens County, New York",2884,175,2709,2020,4586,50833,1952,2006,1431,33.4,1030,1296,94,303,324,2709,428
2015,36081071306,"Census Tract 713.06, Queens County, New York",2922,121,2801,2247,5132,60878,1952,2008,1477,29.1,1145,1405,97,320,430,2801,466
2016,36081071306,"Census Tract 713.06, Queens County, New York",2916,147,2769,2166,4845,61712,1952,2007,1536,31,1057,1325,65,361,414,2769,461
2017,36081071306,"Census Tract 713.06, Queens County, New York",3017,93,2924,2119,4937,72043,1953,2009,1715,29,1290,1039,123,501,487,2924,264
2018,36081071306,"Census Tract 713.06, Queens County, New York",3093,32,3061,2063,4408,72683,1955,2010,1786,29.5,1242,935,117,531,440,3061,222
2019,36081071306,"Census Tract 713.06, Queens County, New York",3044,32,3012,2086,4246,79167,1956,2008,1760,28.3,1133,1178,70,425,370,3012,278
2020,36081071306,"Census Tract 713.06, Queens County, New York",3050,84,2966,2104,4734,87979,1960,2012,1899,29.6,1373,989,189,375,444,2966,192
2012,36081071600,"Census Tract 716, Queens County, New York",0,0,0,0,0,NA,NA,NA,NA,NA,0,0,0,0,0,0,0
2013,36081071600,"Census Tract 716, Queens County, New York",0,0,0,0,0,NA,NA,NA,NA,NA,0,0,0,0,0,0,0
2014,36081071600,"Census Tract 716, Queens County, New York",0,0,0,0,0,NA,NA,NA,NA,NA,0,0,0,0,0,0,0
2015,36081071600,"Census Tract 716, Queens County, New York",0,0,0,0,0,NA,NA,NA,NA,NA,0,0,0,0,0,0,0
2016,36081071600,"Census Tract 716, Queens County, New York",0,0,0,0,0,NA,NA,NA,NA,NA,0,0,0,0,0,0,0
2017,36081071600,"Census Tract 716, Queens County, New York",0,0,0,0,0,NA,NA,NA,NA,NA,0,0,0,0,0,0,0
2018,36081071600,"Census Tract 716, Queens County, New York",0,0,0,0,0,NA,NA,NA,NA,NA,0,0,0,0,0,0,0
2019,36081071600,"Census Tract 716, Queens County, New York",0,0,0,0,0,NA,NA,NA,NA,NA,0,0,0,0,0,0,0
2020,36081071600,"Census Tract 716, Queens County, New York",0,0,0,0,0,NA,NA,NA,NA,NA,0,0,0,0,0,0,0
2012,36081071701,"Census Tract 717.01, Queens County, New York",2610,188,2422,1466,2878,46369,1957,2002,1341,33.3,778,880,130,249,190,2422,340
2013,36081071701,"Census Tract 717.01, Queens County, New York",2591,161,2430,1574,3664,42857,1958,2002,1316,33.4,779,1092,121,202,159,2430,378
2014,36081071701,"Census Tract 717.01, Queens County, New York",2615,141,2474,1569,3384,47631,1957,2001,1357,33.8,764,1066,70,229,204,2474,367
2015,36081071701,"Census Tract 717.01, Queens County, New York",2676,190,2486,1494,3383,49803,1958,1999,1358,30.7,823,1029,68,214,183,2486,388
2016,36081071701,"Census Tract 717.01, Queens County, New York",2688,197,2491,1489,3396,47411,1958,1999,1357,36.6,815,1089,85,122,193,2491,451
2017,36081071701,"Census Tract 717.01, Queens County, New York",2743,184,2559,1433,3367,63304,1959,2000,1430,27.8,815,998,91,171,173,2559,416
2018,36081071701,"Census Tract 717.01, Queens County, New York",2709,233,2476,1342,2840,57183,1957,2001,1489,32.2,801,845,113,228,156,2476,381
2019,36081071701,"Census Tract 717.01, Queens County, New York",2714,283,2431,1217,2737,47303,1957,2008,1578,32.9,706,671,127,260,159,2431,433
2020,36081071701,"Census Tract 717.01, Queens County, New York",2538,206,2332,1176,2568,46875,1955,2012,1675,36.6,735,669,113,292,102,2332,368
2012,36081071702,"Census Tract 717.02, Queens County, New York",1954,0,1954,924,1640,34034,1967,2002,1206,38.5,426,446,33,227,197,1954,221
2013,36081071702,"Census Tract 717.02, Queens County, New York",1945,0,1945,931,1691,34547,1966,2002,1179,37.7,454,496,16,181,238,1945,214
2014,36081071702,"Census Tract 717.02, Queens County, New York",1915,32,1883,934,1499,32757,1967,2002,1171,40.6,493,460,17,146,311,1883,191
2015,36081071702,"Census Tract 717.02, Queens County, New York",1961,47,1914,957,1994,32841,1966,2004,1130,43.7,450,477,27,190,263,1914,292
2016,36081071702,"Census Tract 717.02, Queens County, New York",1963,53,1910,841,1555,26381,1966,2003,1227,50,439,427,35,220,159,1910,339
2017,36081071702,"Census Tract 717.02, Queens County, New York",1989,127,1862,824,1587,30476,1965,2002,1241,45.7,398,362,99,152,211,1862,237
2018,36081071702,"Census Tract 717.02, Queens County, New York",2071,132,1939,930,1785,36944,1967,2005,1433,49.3,464,395,94,224,171,1939,359
2019,36081071702,"Census Tract 717.02, Queens County, New York",2125,137,1988,887,1742,45733,1967,2007,1569,37.9,476,360,79,290,111,1988,381
2020,36081071702,"Census Tract 717.02, Queens County, New York",2036,111,1925,848,1717,58298,1968,2011,1729,38.3,450,324,54,253,101,1925,359
2012,36081071900,"Census Tract 719, Queens County, New York",1028,87,941,651,1405,28938,1954,1999,1115,43.3,198,434,25,82,85,941,211
2013,36081071900,"Census Tract 719, Queens County, New York",1019,66,953,662,1589,51439,1953,2002,1293,31.4,226,401,18,89,140,953,183
2014,36081071900,"Census Tract 719, Queens County, New York",1012,93,919,619,1500,49271,1950,2003,1368,35.6,185,392,20,84,111,919,195
2015,36081071900,"Census Tract 719, Queens County, New York",1044,45,999,700,1690,49231,1954,2005,1424,32.3,290,460,44,81,114,999,207
2016,36081071900,"Census Tract 719, Queens County, New York",1037,70,967,675,1452,41466,1953,2005,1409,38.6,252,445,42,70,120,967,222
2017,36081071900,"Census Tract 719, Queens County, New York",1059,89,970,702,1575,35400,1955,2006,1533,46.5,272,414,59,82,139,970,255
2018,36081071900,"Census Tract 719, Queens County, New York",1073,89,984,693,1545,32125,1956,2005,1643,47.9,297,412,54,114,96,984,235
2019,36081071900,"Census Tract 719, Queens County, New York",1088,81,1007,698,1581,34125,1956,2004,1598,46.9,309,413,53,115,91,1007,190
2020,36081071900,"Census Tract 719, Queens County, New York",1077,61,1016,659,1618,30917,1955,2005,1553,45.7,279,363,23,112,116,1016,163
2012,36081072100,"Census Tract 721, Queens County, New York",2360,221,2139,1188,2459,41932,1953,2002,1168,35.2,536,838,13,110,203,2139,348
2013,36081072100,"Census Tract 721, Queens County, New York",2384,196,2188,1297,2588,43211,1954,2002,1151,31.5,642,847,25,160,249,2188,286
2014,36081072100,"Census Tract 721, Queens County, New York",2352,199,2153,1238,2417,41000,1953,2002,1114,32,534,792,0,186,260,2153,204
2015,36081072100,"Census Tract 721, Queens County, New York",2380,212,2168,1188,2385,35833,1952,2003,1063,28.5,441,800,0,124,264,2168,295
2016,36081072100,"Census Tract 721, Queens County, New York",2370,246,2124,1093,2060,36822,1950,2006,1126,28.8,435,624,0,123,307,2124,412
2017,36081072100,"Census Tract 721, Queens County, New York",2385,325,2060,981,1842,37097,1949,2008,1163,28.7,419,616,0,87,243,2060,431
2018,36081072100,"Census Tract 721, Queens County, New York",2391,291,2100,1011,2112,39632,1948,2007,1225,28.8,467,629,28,96,248,2100,444
2019,36081072100,"Census Tract 721, Queens County, New York",2442,358,2084,958,1918,32321,1948,2009,1324,30.7,499,606,28,94,218,2084,552
2020,36081072100,"Census Tract 721, Queens County, New York",2333,229,2104,896,1765,NA,1948,2007,1318,47,449,428,26,91,335,2104,440
2012,36081072300,"Census Tract 723, Queens County, New York",872,33,839,113,229,79840,1939,2003,1793,27.6,93,102,0,6,5,839,0
2013,36081072300,"Census Tract 723, Queens County, New York",875,141,734,108,197,82000,1939,2003,1788,28.1,86,97,0,6,5,734,0
2014,36081072300,"Census Tract 723, Queens County, New York",866,164,702,97,205,81655,1939,2006,1838,26.6,74,58,9,16,14,702,15
2015,36081072300,"Census Tract 723, Queens County, New York",875,163,712,65,211,NA,1939,2010,2333,20,44,34,7,13,11,712,27
2016,36081072300,"Census Tract 723, Queens County, New York",881,136,745,89,304,173150,1939,2010,2861,19,64,56,7,12,14,745,66
2017,36081072300,"Census Tract 723, Queens County, New York",906,138,768,80,226,NA,1939,2011,3071,25.5,46,52,8,7,13,768,78
2018,36081072300,"Census Tract 723, Queens County, New York",898,59,839,74,216,NA,0,2010,3107,25.7,43,44,8,8,14,839,76
2019,36081072300,"Census Tract 723, Queens County, New York",902,68,834,68,218,185333,0,2013,2917,22.5,52,42,13,7,6,834,109
2020,36081072300,"Census Tract 723, Queens County, New York",845,50,795,83,259,193942,1940,2013,3500,21,53,43,27,7,6,795,90
2012,36081072900,"Census Tract 729, Queens County, New York",509,43,466,106,219,53659,1939,2003,1422,30.2,66,85,0,21,0,466,42
2013,36081072900,"Census Tract 729, Queens County, New York",492,40,452,119,275,55042,1939,2004,1367,30.1,74,94,0,25,0,452,55
2014,36081072900,"Census Tract 729, Queens County, New York",477,64,413,98,227,53816,1942,2008,1447,30.9,73,76,0,22,0,413,60
2015,36081072900,"Census Tract 729, Queens County, New York",507,96,411,96,219,54118,1944,2007,1500,30,75,70,0,22,4,411,29
2016,36081072900,"Census Tract 729, Queens County, New York",509,81,428,94,213,57143,1942,2009,1495,28.8,70,60,0,21,13,428,28
2017,36081072900,"Census Tract 729, Queens County, New York",517,64,453,89,158,54750,1944,2011,1371,27,49,56,0,13,20,453,31
2018,36081072900,"Census Tract 729, Queens County, New York",520,56,464,75,151,63750,1944,2011,1417,25.9,44,38,0,14,17,464,20
2019,36081072900,"Census Tract 729, Queens County, New York",524,53,471,59,104,63854,1944,2011,1446,23.9,36,31,0,10,14,471,11
2020,36081072900,"Census Tract 729, Queens County, New York",555,60,495,65,118,67396,1941,2011,1470,22.9,43,36,0,9,15,495,7
2012,36081073100,"Census Tract 731, Queens County, New York",555,28,527,147,283,81863,1947,2006,1645,21.7,50,104,0,0,43,527,14
2013,36081073100,"Census Tract 731, Queens County, New York",548,38,510,116,202,81319,1953,2009,1522,23.4,61,63,0,0,53,510,19
2014,36081073100,"Census Tract 731, Queens County, New York",584,34,550,147,290,88162,1946,2011,1669,24.2,98,111,6,14,16,550,57
2015,36081073100,"Census Tract 731, Queens County, New York",585,57,528,152,294,81250,1946,2011,1696,25.5,86,106,4,11,31,528,52
2016,36081073100,"Census Tract 731, Queens County, New York",586,18,568,139,275,89750,1946,2012,1900,24.3,90,96,5,16,17,568,38
2017,36081073100,"Census Tract 731, Queens County, New York",593,54,539,142,287,71250,1952,2013,1847,27.7,86,93,5,15,24,539,32
2018,36081073100,"Census Tract 731, Queens County, New York",607,51,556,178,348,71111,1943,2014,1743,30.2,100,118,6,25,33,556,29
2019,36081073100,"Census Tract 731, Queens County, New York",603,59,544,154,345,73523,0,2016,1833,32,91,111,0,15,32,544,6
2020,36081073100,"Census Tract 731, Queens County, New York",573,43,530,152,368,82083,0,NA,1863,23.2,109,109,0,15,26,530,6
2012,36081073700,"Census Tract 737, Queens County, New York",1170,118,1052,582,976,82583,1944,2004,1586,25.3,379,316,9,133,53,1052,36
2013,36081073700,"Census Tract 737, Queens County, New York",1200,142,1058,614,981,80278,1946,2006,1693,28.4,411,375,8,129,68,1058,35
2014,36081073700,"Census Tract 737, Queens County, New York",1204,183,1021,630,980,62813,1946,2006,1647,28.9,391,441,0,79,72,1021,59
2015,36081073700,"Census Tract 737, Queens County, New York",1169,131,1038,677,1047,58594,1944,2009,1595,33,436,471,0,114,63,1038,78
2016,36081073700,"Census Tract 737, Queens County, New York",1180,134,1046,634,977,60179,1943,2011,1640,31.6,407,438,0,99,59,1046,65
2017,36081073700,"Census Tract 737, Queens County, New York",1199,148,1051,656,1113,61824,1944,2011,1736,28.9,433,472,0,100,68,1051,37
2018,36081073700,"Census Tract 737, Queens County, New York",1198,119,1079,608,1062,68250,1944,2012,1686,27.4,423,407,0,103,69,1079,61
2019,36081073700,"Census Tract 737, Queens County, New York",1168,123,1045,612,1152,80658,1945,2013,1777,26.4,466,365,0,150,72,1045,63
2020,36081073700,"Census Tract 737, Queens County, New York",1141,95,1046,594,1156,89231,1946,2015,1920,24.3,474,388,0,137,46,1046,65
2012,36081073900,"Census Tract 739, Queens County, New York",2723,30,2693,1394,2570,80076,1944,2002,1657,24.9,752,991,137,101,165,2693,134
2013,36081073900,"Census Tract 739, Queens County, New York",2745,28,2717,1376,2399,75000,1944,2002,1675,25.9,759,934,128,149,151,2717,112
2014,36081073900,"Census Tract 739, Queens County, New York",2749,28,2721,1459,2641,73083,1945,2004,1749,27.7,849,908,105,255,175,2721,172
2015,36081073900,"Census Tract 739, Queens County, New York",2833,61,2772,1479,2524,67951,1945,2004,1685,28.4,849,865,107,252,238,2772,174
2016,36081073900,"Census Tract 739, Queens County, New York",2839,65,2774,1529,2896,69187,1944,2005,1724,28.2,877,797,166,260,300,2774,221
2017,36081073900,"Census Tract 739, Queens County, New York",2881,68,2813,1457,2906,71815,1945,2010,1799,28.7,938,742,59,280,312,2813,269
2018,36081073900,"Census Tract 739, Queens County, New York",2883,65,2818,1457,2933,91862,1947,2011,1815,22,1085,755,90,232,329,2818,274
2019,36081073900,"Census Tract 739, Queens County, New York",2879,218,2661,1315,2575,94097,1947,2012,1858,23.4,987,705,77,198,294,2661,209
2020,36081073900,"Census Tract 739, Queens County, New York",2809,172,2637,1395,2875,90820,1945,2011,1836,23.8,1055,905,131,132,210,2637,216
2012,36081074100,"Census Tract 741, Queens County, New York",1647,159,1488,550,816,30987,1947,2000,1245,50,247,403,9,38,75,1488,88
2013,36081074100,"Census Tract 741, Queens County, New York",1633,116,1517,540,885,27446,1946,2002,1302,50,286,400,9,48,58,1517,98
2014,36081074100,"Census Tract 741, Queens County, New York",1649,107,1542,569,970,33242,1949,2003,1310,50,279,391,8,58,112,1542,92
2015,36081074100,"Census Tract 741, Queens County, New York",1669,122,1547,552,924,40364,1950,2003,1366,46.3,288,366,9,68,109,1547,104
2016,36081074100,"Census Tract 741, Queens County, New York",1670,83,1587,581,984,44150,1951,2005,1494,35,326,394,9,57,121,1587,162
2017,36081074100,"Census Tract 741, Queens County, New York",1696,56,1640,581,1050,51620,1952,2009,1547,32.7,355,379,0,87,115,1640,183
2018,36081074100,"Census Tract 741, Queens County, New York",1665,71,1594,558,1015,61250,1953,2009,1645,31.8,327,380,0,66,112,1594,138
2019,36081074100,"Census Tract 741, Queens County, New York",1666,78,1588,513,969,64010,1951,2011,1689,31.7,360,353,10,84,51,1588,163
2020,36081074100,"Census Tract 741, Queens County, New York",1657,60,1597,614,1239,69583,1951,2013,1703,28.8,377,360,10,73,158,1597,151
2012,36081074300,"Census Tract 743, Queens County, New York",1899,103,1796,952,2239,38448,1952,2002,1133,33.9,375,566,7,168,211,1796,307
2013,36081074300,"Census Tract 743, Queens County, New York",1943,94,1849,909,2099,33375,1953,2003,1156,34.5,389,480,13,231,174,1849,247
2014,36081074300,"Census Tract 743, Queens County, New York",1988,99,1889,917,2196,42979,1953,2004,1207,39.8,364,500,15,183,208,1889,229
2015,36081074300,"Census Tract 743, Queens County, New York",2002,169,1833,869,1974,46654,1954,2007,1320,33.3,358,375,15,211,237,1833,197
2016,36081074300,"Census Tract 743, Queens County, New York",1997,168,1829,868,1988,40000,1955,2008,1219,40.9,358,439,49,158,169,1829,226
2017,36081074300,"Census Tract 743, Queens County, New York",2002,212,1790,810,1789,38482,1955,2011,1236,39.8,300,420,42,167,133,1790,181
2018,36081074300,"Census Tract 743, Queens County, New York",2012,201,1811,897,2043,42435,1952,2012,1313,37.1,364,497,31,128,184,1811,215
2019,36081074300,"Census Tract 743, Queens County, New York",1999,259,1740,861,1932,43207,1953,2012,1330,33.1,367,462,31,125,169,1740,204
2020,36081074300,"Census Tract 743, Queens County, New York",1941,168,1773,946,2255,55137,1948,2012,1405,40.9,387,548,44,170,143,1773,197
2012,36081074500,"Census Tract 745, Queens County, New York",1596,33,1563,1273,3064,29485,1958,2001,967,32.8,405,801,120,82,230,1563,311
2013,36081074500,"Census Tract 745, Queens County, New York",1602,85,1517,1255,3053,29120,1957,2001,980,34.3,411,754,142,85,221,1517,367
2014,36081074500,"Census Tract 745, Queens County, New York",1612,83,1529,1262,3071,30458,1957,2004,1082,33.3,424,690,127,143,248,1529,374
2015,36081074500,"Census Tract 745, Queens County, New York",1619,114,1505,1209,2878,29515,1957,2004,1096,32.8,412,678,106,161,217,1505,351
2016,36081074500,"Census Tract 745, Queens County, New York",1617,122,1495,1228,3224,32622,1958,2005,1168,34.1,471,653,106,178,260,1495,401
2017,36081074500,"Census Tract 745, Queens County, New York",1636,139,1497,1267,3481,39728,1959,2005,1145,30.6,471,610,95,199,340,1497,349
2018,36081074500,"Census Tract 745, Queens County, New York",1635,51,1584,1334,3526,42365,1960,2004,1312,30.6,541,635,79,237,364,1584,290
2019,36081074500,"Census Tract 745, Queens County, New York",1638,118,1520,1183,3027,39208,1961,2006,1369,32.1,510,668,108,183,229,1520,299
2020,36081074500,"Census Tract 745, Queens County, New York",1588,50,1538,1199,3096,54943,1964,2005,1416,27.3,556,669,170,138,213,1538,295
2012,36081074700,"Census Tract 747, Queens County, New York",1416,177,1239,464,1286,43500,1956,2004,1324,36.5,219,79,45,221,63,1239,104
2013,36081074700,"Census Tract 747, Queens County, New York",1421,131,1290,584,1395,43534,1956,2006,1392,37.1,223,173,46,214,102,1290,138
2014,36081074700,"Census Tract 747, Queens County, New York",1404,142,1262,619,1473,46950,1956,2005,1355,36.4,249,225,39,211,88,1262,98
2015,36081074700,"Census Tract 747, Queens County, New York",1434,70,1364,699,1839,45650,1956,2006,1379,36.9,246,223,46,230,104,1364,131
2016,36081074700,"Census Tract 747, Queens County, New York",1426,76,1350,612,1370,48068,1955,2007,1263,35,217,220,7,180,147,1350,142
2017,36081074700,"Census Tract 747, Queens County, New York",1402,36,1366,725,2002,57989,1958,2008,1508,37.1,209,241,0,198,250,1366,121
2018,36081074700,"Census Tract 747, Queens County, New York",1389,98,1291,665,2055,69320,1961,2011,1616,33,252,160,0,205,265,1291,119
2019,36081074700,"Census Tract 747, Queens County, New York",1358,74,1284,659,2074,71390,1958,2011,1588,31.3,267,144,0,212,262,1284,141
2020,36081074700,"Census Tract 747, Queens County, New York",1307,75,1232,550,1613,88581,1959,2013,1658,25.7,274,112,10,203,202,1232,45
2012,36081074900,"Census Tract 749, Queens County, New York",580,64,516,76,206,96100,1939,2005,1750,22.1,65,56,0,8,0,516,3
2013,36081074900,"Census Tract 749, Queens County, New York",566,22,544,80,248,96518,1939,2004,1958,21.7,66,63,0,12,0,544,11
2014,36081074900,"Census Tract 749, Queens County, New York",554,36,518,67,216,117917,1939,2004,1375,17.4,51,45,0,16,0,518,8
2015,36081074900,"Census Tract 749, Queens County, New York",587,47,540,66,163,160167,1939,2011,NA,18.2,60,54,0,5,0,540,10
2016,36081074900,"Census Tract 749, Queens County, New York",585,46,539,102,288,102500,1945,2014,NA,18,84,86,0,10,0,539,3
2017,36081074900,"Census Tract 749, Queens County, New York",590,45,545,112,329,NA,1951,2016,2694,14.8,90,87,0,11,14,545,2
2018,36081074900,"Census Tract 749, Queens County, New York",585,51,534,105,328,NA,0,2015,3083,24.5,88,92,0,10,3,534,0
2019,36081074900,"Census Tract 749, Queens County, New York",596,61,535,141,420,NA,0,2016,2823,18.1,122,123,0,12,6,535,0
2020,36081074900,"Census Tract 749, Queens County, New York",569,67,502,131,431,167188,0,2017,3501,26.1,115,86,0,44,1,502,3
2012,36081075701,"Census Tract 757.01, Queens County, New York",2746,294,2452,985,1817,54375,1957,2003,1676,39.4,450,709,0,182,94,2452,154
2013,36081075701,"Census Tract 757.01, Queens County, New York",2770,278,2492,1027,1913,43828,1955,2003,1653,43.8,473,756,18,154,99,2492,198
2014,36081075701,"Census Tract 757.01, Queens County, New York",2766,207,2559,1050,2084,63056,1958,2006,1766,38.9,647,761,18,166,105,2559,137
2015,36081075701,"Census Tract 757.01, Queens County, New York",2777,126,2651,1215,2328,52153,1963,2009,1640,34.8,830,774,34,270,137,2651,213
2016,36081075701,"Census Tract 757.01, Queens County, New York",2787,105,2682,1218,2474,53421,1963,2011,1707,36.2,988,692,39,311,164,2682,310
2017,36081075701,"Census Tract 757.01, Queens County, New York",2806,128,2678,1291,2594,60847,1959,2011,1758,34.5,1013,709,71,358,146,2678,323
2018,36081075701,"Census Tract 757.01, Queens County, New York",2819,153,2666,1225,2381,68083,1958,2012,1856,32.9,926,602,62,331,181,2666,274
2019,36081075701,"Census Tract 757.01, Queens County, New York",2776,189,2587,1177,2230,64063,1956,2012,1853,33,829,520,65,323,193,2587,285
2020,36081075701,"Census Tract 757.01, Queens County, New York",2573,160,2413,929,1506,46360,1956,2012,1881,40.4,557,491,60,155,149,2413,170
2012,36081075702,"Census Tract 757.02, Queens County, New York",2420,162,2258,1088,1962,59097,1949,2000,1374,28.3,622,705,50,191,142,2258,175
2013,36081075702,"Census Tract 757.02, Queens County, New York",2426,153,2273,1057,1836,59291,1949,1998,1456,29,665,718,49,168,122,2273,149
2014,36081075702,"Census Tract 757.02, Queens County, New York",2362,92,2270,1093,1859,58951,1949,2001,1461,33.6,738,662,56,204,171,2270,206
2015,36081075702,"Census Tract 757.02, Queens County, New York",2372,167,2205,1001,1863,67188,1947,2001,1524,27.3,719,627,59,210,105,2205,187
2016,36081075702,"Census Tract 757.02, Queens County, New York",2361,291,2070,784,1490,57717,1949,2001,1435,29.4,463,485,62,203,33,2070,203
2017,36081075702,"Census Tract 757.02, Queens County, New York",2377,341,2036,748,1474,57542,1952,2010,1647,31.3,506,517,0,202,18,2036,148
2018,36081075702,"Census Tract 757.02, Queens County, New York",2355,272,2083,695,1459,58428,1950,2011,1701,36.4,442,475,0,196,18,2083,208
2019,36081075702,"Census Tract 757.02, Queens County, New York",2446,270,2176,699,1524,58237,1950,2013,1807,36.4,479,477,0,216,0,2176,166
2020,36081075702,"Census Tract 757.02, Queens County, New York",2527,196,2331,638,1364,62206,1957,2012,1748,27.2,475,404,0,227,0,2331,273
2012,36081076901,"Census Tract 769.01, Queens County, New York",2292,284,2008,940,2013,58913,1941,2001,1504,32.5,497,618,15,152,155,2008,164
2013,36081076901,"Census Tract 769.01, Queens County, New York",2305,298,2007,1035,2147,74073,1942,2005,1580,31.2,703,642,30,232,131,2007,131
2014,36081076901,"Census Tract 769.01, Queens County, New York",2303,278,2025,961,2039,79583,1940,2007,1684,28.2,702,593,39,236,93,2025,179
2015,36081076901,"Census Tract 769.01, Queens County, New York",2329,309,2020,908,1668,74667,1939,2010,1672,28.2,665,526,36,214,132,2020,140
2016,36081076901,"Census Tract 769.01, Queens County, New York",2330,252,2078,1026,1794,74331,1939,2011,1678,27.6,788,589,64,212,161,2078,113
2017,36081076901,"Census Tract 769.01, Queens County, New York",2296,221,2075,984,1668,73793,1939,2011,1690,28.2,729,624,62,172,126,2075,114
2018,36081076901,"Census Tract 769.01, Queens County, New York",2290,263,2027,932,1628,78091,0,2011,1788,26.9,525,565,69,173,125,2027,170
2019,36081076901,"Census Tract 769.01, Queens County, New York",2299,263,2036,1009,1887,83309,0,2011,1822,25.9,592,636,78,162,133,2036,130
2020,36081076901,"Census Tract 769.01, Queens County, New York",2394,216,2178,1021,1890,83309,0,2013,1833,24.7,611,601,72,206,212,2178,184
2012,36081076902,"Census Tract 769.02, Queens County, New York",718,44,674,523,1118,72862,1944,2004,1638,24.6,278,286,12,101,95,674,36
2013,36081076902,"Census Tract 769.02, Queens County, New York",713,25,688,538,1116,74056,1939,2004,1611,24.4,261,284,16,86,126,688,40
2014,36081076902,"Census Tract 769.02, Queens County, New York",709,24,685,512,1049,79712,1949,2007,1658,23.9,308,308,7,102,66,685,37
2015,36081076902,"Census Tract 769.02, Queens County, New York",711,50,661,509,1103,80848,1948,2010,1684,24.2,310,322,6,90,56,661,31
2016,36081076902,"Census Tract 769.02, Queens County, New York",709,48,661,517,1091,75221,1947,2011,1735,27.8,330,284,7,96,88,661,47
2017,36081076902,"Census Tract 769.02, Queens County, New York",703,64,639,494,863,66875,1944,2012,1727,29.8,287,284,7,87,116,639,58
2018,36081076902,"Census Tract 769.02, Queens County, New York",710,71,639,513,910,59438,1943,2011,1740,33,282,274,6,62,160,639,60
2019,36081076902,"Census Tract 769.02, Queens County, New York",708,112,596,475,866,59336,1941,2012,1785,33.4,247,240,3,59,162,596,67
2020,36081076902,"Census Tract 769.02, Queens County, New York",662,81,581,452,774,74167,0,2014,1813,27.5,289,235,5,63,139,581,62
2012,36081077300,"Census Tract 773, Queens County, New York",1204,62,1142,568,1076,48889,1939,1997,1109,30.1,305,424,48,6,90,1142,102
2013,36081077300,"Census Tract 773, Queens County, New York",1210,70,1140,504,731,53250,1939,2001,1160,27,291,383,40,11,70,1140,103
2014,36081077300,"Census Tract 773, Queens County, New York",1204,111,1093,425,598,53875,1939,2004,1198,29.1,199,302,44,12,67,1093,88
2015,36081077300,"Census Tract 773, Queens County, New York",1212,131,1081,419,620,62625,1939,2005,1194,26.9,225,262,44,19,94,1081,82
2016,36081077300,"Census Tract 773, Queens County, New York",1206,153,1053,475,837,72925,1939,2009,1270,23.9,268,254,33,34,154,1053,89
2017,36081077300,"Census Tract 773, Queens County, New York",1203,131,1072,444,853,54643,1939,2010,1313,26.2,236,267,16,34,127,1072,78
2018,36081077300,"Census Tract 773, Queens County, New York",1163,125,1038,439,936,59321,0,2011,1336,28.7,231,248,16,43,125,1038,65
2019,36081077300,"Census Tract 773, Queens County, New York",1168,136,1032,469,976,58839,0,2012,1383,29.9,261,264,15,43,141,1032,52
2020,36081077300,"Census Tract 773, Queens County, New York",1137,113,1024,403,867,63906,0,2014,1495,28,249,227,18,62,91,1024,47
2012,36081077500,"Census Tract 775, Queens County, New York",1039,157,882,508,1117,34938,1939,2001,1199,39.5,247,272,24,77,148,882,80
2013,36081077500,"Census Tract 775, Queens County, New York",1031,169,862,495,843,35625,1939,2003,1319,36.9,240,316,19,56,114,862,54
2014,36081077500,"Census Tract 775, Queens County, New York",1048,187,861,519,956,37212,1939,2004,1327,37.7,225,348,11,37,123,861,44
2015,36081077500,"Census Tract 775, Queens County, New York",1053,193,860,535,963,41705,1944,2006,1347,38,220,346,60,28,101,860,94
2016,36081077500,"Census Tract 775, Queens County, New York",1067,158,909,639,1187,49125,1944,2007,1389,37.6,284,414,72,28,125,909,125
2017,36081077500,"Census Tract 775, Queens County, New York",1080,118,962,670,1138,62661,1942,2009,1399,33.3,324,449,58,19,144,962,132
2018,36081077500,"Census Tract 775, Queens County, New York",1069,110,959,616,1009,66333,0,2011,1435,29.5,317,410,55,20,131,959,124
2019,36081077500,"Census Tract 775, Queens County, New York",1060,167,893,569,988,71595,0,2012,1458,24.6,295,359,53,19,138,893,135
2020,36081077500,"Census Tract 775, Queens County, New York",1115,128,987,705,1173,71406,0,2012,1510,23.5,434,489,38,11,151,987,115
2012,36081077902,"Census Tract 779.02, Queens County, New York",1771,217,1554,510,1404,65104,1949,2004,1599,25.7,285,365,34,48,63,1554,133
2013,36081077902,"Census Tract 779.02, Queens County, New York",1753,208,1545,432,1275,51250,1951,2005,1595,25.2,245,293,32,57,50,1545,71
2014,36081077902,"Census Tract 779.02, Queens County, New York",1722,148,1574,492,1529,70978,1952,2007,1467,23.8,247,340,34,45,73,1574,80
2015,36081077902,"Census Tract 779.02, Queens County, New York",1725,89,1636,522,1730,65174,1949,2008,1497,26.7,297,387,38,35,62,1636,142
2016,36081077902,"Census Tract 779.02, Queens County, New York",1748,137,1611,594,1944,66000,1949,2010,1553,30.5,346,441,31,73,49,1611,181
2017,36081077902,"Census Tract 779.02, Queens County, New York",1776,170,1606,544,1838,65500,1950,2011,1665,35.5,339,435,5,85,19,1606,161
2018,36081077902,"Census Tract 779.02, Queens County, New York",1776,183,1593,578,1856,64797,1950,2011,1607,31.7,321,405,7,99,20,1593,165
2019,36081077902,"Census Tract 779.02, Queens County, New York",1768,197,1571,537,1715,64152,1949,2011,1811,33.4,330,388,19,88,0,1571,187
2020,36081077902,"Census Tract 779.02, Queens County, New York",1688,169,1519,469,1518,62788,1955,2012,1819,31.4,299,291,12,126,0,1519,178
2012,36081077903,"Census Tract 779.03, Queens County, New York",1193,107,1086,532,1412,37500,1948,2001,1178,33.1,183,219,31,115,154,1086,66
2013,36081077903,"Census Tract 779.03, Queens County, New York",1199,115,1084,512,1386,47045,1946,2001,1212,33.8,151,219,45,33,192,1084,57
2014,36081077903,"Census Tract 779.03, Queens County, New York",1211,105,1106,567,1605,49940,1946,2006,1244,29.7,165,267,56,97,108,1106,97
2015,36081077903,"Census Tract 779.03, Queens County, New York",1210,114,1096,561,1660,50506,1946,2005,1226,28.8,145,286,46,94,106,1096,117
2016,36081077903,"Census Tract 779.03, Queens County, New York",1219,79,1140,510,1386,47679,1947,2009,1283,37.1,154,226,48,74,155,1140,147
2017,36081077903,"Census Tract 779.03, Queens County, New York",1237,58,1179,516,1519,50880,1945,2011,1346,36.7,198,246,44,76,99,1179,151
2018,36081077903,"Census Tract 779.03, Queens County, New York",1219,57,1162,560,1636,54397,1946,2011,1348,27.6,216,222,12,112,166,1162,153
2019,36081077903,"Census Tract 779.03, Queens County, New York",1216,71,1145,575,1619,63438,1945,2012,1419,26.6,240,241,4,74,216,1145,131
2020,36081077903,"Census Tract 779.03, Queens County, New York",1160,34,1126,572,1619,62679,1947,2012,1504,38.1,234,186,16,139,208,1126,129
2012,36081077904,"Census Tract 779.04, Queens County, New York",2299,173,2126,1196,3438,61194,1953,2002,1355,26.3,591,644,137,179,236,2126,318
2013,36081077904,"Census Tract 779.04, Queens County, New York",2291,110,2181,1185,3687,63617,1954,2004,1524,26.2,571,665,110,200,210,2181,302
2014,36081077904,"Census Tract 779.04, Queens County, New York",2294,133,2161,1187,3525,62861,1954,2005,1580,27.9,565,667,111,181,228,2161,249
2015,36081077904,"Census Tract 779.04, Queens County, New York",2264,69,2195,1130,3451,54847,1953,2008,1630,30,425,666,47,207,210,2195,229
2016,36081077904,"Census Tract 779.04, Queens County, New York",2261,175,2086,1087,3068,50647,1956,2010,1697,35.7,359,568,30,296,193,2086,180
2017,36081077904,"Census Tract 779.04, Queens County, New York",2237,167,2070,1037,3084,54978,1957,2010,1741,37.2,335,555,14,193,289,2070,128
2018,36081077904,"Census Tract 779.04, Queens County, New York",2232,176,2056,953,2533,54414,1957,2011,1717,38.6,334,436,15,210,307,2056,106
2019,36081077904,"Census Tract 779.04, Queens County, New York",2251,208,2043,978,2688,75313,1956,2012,1698,29.5,327,452,16,246,241,2043,119
2020,36081077904,"Census Tract 779.04, Queens County, New York",2174,202,1972,965,2854,94119,1960,2013,1792,22.4,289,516,18,202,221,1972,124
2012,36081077905,"Census Tract 779.05, Queens County, New York",1284,37,1247,285,554,31179,1954,2001,1346,40.9,185,215,27,31,12,1247,116
2013,36081077905,"Census Tract 779.05, Queens County, New York",1254,78,1176,282,521,34797,1956,2002,1466,45.2,206,175,30,68,9,1176,119
2014,36081077905,"Census Tract 779.05, Queens County, New York",1217,105,1112,235,457,28068,1955,2001,1389,48.6,171,140,30,46,8,1112,104
2015,36081077905,"Census Tract 779.05, Queens County, New York",1214,100,1114,276,625,29524,1949,2001,1449,45,190,122,40,45,58,1114,100
2016,36081077905,"Census Tract 779.05, Queens County, New York",1226,173,1053,285,621,27917,1947,1989,1350,50,182,112,46,32,85,1053,109
2017,36081077905,"Census Tract 779.05, Queens County, New York",1244,147,1097,271,589,40795,1947,1996,1325,39.8,148,113,31,36,81,1097,58
2018,36081077905,"Census Tract 779.05, Queens County, New York",1222,144,1078,253,598,50045,1946,1989,1283,37.2,135,118,33,21,71,1078,46
2019,36081077905,"Census Tract 779.05, Queens County, New York",1234,113,1121,295,751,65083,1948,2011,1543,36.2,138,92,48,26,114,1121,39
2020,36081077905,"Census Tract 779.05, Queens County, New York",1385,148,1237,285,579,NA,1946,1997,1302,41.6,137,76,98,52,55,1237,31
2012,36081077906,"Census Tract 779.06, Queens County, New York",1524,262,1262,700,1505,41653,1955,2002,1181,38.8,156,423,34,80,134,1262,206
2013,36081077906,"Census Tract 779.06, Queens County, New York",1516,209,1307,693,1717,49320,1952,2003,1200,35.2,278,421,31,39,166,1307,202
2014,36081077906,"Census Tract 779.06, Queens County, New York",1470,210,1260,669,1586,49080,1954,2005,1261,33.6,251,423,33,92,96,1260,187
2015,36081077906,"Census Tract 779.06, Queens County, New York",1466,231,1235,605,1654,60250,1953,2007,1507,29.6,279,367,48,107,65,1235,125
2016,36081077906,"Census Tract 779.06, Queens County, New York",1443,85,1358,590,1752,61221,1953,2010,1660,29.6,316,387,43,70,90,1358,175
2017,36081077906,"Census Tract 779.06, Queens County, New York",1421,104,1317,510,1510,58864,1953,2010,1597,32.2,258,372,18,77,43,1317,158
2018,36081077906,"Census Tract 779.06, Queens County, New York",1417,127,1290,446,1315,56563,1956,2008,1368,28.7,214,308,19,95,24,1290,145
2019,36081077906,"Census Tract 779.06, Queens County, New York",1454,171,1283,439,1281,60368,1956,2008,1331,33.4,202,281,19,81,58,1283,153
2020,36081077906,"Census Tract 779.06, Queens County, New York",1439,182,1257,496,1518,60833,1957,2011,1363,35.8,171,297,54,64,81,1257,153
2012,36081077907,"Census Tract 779.07, Queens County, New York",1053,0,1053,721,2221,52614,1959,2002,1264,31.8,261,454,109,38,103,1053,182
2013,36081077907,"Census Tract 779.07, Queens County, New York",1034,0,1034,762,2331,39615,1958,2002,1236,40.6,202,440,81,41,147,1034,238
2014,36081077907,"Census Tract 779.07, Queens County, New York",1032,33,999,769,2168,36875,1957,2004,1302,42.1,225,448,75,51,166,999,204
2015,36081077907,"Census Tract 779.07, Queens County, New York",1038,88,950,734,2189,41698,1958,2006,1351,38.6,297,461,45,67,130,950,164
2016,36081077907,"Census Tract 779.07, Queens County, New York",1024,81,943,710,2098,41755,1956,2007,1427,39.7,281,449,47,56,131,943,136
2017,36081077907,"Census Tract 779.07, Queens County, New York",1037,128,909,708,2264,42311,1952,2009,1423,37.6,260,463,29,29,144,909,162
2018,36081077907,"Census Tract 779.07, Queens County, New York",1063,154,909,702,2384,45081,1952,2012,1587,40.1,294,462,34,19,171,909,167
2019,36081077907,"Census Tract 779.07, Queens County, New York",1059,116,943,711,2547,46875,1954,2013,1698,35.3,346,428,80,41,156,943,193
2020,36081077907,"Census Tract 779.07, Queens County, New York",1030,63,967,740,2800,36895,1955,2014,1723,34.6,313,379,78,39,258,967,227
2012,36081077908,"Census Tract 779.08, Queens County, New York",1432,116,1316,1175,3238,43732,1984,2003,1364,30.2,365,277,309,326,295,1316,274
2013,36081077908,"Census Tract 779.08, Queens County, New York",1430,99,1331,1207,3445,55799,1978,2004,1341,29.2,467,274,300,278,304,1331,207
2014,36081077908,"Census Tract 779.08, Queens County, New York",1428,92,1336,1248,3703,47179,1977,2005,1393,38.6,466,306,306,345,228,1336,238
2015,36081077908,"Census Tract 779.08, Queens County, New York",1455,46,1409,1298,3745,52445,1967,2005,1356,37.5,537,387,422,203,215,1409,194
2016,36081077908,"Census Tract 779.08, Queens County, New York",1451,115,1336,1238,3614,50625,1963,2006,1421,42,494,338,419,227,158,1336,138
2017,36081077908,"Census Tract 779.08, Queens County, New York",1473,191,1282,1207,3601,48375,1961,2009,1477,42.8,508,361,377,205,176,1282,162
2018,36081077908,"Census Tract 779.08, Queens County, New York",1481,266,1215,1158,3332,51207,1958,2011,1642,41,404,354,330,183,254,1215,204
2019,36081077908,"Census Tract 779.08, Queens County, New York",1475,253,1222,1164,3280,50917,1956,2013,1587,34.4,414,264,406,170,278,1222,240
2020,36081077908,"Census Tract 779.08, Queens County, New York",1320,256,1064,1005,2610,50781,1954,2014,1694,34.1,404,123,376,245,242,1064,181
2012,36081078800,"Census Tract 788, Queens County, New York",556,55,501,186,538,48000,1948,2004,1640,32.7,0,0,180,0,0,501,40
2013,36081078800,"Census Tract 788, Queens County, New York",562,65,497,140,340,48125,1961,2007,1713,35.9,0,0,135,0,0,497,37
2014,36081078800,"Census Tract 788, Queens County, New York",573,59,514,137,413,51250,1963,2007,1787,35.7,0,0,119,14,0,514,42
2015,36081078800,"Census Tract 788, Queens County, New York",565,58,507,117,353,50956,1950,2010,1797,37.4,0,0,111,1,0,507,50
2016,36081078800,"Census Tract 788, Queens County, New York",563,31,532,144,508,65125,1950,2011,1834,36.1,0,0,136,8,0,532,55
2017,36081078800,"Census Tract 788, Queens County, New York",582,32,550,143,519,65066,1955,2012,1848,36.4,17,0,132,11,0,550,54
2018,36081078800,"Census Tract 788, Queens County, New York",569,16,553,122,452,48194,1969,2014,1688,29.6,28,0,113,9,0,553,50
2019,36081078800,"Census Tract 788, Queens County, New York",546,23,523,163,558,49402,1965,2014,1692,35.7,32,0,148,0,15,523,44
2020,36081078800,"Census Tract 788, Queens County, New York",568,46,522,119,377,53984,1959,2016,1697,19,30,0,99,0,20,522,14
2012,36081079000,"Census Tract 790, Queens County, New York",835,77,758,412,1210,70313,1952,NA,1185,27.7,92,6,292,21,35,758,123
2013,36081079000,"Census Tract 790, Queens County, New York",828,64,764,404,1223,68421,1961,2005,1237,27.3,83,0,269,20,55,764,132
2014,36081079000,"Census Tract 790, Queens County, New York",836,84,752,391,1255,57109,1964,2006,1239,28.3,52,0,224,41,53,752,128
2015,36081079000,"Census Tract 790, Queens County, New York",818,79,739,386,1320,47361,1967,2007,1257,32.4,94,0,254,27,49,739,148
2016,36081079000,"Census Tract 790, Queens County, New York",832,61,771,385,1416,49688,1969,2009,1331,34.8,96,0,259,34,46,771,134
2017,36081079000,"Census Tract 790, Queens County, New York",828,64,764,351,1270,51477,1967,2011,1412,35.5,74,0,221,46,49,764,120
2018,36081079000,"Census Tract 790, Queens County, New York",836,50,786,321,1170,53950,1969,2011,1506,35.7,96,0,219,59,32,786,104
2019,36081079000,"Census Tract 790, Queens County, New York",837,55,782,348,1065,59444,1965,2011,1502,30.6,119,0,247,39,27,782,76
2020,36081079000,"Census Tract 790, Queens County, New York",786,56,730,379,1288,78558,1967,2012,1661,22.7,83,5,248,45,29,730,35
2012,36081079200,"Census Tract 792, Queens County, New York",741,86,655,200,640,44000,1966,2005,1500,29.5,39,5,159,21,23,655,56
2013,36081079200,"Census Tract 792, Queens County, New York",760,63,697,263,814,48750,1966,2006,1449,29.4,66,4,211,9,45,697,69
2014,36081079200,"Census Tract 792, Queens County, New York",760,37,723,314,1024,42143,1966,2006,1478,45,72,4,253,22,44,723,119
2015,36081079200,"Census Tract 792, Queens County, New York",796,43,753,345,1109,51367,1966,2008,1431,29.5,87,4,268,11,51,753,99
2016,36081079200,"Census Tract 792, Queens County, New York",768,72,696,269,845,54750,1966,2008,1476,29.1,63,5,198,7,36,696,96
2017,36081079200,"Census Tract 792, Queens County, New York",778,48,730,226,723,62206,1968,2011,1604,28.7,53,0,155,14,28,730,92
2018,36081079200,"Census Tract 792, Queens County, New York",734,55,679,176,503,64063,1967,2011,1655,28.3,31,0,120,12,12,679,58
2019,36081079200,"Census Tract 792, Queens County, New York",738,73,665,185,523,63229,1969,2011,1543,27.3,31,0,102,7,39,665,50
2020,36081079200,"Census Tract 792, Queens County, New York",845,60,785,249,518,53036,1965,2011,1452,30.4,88,0,102,53,87,785,105
2012,36081079300,"Census Tract 793, Queens County, New York",0,0,0,0,0,NA,NA,NA,NA,NA,0,0,0,0,0,0,0
2013,36081079300,"Census Tract 793, Queens County, New York",0,0,0,0,0,NA,NA,NA,NA,NA,0,0,0,0,0,0,0
2014,36081079300,"Census Tract 793, Queens County, New York",0,0,0,0,0,NA,NA,NA,NA,NA,0,0,0,0,0,0,0
2015,36081079300,"Census Tract 793, Queens County, New York",0,0,0,0,0,NA,NA,NA,NA,NA,0,0,0,0,0,0,0
2016,36081079300,"Census Tract 793, Queens County, New York",0,0,0,0,0,NA,NA,NA,NA,NA,0,0,0,0,0,0,0
2017,36081079300,"Census Tract 793, Queens County, New York",0,0,0,0,0,NA,NA,NA,NA,NA,0,0,0,0,0,0,0
2018,36081079300,"Census Tract 793, Queens County, New York",0,0,0,0,0,NA,NA,NA,NA,NA,0,0,0,0,0,0,0
2019,36081079300,"Census Tract 793, Queens County, New York",0,0,0,0,0,NA,NA,NA,NA,NA,0,0,0,0,0,0,0
2020,36081079300,"Census Tract 793, Queens County, New York",0,0,0,0,0,NA,NA,NA,NA,NA,0,0,0,0,0,0,0
2012,36081079701,"Census Tract 797.01, Queens County, New York",3027,234,2793,2191,5232,45216,1966,2002,1287,32.8,1046,363,154,1419,258,2793,573
2013,36081079701,"Census Tract 797.01, Queens County, New York",2971,230,2741,2065,5120,47712,1967,2003,1319,33,959,255,168,1348,296,2741,576
2014,36081079701,"Census Tract 797.01, Queens County, New York",2941,212,2729,1936,4748,42589,1966,2003,1322,32.5,916,290,150,1217,304,2729,664
2015,36081079701,"Census Tract 797.01, Queens County, New York",2943,138,2805,1915,4826,35075,1966,2006,1288,32,843,314,161,1180,250,2805,707
2016,36081079701,"Census Tract 797.01, Queens County, New York",2965,220,2745,1984,5026,35000,1965,2008,1310,33.2,834,270,206,1291,195,2745,807
2017,36081079701,"Census Tract 797.01, Queens County, New York",2994,140,2854,2144,5631,30638,1965,2010,1368,39.7,815,257,216,1463,204,2854,983
2018,36081079701,"Census Tract 797.01, Queens County, New York",3022,209,2813,2136,5263,28917,1964,2010,1364,44,786,317,221,1432,133,2813,908
2019,36081079701,"Census Tract 797.01, Queens County, New York",2970,263,2707,2067,5215,27742,1964,2011,1411,51,717,245,162,1442,173,2707,878
2020,36081079701,"Census Tract 797.01, Queens County, New York",2928,206,2722,2138,5349,32470,1964,2011,1412,39.7,615,231,79,1506,285,2722,755
2012,36081079702,"Census Tract 797.02, Queens County, New York",1612,110,1502,1017,2650,38063,1959,2003,1167,41.3,298,30,18,655,303,1502,339
2013,36081079702,"Census Tract 797.02, Queens County, New York",1658,121,1537,965,2490,35477,1958,2004,1217,42.4,270,36,22,652,225,1537,406
2014,36081079702,"Census Tract 797.02, Queens County, New York",1678,24,1654,1164,3374,42842,1962,2006,1286,33.5,177,52,0,955,147,1654,333
2015,36081079702,"Census Tract 797.02, Queens County, New York",1702,95,1607,1204,3776,35959,1963,2007,1278,37,198,75,0,949,161,1607,380
2016,36081079702,"Census Tract 797.02, Queens County, New York",1704,108,1596,1243,3910,36729,1961,2007,1374,38.9,140,106,0,950,153,1596,373
2017,36081079702,"Census Tract 797.02, Queens County, New York",1793,158,1635,1294,3869,39653,1962,2009,1355,39.1,157,95,0,978,176,1635,410
2018,36081079702,"Census Tract 797.02, Queens County, New York",1788,167,1621,1233,3770,41632,1964,2010,1353,38.1,143,120,0,895,191,1621,408
2019,36081079702,"Census Tract 797.02, Queens County, New York",1764,238,1526,1124,3233,37875,1964,2011,1534,48.6,191,98,0,830,162,1526,439
2020,36081079702,"Census Tract 797.02, Queens County, New York",1580,165,1415,1035,3089,42828,1961,2012,1551,39.9,155,70,0,775,167,1415,391
2012,36081079900,"Census Tract 799, Queens County, New York",1128,69,1059,523,1690,53912,1965,2005,1493,36,171,53,16,323,131,1059,215
2013,36081079900,"Census Tract 799, Queens County, New York",1095,64,1031,556,1761,50000,1971,2008,1431,39.2,181,63,21,297,175,1031,189
2014,36081079900,"Census Tract 799, Queens County, New York",1098,52,1046,542,1592,29815,1967,2011,1381,46.4,103,81,20,295,146,1046,270
2015,36081079900,"Census Tract 799, Queens County, New York",1085,81,1004,564,1654,32917,1973,2011,1339,45.4,102,72,21,322,149,1004,274
2016,36081079900,"Census Tract 799, Queens County, New York",1080,124,956,535,1612,34137,1968,2011,1324,40.3,152,77,22,324,112,956,226
2017,36081079900,"Census Tract 799, Queens County, New York",1001,90,911,584,2026,43813,1949,2013,1473,41.5,105,85,0,374,125,911,220
2018,36081079900,"Census Tract 799, Queens County, New York",982,103,879,529,1690,29469,1948,2013,1496,45.7,98,72,0,362,95,879,249
2019,36081079900,"Census Tract 799, Queens County, New York",993,125,868,538,1884,41250,1947,2013,1548,40.1,110,47,0,371,120,868,210
2020,36081079900,"Census Tract 799, Queens County, New York",1037,73,964,658,2155,31827,1950,2014,1673,46.4,120,88,0,468,102,964,308
2012,36081080301,"Census Tract 803.01, Queens County, New York",1418,22,1396,817,2427,49769,1961,2005,1317,34.3,164,121,0,426,239,1396,164
2013,36081080301,"Census Tract 803.01, Queens County, New York",1450,50,1400,865,2675,41858,1963,2006,1336,37.4,137,127,0,437,273,1400,193
2014,36081080301,"Census Tract 803.01, Queens County, New York",1393,59,1334,778,2507,51488,1966,2007,1340,35.3,135,103,0,409,243,1334,168
2015,36081080301,"Census Tract 803.01, Queens County, New York",1381,63,1318,787,2793,53274,1969,2008,1443,34.7,112,88,0,480,204,1318,132
2016,36081080301,"Census Tract 803.01, Queens County, New York",1321,37,1284,739,2627,53353,1966,2010,1496,36.4,58,94,19,408,183,1284,128
2017,36081080301,"Census Tract 803.01, Queens County, New York",1319,118,1201,697,2453,47250,1967,2010,1576,37.3,49,121,21,374,155,1201,137
2018,36081080301,"Census Tract 803.01, Queens County, New York",1240,110,1130,702,2395,52262,1966,2011,1639,38.1,60,78,22,423,161,1130,113
2019,36081080301,"Census Tract 803.01, Queens County, New York",1228,102,1126,689,2326,58277,1964,2012,1593,38.7,36,69,25,395,177,1126,110
2020,36081080301,"Census Tract 803.01, Queens County, New York",1149,100,1049,618,2088,60877,1962,2013,1530,41.2,43,50,26,321,221,1049,75
2012,36081080302,"Census Tract 803.02, Queens County, New York",1090,88,1002,303,907,44421,1953,2005,1428,42.4,150,65,18,114,106,1002,97
2013,36081080302,"Census Tract 803.02, Queens County, New York",1117,112,1005,324,911,52574,1954,2006,1487,38.5,140,88,21,83,132,1005,88
2014,36081080302,"Census Tract 803.02, Queens County, New York",1189,77,1112,365,934,53525,1955,2007,1645,42.9,121,65,23,84,193,1112,67
2015,36081080302,"Census Tract 803.02, Queens County, New York",1146,75,1071,292,1043,68516,1971,2011,1442,27.3,103,49,24,150,69,1071,58
2016,36081080302,"Census Tract 803.02, Queens County, New York",1147,91,1056,308,1019,68625,1958,2011,1849,29,88,50,30,117,111,1056,40
2017,36081080302,"Census Tract 803.02, Queens County, New York",1120,52,1068,389,1216,50991,1971,2011,1571,28.8,66,45,0,225,119,1068,120
2018,36081080302,"Census Tract 803.02, Queens County, New York",1071,24,1047,400,1387,43438,1965,2011,1531,31.2,83,40,0,266,94,1047,125
2019,36081080302,"Census Tract 803.02, Queens County, New York",1072,25,1047,465,1618,51208,1963,2011,1440,29.4,68,66,0,298,101,1047,100
2020,36081080302,"Census Tract 803.02, Queens County, New York",1038,0,1038,578,1914,31940,1951,2012,1576,33.4,78,69,0,422,87,1038,84
2012,36081080900,"Census Tract 809, Queens County, New York",2760,108,2652,799,2342,37056,1954,1999,974,36.6,239,522,146,86,45,2652,324
2013,36081080900,"Census Tract 809, Queens County, New York",2795,117,2678,805,1992,29736,1954,1999,896,31.2,226,473,131,135,66,2678,260
2014,36081080900,"Census Tract 809, Queens County, New York",2819,111,2708,752,1895,40128,1955,1995,923,30.1,158,458,112,108,74,2708,225
2015,36081080900,"Census Tract 809, Queens County, New York",2859,125,2734,741,1800,42194,1954,1994,894,27.8,118,362,165,128,86,2734,169
2016,36081080900,"Census Tract 809, Queens County, New York",2885,111,2774,909,2196,49788,1953,1995,1001,26,135,385,139,199,186,2774,185
2017,36081080900,"Census Tract 809, Queens County, New York",2880,111,2769,1065,2535,48722,1952,1988,1051,27.8,186,387,105,201,372,2769,229
2018,36081080900,"Census Tract 809, Queens County, New York",2878,73,2805,1130,2715,52500,1953,1989,1156,26.9,219,394,130,184,422,2805,284
2019,36081080900,"Census Tract 809, Queens County, New York",2881,218,2663,1013,2508,51694,1953,1991,1260,29.1,299,366,155,195,297,2663,369
2020,36081080900,"Census Tract 809, Queens County, New York",2848,284,2564,903,2217,42209,1953,2004,1246,28.4,310,344,78,174,307,2564,352
2012,36081081400,"Census Tract 814, Queens County, New York",991,66,925,255,1004,51250,1954,2007,1470,38.9,0,0,207,0,25,925,97
2013,36081081400,"Census Tract 814, Queens County, New York",1064,63,1001,246,801,50093,1939,2008,1544,44,0,0,174,0,51,1001,114
2014,36081081400,"Census Tract 814, Queens County, New York",1119,104,1015,266,887,50921,1943,2007,1527,43.3,0,0,183,0,53,1015,153
2015,36081081400,"Census Tract 814, Queens County, New York",1067,93,974,262,955,41638,1939,2006,1551,44.1,0,0,173,0,58,974,170
2016,36081081400,"Census Tract 814, Queens County, New York",1083,94,989,260,938,51176,1939,2007,1532,34.1,0,0,114,46,65,989,169
2017,36081081400,"Census Tract 814, Queens County, New York",1119,149,970,249,989,41534,1941,2010,1419,40.7,0,0,84,57,97,970,157
2018,36081081400,"Census Tract 814, Queens County, New York",1117,180,937,308,1186,43482,0,2008,1648,46.9,0,0,121,55,124,937,169
2019,36081081400,"Census Tract 814, Queens County, New York",1155,137,1018,317,1207,63813,1940,2012,1738,34,0,0,120,52,145,1018,112
2020,36081081400,"Census Tract 814, Queens County, New York",1124,98,1026,290,1366,NA,1942,2016,1869,40.9,0,0,97,36,143,1026,119
2012,36081081800,"Census Tract 818, Queens County, New York",1091,29,1062,318,1061,30893,1946,2004,1504,50,39,0,120,55,85,1062,134
2013,36081081800,"Census Tract 818, Queens County, New York",1069,17,1052,352,1129,33906,1947,2005,1532,50,31,0,142,51,107,1052,137
2014,36081081800,"Census Tract 818, Queens County, New York",1133,18,1115,387,1343,27054,1946,2006,1535,50,33,0,148,67,112,1115,209
2015,36081081800,"Census Tract 818, Queens County, New York",1085,33,1052,355,1286,33009,1949,2008,1560,50,64,17,122,41,128,1052,217
2016,36081081800,"Census Tract 818, Queens County, New York",1087,43,1044,297,1154,40701,1945,2010,1405,41,42,46,85,48,66,1044,208
2017,36081081800,"Census Tract 818, Queens County, New York",1064,68,996,379,1410,61250,1946,2010,1687,30.7,92,60,108,64,124,996,173
2018,36081081800,"Census Tract 818, Queens County, New York",1140,97,1043,380,1356,44348,1951,2009,1706,33.8,55,58,59,127,105,1043,216
2019,36081081800,"Census Tract 818, Queens County, New York",1132,114,1018,393,1328,47188,1958,2010,1861,33.6,41,58,118,97,102,1018,155
2020,36081081800,"Census Tract 818, Queens County, New York",1139,106,1033,416,1435,67857,1956,2015,1989,31.9,68,104,138,136,48,1033,132
2012,36081083700,"Census Tract 837, Queens County, New York",1757,56,1701,383,1038,37462,1960,2006,1243,41.4,191,110,29,164,80,1701,245
2013,36081083700,"Census Tract 837, Queens County, New York",1691,78,1613,398,1135,39052,1962,2006,1295,43.8,171,98,26,190,84,1613,251
2014,36081083700,"Census Tract 837, Queens County, New York",1680,99,1581,428,1273,40641,1960,2008,1200,41.4,159,105,29,244,50,1581,280
2015,36081083700,"Census Tract 837, Queens County, New York",1656,117,1539,540,1696,35116,1957,2010,1226,47.4,94,117,0,378,45,1539,250
2016,36081083700,"Census Tract 837, Queens County, New York",1677,142,1535,542,1772,36429,1958,2011,1290,47,80,100,0,390,46,1535,246
2017,36081083700,"Census Tract 837, Queens County, New York",1672,142,1530,569,2015,40156,1958,2012,1438,44.5,47,69,0,458,36,1530,175
2018,36081083700,"Census Tract 837, Queens County, New York",1658,122,1536,632,2180,39399,1955,2013,1440,39.9,48,85,0,476,64,1536,215
2019,36081083700,"Census Tract 837, Queens County, New York",1571,68,1503,711,2303,43926,1953,2012,1496,39,52,79,0,536,90,1503,195
2020,36081083700,"Census Tract 837, Queens County, New York",1686,66,1620,629,1959,45592,1945,2014,1657,36.4,31,99,0,393,131,1620,153
2012,36081083800,"Census Tract 838, Queens County, New York",1793,111,1682,323,1112,40050,1952,2003,1459,47.8,15,31,54,61,130,1682,86
2013,36081083800,"Census Tract 838, Queens County, New York",1785,104,1681,369,1508,40880,1952,2005,1620,45.1,20,61,76,66,84,1681,58
2014,36081083800,"Census Tract 838, Queens County, New York",1796,95,1701,449,1826,34743,1954,2007,1604,47.2,32,69,83,98,116,1701,114
2015,36081083800,"Census Tract 838, Queens County, New York",1788,73,1715,556,2204,45000,1950,2008,1532,43.5,39,98,85,152,140,1715,150
2016,36081083800,"Census Tract 838, Queens County, New York",1753,152,1601,599,2118,47176,1952,2010,1532,34,81,97,81,195,148,1601,108
2017,36081083800,"Census Tract 838, Queens County, New York",1749,137,1612,602,1955,45357,1949,2011,1521,36.1,97,73,102,204,188,1612,136
2018,36081083800,"Census Tract 838, Queens County, New York",1728,137,1591,498,1400,44706,1950,2011,1593,38.6,67,51,79,188,180,1591,131
2019,36081083800,"Census Tract 838, Queens County, New York",1712,198,1514,483,1217,48831,1949,2011,1576,35.9,92,55,105,130,170,1514,81
2020,36081083800,"Census Tract 838, Queens County, New York",1655,193,1462,464,1372,47222,1955,2011,1727,38.5,86,25,112,147,147,1462,55
2012,36081084000,"Census Tract 840, Queens County, New York",2099,79,2020,556,1691,48654,1954,2004,1357,28.5,128,0,139,101,219,2020,251
2013,36081084000,"Census Tract 840, Queens County, New York",1990,49,1941,512,1591,36458,1952,2006,1446,44.2,122,22,158,129,107,1941,177
2014,36081084000,"Census Tract 840, Queens County, New York",1969,79,1890,514,1588,35880,1953,2007,1431,46.2,115,22,172,98,112,1890,198
2015,36081084000,"Census Tract 840, Queens County, New York",1958,89,1869,502,1728,40379,1951,2008,1315,46.4,118,29,130,144,86,1869,196
2016,36081084000,"Census Tract 840, Queens County, New York",1965,103,1862,525,1572,32275,1954,2005,1147,50,36,35,143,137,93,1862,354
2017,36081084000,"Census Tract 840, Queens County, New York",1974,138,1836,570,1757,40542,1952,2007,1306,47.5,73,35,158,210,78,1836,283
2018,36081084000,"Census Tract 840, Queens County, New York",1930,123,1807,600,1836,38796,1956,2008,1511,51,123,50,130,214,91,1807,241
2019,36081084000,"Census Tract 840, Queens County, New York",1955,154,1801,532,1608,43173,1957,2009,1783,39,84,52,158,187,52,1801,201
2020,36081084000,"Census Tract 840, Queens County, New York",1983,102,1881,503,1588,58807,1956,2008,1641,29.7,67,18,156,191,34,1881,176
2012,36081084500,"Census Tract 845, Queens County, New York",2054,102,1952,1659,3894,29554,1967,2003,1087,39.7,394,230,391,869,190,1952,535
2013,36081084500,"Census Tract 845, Queens County, New York",2127,83,2044,1750,3761,24698,1964,2003,1043,43.4,385,324,331,878,270,2044,539
2014,36081084500,"Census Tract 845, Queens County, New York",2134,121,2013,1757,3724,22775,1969,2006,954,48,336,242,317,1013,157,2013,643
2015,36081084500,"Census Tract 845, Queens County, New York",2189,235,1954,1716,3476,23188,1970,2006,948,45.6,292,159,374,985,198,1954,578
2016,36081084500,"Census Tract 845, Queens County, New York",2227,224,2003,1767,3677,23780,1967,2010,993,47.1,283,160,246,1074,276,2003,587
2017,36081084500,"Census Tract 845, Queens County, New York",2252,141,2111,1852,4107,25485,1967,2010,1051,45.3,248,177,197,1115,351,2111,618
2018,36081084500,"Census Tract 845, Queens County, New York",2265,189,2076,1844,4177,26851,1974,2010,1118,45.8,194,176,203,1084,381,2076,657
2019,36081084500,"Census Tract 845, Queens County, New York",2211,236,1975,1736,3956,29138,1965,2010,1137,44.1,224,198,210,874,475,1975,623
2020,36081084500,"Census Tract 845, Queens County, New York",2157,170,1987,1699,3914,30061,1965,2010,1135,42.1,264,269,175,748,528,1987,623
2012,36081084601,"Census Tract 846.01, Queens County, New York",1002,76,926,261,699,44750,1955,2005,1323,29.7,59,60,13,45,20,926,65
2013,36081084601,"Census Tract 846.01, Queens County, New York",998,88,910,297,816,41094,1956,2005,1369,44.7,46,58,19,43,57,910,69
2014,36081084601,"Census Tract 846.01, Queens County, New York",951,116,835,306,867,33125,1956,2006,1376,50,53,44,19,54,60,835,83
2015,36081084601,"Census Tract 846.01, Queens County, New York",925,133,792,322,1035,47292,1956,2005,1375,37.5,99,50,5,68,91,792,76
2016,36081084601,"Census Tract 846.01, Queens County, New York",917,100,817,306,974,49222,1956,2006,1517,40.2,90,56,15,32,116,817,96
2017,36081084601,"Census Tract 846.01, Queens County, New York",976,71,905,296,913,48413,1957,2006,1571,43.1,67,55,19,58,112,905,105
2018,36081084601,"Census Tract 846.01, Queens County, New York",968,75,893,276,822,51250,1958,2007,1598,40.3,81,55,21,55,92,893,74
2019,36081084601,"Census Tract 846.01, Queens County, New York",990,52,938,275,848,51308,1956,2006,1567,31,73,40,20,48,118,938,87
2020,36081084601,"Census Tract 846.01, Queens County, New York",897,71,826,200,570,52105,1956,2011,1675,29.5,37,34,20,43,94,826,73
2012,36081084602,"Census Tract 846.02, Queens County, New York",261,5,256,122,477,45833,1948,2006,1409,37.5,15,5,0,0,102,256,17
2013,36081084602,"Census Tract 846.02, Queens County, New York",259,4,255,77,303,58063,1976,2006,1433,29.6,12,4,0,0,58,255,22
2014,36081084602,"Census Tract 846.02, Queens County, New York",256,4,252,94,335,60500,1975,2007,1444,29.7,19,9,0,4,62,252,21
2015,36081084602,"Census Tract 846.02, Queens County, New York",289,15,274,97,330,NA,1951,2009,1650,35.2,31,8,14,5,53,274,21
2016,36081084602,"Census Tract 846.02, Queens County, New York",255,27,228,67,239,NA,1951,2010,1920,34.1,29,4,17,4,38,228,13
2017,36081084602,"Census Tract 846.02, Queens County, New York",240,23,217,54,164,NA,1957,2009,2135,34.6,25,3,14,3,31,217,9
2018,36081084602,"Census Tract 846.02, Queens County, New York",224,24,200,72,205,NA,1972,2011,2038,51,28,3,16,4,32,200,5
2019,36081084602,"Census Tract 846.02, Queens County, New York",219,24,195,69,203,32404,1956,2013,2168,51,19,0,30,0,26,195,4
2020,36081084602,"Census Tract 846.02, Queens County, New York",226,26,200,78,329,NA,1957,2008,2393,22,9,0,17,0,49,200,4
2012,36081084900,"Census Tract 849, Queens County, New York",2425,122,2303,2013,6428,37827,1959,2004,1348,44.9,210,10,85,1468,344,2303,475
2013,36081084900,"Census Tract 849, Queens County, New York",2525,211,2314,2003,6712,34990,1958,2006,1335,45.6,281,29,89,1391,396,2314,568
2014,36081084900,"Census Tract 849, Queens County, New York",2565,228,2337,2047,7134,30160,1960,2007,1307,50,214,25,107,1433,380,2337,644
2015,36081084900,"Census Tract 849, Queens County, New York",2569,343,2226,1960,6670,25296,1962,2009,1319,50,203,45,111,1372,405,2226,610
2016,36081084900,"Census Tract 849, Queens County, New York",2619,337,2282,2067,7431,25804,1958,2009,1446,50,361,13,165,1468,349,2282,835
2017,36081084900,"Census Tract 849, Queens County, New York",2665,405,2260,2031,6521,25625,1953,2010,1403,50,250,31,208,1410,418,2260,863
2018,36081084900,"Census Tract 849, Queens County, New York",2631,329,2302,2110,6525,29043,1960,2011,1562,51,263,0,169,1662,279,2302,909
2019,36081084900,"Census Tract 849, Queens County, New York",2632,294,2338,2161,6496,34289,1946,2010,1585,51,310,0,196,1505,479,2338,787
2020,36081084901,"Census Tract 849.01, Queens County, New York",991,30,961,858,2598,36875,0,2012,1748,51,63,0,48,748,34,961,362
2020,36081084902,"Census Tract 849.02, Queens County, New York",1697,122,1575,1491,4243,NA,1970,2011,1411,38.7,177,80,123,1063,248,1575,601
2012,36081085300,"Census Tract 853, Queens County, New York",2046,213,1833,1124,2792,26569,1966,2005,1268,50,409,99,47,842,152,1833,465
2013,36081085300,"Census Tract 853, Queens County, New York",2004,217,1787,1102,2837,25417,1967,2006,1277,50,346,57,35,834,195,1787,491
2014,36081085300,"Census Tract 853, Queens County, New York",2032,227,1805,1147,3009,28211,1968,2007,1364,50,305,45,52,953,118,1805,486
2015,36081085300,"Census Tract 853, Queens County, New York",2088,329,1759,1125,2878,31894,1966,2008,1464,50,297,29,55,963,101,1759,416
2016,36081085300,"Census Tract 853, Queens County, New York",2100,335,1765,1138,2824,32201,1962,2007,1423,49.4,216,50,53,940,87,1765,434
2017,36081085300,"Census Tract 853, Queens County, New York",2189,315,1874,1134,3096,34571,1960,2007,1557,47.3,180,51,56,924,92,1874,518
2018,36081085300,"Census Tract 853, Queens County, New York",2288,302,1986,1236,3274,30925,1957,2004,1429,46.3,215,71,68,967,130,1986,602
2019,36081085300,"Census Tract 853, Queens County, New York",2291,231,2060,1275,3575,33006,1954,2006,1615,46,159,67,31,1097,53,2060,544
2020,36081085300,"Census Tract 853, Queens County, New York",2292,132,2160,1347,3333,32370,1957,2005,1564,38.3,214,114,43,1049,51,2160,466
2012,36081085500,"Census Tract 855, Queens County, New York",2695,161,2534,2174,5622,45132,1958,2003,1243,33.2,700,186,95,1435,415,2534,337
2013,36081085500,"Census Tract 855, Queens County, New York",2690,212,2478,2138,5732,49583,1959,2003,1271,31.5,750,193,97,1377,440,2478,432
2014,36081085500,"Census Tract 855, Queens County, New York",2583,158,2425,2037,5515,42134,1958,2005,1311,33.3,640,200,172,1235,388,2425,530
2015,36081085500,"Census Tract 855, Queens County, New York",2638,195,2443,2112,5491,41148,1958,2006,1275,32.8,694,173,117,1351,398,2443,534
2016,36081085500,"Census Tract 855, Queens County, New York",2692,179,2513,2242,5924,35443,1955,2008,1287,41.6,597,139,153,1400,460,2513,595
2017,36081085500,"Census Tract 855, Queens County, New York",2701,196,2505,2207,5733,34406,1953,2010,1251,43.3,541,154,166,1333,428,2505,571
2018,36081085500,"Census Tract 855, Queens County, New York",2721,115,2606,2392,6316,36034,1952,2011,1278,42.7,502,190,147,1394,540,2606,552
2019,36081085500,"Census Tract 855, Queens County, New York",2813,129,2684,2545,6329,37377,1949,2011,1332,42.7,515,223,84,1546,584,2684,524
2020,36081085500,"Census Tract 855, Queens County, New York",2756,117,2639,2393,6301,34993,1949,2012,1450,47.1,344,354,43,1476,471,2639,456
2012,36081085700,"Census Tract 857, Queens County, New York",1940,43,1897,1492,4935,36042,1952,2002,1314,46.4,342,116,35,979,267,1897,520
2013,36081085700,"Census Tract 857, Queens County, New York",1890,60,1830,1411,4401,38068,1954,2002,1304,45.3,245,113,61,882,284,1830,480
2014,36081085700,"Census Tract 857, Queens County, New York",1895,95,1800,1436,4344,36558,1959,2003,1328,45.2,286,142,85,809,362,1800,558
2015,36081085700,"Census Tract 857, Queens County, New York",1894,156,1738,1398,4338,32778,1958,2005,1323,48.4,228,68,76,902,303,1738,477
2016,36081085700,"Census Tract 857, Queens County, New York",1923,150,1773,1468,4423,37318,1957,2007,1335,43.5,170,104,27,961,354,1773,500
2017,36081085700,"Census Tract 857, Queens County, New York",1994,170,1824,1514,4217,35431,1954,2010,1374,43.9,189,121,44,968,362,1824,427
2018,36081085700,"Census Tract 857, Queens County, New York",2041,202,1839,1520,4133,37457,1952,2011,1397,41.9,191,126,31,1020,329,1839,395
2019,36081085700,"Census Tract 857, Queens County, New York",1961,178,1783,1437,3910,38932,1949,2011,1394,41.8,190,146,29,969,270,1783,312
2020,36081085700,"Census Tract 857, Queens County, New York",1916,109,1807,1452,3811,38938,1948,2012,1470,40.7,254,114,26,981,316,1807,405
2012,36081085900,"Census Tract 859, Queens County, New York",2191,221,1970,1306,3617,34392,1953,2004,1243,40.1,398,280,10,694,226,1970,393
2013,36081085900,"Census Tract 859, Queens County, New York",2245,322,1923,1190,3205,39890,1954,2004,1292,36.1,411,294,13,598,173,1923,400
2014,36081085900,"Census Tract 859, Queens County, New York",2241,317,1924,1272,3635,36048,1958,2006,1318,41.6,375,258,11,731,142,1924,454
2015,36081085900,"Census Tract 859, Queens County, New York",2211,306,1905,1242,3434,39435,1955,2009,1353,41,357,209,12,752,143,1905,383
2016,36081085900,"Census Tract 859, Queens County, New York",2135,322,1813,1154,3132,42833,1956,2011,1290,36.9,225,151,32,805,108,1813,333
2017,36081085900,"Census Tract 859, Queens County, New York",2140,264,1876,1099,3023,41164,1955,2010,1367,33.8,181,159,10,756,144,1876,411
2018,36081085900,"Census Tract 859, Queens County, New York",2119,209,1910,1121,3114,37346,1958,2010,1450,44.9,107,84,20,794,179,1910,417
2019,36081085900,"Census Tract 859, Queens County, New York",2139,258,1881,1101,3119,40786,1952,2009,1443,41.3,133,87,19,793,177,1881,428
2020,36081085900,"Census Tract 859, Queens County, New York",2319,270,2049,1234,2961,51064,1950,2010,1459,30.9,404,277,21,833,60,2049,470
2012,36081086100,"Census Tract 861, Queens County, New York",939,23,916,480,1121,36977,1945,2003,1019,24.4,163,103,12,309,64,916,122
2013,36081086100,"Census Tract 861, Queens County, New York",932,45,887,440,1094,43929,1945,2001,985,24.8,163,80,30,285,55,887,137
2014,36081086100,"Census Tract 861, Queens County, New York",922,67,855,460,1096,43306,1944,2003,991,30.4,159,76,42,257,105,855,161
2015,36081086100,"Census Tract 861, Queens County, New York",886,58,828,451,1069,35809,1949,2008,1145,47.1,91,78,22,246,111,828,179
2016,36081086100,"Census Tract 861, Queens County, New York",881,98,783,424,1091,32000,1948,2011,1253,46.9,96,67,23,258,81,783,178
2017,36081086100,"Census Tract 861, Queens County, New York",893,131,762,386,1004,32059,1949,2011,1306,49.1,63,71,18,231,72,762,184
2018,36081086100,"Census Tract 861, Queens County, New York",909,129,780,429,1064,30250,1951,2011,1288,51,72,80,0,260,89,780,162
2019,36081086100,"Census Tract 861, Queens County, New York",906,113,793,440,1067,26897,1955,2011,1281,51,66,71,0,303,66,793,193
2020,36081086100,"Census Tract 861, Queens County, New York",926,130,796,452,1127,40449,1951,2011,1131,27.6,55,54,0,295,103,796,200
2012,36081086300,"Census Tract 863, Queens County, New York",2779,68,2711,2368,6314,29824,1964,2005,1197,38.9,667,78,130,1797,354,2711,714
2013,36081086300,"Census Tract 863, Queens County, New York",2751,127,2624,2244,5802,29188,1964,2005,1243,44.1,649,114,97,1633,392,2624,766
2014,36081086300,"Census Tract 863, Queens County, New York",2775,190,2585,2155,5768,32072,1967,2007,1267,43,621,80,83,1592,389,2585,732
2015,36081086300,"Census Tract 863, Queens County, New York",2743,283,2460,1967,5326,31908,1965,2010,1272,42.3,528,102,65,1455,323,2460,633
2016,36081086300,"Census Tract 863, Queens County, New York",2714,316,2398,1841,4862,36690,1965,2010,1321,33.6,359,125,40,1434,221,2398,507
2017,36081086300,"Census Tract 863, Queens County, New York",2729,325,2404,1717,4627,34905,1961,2009,1390,38.2,259,145,71,1311,190,2404,454
2018,36081086300,"Census Tract 863, Queens County, New York",2747,353,2394,1857,5026,36705,1965,2011,1439,36.3,192,140,73,1387,257,2394,342
2019,36081086300,"Census Tract 863, Queens County, New York",2750,353,2397,1827,4987,37712,1960,2011,1547,33.1,158,143,90,1235,359,2397,405
2020,36081086300,"Census Tract 863, Queens County, New York",2627,233,2394,1826,5455,47767,1963,2012,1520,32.9,181,162,85,1246,333,2394,540
2012,36081086400,"Census Tract 864, Queens County, New York",812,60,752,340,895,44135,1939,2005,1300,33,65,80,30,90,140,752,105
2013,36081086400,"Census Tract 864, Queens County, New York",836,59,777,339,971,44375,1939,2005,1372,32.8,51,83,30,70,154,777,90
2014,36081086400,"Census Tract 864, Queens County, New York",819,62,757,302,945,48864,1942,2007,1333,32,62,66,24,45,162,757,79
2015,36081086400,"Census Tract 864, Queens County, New York",829,29,800,352,1195,48409,1940,2010,1388,32.6,72,70,77,55,150,800,117
2016,36081086400,"Census Tract 864, Queens County, New York",836,43,793,364,1277,49500,1939,2011,1469,32.2,70,50,76,64,170,793,124
2017,36081086400,"Census Tract 864, Queens County, New York",863,42,821,361,1311,46406,1939,2011,1532,33.8,83,39,72,72,163,821,142
2018,36081086400,"Census Tract 864, Queens County, New York",839,45,794,360,1263,52083,0,2011,1483,32,92,49,89,44,168,794,132
2019,36081086400,"Census Tract 864, Queens County, New York",801,59,742,330,1258,52500,0,2012,1656,32.6,78,48,83,46,142,742,129
2020,36081086400,"Census Tract 864, Queens County, New York",744,48,696,277,1132,50208,1943,2012,1516,32.4,67,53,31,35,141,696,114
2012,36081086500,"Census Tract 865, Queens County, New York",2197,311,1886,1694,3823,31833,1958,2004,1324,41.7,505,375,0,1136,135,1886,501
2013,36081086500,"Census Tract 865, Queens County, New York",2203,315,1888,1638,3591,38500,1969,2004,1359,38,460,447,0,958,177,1888,495
2014,36081086500,"Census Tract 865, Queens County, New York",2216,318,1898,1610,3644,36690,1969,2006,1426,40.5,483,371,0,984,179,1898,569
2015,36081086500,"Census Tract 865, Queens County, New York",2204,269,1935,1607,3692,30450,1969,2007,1406,47.2,421,331,0,1108,156,1935,573
2016,36081086500,"Census Tract 865, Queens County, New York",2292,294,1998,1672,3917,29236,1971,2010,1485,50,430,308,0,1232,119,1998,611
2017,36081086500,"Census Tract 865, Queens County, New York",2318,310,2008,1640,3805,29648,1967,2011,1539,50,300,341,0,1196,88,2008,595
2018,36081086500,"Census Tract 865, Queens County, New York",2347,294,2053,1691,3765,26939,1963,2012,1598,51,293,289,0,1327,75,2053,621
2019,36081086500,"Census Tract 865, Queens County, New York",2332,262,2070,1745,3673,28931,1964,2013,1617,51,281,393,25,1213,128,2070,451
2020,36081086500,"Census Tract 865, Queens County, New York",2518,293,2225,1805,3455,40102,1972,2016,1666,51,474,556,25,1114,110,2225,461
2012,36081086900,"Census Tract 869, Queens County, New York",808,59,749,568,1635,52115,1996,2006,1591,31.2,224,0,0,475,83,749,186
2013,36081086900,"Census Tract 869, Queens County, New York",893,68,825,566,1599,46875,2000,2007,1590,33,201,0,15,467,75,825,187
2014,36081086900,"Census Tract 869, Queens County, New York",819,87,732,564,1632,37188,2000,2008,1681,37.6,181,8,14,470,63,732,190
2015,36081086900,"Census Tract 869, Queens County, New York",836,71,765,631,2007,31450,1998,2010,1590,42.3,198,10,16,536,56,765,257
2016,36081086900,"Census Tract 869, Queens County, New York",821,95,726,591,1708,27443,1995,2011,1596,50,126,19,20,497,50,726,251
2017,36081086900,"Census Tract 869, Queens County, New York",814,107,707,568,1692,26742,1997,NA,1631,50,76,26,17,465,60,707,212
2018,36081086900,"Census Tract 869, Queens County, New York",784,114,670,554,1641,28776,1996,2013,1658,51,67,27,0,465,53,670,196
2019,36081086900,"Census Tract 869, Queens County, New York",802,128,674,581,1539,29340,1998,2014,1774,51,66,16,0,530,25,674,148
2020,36081086900,"Census Tract 869, Queens County, New York",835,144,691,585,1296,41285,1993,2014,1789,44.9,40,16,0,455,101,691,92
2012,36081087100,"Census Tract 871, Queens County, New York",906,170,736,701,1854,13503,1956,2001,400,33.2,108,11,215,155,325,736,371
2013,36081087100,"Census Tract 871, Queens County, New York",1047,279,768,670,1731,17973,1957,2002,704,33.7,104,32,208,157,291,768,306
2014,36081087100,"Census Tract 871, Queens County, New York",1144,277,867,739,2001,18993,1957,2005,757,33,142,28,221,231,252,867,365
2015,36081087100,"Census Tract 871, Queens County, New York",1218,318,900,762,2010,22667,1958,2005,716,30.4,164,39,256,244,223,900,338
2016,36081087100,"Census Tract 871, Queens County, New York",1240,316,924,739,1861,24145,1958,2006,753,31.9,127,33,249,259,195,924,303
2017,36081087100,"Census Tract 871, Queens County, New York",1208,257,951,752,1933,33182,1959,2007,889,30.9,141,36,250,290,165,951,248
2018,36081087100,"Census Tract 871, Queens County, New York",1312,246,1066,861,2129,33750,1960,2010,935,34.2,150,28,261,351,190,1066,246
2019,36081087100,"Census Tract 871, Queens County, New York",1370,301,1069,883,2216,35927,1970,2012,1075,36.8,148,19,241,413,202,1069,226
2020,36081087100,"Census Tract 871, Queens County, New York",1512,348,1164,960,2397,35000,1977,2013,1144,38.2,243,20,186,490,236,1164,276
2012,36081088400,"Census Tract 884, Queens County, New York",3005,244,2761,698,1797,65962,1958,2004,1445,29.6,169,552,0,14,132,2761,204
2013,36081088400,"Census Tract 884, Queens County, New York",3090,339,2751,686,1870,73269,1955,2004,1493,29.1,186,527,0,28,131,2751,141
2014,36081088400,"Census Tract 884, Queens County, New York",3085,344,2741,570,1631,59773,1962,2006,1433,27.9,154,401,0,27,142,2741,161
2015,36081088400,"Census Tract 884, Queens County, New York",3057,450,2607,594,1703,75871,1965,2007,1637,27.6,111,447,0,17,130,2607,179
2016,36081088400,"Census Tract 884, Queens County, New York",3014,389,2625,599,1436,69208,1963,2007,1710,28.5,71,468,0,16,115,2625,263
2017,36081088400,"Census Tract 884, Queens County, New York",3066,336,2730,749,1919,78466,1962,2007,1609,25.9,100,524,46,15,164,2730,260
2018,36081088400,"Census Tract 884, Queens County, New York",3085,230,2855,841,1944,80850,1959,2007,1644,26.5,111,560,44,0,221,2855,165
2019,36081088400,"Census Tract 884, Queens County, New York",3048,239,2809,861,1888,81455,1958,2006,1670,26.5,119,555,58,0,229,2809,176
2020,36081088400,"Census Tract 884, Queens County, New York",3371,146,3225,863,1871,85865,1957,2007,1749,26.8,163,503,111,0,252,3225,336
2012,36081088901,"Census Tract 889.01, Queens County, New York",4210,295,3915,1446,3723,25989,1968,2001,775,31.8,349,325,229,612,334,3915,570
2013,36081088901,"Census Tract 889.01, Queens County, New York",4341,315,4026,1843,4705,26784,1971,2003,880,31.4,458,324,245,948,345,4026,706
2014,36081088901,"Census Tract 889.01, Queens County, New York",4444,332,4112,1772,4479,33598,1970,2004,1033,32.5,526,412,137,809,428,4112,658
2015,36081088901,"Census Tract 889.01, Queens County, New York",4579,474,4105,1822,4596,26944,1971,2006,1137,37.3,400,369,116,879,468,4105,817
2016,36081088901,"Census Tract 889.01, Queens County, New York",4719,529,4190,1976,4915,34375,1972,2009,1245,34.1,502,362,121,945,548,4190,766
2017,36081088901,"Census Tract 889.01, Queens County, New York",4777,597,4180,2065,5527,40884,1971,2010,1316,35.4,542,275,141,1047,602,4180,649
2018,36081088901,"Census Tract 889.01, Queens County, New York",4657,780,3877,1704,4370,43598,1966,2010,1374,39,361,246,121,843,494,3877,542
2019,36081088901,"Census Tract 889.01, Queens County, New York",4664,905,3759,1758,4326,31078,1971,2011,1425,44.5,372,217,108,1092,341,3759,654
2020,36081088902,"Census Tract 889.02, Queens County, New York",2958,736,2222,1398,3227,46011,1979,2012,1470,33.2,457,102,146,896,153,2222,358
2020,36081088903,"Census Tract 889.03, Queens County, New York",1834,35,1799,363,967,NA,1959,2015,1884,23.5,118,103,0,125,135,1799,253
2012,36081089200,"Census Tract 892, Queens County, New York",3011,0,3011,145,443,87153,1981,2008,1141,25.6,79,61,0,0,84,3011,159
2013,36081089200,"Census Tract 892, Queens County, New York",2976,110,2866,130,374,44167,1982,2009,1114,14.8,59,49,0,0,81,2866,154
2014,36081089200,"Census Tract 892, Queens County, New York",2898,181,2717,139,447,71816,1967,2011,NA,NA,108,84,0,0,55,2717,123
2015,36081089200,"Census Tract 892, Queens County, New York",2880,263,2617,284,980,NA,1958,2011,2023,23.9,161,151,0,0,133,2617,123
2016,36081089200,"Census Tract 892, Queens County, New York",2823,337,2486,252,869,NA,1959,2011,1979,24.2,155,141,0,0,111,2486,57
2017,36081089200,"Census Tract 892, Queens County, New York",2849,417,2432,396,1393,NA,1950,2012,1771,24.4,190,333,0,0,63,2432,111
2018,36081089200,"Census Tract 892, Queens County, New York",2855,284,2571,366,1080,33571,1956,2010,1815,29.1,215,338,0,0,28,2571,188
2019,36081089200,"Census Tract 892, Queens County, New York",2896,246,2650,314,1006,33558,1952,2011,1750,24.1,158,283,0,0,31,2650,195
2020,36081089201,"Census Tract 892.01, Queens County, New York",2868,241,2627,323,765,NA,1955,2009,1694,28,151,255,0,0,11,2627,227
2020,36081089202,"Census Tract 892.02, Queens County, New York",0,0,0,0,0,NA,NA,NA,NA,NA,0,0,0,0,0,0,0
2012,36081090700,"Census Tract 907, Queens County, New York",496,40,456,237,544,30406,1966,2006,1050,38.9,68,68,33,63,73,456,51
2013,36081090700,"Census Tract 907, Queens County, New York",481,61,420,216,594,26000,1958,2006,1141,41.3,49,78,10,53,72,420,60
2014,36081090700,"Census Tract 907, Queens County, New York",464,60,404,171,474,31993,1955,2007,1302,37.2,56,71,0,55,40,404,42
2015,36081090700,"Census Tract 907, Queens County, New York",472,53,419,185,411,31595,1954,2011,1327,39.4,39,72,0,70,39,419,63
2016,36081090700,"Census Tract 907, Queens County, New York",460,55,405,151,383,27750,1950,2010,1527,50,10,81,0,40,25,405,57
2017,36081090700,"Census Tract 907, Queens County, New York",490,55,435,163,464,29688,1946,2011,1613,50,9,78,0,40,41,435,66
2018,36081090700,"Census Tract 907, Queens County, New York",491,38,453,180,462,28636,1945,2012,1675,48.5,7,66,0,40,74,453,50
2019,36081090700,"Census Tract 907, Queens County, New York",472,13,459,202,576,30500,1945,2011,1793,48.5,19,79,0,45,78,459,74
2020,36081090700,"Census Tract 907, Queens County, New York",476,11,465,219,715,29313,1953,2009,1836,51,13,61,0,35,94,465,56
2012,36081091601,"Census Tract 916.01, Queens County, New York",2719,977,1742,84,164,41250,1982,2000,726,12.2,9,84,0,0,0,1742,30
2013,36081091601,"Census Tract 916.01, Queens County, New York",2566,865,1701,52,71,28438,1975,2002,908,23.8,9,52,0,0,0,1701,34
2014,36081091601,"Census Tract 916.01, Queens County, New York",2384,800,1584,50,80,39444,1951,2002,528,21.7,18,50,0,0,0,1584,45
2015,36081091601,"Census Tract 916.01, Queens County, New York",2411,891,1520,51,81,42639,1951,2000,NA,20.9,18,51,0,0,0,1520,54
2016,36081091601,"Census Tract 916.01, Queens County, New York",2377,881,1496,45,63,NA,1984,2006,NA,NA,45,45,0,0,0,1496,69
2017,36081091601,"Census Tract 916.01, Queens County, New York",2400,1002,1398,45,56,40337,1981,2009,NA,NA,34,45,0,0,0,1398,66
2018,36081091601,"Census Tract 916.01, Queens County, New York",2553,1188,1365,43,53,40871,1981,2009,NA,NA,33,43,0,0,0,1365,51
2019,36081091601,"Census Tract 916.01, Queens County, New York",2687,1231,1456,61,117,NA,1984,2013,741,20.9,52,61,0,0,0,1456,45
2012,36081091602,"Census Tract 916.02, Queens County, New York",0,0,0,0,0,NA,NA,NA,NA,NA,0,0,0,0,0,0,0
2013,36081091602,"Census Tract 916.02, Queens County, New York",0,0,0,0,0,NA,NA,NA,NA,NA,0,0,0,0,0,0,0
2014,36081091602,"Census Tract 916.02, Queens County, New York",0,0,0,0,0,NA,NA,NA,NA,NA,0,0,0,0,0,0,0
2015,36081091602,"Census Tract 916.02, Queens County, New York",0,0,0,0,0,NA,NA,NA,NA,NA,0,0,0,0,0,0,0
2016,36081091602,"Census Tract 916.02, Queens County, New York",0,0,0,0,0,NA,NA,NA,NA,NA,0,0,0,0,0,0,0
2017,36081091602,"Census Tract 916.02, Queens County, New York",0,0,0,0,0,NA,NA,NA,NA,NA,0,0,0,0,0,0,0
2018,36081091602,"Census Tract 916.02, Queens County, New York",0,0,0,0,0,NA,NA,NA,NA,NA,0,0,0,0,0,0,0
2019,36081091602,"Census Tract 916.02, Queens County, New York",0,0,0,0,0,NA,NA,NA,NA,NA,0,0,0,0,0,0,0
2020,36081091602,"Census Tract 916.02, Queens County, New York",0,0,0,0,0,NA,NA,NA,NA,NA,0,0,0,0,0,0,0
2020,36081091603,"Census Tract 916.03, Queens County, New York",2628,1333,1295,51,95,NA,1984,2012,788,21.2,43,51,0,0,0,1295,50
2020,36081091604,"Census Tract 916.04, Queens County, New York",0,0,0,0,0,NA,NA,NA,NA,NA,0,0,0,0,0,0,0
2012,36081091800,"Census Tract 918, Queens County, New York",12,0,12,0,0,NA,NA,NA,NA,NA,0,0,0,0,0,12,0
2013,36081091800,"Census Tract 918, Queens County, New York",12,0,12,0,0,NA,NA,NA,NA,NA,0,0,0,0,0,12,0
2014,36081091800,"Census Tract 918, Queens County, New York",3,0,3,0,0,NA,NA,NA,NA,NA,0,0,0,0,0,3,0
2015,36081091800,"Census Tract 918, Queens County, New York",4,0,4,0,0,NA,NA,NA,NA,NA,0,0,0,0,0,4,0
2016,36081091800,"Census Tract 918, Queens County, New York",3,0,3,0,0,NA,NA,NA,NA,NA,0,0,0,0,0,3,0
2017,36081091800,"Census Tract 918, Queens County, New York",3,0,3,0,0,NA,NA,NA,NA,NA,0,0,0,0,0,3,0
2018,36081091800,"Census Tract 918, Queens County, New York",7,0,7,0,0,NA,NA,NA,NA,NA,0,0,0,0,0,7,0
2019,36081091800,"Census Tract 918, Queens County, New York",6,0,6,0,0,NA,NA,NA,NA,NA,0,0,0,0,0,6,0
2020,36081091800,"Census Tract 918, Queens County, New York",7,0,7,0,0,NA,NA,NA,NA,NA,0,0,0,0,0,7,0
2012,36081091900,"Census Tract 919, Queens County, New York",1791,77,1714,909,2854,61250,1961,2005,1589,30.1,170,242,0,185,457,1714,216
2013,36081091900,"Census Tract 919, Queens County, New York",1840,81,1759,1000,3350,53821,1963,2006,1607,29.2,200,254,9,228,489,1759,241
2014,36081091900,"Census Tract 919, Queens County, New York",1783,75,1708,886,2967,50132,1960,2007,1570,28.3,142,249,10,202,408,1708,225
2015,36081091900,"Census Tract 919, Queens County, New York",1847,100,1747,989,3089,42238,1948,2010,1536,37,174,289,8,237,435,1747,280
2016,36081091900,"Census Tract 919, Queens County, New York",1802,117,1685,927,3106,45582,1941,2011,1547,37.7,145,209,7,217,438,1685,246
2017,36081091900,"Census Tract 919, Queens County, New York",1745,136,1609,903,3082,47561,1947,2012,1599,40.1,125,131,10,289,410,1609,166
2018,36081091900,"Census Tract 919, Queens County, New York",1687,117,1570,900,2788,49259,1944,2011,1546,30.6,147,168,0,276,399,1570,178
2019,36081091900,"Census Tract 919, Queens County, New York",1662,108,1554,984,2975,48131,1942,2012,1604,42.5,150,107,44,355,423,1554,174
2020,36081091900,"Census Tract 919, Queens County, New York",1567,84,1483,808,2429,48646,1953,2012,1594,43.5,120,58,49,311,375,1483,153
2012,36081092200,"Census Tract 922, Queens County, New York",821,19,802,143,311,101128,1942,2005,2001,31.9,26,143,0,0,0,802,49
2013,36081092200,"Census Tract 922, Queens County, New York",816,37,779,120,263,103333,1942,2005,1972,32.3,15,120,0,0,0,779,56
2014,36081092200,"Census Tract 922, Queens County, New York",802,65,737,97,246,104850,1940,2004,2001,30.6,23,91,0,0,6,737,35
2015,36081092200,"Census Tract 922, Queens County, New York",824,69,755,85,239,NA,1948,2004,1705,23.8,13,78,0,0,7,755,28
2016,36081092200,"Census Tract 922, Queens County, New York",828,89,739,60,189,53977,1946,2001,1448,32.2,9,51,0,0,9,739,20
2017,36081092200,"Census Tract 922, Queens County, New York",845,110,735,22,40,NA,1982,2010,1750,50,6,16,0,0,6,735,25
2018,36081092200,"Census Tract 922, Queens County, New York",868,97,771,30,56,NA,1947,2011,2042,23.9,7,23,0,0,7,771,18
2019,36081092200,"Census Tract 922, Queens County, New York",896,79,817,27,60,NA,1957,2014,2125,24.6,5,27,0,0,0,817,36
2020,36081092200,"Census Tract 922, Queens County, New York",851,72,779,31,63,NA,NA,NA,NA,NA,14,31,0,0,0,779,32
2012,36081092500,"Census Tract 925, Queens County, New York",1295,115,1180,868,2321,47857,1949,2005,1361,33.9,186,376,32,114,358,1180,178
2013,36081092500,"Census Tract 925, Queens County, New York",1232,88,1144,820,2263,40714,1948,2007,1356,42.6,184,307,37,90,401,1144,183
2014,36081092500,"Census Tract 925, Queens County, New York",1213,50,1163,813,2564,43147,1952,2008,1443,41.6,152,220,21,122,463,1163,219
2015,36081092500,"Census Tract 925, Queens County, New York",1271,68,1203,848,2709,42287,1939,2009,1426,43.1,125,188,55,145,460,1203,226
2016,36081092500,"Census Tract 925, Queens County, New York",1262,69,1193,801,2504,31625,1939,2010,1433,50,108,159,58,171,413,1193,248
2017,36081092500,"Census Tract 925, Queens County, New York",1288,141,1147,759,2445,34861,1939,2011,1486,49.1,79,134,55,243,307,1147,227
2018,36081092500,"Census Tract 925, Queens County, New York",1257,131,1126,747,2477,44250,0,2011,1529,33.4,97,126,50,261,292,1126,238
2019,36081092500,"Census Tract 925, Queens County, New York",1220,160,1060,726,2128,43468,1943,2012,1630,39.7,82,151,55,236,266,1060,201
2020,36081092500,"Census Tract 925, Queens County, New York",1122,157,965,589,1727,40750,1955,2012,1648,51,61,133,0,171,269,965,198
2012,36081092800,"Census Tract 928, Queens County, New York",1385,154,1231,58,78,62188,1939,2003,1406,22.9,44,50,0,0,0,1231,27
2013,36081092800,"Census Tract 928, Queens County, New York",1366,184,1182,70,104,37262,1939,2004,1217,21.8,42,57,0,0,0,1182,26
2014,36081092800,"Census Tract 928, Queens County, New York",1378,154,1224,79,122,98068,1939,2004,1550,23.3,49,79,0,0,0,1224,20
2015,36081092800,"Census Tract 928, Queens County, New York",1350,187,1163,79,133,125179,1939,2004,NA,19,49,79,0,0,0,1163,16
2016,36081092800,"Census Tract 928, Queens County, New York",1296,182,1114,64,137,113333,1951,2005,NA,23.1,36,64,0,0,0,1114,5
2017,36081092800,"Census Tract 928, Queens County, New York",1302,93,1209,74,213,113056,1952,2008,NA,28.2,46,74,0,0,0,1209,8
2018,36081092800,"Census Tract 928, Queens County, New York",1322,84,1238,86,265,91111,1952,2009,NA,26.7,69,77,0,9,0,1238,20
2019,36081092800,"Census Tract 928, Queens County, New York",1289,71,1218,124,461,93500,0,2016,1777,20.8,70,114,0,10,0,1218,21
2020,36081092800,"Census Tract 928, Queens County, New York",1269,65,1204,155,541,120893,0,2014,1438,14.2,89,148,0,7,0,1204,16
2012,36081092900,"Census Tract 929, Queens County, New York",2340,218,2122,1212,3720,49322,1960,2005,1413,31.5,522,250,60,222,605,2122,23
2013,36081092900,"Census Tract 929, Queens County, New York",2273,226,2047,1183,3610,50459,1969,2006,1387,33.2,358,169,64,252,614,2047,59
2014,36081092900,"Census Tract 929, Queens County, New York",2236,162,2074,1273,3872,45137,1970,2010,1472,39.2,251,263,20,248,659,2074,164
2015,36081092900,"Census Tract 929, Queens County, New York",2318,90,2228,1504,4253,46984,1968,2011,1438,37,247,259,8,345,777,2228,179
2016,36081092900,"Census Tract 929, Queens County, New York",2329,108,2221,1395,3965,45413,1965,2011,1462,37.8,178,282,11,294,684,2221,187
2017,36081092900,"Census Tract 929, Queens County, New York",2333,147,2186,1389,3927,42192,1965,2011,1570,38.9,136,293,24,335,700,2186,210
2018,36081092900,"Census Tract 929, Queens County, New York",2397,149,2248,1480,3880,40393,1961,NA,1636,44.1,167,367,13,326,734,2248,190
2019,36081092900,"Census Tract 929, Queens County, New York",2423,126,2297,1380,3765,55865,1950,2012,1662,33.3,187,295,18,376,640,2297,89
2020,36081092900,"Census Tract 929, Queens County, New York",2345,154,2191,1177,3775,65612,1950,2014,1825,29.4,269,279,18,295,585,2191,92
2012,36081093401,"Census Tract 934.01, Queens County, New York",1804,266,1538,435,768,48164,1941,2004,1519,28.4,251,421,0,0,14,1538,84
2013,36081093401,"Census Tract 934.01, Queens County, New York",1759,314,1445,395,743,33850,1950,2006,1434,35,246,354,0,0,41,1445,85
2014,36081093401,"Census Tract 934.01, Queens County, New York",1697,308,1389,522,977,33103,1951,2008,1414,33,303,493,0,0,29,1389,123
2015,36081093401,"Census Tract 934.01, Queens County, New York",1653,319,1334,446,964,67000,1947,2009,1436,28.1,235,413,0,0,33,1334,72
2016,36081093401,"Census Tract 934.01, Queens County, New York",1587,246,1341,510,1065,62250,1954,2010,1487,28.4,281,476,0,0,34,1341,77
2017,36081093401,"Census Tract 934.01, Queens County, New York",1600,207,1393,494,1032,58636,1960,2012,1493,30.5,236,425,0,0,69,1393,84
2018,36081093401,"Census Tract 934.01, Queens County, New York",1599,126,1473,488,1000,58750,1961,2015,1669,30.5,244,400,0,20,68,1473,96
2019,36081093401,"Census Tract 934.01, Queens County, New York",1598,77,1521,533,1095,59821,1963,2016,1743,35,230,438,0,21,74,1521,101
2020,36081093401,"Census Tract 934.01, Queens County, New York",1520,91,1429,541,1111,62422,1964,2016,1724,31.7,277,440,0,17,84,1429,100
2012,36081093402,"Census Tract 934.02, Queens County, New York",1954,316,1638,720,1388,39514,1958,2005,1124,25.2,204,446,139,72,63,1638,124
2013,36081093402,"Census Tract 934.02, Queens County, New York",1936,297,1639,681,1254,48015,1961,2006,1223,30.3,165,437,100,53,91,1639,122
2014,36081093402,"Census Tract 934.02, Queens County, New York",1990,337,1653,684,1303,55172,1957,2009,1233,27.9,164,466,93,69,56,1653,144
2015,36081093402,"Census Tract 934.02, Queens County, New York",1928,310,1618,806,1670,52027,1952,2010,1252,29,232,525,84,116,81,1618,198
2016,36081093402,"Census Tract 934.02, Queens County, New York",2046,222,1824,901,1818,61850,1939,2011,1338,29.4,269,609,114,64,147,1824,246
2017,36081093402,"Census Tract 934.02, Queens County, New York",2044,270,1774,955,1930,59125,1939,2012,1341,28.7,266,666,87,84,132,1774,237
2018,36081093402,"Census Tract 934.02, Queens County, New York",2000,282,1718,920,1914,63854,0,2012,1311,27.4,288,666,63,92,87,1718,185
2019,36081093402,"Census Tract 934.02, Queens County, New York",1941,264,1677,922,1984,60208,1946,2012,1401,30.8,278,641,95,64,112,1677,221
2020,36081093402,"Census Tract 934.02, Queens County, New York",1864,311,1553,767,1520,59583,1949,2012,1430,30.8,232,541,105,27,95,1553,172
2012,36081093800,"Census Tract 938, Queens County, New York",2685,380,2305,1604,3346,46200,1964,2002,1084,30.1,627,1257,149,16,182,2305,242
2013,36081093800,"Census Tract 938, Queens County, New York",2634,333,2301,1745,3992,46008,1963,2002,1025,29.2,599,1293,251,0,221,2301,316
2014,36081093800,"Census Tract 938, Queens County, New York",2581,362,2219,1665,3913,43750,1963,2003,1018,31.2,568,1194,207,14,269,2219,320
2015,36081093800,"Census Tract 938, Queens County, New York",2579,405,2174,1754,3643,53173,1963,2003,1032,27.3,382,1031,219,17,506,2174,274
2016,36081093800,"Census Tract 938, Queens County, New York",2480,361,2119,1614,3303,47813,1964,2005,1080,27.2,366,1157,165,17,297,2119,331
2017,36081093800,"Census Tract 938, Queens County, New York",2519,307,2212,1680,3129,41149,1962,2005,1178,29.3,322,1226,189,16,269,2212,410
2018,36081093800,"Census Tract 938, Queens County, New York",2586,352,2234,1594,2725,40682,1962,2006,1293,30.1,313,1092,194,26,270,2234,504
2019,36081093800,"Census Tract 938, Queens County, New York",2555,336,2219,1461,2554,50404,1963,2008,1347,27.4,307,1069,155,0,229,2219,408
2020,36081093800,"Census Tract 938, Queens County, New York",2383,309,2074,1414,2774,52545,1964,2011,1445,33.6,322,967,109,0,331,2074,386
2012,36081093900,"Census Tract 939, Queens County, New York",1656,131,1525,511,1420,44427,1956,2006,1416,29.6,81,257,8,44,202,1525,84
2013,36081093900,"Census Tract 939, Queens County, New York",1806,140,1666,553,1555,43986,1975,2006,1574,32.3,127,257,8,69,219,1666,132
2014,36081093900,"Census Tract 939, Queens County, New York",1840,232,1608,525,1837,46927,1982,2008,1586,29.7,108,202,8,78,237,1608,155
2015,36081093900,"Census Tract 939, Queens County, New York",1889,303,1586,557,1890,50329,1979,2008,1624,31.3,107,198,13,100,246,1586,183
2016,36081093900,"Census Tract 939, Queens County, New York",1794,236,1558,525,1816,38650,1973,2010,1681,34.9,87,161,7,112,245,1558,184
2017,36081093900,"Census Tract 939, Queens County, New York",1815,189,1626,577,2067,58472,1975,2012,1761,34,116,147,15,134,281,1626,190
2018,36081093900,"Census Tract 939, Queens County, New York",1820,198,1622,681,2470,51612,1959,2012,1765,34.6,115,200,8,163,312,1622,161
2019,36081093900,"Census Tract 939, Queens County, New York",1811,110,1701,676,2365,57500,1974,2014,1881,41.7,94,183,38,160,307,1701,131
2020,36081093900,"Census Tract 939, Queens County, New York",1737,59,1678,797,3304,78338,1983,2014,1866,31.4,156,220,43,145,398,1678,103
2012,36081094201,"Census Tract 942.01, Queens County, New York",1371,132,1239,844,2317,44625,1980,2004,1251,32.7,237,208,365,0,304,1239,138
2013,36081094201,"Census Tract 942.01, Queens County, New York",1447,189,1258,910,2580,49300,1991,2005,1424,34.8,259,197,412,29,318,1258,164
2014,36081094201,"Census Tract 942.01, Queens County, New York",1443,178,1265,952,2699,39821,1988,2007,1465,39,281,253,469,27,241,1265,110
2015,36081094201,"Census Tract 942.01, Queens County, New York",1460,173,1287,1004,2489,41071,1979,2007,1348,37.2,360,287,435,26,335,1287,142
2016,36081094201,"Census Tract 942.01, Queens County, New York",1479,146,1333,1010,2418,43088,1974,2008,1248,37.2,274,282,404,23,357,1333,92
2017,36081094201,"Census Tract 942.01, Queens County, New York",1455,179,1276,1046,2497,51179,1974,2008,1272,33.2,229,233,399,22,439,1276,100
2018,36081094201,"Census Tract 942.01, Queens County, New York",1460,161,1299,992,2293,50341,1973,2009,1224,32.5,194,267,385,0,364,1299,112
2019,36081094201,"Census Tract 942.01, Queens County, New York",1516,177,1339,984,2177,52857,1976,2011,1227,30.4,169,222,354,0,443,1339,121
2020,36081094201,"Census Tract 942.01, Queens County, New York",1468,199,1269,994,2057,59091,1976,2013,1308,27.9,272,168,349,13,494,1269,91
2012,36081094202,"Census Tract 942.02, Queens County, New York",1873,286,1587,1100,3391,27300,1959,2003,688,31.5,164,110,687,23,352,1587,452
2013,36081094202,"Census Tract 942.02, Queens County, New York",1908,223,1685,1058,3324,24383,1960,2004,698,31.6,172,146,562,37,365,1685,463
2014,36081094202,"Census Tract 942.02, Queens County, New York",1876,212,1664,1056,3057,22530,1960,2004,677,33.4,175,135,566,51,359,1664,482
2015,36081094202,"Census Tract 942.02, Queens County, New York",1876,232,1644,1072,3105,24655,1957,2006,680,32.4,181,128,538,63,433,1644,467
2016,36081094202,"Census Tract 942.02, Queens County, New York",1902,200,1702,1097,3246,30017,1958,2006,672,30.6,180,142,549,75,407,1702,438
2017,36081094202,"Census Tract 942.02, Queens County, New York",1893,252,1641,982,2689,27143,1958,2009,758,31.4,147,75,548,74,364,1641,370
2018,36081094202,"Census Tract 942.02, Queens County, New York",1923,236,1687,1009,2696,29942,1958,2010,825,31.6,198,110,555,72,364,1687,337
2019,36081094202,"Census Tract 942.02, Queens County, New York",1972,233,1739,965,2750,35125,1958,2011,797,27.4,143,108,493,46,386,1739,294
2020,36081094202,"Census Tract 942.02, Queens County, New York",2298,163,2135,1159,2918,27855,1958,2008,875,32,154,124,514,23,275,2135,506
2012,36081094203,"Census Tract 942.03, Queens County, New York",2778,240,2538,1430,2998,44420,1965,1999,765,22.6,300,717,428,19,348,2538,249
2013,36081094203,"Census Tract 942.03, Queens County, New York",2753,190,2563,1590,3214,43542,1964,1998,804,23,386,1031,299,52,216,2563,230
2014,36081094203,"Census Tract 942.03, Queens County, New York",2771,127,2644,1708,3678,43838,1964,1999,852,25.1,481,923,472,63,268,2644,190
2015,36081094203,"Census Tract 942.03, Queens County, New York",2777,92,2685,1571,3403,43702,1963,2000,865,25.1,398,875,315,81,288,2685,244
2016,36081094203,"Census Tract 942.03, Queens County, New York",2783,74,2709,1476,3092,36619,1965,2002,928,25.7,334,850,206,87,303,2709,250
2017,36081094203,"Census Tract 942.03, Queens County, New York",2819,82,2737,1467,3539,36580,1966,2006,1021,28.9,296,854,106,69,420,2737,324
2018,36081094203,"Census Tract 942.03, Queens County, New York",2846,79,2767,1425,3262,36827,1968,2008,1012,29.1,330,819,133,30,424,2767,331
2019,36081094203,"Census Tract 942.03, Queens County, New York",2870,123,2747,1513,3417,49926,1970,2009,942,27,437,859,196,31,426,2747,305
2020,36081094203,"Census Tract 942.03, Queens County, New York",2935,149,2786,1626,3419,39583,1968,2007,898,27.9,522,854,156,32,585,2786,369
2012,36081094500,"Census Tract 945, Queens County, New York",1496,164,1332,385,1181,51856,1965,2004,1788,39.7,69,212,0,94,117,1332,167
2013,36081094500,"Census Tract 945, Queens County, New York",1500,164,1336,394,1193,52105,1967,2004,1789,39.6,104,195,0,103,123,1336,161
2014,36081094500,"Census Tract 945, Queens County, New York",1480,174,1306,272,909,73750,1967,2006,1979,37.3,91,115,0,73,105,1306,186
2015,36081094500,"Census Tract 945, Queens County, New York",1459,120,1339,273,839,31366,1967,2006,1906,48,116,109,0,66,98,1339,187
2016,36081094500,"Census Tract 945, Queens County, New York",1439,201,1238,190,582,27069,1972,2009,1611,50,95,83,0,47,60,1238,148
2017,36081094500,"Census Tract 945, Queens County, New York",1428,223,1205,198,691,31875,1973,2009,1634,50,109,98,0,45,55,1205,155
2018,36081094500,"Census Tract 945, Queens County, New York",1419,256,1163,290,1038,48229,1975,2011,1819,48.9,86,112,0,68,110,1163,110
2019,36081094500,"Census Tract 945, Queens County, New York",1395,256,1139,307,1167,44250,1972,2013,1990,51,88,103,0,48,156,1139,74
2020,36081094500,"Census Tract 945, Queens County, New York",1373,201,1172,319,1143,51067,1970,2017,2298,49.3,135,129,0,21,153,1172,69
2012,36081094700,"Census Tract 947, Queens County, New York",827,75,752,387,1291,51473,1941,2006,1547,37.7,75,167,4,53,167,752,91
2013,36081094700,"Census Tract 947, Queens County, New York",838,78,760,366,1216,52375,1943,2006,1585,39,68,169,4,54,143,760,76
2014,36081094700,"Census Tract 947, Queens County, New York",851,77,774,397,1333,52721,1944,2008,1446,40,77,151,5,60,176,774,70
2015,36081094700,"Census Tract 947, Queens County, New York",845,82,763,417,1455,48750,1958,2009,1458,42.7,92,173,4,66,169,763,102
2016,36081094700,"Census Tract 947, Queens County, New York",855,65,790,405,1281,41797,1949,2011,1511,45.1,95,144,0,47,205,790,101
2017,36081094700,"Census Tract 947, Queens County, New York",852,77,775,407,1199,42917,1952,2011,1482,43.1,72,121,0,65,212,775,104
2018,36081094700,"Census Tract 947, Queens County, New York",797,79,718,426,1210,39000,1949,2011,1560,44.4,77,130,0,62,225,718,129
2019,36081094700,"Census Tract 947, Queens County, New York",799,87,712,396,1123,46429,1953,2012,1662,38.6,69,115,0,54,227,712,104
2020,36081094700,"Census Tract 947, Queens County, New York",741,42,699,391,1108,37656,1962,2012,1715,48.8,77,58,0,70,263,699,103
2012,36081095400,"Census Tract 954, Queens County, New York",1796,343,1453,777,2179,31377,1963,2005,1257,44.5,114,170,467,0,140,1453,286
2013,36081095400,"Census Tract 954, Queens County, New York",1867,321,1546,806,2152,33017,1964,2005,1138,34.4,124,198,462,0,146,1546,236
2014,36081095400,"Census Tract 954, Queens County, New York",1844,299,1545,693,1814,22762,1965,2005,1026,43.9,115,191,417,0,108,1545,313
2015,36081095400,"Census Tract 954, Queens County, New York",1832,377,1455,605,1709,23454,1964,2009,1264,40.8,111,124,379,0,125,1455,281
2016,36081095400,"Census Tract 954, Queens County, New York",1918,397,1521,634,1988,28667,1966,2011,1342,37.7,176,82,430,10,114,1521,265
2017,36081095400,"Census Tract 954, Queens County, New York",1977,343,1634,746,2191,33750,1975,2012,1437,36.6,230,63,537,10,157,1634,322
2018,36081095400,"Census Tract 954, Queens County, New York",2005,330,1675,808,2440,39205,1972,2013,1548,41.4,255,34,595,19,187,1675,389
2019,36081095400,"Census Tract 954, Queens County, New York",2125,279,1846,977,2874,39639,1979,2014,1746,40.2,261,61,608,20,275,1846,410
2020,36081095400,"Census Tract 954, Queens County, New York",1993,189,1804,961,2755,47849,1987,2015,1765,36.4,251,84,559,30,272,1804,301
2012,36081096400,"Census Tract 964, Queens County, New York",1383,250,1133,423,1198,43125,1977,2007,1367,36.9,40,0,364,19,34,1133,141
2013,36081096400,"Census Tract 964, Queens County, New York",1412,224,1188,454,1319,46250,1983,2007,1438,38,29,0,384,11,52,1188,172
2014,36081096400,"Census Tract 964, Queens County, New York",1430,173,1257,510,1395,44375,1967,2008,1396,40.6,41,12,371,8,113,1257,176
2015,36081096400,"Census Tract 964, Queens County, New York",1497,211,1286,489,1377,45075,1966,2011,1336,38.7,69,6,290,27,160,1286,122
2016,36081096400,"Census Tract 964, Queens County, New York",1658,223,1435,530,1635,31420,1982,2011,1333,39,70,16,285,51,178,1435,153
2017,36081096400,"Census Tract 964, Queens County, New York",1808,203,1605,604,1800,31111,1974,2012,1337,39,92,50,306,50,198,1605,236
2018,36081096400,"Census Tract 964, Queens County, New York",1932,147,1785,706,1994,47619,1990,2012,1404,33.8,175,62,375,78,191,1785,237
2019,36081096400,"Census Tract 964, Queens County, New York",2082,150,1932,730,2067,49621,1994,2012,1395,34.5,199,60,412,85,173,1932,197
2020,36081096400,"Census Tract 964, Queens County, New York",2254,87,2167,844,2067,55238,2001,2013,1527,36.2,287,120,499,58,233,2167,134
2012,36081097202,"Census Tract 972.02, Queens County, New York",1111,257,854,837,2145,16107,1972,2003,901,50,82,28,690,0,138,854,464
2013,36081097202,"Census Tract 972.02, Queens County, New York",1123,286,837,820,2500,21607,1970,2004,1024,50,73,46,573,0,219,837,419
2014,36081097202,"Census Tract 972.02, Queens County, New York",1122,318,804,799,2395,25264,1971,2006,980,46.2,112,68,559,0,183,804,347
2015,36081097202,"Census Tract 972.02, Queens County, New York",1135,256,879,874,2624,35375,1973,2008,1035,36.3,154,74,620,0,216,879,279
2016,36081097202,"Census Tract 972.02, Queens County, New York",1171,173,998,992,2866,32604,1973,2010,1074,35.7,154,72,696,0,225,998,375
2017,36081097202,"Census Tract 972.02, Queens County, New York",1143,107,1036,1024,3189,34457,1972,2011,1117,36.1,150,51,784,0,198,1036,398
2018,36081097202,"Census Tract 972.02, Queens County, New York",1172,59,1113,1103,3135,31949,1971,2012,1165,38,152,46,843,7,206,1113,455
2019,36081097202,"Census Tract 972.02, Queens County, New York",1179,53,1126,1119,3036,31344,1970,2012,1148,36.7,123,35,886,6,193,1126,461
2020,36081097202,"Census Tract 972.02, Queens County, New York",1218,40,1178,1171,3258,25170,1972,2012,1172,40.5,122,58,921,33,140,1178,506
2012,36081097203,"Census Tract 972.03, Queens County, New York",2403,34,2369,2196,6932,14904,1968,2002,481,29.7,186,9,1599,91,637,2369,1068
2013,36081097203,"Census Tract 972.03, Queens County, New York",2443,157,2286,2183,6942,16211,1967,2002,433,29.4,227,47,1466,94,697,2286,1045
2014,36081097203,"Census Tract 972.03, Queens County, New York",2532,213,2319,2210,6603,19292,1964,2003,420,28.1,241,50,1434,61,765,2319,928
2015,36081097203,"Census Tract 972.03, Queens County, New York",2534,300,2234,2150,6187,19846,1959,2003,410,27.7,239,34,1316,55,831,2234,929
2016,36081097203,"Census Tract 972.03, Queens County, New York",2549,242,2307,2234,6583,20389,1959,2004,413,26.1,227,40,1294,72,876,2307,974
2017,36081097203,"Census Tract 972.03, Queens County, New York",2573,243,2330,2245,6781,25404,1961,2006,471,25.5,211,51,1292,64,891,2330,792
2018,36081097203,"Census Tract 972.03, Queens County, New York",2615,148,2467,2359,7082,28484,1960,2008,551,25.7,187,13,1352,125,925,2467,754
2019,36081097203,"Census Tract 972.03, Queens County, New York",2638,158,2480,2388,7165,30558,1963,2010,578,25.2,234,53,1336,142,904,2480,776
2012,36081097204,"Census Tract 972.04, Queens County, New York",1121,83,1038,668,1831,31500,1964,2004,693,24.7,89,26,545,0,151,1038,257
2013,36081097204,"Census Tract 972.04, Queens County, New York",1141,82,1059,752,1752,34429,1960,2003,746,20.9,148,26,585,0,168,1059,147
2014,36081097204,"Census Tract 972.04, Queens County, New York",1185,93,1092,801,1830,32819,1958,2003,785,25.2,148,37,559,0,208,1092,163
2015,36081097204,"Census Tract 972.04, Queens County, New York",1185,78,1107,804,2277,30918,1957,2003,801,29.1,95,58,519,0,235,1107,216
2016,36081097204,"Census Tract 972.04, Queens County, New York",1188,137,1051,850,2606,31111,1958,2004,798,27,76,45,525,0,301,1051,200
2017,36081097204,"Census Tract 972.04, Queens County, New York",1223,174,1049,852,2433,32372,1963,2007,815,25.1,64,12,546,0,359,1049,173
2018,36081097204,"Census Tract 972.04, Queens County, New York",1210,174,1036,858,2435,32418,1964,2006,746,25.6,66,12,507,0,365,1036,188
2019,36081097204,"Census Tract 972.04, Queens County, New York",1223,154,1069,803,2335,42128,1965,2007,729,19.9,78,13,485,0,347,1069,170
2020,36081097204,"Census Tract 972.04, Queens County, New York",1267,123,1144,846,2415,48578,1964,2010,839,19.9,153,0,489,40,377,1144,128
2020,36081097205,"Census Tract 972.05, Queens County, New York",1228,52,1176,1176,3523,25711,1962,2013,538,25.7,122,51,685,134,323,1176,392
2020,36081097206,"Census Tract 972.06, Queens County, New York",1359,88,1271,1130,3082,40248,1976,2010,586,19.5,117,11,695,0,299,1271,348
2020,36081097207,"Census Tract 972.07, Queens County, New York",0,0,0,0,0,NA,NA,NA,NA,NA,0,0,0,0,0,0,0
2012,36081097300,"Census Tract 973, Queens County, New York",771,17,754,93,164,15511,1949,2009,1732,50,22,10,0,0,83,754,4
2013,36081097300,"Census Tract 973, Queens County, New York",768,12,756,72,124,14808,1949,2009,NA,50,17,0,0,0,72,756,6
2014,36081097300,"Census Tract 973, Queens County, New York",766,10,756,76,130,14762,1949,2008,1732,50,17,5,0,0,71,756,14
2015,36081097300,"Census Tract 973, Queens County, New York",761,53,708,46,101,NA,1963,2012,1720,50,24,5,0,0,41,708,15
2016,36081097300,"Census Tract 973, Queens County, New York",757,73,684,62,87,16625,1945,2013,1728,50,21,39,0,0,23,684,15
2017,36081097300,"Census Tract 973, Queens County, New York",776,95,681,60,87,NA,1947,2016,1727,33.4,5,55,0,0,5,681,17
2018,36081097300,"Census Tract 973, Queens County, New York",789,125,664,66,118,74000,1948,2015,1725,32,12,61,0,0,5,664,22
2019,36081097300,"Census Tract 973, Queens County, New York",793,126,667,83,173,108438,1952,2014,1764,21.4,8,78,0,0,5,667,12
2020,36081097300,"Census Tract 973, Queens County, New York",780,75,705,111,264,82917,1954,2016,1855,33.4,5,90,0,0,21,705,17
2012,36081098100,"Census Tract 981, Queens County, New York",844,37,807,199,493,39639,1942,2004,1574,50,89,107,0,27,65,807,47
2013,36081098100,"Census Tract 981, Queens County, New York",845,44,801,158,391,39583,1955,2005,1750,50,63,57,0,31,70,801,54
2014,36081098100,"Census Tract 981, Queens County, New York",864,73,791,172,468,41736,1939,2005,1698,50,69,75,0,27,56,791,73
2015,36081098100,"Census Tract 981, Queens County, New York",862,67,795,155,428,52569,1951,2007,1616,34.8,36,78,0,24,40,795,75
2016,36081098100,"Census Tract 981, Queens County, New York",867,92,775,140,392,53194,1939,2007,1558,33.8,34,60,0,24,42,775,71
2017,36081098100,"Census Tract 981, Queens County, New York",883,102,781,135,398,56691,1966,2007,1730,34.6,46,58,0,31,34,781,57
2018,36081098100,"Census Tract 981, Queens County, New York",869,98,771,133,392,56458,1956,2007,1700,36.2,45,52,0,29,40,771,62
2019,36081098100,"Census Tract 981, Queens County, New York",847,105,742,115,295,66250,1979,2010,1689,35.9,37,46,0,43,26,742,53
2020,36081098100,"Census Tract 981, Queens County, New York",843,93,750,135,354,61518,1973,2016,1754,34.3,41,64,0,33,38,750,51
2012,36081098700,"Census Tract 987, Queens County, New York",975,22,953,248,667,82222,1955,2004,1429,24.3,108,149,0,24,75,953,9
2013,36081098700,"Census Tract 987, Queens County, New York",992,26,966,284,809,60962,1953,2005,1368,24.6,108,200,0,23,61,966,12
2014,36081098700,"Census Tract 987, Queens County, New York",992,56,936,285,736,68661,1952,2007,1558,23.7,112,175,15,22,73,936,20
2015,36081098700,"Census Tract 987, Queens County, New York",1001,91,910,213,565,45707,1953,2008,1496,36.6,74,129,17,22,45,910,39
2016,36081098700,"Census Tract 987, Queens County, New York",1012,133,879,236,595,49800,1952,2009,1470,28.5,68,149,17,38,32,879,40
2017,36081098700,"Census Tract 987, Queens County, New York",1006,158,848,183,478,57589,1955,2010,1571,38.9,39,126,16,36,5,848,48
2018,36081098700,"Census Tract 987, Queens County, New York",990,156,834,166,346,39444,1959,2011,1737,51,40,112,14,34,6,834,65
2019,36081098700,"Census Tract 987, Queens County, New York",991,135,856,190,356,29886,1963,2012,1579,43.7,29,157,0,26,7,856,81
2020,36081098700,"Census Tract 987, Queens County, New York",998,95,903,246,485,54583,1967,2014,1649,34.6,29,144,36,52,50,903,67
2012,36081099100,"Census Tract 991, Queens County, New York",3098,148,2950,520,1344,46765,1953,2001,1484,39.3,52,396,0,47,77,2950,159
2013,36081099100,"Census Tract 991, Queens County, New York",3108,182,2926,533,1411,49111,1953,2002,1527,37.9,162,378,0,28,83,2926,140
2014,36081099100,"Census Tract 991, Queens County, New York",3100,263,2837,447,971,49044,1954,2001,1366,37.5,165,293,0,48,62,2837,143
2015,36081099100,"Census Tract 991, Queens County, New York",3102,336,2766,467,1016,48869,1954,2003,1404,37,159,327,0,35,64,2766,145
2016,36081099100,"Census Tract 991, Queens County, New York",3099,380,2719,374,865,79107,1954,2006,1613,32.2,145,274,0,14,45,2719,102
2017,36081099100,"Census Tract 991, Queens County, New York",3133,276,2857,292,810,94167,1954,2009,2375,25.9,156,198,0,48,0,2857,98
2018,36081099100,"Census Tract 991, Queens County, New York",3163,293,2870,208,458,65882,1958,1999,1603,28.8,47,153,0,55,0,2870,142
2019,36081099100,"Census Tract 991, Queens County, New York",3143,230,2913,264,560,96293,1953,2015,1713,26.9,68,221,0,43,0,2913,186
2020,36081099100,"Census Tract 991, Queens County, New York",2971,164,2807,377,630,54461,1942,2016,1687,27.9,67,333,0,44,0,2807,220
2012,36081099200,"Census Tract 992, Queens County, New York",1373,188,1185,855,2821,41438,1973,2003,1081,29.9,108,103,540,0,248,1185,277
2013,36081099200,"Census Tract 992, Queens County, New York",1348,246,1102,822,2720,34583,1975,2004,1118,34,95,106,472,0,238,1102,323
2014,36081099200,"Census Tract 992, Queens County, New York",1389,177,1212,880,2630,25600,1973,2006,1127,39.7,95,119,493,0,236,1212,360
2015,36081099200,"Census Tract 992, Queens County, New York",1405,108,1297,969,2905,27052,1973,2010,1095,35.9,114,129,524,0,281,1297,329
2016,36081099200,"Census Tract 992, Queens County, New York",1426,88,1338,1025,3245,26207,1970,2011,1039,34.3,156,121,509,21,283,1338,390
2017,36081099200,"Census Tract 992, Queens County, New York",1402,88,1314,997,3023,23179,1970,2011,1049,42.6,172,151,445,22,336,1314,459
2018,36081099200,"Census Tract 992, Queens County, New York",1427,35,1392,1064,2969,25665,1969,2010,1006,37.9,173,146,544,26,308,1392,407
2019,36081099200,"Census Tract 992, Queens County, New York",1425,20,1405,1050,2969,27571,1968,2011,920,34.5,181,152,555,52,257,1405,357
2020,36081099200,"Census Tract 992, Queens County, New York",1544,100,1444,1118,3058,28144,1973,2011,1059,38.4,140,148,576,64,292,1444,400
2012,36081099701,"Census Tract 997.01, Queens County, New York",1263,96,1167,304,615,36875,1956,2000,1239,36.8,91,241,0,42,21,1167,94
2013,36081099701,"Census Tract 997.01, Queens County, New York",1252,57,1195,316,632,35795,1958,2003,1388,37.8,126,245,0,51,20,1195,90
2014,36081099701,"Census Tract 997.01, Queens County, New York",1265,56,1209,285,606,32969,1965,2006,1659,34.8,126,206,0,49,30,1209,116
2015,36081099701,"Census Tract 997.01, Queens County, New York",1275,98,1177,244,550,NA,1968,2008,1655,32.3,127,191,0,45,8,1177,87
2016,36081099701,"Census Tract 997.01, Queens County, New York",1299,99,1200,267,686,82950,1966,2011,1792,20.7,180,138,0,46,83,1200,66
2017,36081099701,"Census Tract 997.01, Queens County, New York",1309,80,1229,252,607,85500,1969,2012,1810,22,194,151,0,51,50,1229,121
2018,36081099701,"Census Tract 997.01, Queens County, New York",1307,64,1243,195,516,101406,1974,2014,2130,20.1,170,109,0,35,51,1243,106
2019,36081099701,"Census Tract 997.01, Queens County, New York",1313,67,1246,176,488,149196,1975,2016,2382,18.6,161,81,0,50,45,1246,55
2020,36081099701,"Census Tract 997.01, Queens County, New York",1187,37,1150,182,491,151250,1977,2016,2500,19,167,87,0,50,45,1150,60
2012,36081099703,"Census Tract 997.03, Queens County, New York",2052,129,1923,668,1817,49756,1971,2004,2001,38.3,331,377,0,162,129,1923,58
2013,36081099703,"Census Tract 997.03, Queens County, New York",2029,104,1925,665,1601,56612,1968,2004,2001,36.4,263,471,0,72,122,1925,58
2014,36081099703,"Census Tract 997.03, Queens County, New York",2042,231,1811,705,1688,68487,1969,2006,2001,34.9,361,440,9,149,107,1811,71
2015,36081099703,"Census Tract 997.03, Queens County, New York",2031,222,1809,677,1529,77639,1968,2007,2050,28.1,330,479,6,112,80,1809,75
2016,36081099703,"Census Tract 997.03, Queens County, New York",2043,274,1769,745,1825,84671,1970,2007,2085,28.4,373,467,10,150,118,1769,93
2017,36081099703,"Census Tract 997.03, Queens County, New York",2050,281,1769,599,1464,103494,1968,2010,2133,23.8,349,418,11,159,11,1769,90
2018,36081099703,"Census Tract 997.03, Queens County, New York",2024,293,1731,548,1263,105449,1968,2011,2098,26.8,336,334,13,189,12,1731,94
2019,36081099703,"Census Tract 997.03, Queens County, New York",2015,227,1788,523,1172,77663,1967,2012,2105,29.5,332,296,0,159,68,1788,82
2020,36081099703,"Census Tract 997.03, Queens County, New York",1830,171,1659,521,1108,86477,1967,2013,2149,24.5,353,280,0,145,96,1659,56
2012,36081099704,"Census Tract 997.04, Queens County, New York",3888,95,3793,1447,3075,77917,1973,2003,1590,27.8,906,948,79,325,95,3793,336
2013,36081099704,"Census Tract 997.04, Queens County, New York",3836,190,3646,1358,2938,69414,1973,2004,1647,29.1,847,864,51,308,135,3646,393
2014,36081099704,"Census Tract 997.04, Queens County, New York",3781,188,3593,1238,2728,67966,1974,2005,1788,33.6,803,815,41,260,122,3593,397
2015,36081099704,"Census Tract 997.04, Queens County, New York",3881,237,3644,1235,2605,64335,1976,2008,1640,28.9,774,836,34,213,152,3644,394
2016,36081099704,"Census Tract 997.04, Queens County, New York",3902,413,3489,1241,2759,63185,1978,2010,1800,26.5,771,714,63,276,188,3489,344
2017,36081099704,"Census Tract 997.04, Queens County, New York",3974,500,3474,1115,2274,67768,1980,2010,1901,28,722,708,0,246,161,3474,385
2018,36081099704,"Census Tract 997.04, Queens County, New York",4072,382,3690,1195,2391,69779,1980,2010,2002,27.4,809,732,12,256,195,3690,377
2019,36081099704,"Census Tract 997.04, Queens County, New York",4059,402,3657,1164,2052,68393,1979,2011,2038,27.7,792,710,29,267,158,3657,379
2020,36081099704,"Census Tract 997.04, Queens County, New York",4097,525,3572,1057,1753,54618,1977,2012,2021,29.3,706,631,35,203,188,3572,285
2012,36081099705,"Census Tract 997.05, Queens County, New York",1110,107,1003,311,1004,126514,1978,2006,2001,26.1,256,164,0,138,9,1003,61
2013,36081099705,"Census Tract 997.05, Queens County, New York",1112,91,1021,274,712,125227,1977,2007,2001,24.5,214,182,0,80,12,1021,47
2014,36081099705,"Census Tract 997.05, Queens County, New York",1119,95,1024,285,755,156125,1975,2007,2001,20.1,247,207,0,54,24,1024,30
2015,36081099705,"Census Tract 997.05, Queens County, New York",1134,90,1044,314,902,126818,1973,2008,2256,14.6,216,206,0,69,39,1044,82
2016,36081099705,"Census Tract 997.05, Queens County, New York",1116,147,969,250,777,105500,1969,2011,2430,25.2,216,125,0,75,50,969,117
2017,36081099705,"Census Tract 997.05, Queens County, New York",1138,94,1044,292,866,106154,1971,2011,2342,25.4,247,120,0,103,69,1044,133
2018,36081099705,"Census Tract 997.05, Queens County, New York",1148,93,1055,291,872,107917,1969,2012,2341,26.2,244,114,0,118,59,1055,135
2019,36081099705,"Census Tract 997.05, Queens County, New York",1119,138,981,236,658,100476,1972,2012,2367,27.9,191,65,0,122,49,981,100
2020,36081099705,"Census Tract 997.05, Queens County, New York",1242,303,939,274,1050,115365,1969,2014,2176,26.9,195,52,0,128,94,939,51
2012,36081099801,"Census Tract 998.01, Queens County, New York",2510,297,2213,1853,5187,48644,1956,2004,1115,27.9,423,110,1267,20,482,2213,456
2013,36081099801,"Census Tract 998.01, Queens County, New York",2469,333,2136,1668,4417,49601,1957,2004,1124,27.7,334,86,1160,31,421,2136,324
2014,36081099801,"Census Tract 998.01, Queens County, New York",2489,243,2246,1707,4682,49457,1956,2004,1167,26.8,278,191,1124,34,396,2246,323
2015,36081099801,"Census Tract 998.01, Queens County, New York",2496,253,2243,1618,4849,49167,1956,2004,1133,25.4,326,281,990,35,312,2243,360
2016,36081099801,"Census Tract 998.01, Queens County, New York",2670,262,2408,1743,5122,41597,1957,2007,1213,28.4,370,237,1100,34,438,2408,313
2017,36081099801,"Census Tract 998.01, Queens County, New York",2678,273,2405,1648,4855,51424,1957,2009,1317,26.6,311,261,1072,19,402,2405,269
2018,36081099801,"Census Tract 998.01, Queens County, New York",2793,219,2574,1874,5602,64844,1958,2009,1400,23.4,384,174,1322,41,413,2574,249
2019,36081099801,"Census Tract 998.01, Queens County, New York",2780,224,2556,2103,6453,69538,1958,2011,1490,23.6,450,106,1558,60,455,2556,151
2020,36081099801,"Census Tract 998.01, Queens County, New York",2732,98,2634,2233,6556,59914,1959,2011,1465,25.3,330,68,1413,70,685,2634,170
2012,36081099802,"Census Tract 998.02, Queens County, New York",2904,375,2529,2404,4732,19104,1965,2004,547,28.2,731,1070,1035,96,198,2529,877
2013,36081099802,"Census Tract 998.02, Queens County, New York",2925,489,2436,2274,4474,20964,1962,2004,820,28.7,679,814,1175,92,175,2436,805
2014,36081099802,"Census Tract 998.02, Queens County, New York",2952,381,2571,2347,4779,21459,1963,2006,876,29.8,653,771,1304,55,207,2571,759
2015,36081099802,"Census Tract 998.02, Queens County, New York",2983,334,2649,2424,4699,33148,1967,2007,1003,33.4,870,651,1497,77,171,2649,762
2016,36081099802,"Census Tract 998.02, Queens County, New York",2969,490,2479,2296,5111,31326,1966,2008,1002,34.4,935,703,1315,80,257,2479,902
2017,36081099802,"Census Tract 998.02, Queens County, New York",3010,458,2552,2332,4932,33279,1969,2009,1139,32.2,1083,748,1244,40,319,2552,897
2018,36081099802,"Census Tract 998.02, Queens County, New York",3033,357,2676,2513,5695,41739,1978,2011,1236,31.7,1211,741,1282,94,459,2676,833
2019,36081099802,"Census Tract 998.02, Queens County, New York",2977,308,2669,2644,6340,44085,1974,2011,1212,32.5,1256,848,1360,93,392,2669,742
2020,36081099802,"Census Tract 998.02, Queens County, New York",2655,205,2450,2387,5856,49821,1973,2012,1271,30.9,1080,681,1253,80,421,2450,715
2012,36081099900,"Census Tract 999, Queens County, New York",0,0,0,0,0,NA,NA,NA,NA,NA,0,0,0,0,0,0,0
2013,36081099900,"Census Tract 999, Queens County, New York",0,0,0,0,0,NA,NA,NA,NA,NA,0,0,0,0,0,0,0
2014,36081099900,"Census Tract 999, Queens County, New York",0,0,0,0,0,NA,NA,NA,NA,NA,0,0,0,0,0,0,0
2015,36081099900,"Census Tract 999, Queens County, New York",0,0,0,0,0,NA,NA,NA,NA,NA,0,0,0,0,0,0,0
2016,36081099900,"Census Tract 999, Queens County, New York",0,0,0,0,0,NA,NA,NA,NA,NA,0,0,0,0,0,0,0
2017,36081099900,"Census Tract 999, Queens County, New York",0,0,0,0,0,NA,NA,NA,NA,NA,0,0,0,0,0,0,0
2018,36081099900,"Census Tract 999, Queens County, New York",0,0,0,0,0,NA,NA,NA,NA,NA,0,0,0,0,0,0,0
2019,36081099900,"Census Tract 999, Queens County, New York",0,0,0,0,0,NA,NA,NA,NA,NA,0,0,0,0,0,0,0
2020,36081099900,"Census Tract 999, Queens County, New York",0,0,0,0,0,NA,NA,NA,NA,NA,0,0,0,0,0,0,0
2012,36081100801,"Census Tract 1008.01, Queens County, New York",722,57,665,165,757,44432,1955,2004,1149,29.8,25,92,65,0,8,665,111
2013,36081100801,"Census Tract 1008.01, Queens County, New York",721,48,673,168,566,16622,1955,2005,1417,50,47,63,72,0,33,673,136
2014,36081100801,"Census Tract 1008.01, Queens County, New York",686,71,615,177,578,17083,1955,2005,1596,50,79,64,84,0,29,615,134
2015,36081100801,"Census Tract 1008.01, Queens County, New York",683,75,608,193,625,NA,1954,2005,1639,50,85,73,80,0,40,608,135
2016,36081100801,"Census Tract 1008.01, Queens County, New York",671,55,616,142,506,41923,1955,2005,1679,50,98,46,82,14,0,616,59
2017,36081100801,"Census Tract 1008.01, Queens County, New York",674,43,631,140,511,51875,1955,2005,1708,44,78,46,80,14,0,631,44
2018,36081100801,"Census Tract 1008.01, Queens County, New York",681,48,633,108,406,64583,1956,2003,1781,40.6,51,25,69,14,0,633,47
2019,36081100801,"Census Tract 1008.01, Queens County, New York",698,35,663,111,461,63036,1960,2009,1738,44.3,22,35,57,19,0,663,45
2020,36081100801,"Census Tract 1008.01, Queens County, New York",690,21,669,136,527,77500,1960,2011,1716,35,53,38,61,37,0,669,41
2012,36081100802,"Census Tract 1008.02, Queens County, New York",2623,240,2383,1369,4607,37841,1955,2005,1264,31.6,379,148,733,28,419,2383,593
2013,36081100802,"Census Tract 1008.02, Queens County, New York",2613,173,2440,1325,4656,39785,1953,2005,1171,30.5,410,165,608,28,448,2440,551
2014,36081100802,"Census Tract 1008.02, Queens County, New York",2594,181,2413,1233,4492,39153,1954,2006,1242,32.8,265,151,526,16,480,2413,546
2015,36081100802,"Census Tract 1008.02, Queens County, New York",2593,124,2469,1272,5224,50000,1958,2008,1276,30.3,311,150,533,0,574,2469,420
2016,36081100802,"Census Tract 1008.02, Queens County, New York",2598,107,2491,1310,5088,45901,1965,2011,1241,33.9,323,188,529,33,547,2491,447
2017,36081100802,"Census Tract 1008.02, Queens County, New York",2602,59,2543,1257,4404,44745,1957,2010,1291,35.2,341,217,528,21,512,2543,448
2018,36081100802,"Census Tract 1008.02, Queens County, New York",2588,30,2558,1451,5041,52530,1963,2012,1431,31.9,340,207,732,24,514,2558,418
2019,36081100802,"Census Tract 1008.02, Queens County, New York",2570,0,2570,1463,4930,54969,1963,2012,1417,27.8,401,233,704,23,503,2570,428
2020,36081100803,"Census Tract 1008.03, Queens County, New York",1244,43,1201,722,2310,40580,1958,2012,1017,31.8,144,73,378,15,285,1201,388
2020,36081100804,"Census Tract 1008.04, Queens County, New York",1493,60,1433,657,1751,52064,1988,2011,1727,39.2,216,64,540,33,20,1433,90
2012,36081101001,"Census Tract 1010.01, Queens County, New York",3444,461,2983,2397,6603,27459,1966,2004,1007,33.9,286,364,1162,39,956,2983,999
2013,36081101001,"Census Tract 1010.01, Queens County, New York",3432,410,3022,2524,6413,21575,1967,2004,1001,35.9,309,406,1091,29,999,3022,1109
2014,36081101001,"Census Tract 1010.01, Queens County, New York",3465,338,3127,2686,6808,20477,1967,2005,1034,36.1,338,410,1091,18,1167,3127,1234
2015,36081101001,"Census Tract 1010.01, Queens County, New York",3522,299,3223,2743,7552,21151,1967,2006,1006,34,342,376,1045,29,1250,3223,1184
2016,36081101001,"Census Tract 1010.01, Queens County, New York",3542,222,3320,2916,7640,20890,1969,2005,1024,36.2,490,444,1296,40,1133,3320,1184
2017,36081101001,"Census Tract 1010.01, Queens County, New York",3580,201,3379,2924,7431,22645,1970,2005,1000,35.1,536,376,1381,52,1153,3379,1212
2018,36081101001,"Census Tract 1010.01, Queens County, New York",3497,172,3325,2742,7209,28466,1967,2006,1018,31.2,604,396,1285,58,1102,3325,930
2019,36081101001,"Census Tract 1010.01, Queens County, New York",3433,90,3343,2734,7640,33500,1962,2008,1059,32.3,565,452,1355,57,965,3343,841
2012,36081101002,"Census Tract 1010.02, Queens County, New York",1663,107,1556,1090,1938,12669,1973,2004,965,50,304,616,366,0,176,1556,663
2013,36081101002,"Census Tract 1010.02, Queens County, New York",1698,121,1577,1108,2043,13307,1973,2005,1027,50,335,663,383,0,125,1577,629
2014,36081101002,"Census Tract 1010.02, Queens County, New York",1745,157,1588,1123,2100,15341,1973,2006,1028,50,361,669,381,0,142,1588,572
2015,36081101002,"Census Tract 1010.02, Queens County, New York",1754,194,1560,1126,2058,21842,1974,2010,1059,44.8,297,565,514,0,112,1560,506
2016,36081101002,"Census Tract 1010.02, Queens County, New York",1743,205,1538,1199,2304,23520,1974,2011,1167,46.9,328,577,523,0,140,1538,482
2017,36081101002,"Census Tract 1010.02, Queens County, New York",1783,199,1584,1166,2071,20952,1974,2012,1143,47,250,514,549,9,105,1584,504
2018,36081101002,"Census Tract 1010.02, Queens County, New York",1820,220,1600,1119,1832,21476,1971,2013,1137,46.4,213,353,612,43,123,1600,468
2019,36081101002,"Census Tract 1010.02, Queens County, New York",1841,185,1656,1130,1737,16463,1972,2013,1111,51,194,359,560,55,167,1656,600
2020,36081101002,"Census Tract 1010.02, Queens County, New York",1736,102,1634,1012,1538,12071,1974,2014,1121,51,197,337,466,55,181,1634,569
2020,36081101003,"Census Tract 1010.03, Queens County, New York",1170,32,1138,997,2917,53422,1958,2012,1532,22.7,288,275,397,3,385,1138,155
2020,36081101004,"Census Tract 1010.04, Queens County, New York",2454,47,2407,1769,4115,26029,1961,2008,1054,37.3,462,261,1016,120,417,2407,704
2012,36081101700,"Census Tract 1017, Queens County, New York",2550,183,2367,462,1115,40617,1956,1998,1030,26.6,183,355,0,83,24,2367,168
2013,36081101700,"Census Tract 1017, Queens County, New York",2547,181,2366,438,1071,41607,1955,2001,1154,24.6,227,358,0,34,30,2366,142
2014,36081101700,"Census Tract 1017, Queens County, New York",2555,176,2379,416,849,41757,1956,2000,1150,26.3,222,346,0,37,16,2379,205
2015,36081101700,"Census Tract 1017, Queens County, New York",2559,95,2464,436,918,50698,1956,2008,1579,23.9,181,271,0,69,79,2464,169
2016,36081101700,"Census Tract 1017, Queens County, New York",2522,101,2421,507,1237,NA,1958,2008,1812,24.3,165,252,0,95,142,2421,215
2017,36081101700,"Census Tract 1017, Queens County, New York",2562,191,2371,424,1011,93547,1960,2009,2000,24.9,157,150,0,99,158,2371,177
2018,36081101700,"Census Tract 1017, Queens County, New York",2579,138,2441,405,880,53630,1959,2008,1595,28.4,91,131,0,95,179,2441,170
2019,36081101700,"Census Tract 1017, Queens County, New York",2580,176,2404,378,847,55541,1960,2007,1574,28.8,83,144,0,74,160,2404,205
2020,36081101700,"Census Tract 1017, Queens County, New York",2424,176,2248,295,748,41971,1963,2004,1750,49.3,76,101,0,76,118,2248,203
2012,36081102900,"Census Tract 1029, Queens County, New York",1350,117,1233,569,1728,93266,1968,2005,1787,23.6,178,257,0,100,212,1233,50
2013,36081102900,"Census Tract 1029, Queens County, New York",1360,57,1303,643,1846,77985,1967,2005,1755,24.7,218,309,0,131,203,1303,49
2014,36081102900,"Census Tract 1029, Queens County, New York",1356,57,1299,627,1755,65491,1970,2006,1719,29.2,186,321,0,116,190,1299,86
2015,36081102900,"Census Tract 1029, Queens County, New York",1345,27,1318,534,1466,63750,1971,2007,1680,31.1,172,276,0,96,162,1318,62
2016,36081102900,"Census Tract 1029, Queens County, New York",1354,54,1300,408,945,51429,1968,2010,1630,37.8,107,320,0,49,39,1300,67
2017,36081102900,"Census Tract 1029, Queens County, New York",1370,29,1341,464,1160,50172,1966,2010,1642,37.3,92,326,0,81,42,1341,52
2018,36081102900,"Census Tract 1029, Queens County, New York",1378,29,1349,410,1014,56324,1969,2009,1709,35.6,65,284,0,44,68,1349,58
2019,36081102900,"Census Tract 1029, Queens County, New York",1425,121,1304,404,1080,64107,1966,2007,1888,34.6,86,237,0,63,90,1304,38
2020,36081102900,"Census Tract 1029, Queens County, New York",1556,143,1413,670,1520,73636,1976,2001,1868,28.4,227,368,0,72,93,1413,23
2012,36081103201,"Census Tract 1032.01, Queens County, New York",2065,178,1887,1536,4693,18871,1962,2003,951,41.5,122,64,956,43,470,1887,788
2013,36081103201,"Census Tract 1032.01, Queens County, New York",2060,192,1868,1512,5250,24159,1961,2004,941,41,134,35,968,44,448,1868,657
2014,36081103201,"Census Tract 1032.01, Queens County, New York",2112,153,1959,1550,5668,23849,1964,2006,941,38.8,133,30,926,48,551,1959,691
2015,36081103201,"Census Tract 1032.01, Queens County, New York",2168,188,1980,1587,5735,26458,1955,2008,1028,43.1,134,0,957,14,657,1980,620
2016,36081103201,"Census Tract 1032.01, Queens County, New York",2132,176,1956,1521,5022,25571,1956,2008,896,37.7,73,10,883,12,658,1956,564
2017,36081103201,"Census Tract 1032.01, Queens County, New York",2108,174,1934,1591,5301,25309,1957,2011,896,38.7,60,34,815,19,743,1934,639
2018,36081103201,"Census Tract 1032.01, Queens County, New York",2121,119,2002,1655,5125,28285,1952,2011,1212,36.1,143,71,818,37,735,2002,642
2019,36081103201,"Census Tract 1032.01, Queens County, New York",2068,125,1943,1602,5240,37835,1955,2011,1266,36,96,92,756,31,745,1943,617
2020,36081103201,"Census Tract 1032.01, Queens County, New York",1905,152,1753,1454,4959,33214,1963,2011,1283,34.4,80,98,711,31,606,1753,628
2012,36081103202,"Census Tract 1032.02, Queens County, New York",1952,108,1844,1135,3400,40030,1949,2005,1212,35.3,232,328,517,0,291,1844,296
2013,36081103202,"Census Tract 1032.02, Queens County, New York",1927,133,1794,1097,3418,42542,1952,2007,1262,37.4,197,303,402,0,359,1794,251
2014,36081103202,"Census Tract 1032.02, Queens County, New York",1925,103,1822,1206,4148,45145,1959,2008,1331,37.2,150,303,395,0,465,1822,268
2015,36081103202,"Census Tract 1032.02, Queens County, New York",1933,101,1832,1310,4982,43452,1963,2009,1377,41.4,256,373,360,14,519,1832,280
2016,36081103202,"Census Tract 1032.02, Queens County, New York",1933,66,1867,1339,5374,46603,1961,2010,1482,40.8,237,396,243,12,690,1867,287
2017,36081103202,"Census Tract 1032.02, Queens County, New York",1940,64,1876,1379,5586,46026,1963,2009,1542,43,277,412,296,12,681,1876,377
2018,36081103202,"Census Tract 1032.02, Queens County, New York",1981,61,1920,1383,5548,45234,1965,2010,1668,42.2,360,429,326,28,622,1920,442
2019,36081103202,"Census Tract 1032.02, Queens County, New York",2016,34,1982,1479,5736,46671,1959,2010,1731,40.6,376,454,306,31,673,1982,432
2020,36081103202,"Census Tract 1032.02, Queens County, New York",2308,52,2256,1601,5552,62264,1960,2013,1707,33.8,501,496,313,12,748,2256,415
2012,36081103300,"Census Tract 1033, Queens County, New York",1524,73,1451,504,1465,66176,1955,2003,1492,29.5,125,303,0,164,37,1451,76
2013,36081103300,"Census Tract 1033, Queens County, New York",1582,29,1553,470,1463,60931,1956,2004,1645,32.6,118,268,0,162,40,1553,85
2014,36081103300,"Census Tract 1033, Queens County, New York",1558,121,1437,408,1107,59205,1959,2006,1727,35.5,109,275,0,93,40,1437,106
2015,36081103300,"Census Tract 1033, Queens County, New York",1572,143,1429,427,1076,55050,1971,2009,1718,37.4,132,281,0,121,25,1429,113
2016,36081103300,"Census Tract 1033, Queens County, New York",1588,150,1438,380,970,55577,1971,2009,1693,37,138,269,0,84,27,1438,62
2017,36081103300,"Census Tract 1033, Queens County, New York",1604,140,1464,402,961,51409,1975,2010,1725,39.5,168,279,0,123,0,1464,84
2018,36081103300,"Census Tract 1033, Queens County, New York",1598,174,1424,400,1039,53598,1977,2012,1792,21.9,212,285,11,99,16,1424,75
2019,36081103300,"Census Tract 1033, Queens County, New York",1625,144,1481,493,1243,44792,1971,2013,1759,26.2,230,355,16,116,11,1481,86
2020,36081103300,"Census Tract 1033, Queens County, New York",1465,102,1363,479,1451,66369,1967,2014,1853,29.4,192,320,19,124,25,1363,82
2012,36081103900,"Census Tract 1039, Queens County, New York",2281,217,2064,976,2507,51406,1958,2003,1570,33.7,388,650,0,246,80,2064,110
2013,36081103900,"Census Tract 1039, Queens County, New York",2244,152,2092,944,2691,56094,1957,2005,1592,30.8,360,601,0,256,87,2092,105
2014,36081103900,"Census Tract 1039, Queens County, New York",2213,103,2110,919,2748,62996,1959,2005,1748,31.6,381,582,0,210,127,2110,120
2015,36081103900,"Census Tract 1039, Queens County, New York",2261,154,2107,907,2752,61297,1959,2008,1666,30.9,442,381,0,355,171,2107,111
2016,36081103900,"Census Tract 1039, Queens County, New York",2220,159,2061,871,2557,62232,1960,2009,1639,30.3,419,347,0,358,153,2061,103
2017,36081103900,"Census Tract 1039, Queens County, New York",2258,160,2098,809,2791,64986,1959,2011,1820,30.4,478,254,0,392,148,2098,111
2018,36081103900,"Census Tract 1039, Queens County, New York",2298,197,2101,807,2439,66732,1960,2011,1780,29.9,506,232,0,341,215,2101,187
2019,36081103900,"Census Tract 1039, Queens County, New York",2306,199,2107,969,2755,66595,1955,2012,1775,28.1,523,295,0,437,218,2107,199
2020,36081103900,"Census Tract 1039, Queens County, New York",2333,144,2189,1026,2831,44542,1953,2015,1805,37.1,358,411,0,368,247,2189,335
2012,36081104700,"Census Tract 1047, Queens County, New York",2683,168,2515,880,2130,58750,1959,2003,1420,29.9,323,523,0,241,90,2515,119
2013,36081104700,"Census Tract 1047, Queens County, New York",2751,147,2604,949,2335,55694,1960,2004,1434,29.7,300,579,0,262,80,2604,106
2014,36081104700,"Census Tract 1047, Queens County, New York",2719,253,2466,847,2197,40069,1956,2004,1408,31.3,163,535,0,205,53,2466,157
2015,36081104700,"Census Tract 1047, Queens County, New York",2731,213,2518,935,2417,50926,1957,2006,1608,30.7,189,441,0,278,95,2518,238
2016,36081104700,"Census Tract 1047, Queens County, New York",2864,188,2676,1077,2783,50111,1955,2006,1641,33.4,209,410,0,359,182,2676,315
2017,36081104700,"Census Tract 1047, Queens County, New York",2888,269,2619,962,2529,34844,1954,2009,1652,38.7,200,270,0,400,160,2619,378
2018,36081104700,"Census Tract 1047, Queens County, New York",2837,231,2606,1010,2391,42955,1954,2010,1620,47.3,207,240,0,438,199,2606,367
2019,36081104700,"Census Tract 1047, Queens County, New York",2857,187,2670,998,2253,37391,1957,2010,1860,51,195,224,0,502,172,2670,304
2020,36081104700,"Census Tract 1047, Queens County, New York",2901,302,2599,1159,2849,53859,1960,2012,1738,43.8,194,222,0,515,397,2599,257
2012,36081105900,"Census Tract 1059, Queens County, New York",1354,132,1222,217,495,58958,1957,2004,1432,26.8,75,84,0,105,28,1222,27
2013,36081105900,"Census Tract 1059, Queens County, New York",1340,61,1279,174,406,86250,1959,2004,1604,18,33,63,0,80,31,1279,32
2014,36081105900,"Census Tract 1059, Queens County, New York",1332,58,1274,192,490,87500,1970,2006,1750,19.1,39,51,0,96,37,1274,46
2015,36081105900,"Census Tract 1059, Queens County, New York",1331,54,1277,213,559,90875,1958,2010,1781,16.5,61,101,0,94,9,1277,56
2016,36081105900,"Census Tract 1059, Queens County, New York",1321,54,1267,214,622,90000,1959,2011,1859,15.7,71,80,0,105,10,1267,79
2017,36081105900,"Census Tract 1059, Queens County, New York",1379,20,1359,178,599,65909,1964,2012,1930,28.8,41,52,0,95,11,1359,109
2018,36081105900,"Census Tract 1059, Queens County, New York",1368,80,1288,167,576,69125,1965,2012,2038,28.9,54,54,0,85,10,1288,116
2019,36081105900,"Census Tract 1059, Queens County, New York",1357,75,1282,141,482,70875,1958,2012,1853,30.8,56,74,0,57,0,1282,100
2020,36081105900,"Census Tract 1059, Queens County, New York",1323,119,1204,120,440,44848,1965,2012,1863,42,49,48,0,63,0,1204,87
2012,36081107201,"Census Tract 1072.01, Queens County, New York",1046,222,824,181,382,27163,1939,1997,917,50,7,173,0,0,8,824,47
2013,36081107201,"Census Tract 1072.01, Queens County, New York",1022,226,796,155,318,41625,1939,1998,814,50,6,126,0,0,29,796,49
2014,36081107201,"Census Tract 1072.01, Queens County, New York",1002,207,795,148,308,41818,1939,2007,1219,50,14,119,0,6,23,795,76
2015,36081107201,"Census Tract 1072.01, Queens County, New York",999,161,838,168,423,52917,1940,2011,1420,49,20,137,0,7,24,838,81
2016,36081107201,"Census Tract 1072.01, Queens County, New York",965,106,859,150,419,54412,1941,2011,1450,40,20,122,0,5,23,859,74
2017,36081107201,"Census Tract 1072.01, Queens County, New York",967,161,806,147,359,55078,1941,2011,1637,50,21,118,0,6,23,806,39
2018,36081107201,"Census Tract 1072.01, Queens County, New York",996,224,772,172,492,60536,1943,2009,1663,29,32,142,0,6,24,772,52
2019,36081107201,"Census Tract 1072.01, Queens County, New York",1003,194,809,181,445,44141,0,2009,1545,28.8,75,131,0,0,50,809,82
2020,36081107201,"Census Tract 1072.01, Queens County, New York",990,177,813,176,374,43485,0,2006,1345,51,60,94,16,5,61,813,104
2012,36081107202,"Census Tract 1072.02, Queens County, New York",0,0,0,0,0,NA,NA,NA,NA,NA,0,0,0,0,0,0,0
2013,36081107202,"Census Tract 1072.02, Queens County, New York",0,0,0,0,0,NA,NA,NA,NA,NA,0,0,0,0,0,0,0
2014,36081107202,"Census Tract 1072.02, Queens County, New York",0,0,0,0,0,NA,NA,NA,NA,NA,0,0,0,0,0,0,0
2015,36081107202,"Census Tract 1072.02, Queens County, New York",0,0,0,0,0,NA,NA,NA,NA,NA,0,0,0,0,0,0,0
2016,36081107202,"Census Tract 1072.02, Queens County, New York",0,0,0,0,0,NA,NA,NA,NA,NA,0,0,0,0,0,0,0
2017,36081107202,"Census Tract 1072.02, Queens County, New York",0,0,0,0,0,NA,NA,NA,NA,NA,0,0,0,0,0,0,0
2018,36081107202,"Census Tract 1072.02, Queens County, New York",0,0,0,0,0,NA,NA,NA,NA,NA,0,0,0,0,0,0,0
2019,36081107202,"Census Tract 1072.02, Queens County, New York",0,0,0,0,0,NA,NA,NA,NA,NA,0,0,0,0,0,0,0
2020,36081107202,"Census Tract 1072.02, Queens County, New York",0,0,0,0,0,NA,NA,NA,NA,NA,0,0,0,0,0,0,0
2012,36081108500,"Census Tract 1085, Queens County, New York",975,0,975,317,766,58008,1947,2005,1250,29.7,166,174,0,123,0,975,89
2013,36081108500,"Census Tract 1085, Queens County, New York",1004,0,1004,304,752,65104,1956,2006,1656,31.8,137,152,0,131,0,1004,95
2014,36081108500,"Census Tract 1085, Queens County, New York",1043,17,1026,332,834,37609,1950,2006,1564,36.3,108,128,0,155,30,1026,110
2015,36081108500,"Census Tract 1085, Queens County, New York",1003,52,951,339,853,39034,1954,2007,1587,34.6,94,131,0,160,29,951,114
2016,36081108500,"Census Tract 1085, Queens County, New York",1007,93,914,297,699,39836,1958,2007,1416,36.5,50,118,0,144,35,914,109
2017,36081108500,"Census Tract 1085, Queens County, New York",986,88,898,292,709,46136,1954,2007,1413,35.3,67,125,0,127,40,898,101
2018,36081108500,"Census Tract 1085, Queens County, New York",961,110,851,318,839,63421,1950,2009,1468,32.1,67,130,7,133,48,851,101
2019,36081108500,"Census Tract 1085, Queens County, New York",955,91,864,305,788,72708,1955,2012,1668,32.6,122,100,16,113,76,864,55
2020,36081108500,"Census Tract 1085, Queens County, New York",1056,94,962,294,861,66000,1955,2016,1800,37.2,119,77,31,115,71,962,54
2012,36081109300,"Census Tract 1093, Queens County, New York",1141,79,1062,88,302,93500,1956,2006,1811,37.1,47,41,0,37,10,1062,16
2013,36081109300,"Census Tract 1093, Queens County, New York",1136,94,1042,134,531,76413,1961,2006,1907,37.9,63,60,0,63,11,1042,8
2014,36081109300,"Census Tract 1093, Queens County, New York",1136,80,1056,95,334,76042,1965,2007,1910,47.2,63,60,0,24,11,1056,17
2015,36081109300,"Census Tract 1093, Queens County, New York",1115,53,1062,119,409,NA,1966,2010,1794,50,67,62,0,36,21,1062,17
2016,36081109300,"Census Tract 1093, Queens County, New York",1107,24,1083,161,454,NA,1966,2010,1658,50,75,101,0,37,23,1083,46
2017,36081109300,"Census Tract 1093, Queens County, New York",1112,25,1087,155,494,NA,1962,2009,1856,50,48,90,0,39,26,1087,75
2018,36081109300,"Census Tract 1093, Queens County, New York",1115,40,1075,158,412,26786,1958,2014,1769,51,61,87,0,45,26,1075,121
2019,36081109300,"Census Tract 1093, Queens County, New York",1115,42,1073,162,437,NA,1955,2015,1611,51,51,82,0,44,36,1073,131
2020,36081109300,"Census Tract 1093, Queens County, New York",1048,47,1001,142,402,NA,1949,2013,2219,23.3,53,87,0,37,18,1001,104
2012,36081109700,"Census Tract 1097, Queens County, New York",730,72,658,149,475,62083,1973,2004,1490,31,118,73,14,17,45,658,23
2013,36081109700,"Census Tract 1097, Queens County, New York",710,54,656,206,572,61964,1963,2005,1777,30.2,141,131,16,13,46,656,23
2014,36081109700,"Census Tract 1097, Queens County, New York",697,45,652,198,507,61429,1949,2005,1632,31.2,119,115,14,26,43,652,14
2015,36081109700,"Census Tract 1097, Queens County, New York",702,67,635,186,382,92059,1949,2007,1776,26.1,95,133,0,30,23,635,17
2016,36081109700,"Census Tract 1097, Queens County, New York",693,66,627,184,385,91250,1952,2010,1786,27.1,95,125,0,31,28,627,13
2017,36081109700,"Census Tract 1097, Queens County, New York",700,61,639,176,428,83750,1953,2011,1981,26.2,74,120,7,35,14,639,7
2018,36081109700,"Census Tract 1097, Queens County, New York",698,60,638,138,328,86250,1969,2011,1456,29.1,60,61,6,48,23,638,7
2019,36081109700,"Census Tract 1097, Queens County, New York",697,68,629,147,329,81607,1963,2013,2054,29.7,61,69,6,43,29,629,10
2020,36081109700,"Census Tract 1097, Queens County, New York",717,87,630,128,290,81250,1949,2015,3053,36.1,63,44,14,49,30,630,11
2012,36081109900,"Census Tract 1099, Queens County, New York",1236,62,1174,258,671,46042,1953,2005,1375,34.8,154,137,0,93,12,1174,135
2013,36081109900,"Census Tract 1099, Queens County, New York",1234,54,1180,301,926,49963,1958,2006,1446,28.1,173,149,0,115,23,1180,142
2014,36081109900,"Census Tract 1099, Queens County, New York",1241,58,1183,293,954,66806,1956,2006,1441,24.7,138,122,0,75,84,1183,70
2015,36081109900,"Census Tract 1099, Queens County, New York",1226,9,1217,245,885,57604,1957,2006,1504,28.3,133,61,0,83,89,1217,80
2016,36081109900,"Census Tract 1099, Queens County, New York",1195,37,1158,300,953,75565,1950,2008,1484,25.4,117,79,0,101,108,1158,83
2017,36081109900,"Census Tract 1099, Queens County, New York",1166,50,1116,309,990,67422,1950,2008,1629,28.3,101,84,3,115,99,1116,70
2018,36081109900,"Census Tract 1099, Queens County, New York",1159,51,1108,336,791,56818,1951,2010,1426,29.6,84,91,8,136,97,1108,92
2019,36081109900,"Census Tract 1099, Queens County, New York",1153,46,1107,336,803,57500,1958,2011,1499,33.6,101,104,8,169,48,1107,109
2020,36081109900,"Census Tract 1099, Queens County, New York",1241,72,1169,311,697,52292,1959,2011,1482,33.6,79,95,8,160,41,1169,121
2012,36081111300,"Census Tract 1113, Queens County, New York",920,44,876,193,494,66028,1959,2000,1559,22.4,47,96,0,45,52,876,34
2013,36081111300,"Census Tract 1113, Queens County, New York",913,6,907,257,716,66906,1967,2003,1581,22.9,85,133,0,77,47,907,44
2014,36081111300,"Census Tract 1113, Queens County, New York",909,21,888,257,672,68277,1971,2006,1628,24.1,84,139,0,75,43,888,38
2015,36081111300,"Census Tract 1113, Queens County, New York",885,51,834,243,698,65563,1980,2009,1955,34.5,91,162,0,60,21,834,44
2016,36081111300,"Census Tract 1113, Queens County, New York",871,73,798,261,832,72824,1980,2010,1932,30.7,112,171,0,66,24,798,35
2017,36081111300,"Census Tract 1113, Queens County, New York",889,66,823,229,695,52813,1976,2009,2159,33.8,92,180,0,33,16,823,62
2018,36081111300,"Census Tract 1113, Queens County, New York",872,88,784,213,613,48456,1973,2010,2255,51,73,162,0,22,29,784,74
2019,36081111300,"Census Tract 1113, Queens County, New York",871,91,780,193,578,NA,1971,2010,2288,38.5,72,141,0,23,29,780,65
2020,36081111300,"Census Tract 1113, Queens County, New York",836,56,780,175,430,NA,1965,2013,2300,49.7,73,141,0,20,14,780,88
2012,36081112300,"Census Tract 1123, Queens County, New York",880,90,790,546,1561,64185,1954,2005,1656,35.2,320,219,5,178,131,790,73
2013,36081112300,"Census Tract 1123, Queens County, New York",881,104,777,534,1573,62778,1954,2006,1698,35.7,303,184,5,177,142,777,48
2014,36081112300,"Census Tract 1123, Queens County, New York",857,93,764,530,1409,58947,1957,2008,1733,37.9,283,215,6,152,128,764,101
2015,36081112300,"Census Tract 1123, Queens County, New York",836,47,789,540,1379,60000,1957,2010,1746,35.7,287,216,6,159,145,789,104
2016,36081112300,"Census Tract 1123, Queens County, New York",836,78,758,503,1225,63938,1959,2011,1789,29.6,275,255,0,129,108,758,68
2017,36081112300,"Census Tract 1123, Queens County, New York",856,77,779,505,1197,64712,1961,2011,1764,30.5,257,247,11,114,123,779,95
2018,36081112300,"Census Tract 1123, Queens County, New York",866,104,762,526,1289,70682,1957,2012,1807,29.3,293,258,21,109,133,762,108
2019,36081112300,"Census Tract 1123, Queens County, New York",855,122,733,487,1348,80781,1961,2013,1961,29.1,315,202,17,147,116,733,62
2020,36081112300,"Census Tract 1123, Queens County, New York",840,119,721,507,1468,97917,1960,2015,1981,27.7,326,224,35,157,86,721,56
2012,36081112900,"Census Tract 1129, Queens County, New York",956,96,860,288,678,79118,1963,2004,1503,25.8,142,225,9,54,0,860,40
2013,36081112900,"Census Tract 1129, Queens County, New York",944,68,876,297,733,80865,1967,2008,1674,24.4,164,219,0,78,0,876,32
2014,36081112900,"Census Tract 1129, Queens County, New York",945,33,912,377,951,81125,1964,2010,1680,25.4,192,273,5,94,5,912,50
2015,36081112900,"Census Tract 1129, Queens County, New York",929,43,886,371,1078,95551,1964,2011,1812,19.8,232,260,19,87,5,886,45
2016,36081112900,"Census Tract 1129, Queens County, New York",913,129,784,324,945,98621,1965,2012,1854,21.9,212,243,13,62,6,784,49
2017,36081112900,"Census Tract 1129, Queens County, New York",949,104,845,304,794,89583,1960,NA,1885,24,200,214,17,62,11,845,73
2018,36081112900,"Census Tract 1129, Queens County, New York",951,115,836,281,792,96250,1956,2012,1997,24.9,162,195,15,58,13,836,59
2019,36081112900,"Census Tract 1129, Queens County, New York",947,128,819,229,632,106150,1957,2012,1963,23.5,155,158,10,48,13,819,46
2020,36081112900,"Census Tract 1129, Queens County, New York",860,122,738,215,761,93542,1955,2015,1941,24.6,124,140,6,33,31,738,31
2012,36081113300,"Census Tract 1133, Queens County, New York",710,133,577,135,276,21378,1948,2004,1594,50,25,110,0,15,10,577,18
2013,36081113300,"Census Tract 1133, Queens County, New York",692,86,606,131,305,24338,1946,2003,1738,50,25,87,0,28,16,606,19
2014,36081113300,"Census Tract 1133, Queens County, New York",672,62,610,127,396,47396,1958,2007,2000,48.3,45,60,0,45,22,610,35
2015,36081113300,"Census Tract 1133, Queens County, New York",667,54,613,146,409,47333,1955,2005,1802,50,42,58,0,45,43,613,39
2016,36081113300,"Census Tract 1133, Queens County, New York",665,50,615,141,415,60375,1955,2007,1833,50,39,57,0,48,36,615,38
2017,36081113300,"Census Tract 1133, Queens County, New York",683,24,659,129,346,69712,1953,2005,1875,38.6,44,66,0,32,31,659,43
2018,36081113300,"Census Tract 1133, Queens County, New York",673,45,628,126,341,78382,1954,2006,1859,36.1,58,74,0,29,23,628,28
2019,36081113300,"Census Tract 1133, Queens County, New York",676,76,600,134,348,85417,1952,2006,1809,31.5,51,86,0,10,38,600,28
2020,36081113300,"Census Tract 1133, Queens County, New York",690,62,628,122,271,63250,1965,2010,1756,51,30,56,0,27,39,628,37
2012,36081113900,"Census Tract 1139, Queens County, New York",1527,71,1456,719,1613,53882,1951,2004,1352,33,230,472,0,138,119,1456,148
2013,36081113900,"Census Tract 1139, Queens County, New York",1456,33,1423,654,1444,50000,1952,2005,1377,36.4,238,440,0,128,96,1423,177
2014,36081113900,"Census Tract 1139, Queens County, New York",1437,52,1385,704,1677,54231,1952,2006,1397,34.5,214,475,0,123,116,1385,169
2015,36081113900,"Census Tract 1139, Queens County, New York",1454,48,1406,776,1893,57431,1950,2010,1460,33.4,203,479,0,208,100,1406,174
2016,36081113900,"Census Tract 1139, Queens County, New York",1448,79,1369,760,1832,56458,1951,2010,1546,32.2,194,385,0,207,144,1369,161
2017,36081113900,"Census Tract 1139, Queens County, New York",1441,81,1360,776,1752,55855,1948,2011,1656,32.9,173,386,0,269,96,1360,178
2018,36081113900,"Census Tract 1139, Queens County, New York",1503,50,1453,863,1986,59246,1949,2011,1681,31,156,371,19,312,157,1453,195
2019,36081113900,"Census Tract 1139, Queens County, New York",1473,21,1452,791,1743,59855,1950,2012,1749,32.8,188,295,18,291,180,1452,229
2020,36081113900,"Census Tract 1139, Queens County, New York",1469,20,1449,826,1909,60508,1955,2011,1770,31.7,231,286,23,215,194,1449,166
2012,36081114100,"Census Tract 1141, Queens County, New York",868,82,786,88,149,53409,1956,2005,1662,36,14,48,0,17,23,786,10
2013,36081114100,"Census Tract 1141, Queens County, New York",858,79,779,88,151,52917,1960,2005,1583,50,28,45,0,22,21,779,10
2014,36081114100,"Census Tract 1141, Queens County, New York",890,93,797,103,187,57250,1958,2004,1705,34.4,41,54,0,23,26,797,6
2015,36081114100,"Census Tract 1141, Queens County, New York",873,44,829,119,221,55750,1956,2004,1683,32,54,68,0,24,27,829,33
2016,36081114100,"Census Tract 1141, Queens County, New York",870,49,821,91,179,74063,1956,2002,1463,21.4,63,66,5,13,12,821,47
2017,36081114100,"Census Tract 1141, Queens County, New York",876,49,827,84,185,NA,1948,2002,1964,50,45,44,5,28,12,827,62
2018,36081114100,"Census Tract 1141, Queens County, New York",875,50,825,76,174,NA,1946,2000,2608,24.2,47,38,8,23,15,825,61
2019,36081114100,"Census Tract 1141, Queens County, New York",883,62,821,116,247,35536,0,2002,2565,51,52,62,7,47,7,821,88
2020,36081114100,"Census Tract 1141, Queens County, New York",891,43,848,98,230,36389,0,2007,2583,51,38,46,8,44,8,848,45
2012,36081114700,"Census Tract 1147, Queens County, New York",673,25,648,89,205,71118,1939,2005,1550,26.9,8,39,0,36,14,648,26
2013,36081114700,"Census Tract 1147, Queens County, New York",660,40,620,75,182,78906,1939,2005,2001,30.3,11,29,0,46,0,620,58
2014,36081114700,"Census Tract 1147, Queens County, New York",638,15,623,57,160,73203,1943,2009,2001,42.6,15,10,0,40,7,623,49
2015,36081114700,"Census Tract 1147, Queens County, New York",632,22,610,93,205,60583,1944,2010,1938,44.5,19,46,0,40,7,610,30
2016,36081114700,"Census Tract 1147, Queens County, New York",641,19,622,107,214,60089,1939,2011,1820,43.5,31,52,0,49,6,622,38
2017,36081114700,"Census Tract 1147, Queens County, New York",645,38,607,70,112,NA,1939,2010,1711,45.3,16,60,0,5,5,607,46
2018,36081114700,"Census Tract 1147, Queens County, New York",651,35,616,86,191,NA,0,2011,1734,42.8,30,69,0,12,5,616,24
2019,36081114700,"Census Tract 1147, Queens County, New York",646,44,602,98,203,49583,0,2012,2069,41,31,79,0,19,0,602,40
2020,36081114700,"Census Tract 1147, Queens County, New York",664,42,622,98,311,83466,0,2018,2200,36.7,24,79,0,19,0,622,46
2012,36081115100,"Census Tract 1151, Queens County, New York",389,45,344,18,28,67045,1972,2006,1205,22.7,18,18,0,0,0,344,4
2013,36081115100,"Census Tract 1151, Queens County, New York",388,39,349,35,68,66250,1949,2006,1413,30.1,22,22,0,13,0,349,11
2014,36081115100,"Census Tract 1151, Queens County, New York",379,30,349,39,138,51950,1939,2011,1625,33.4,14,14,0,25,0,349,13
2015,36081115100,"Census Tract 1151, Queens County, New York",370,9,361,50,184,52232,1939,2011,1597,31.7,11,11,0,28,11,361,18
2016,36081115100,"Census Tract 1151, Queens County, New York",382,24,358,60,200,51600,1939,2012,1651,33.8,8,8,0,25,27,358,13
2017,36081115100,"Census Tract 1151, Queens County, New York",392,32,360,65,227,52946,1939,2012,1613,33.8,4,8,0,29,28,360,15
2018,36081115100,"Census Tract 1151, Queens County, New York",397,43,354,51,192,54083,0,NA,1681,36.8,6,11,0,15,25,354,4
2019,36081115100,"Census Tract 1151, Queens County, New York",396,52,344,43,113,NA,0,2013,1616,28.6,9,11,0,4,28,344,10
2020,36081115100,"Census Tract 1151, Queens County, New York",425,93,332,31,74,NA,0,2012,1544,51,9,10,0,4,17,332,13
2012,36081115500,"Census Tract 1155, Queens County, New York",768,32,736,345,1165,63438,1939,2005,1361,26.3,122,73,31,174,114,736,124
2013,36081115500,"Census Tract 1155, Queens County, New York",763,37,726,345,1325,63393,1939,2007,1382,25.7,97,68,19,149,128,726,124
2014,36081115500,"Census Tract 1155, Queens County, New York",767,31,736,351,1295,50966,1939,2008,1430,27.2,68,45,21,162,139,736,97
2015,36081115500,"Census Tract 1155, Queens County, New York",742,49,693,326,1022,40625,1939,2010,1380,32.3,63,38,0,157,126,693,97
2016,36081115500,"Census Tract 1155, Queens County, New York",742,54,688,349,1234,39688,1939,2011,1386,33.9,45,25,0,159,160,688,115
2017,36081115500,"Census Tract 1155, Queens County, New York",738,39,699,375,1265,48750,1940,2012,1425,29.3,50,45,19,142,164,699,96
2018,36081115500,"Census Tract 1155, Queens County, New York",717,44,673,363,1228,42232,1951,2012,1473,35.6,57,60,21,132,145,673,94
2019,36081115500,"Census Tract 1155, Queens County, New York",708,33,675,406,1284,47609,1946,2012,1568,40.8,81,66,17,161,162,675,96
2020,36081115500,"Census Tract 1155, Queens County, New York",741,11,730,433,1507,54201,1944,2012,1619,37.3,113,114,19,156,113,730,100
2012,36081115700,"Census Tract 1157, Queens County, New York",1267,58,1209,488,1181,47356,1964,2004,1468,37.7,175,126,0,329,33,1209,97
2013,36081115700,"Census Tract 1157, Queens County, New York",1260,24,1236,482,1312,46225,1963,2006,1410,39,160,131,12,322,29,1236,131
2014,36081115700,"Census Tract 1157, Queens County, New York",1272,62,1210,477,1309,43472,1963,2008,1408,38.2,91,106,10,361,10,1210,166
2015,36081115700,"Census Tract 1157, Queens County, New York",1282,64,1218,525,1393,45670,1962,2010,1369,35.7,126,120,38,367,10,1218,223
2016,36081115700,"Census Tract 1157, Queens County, New York",1290,69,1221,576,1454,32357,1958,2011,1416,45.5,136,94,30,452,12,1221,264
2017,36081115700,"Census Tract 1157, Queens County, New York",1313,91,1222,620,1522,35298,1957,2011,1439,49.1,124,99,30,482,20,1222,222
2018,36081115700,"Census Tract 1157, Queens County, New York",1320,88,1232,684,1554,30469,1957,2012,1454,51,118,124,22,499,39,1232,286
2019,36081115700,"Census Tract 1157, Queens County, New York",1313,64,1249,715,1529,30424,1957,2012,1508,51,137,183,29,449,46,1249,267
2020,36081115700,"Census Tract 1157, Queens County, New York",1219,63,1156,742,1765,38080,1958,2012,1622,49.1,199,162,0,506,62,1156,211
2012,36081115900,"Census Tract 1159, Queens County, New York",1472,57,1415,881,2311,35230,1956,2003,1333,40.8,206,151,103,481,201,1415,195
2013,36081115900,"Census Tract 1159, Queens County, New York",1502,113,1389,887,2552,35250,1956,2003,1412,45.6,246,129,116,496,194,1389,246
2014,36081115900,"Census Tract 1159, Queens County, New York",1515,154,1361,932,2779,46574,1957,2005,1393,37.3,267,134,128,595,117,1361,224
2015,36081115900,"Census Tract 1159, Queens County, New York",1513,139,1374,941,2845,48242,1956,2006,1381,36.5,256,120,117,617,128,1374,228
2016,36081115900,"Census Tract 1159, Queens County, New York",1532,133,1399,913,2799,48040,1956,2008,1469,34.8,191,99,76,667,108,1399,263
2017,36081115900,"Census Tract 1159, Queens County, New York",1478,156,1322,834,2525,48675,1954,2011,1479,34.5,139,79,31,687,37,1322,224
2018,36081115900,"Census Tract 1159, Queens County, New York",1446,117,1329,848,2329,39583,1952,2010,1526,34.6,171,76,8,655,109,1329,224
2019,36081115900,"Census Tract 1159, Queens County, New York",1418,70,1348,818,2287,42262,1949,2007,1572,35.7,155,73,9,644,81,1348,220
2020,36081115900,"Census Tract 1159, Queens County, New York",1625,69,1556,1008,2223,27813,1943,2011,1668,51,153,63,9,860,64,1556,474
2012,36081116100,"Census Tract 1161, Queens County, New York",1653,80,1573,1126,3678,50750,1966,2004,1385,33.7,327,77,37,754,193,1573,368
2013,36081116100,"Census Tract 1161, Queens County, New York",1625,109,1516,1008,3115,56136,1971,2004,1353,32.2,214,51,49,628,225,1516,287
2014,36081116100,"Census Tract 1161, Queens County, New York",1603,160,1443,867,2674,49338,1973,2004,1404,36.6,168,51,52,480,214,1443,265
2015,36081116100,"Census Tract 1161, Queens County, New York",1610,132,1478,904,2662,46917,1971,2005,1405,39.5,143,73,43,541,213,1478,317
2016,36081116100,"Census Tract 1161, Queens County, New York",1620,141,1479,918,2816,45172,1971,2007,1426,40.7,113,75,42,581,191,1479,310
2017,36081116100,"Census Tract 1161, Queens County, New York",1627,133,1494,1000,2764,22805,1969,2011,1348,50,122,72,50,710,133,1494,502
2018,36081116100,"Census Tract 1161, Queens County, New York",1665,176,1489,1070,2790,20096,1965,2012,1473,51,161,101,47,772,130,1489,561
2019,36081116100,"Census Tract 1161, Queens County, New York",1686,177,1509,1106,2772,22583,1964,2012,1518,51,237,93,39,826,139,1509,568
2020,36081116100,"Census Tract 1161, Queens County, New York",1711,210,1501,1013,2244,26938,1967,2013,1555,51,248,44,75,631,254,1501,429
2012,36081116300,"Census Tract 1163, Queens County, New York",2897,115,2782,2331,6724,32071,1961,2004,1322,43.9,489,292,134,1402,463,2782,745
2013,36081116300,"Census Tract 1163, Queens County, New York",2847,71,2776,2348,6874,32993,1956,2005,1327,42.6,376,281,128,1481,418,2776,717
2014,36081116300,"Census Tract 1163, Queens County, New York",2872,101,2771,2327,6911,38590,1955,2007,1355,39.8,384,287,113,1516,383,2771,646
2015,36081116300,"Census Tract 1163, Queens County, New York",2897,128,2769,2452,7284,35380,1957,2008,1343,41.4,302,222,116,1698,360,2769,632
2016,36081116300,"Census Tract 1163, Queens County, New York",2930,105,2825,2528,7737,34045,1954,2010,1386,45.6,320,187,109,1639,531,2825,796
2017,36081116300,"Census Tract 1163, Queens County, New York",2912,101,2811,2452,7619,34211,1958,2011,1434,46.3,303,198,128,1628,469,2811,764
2018,36081116300,"Census Tract 1163, Queens County, New York",2867,104,2763,2394,7123,34474,1959,NA,1506,48.3,314,203,117,1565,488,2763,778
2019,36081116300,"Census Tract 1163, Queens County, New York",2930,76,2854,2436,7107,33904,1960,2012,1502,49.6,331,223,64,1586,486,2854,827
2020,36081116301,"Census Tract 1163.01, Queens County, New York",1651,114,1537,1227,3214,24005,1953,2011,1406,49.8,202,134,64,808,221,1537,518
2020,36081116302,"Census Tract 1163.02, Queens County, New York",1353,0,1353,1056,2908,45542,1950,2012,1248,34.2,317,313,20,666,57,1353,317
2012,36081116700,"Census Tract 1167, Queens County, New York",660,49,611,408,1053,41875,1971,2005,1438,36.7,103,63,0,246,99,611,80
2013,36081116700,"Census Tract 1167, Queens County, New York",645,62,583,424,1255,26483,1964,2008,1379,50,105,56,0,245,123,583,121
2014,36081116700,"Census Tract 1167, Queens County, New York",653,57,596,447,1406,29531,1959,2008,1399,49.9,96,62,0,257,128,596,145
2015,36081116700,"Census Tract 1167, Queens County, New York",688,97,591,440,1508,31500,1956,2010,1420,49.6,86,52,5,267,116,591,150
2016,36081116700,"Census Tract 1167, Queens County, New York",711,136,575,422,1336,26250,1955,2011,1496,50,79,34,6,269,90,575,194
2017,36081116700,"Census Tract 1167, Queens County, New York",703,108,595,447,1546,26578,1956,2012,1529,50,85,21,12,326,82,595,221
2018,36081116700,"Census Tract 1167, Queens County, New York",669,115,554,386,1206,37778,1955,2012,1635,44.3,67,20,5,278,67,554,164
2019,36081116700,"Census Tract 1167, Queens County, New York",669,109,560,433,1244,32250,1955,2014,1662,44.2,71,0,5,324,72,560,177
2020,36081116700,"Census Tract 1167, Queens County, New York",659,74,585,461,1408,29271,1949,2015,1646,47.3,94,7,0,335,96,585,186
2012,36081117100,"Census Tract 1171, Queens County, New York",1085,104,981,638,1765,30455,1957,2004,1218,37.2,185,192,8,261,144,981,240
2013,36081117100,"Census Tract 1171, Queens County, New York",1098,108,990,688,1883,38750,1957,2005,1243,35.9,228,159,8,323,165,990,238
2014,36081117100,"Census Tract 1171, Queens County, New York",1073,76,997,727,1957,37292,1955,2007,1297,37.6,224,132,7,364,186,997,268
2015,36081117100,"Census Tract 1171, Queens County, New York",1035,71,964,669,1781,36563,1952,2007,1308,43.4,197,116,14,311,193,964,207
2016,36081117100,"Census Tract 1171, Queens County, New York",995,67,928,599,1433,37596,1949,2009,1387,41.6,124,91,5,336,153,928,190
2017,36081117100,"Census Tract 1171, Queens County, New York",971,52,919,593,1439,41226,1943,2010,1391,38.8,108,93,6,303,185,919,143
2018,36081117100,"Census Tract 1171, Queens County, New York",940,38,902,581,1471,43431,1947,2011,1446,37.7,114,81,7,299,189,902,161
2019,36081117100,"Census Tract 1171, Queens County, New York",943,69,874,526,1338,46250,1945,2012,1597,32.5,105,92,4,287,141,874,136
2020,36081117100,"Census Tract 1171, Queens County, New York",918,85,833,487,1304,52841,1945,2014,1750,41.3,131,57,23,284,126,833,123
2012,36081117500,"Census Tract 1175, Queens County, New York",2081,164,1917,1093,2925,51949,1945,2004,1492,32,524,356,58,539,155,1917,181
2013,36081117500,"Census Tract 1175, Queens County, New York",2100,120,1980,1094,2810,46359,1946,2005,1491,33.7,490,330,51,572,156,1980,232
2014,36081117500,"Census Tract 1175, Queens County, New York",2093,193,1900,913,2161,53884,1944,2006,1576,31.3,377,275,46,497,95,1900,189
2015,36081117500,"Census Tract 1175, Queens County, New York",2090,198,1892,926,2077,48418,1947,2008,1483,33.9,293,316,10,492,108,1892,203
2016,36081117500,"Census Tract 1175, Queens County, New York",2064,127,1937,1024,2248,49833,1949,2009,1407,33.5,284,350,10,574,90,1937,148
2017,36081117500,"Census Tract 1175, Queens County, New York",2043,134,1909,1090,2372,56250,1947,2010,1444,32.2,284,390,9,541,150,1909,171
2018,36081117500,"Census Tract 1175, Queens County, New York",2023,134,1889,1112,2402,46375,1945,2010,1417,37.6,254,402,11,520,179,1889,198
2019,36081117500,"Census Tract 1175, Queens County, New York",2047,119,1928,1159,2581,50774,1944,2011,1550,39.8,292,498,0,461,189,1928,184
2020,36081117500,"Census Tract 1175, Queens County, New York",1870,110,1760,978,2199,57182,1943,2012,1658,33.9,318,362,8,405,175,1760,183
2012,36081118100,"Census Tract 1181, Queens County, New York",678,76,602,307,887,57839,1969,2006,1446,35.5,152,80,23,151,54,602,47
2013,36081118100,"Census Tract 1181, Queens County, New York",705,100,605,307,782,54469,1964,2005,1479,35.5,137,130,11,114,42,605,48
2014,36081118100,"Census Tract 1181, Queens County, New York",723,129,594,322,822,58864,1959,2004,1428,32.9,145,169,12,108,19,594,69
2015,36081118100,"Census Tract 1181, Queens County, New York",725,166,559,360,924,61524,1955,2005,1541,29.6,191,177,12,135,24,559,58
2016,36081118100,"Census Tract 1181, Queens County, New York",730,127,603,382,967,59464,1950,2006,1546,28.4,189,202,6,142,32,603,93
2017,36081118100,"Census Tract 1181, Queens County, New York",740,128,612,378,936,61071,1949,2006,1589,29.8,167,209,5,122,42,612,91
2018,36081118100,"Census Tract 1181, Queens County, New York",724,113,611,385,1000,61761,1947,2010,1673,33.5,182,164,11,140,76,611,89
2019,36081118100,"Census Tract 1181, Queens County, New York",723,101,622,371,918,63125,1948,2011,1730,33.5,185,144,12,160,61,622,87
2020,36081118100,"Census Tract 1181, Queens County, New York",688,62,626,377,1008,54625,1952,2012,1725,46.1,121,144,24,142,81,626,115
2012,36081118500,"Census Tract 1185, Queens County, New York",728,17,711,549,1605,50964,1958,2004,1558,29.9,96,148,18,239,135,711,86
2013,36081118500,"Census Tract 1185, Queens County, New York",722,25,697,540,1610,50673,1956,2005,1583,32.1,121,137,16,262,125,697,74
2014,36081118500,"Census Tract 1185, Queens County, New York",709,20,689,511,1441,49226,1955,2006,1472,32.6,138,148,7,267,89,689,111
2015,36081118500,"Census Tract 1185, Queens County, New York",717,45,672,479,1501,42031,1957,2008,1425,33,139,84,8,257,130,672,108
2016,36081118500,"Census Tract 1185, Queens County, New York",754,49,705,531,1725,42330,1952,2010,1466,37.8,176,64,8,283,170,705,130
2017,36081118500,"Census Tract 1185, Queens County, New York",731,50,681,533,1705,42938,1950,2011,1629,41.8,197,45,6,299,158,681,139
2018,36081118500,"Census Tract 1185, Queens County, New York",731,56,675,532,1645,44231,1947,2011,1611,41.3,172,50,4,298,163,675,126
2019,36081118500,"Census Tract 1185, Queens County, New York",671,53,618,502,1564,46034,1946,2011,1658,42.4,162,31,3,276,180,618,102
2020,36081118500,"Census Tract 1185, Queens County, New York",675,67,608,542,1681,49559,1952,2011,1793,44.1,150,36,22,257,223,608,94
2012,36081118700,"Census Tract 1187, Queens County, New York",839,31,808,376,988,50114,1976,2005,1380,37,43,36,27,181,133,808,78
2013,36081118700,"Census Tract 1187, Queens County, New York",822,62,760,402,973,41735,1974,2005,1304,37.8,23,39,20,217,126,760,91
2014,36081118700,"Census Tract 1187, Queens County, New York",802,56,746,422,1115,33182,1970,2006,1260,44.4,32,36,21,210,156,746,94
2015,36081118700,"Census Tract 1187, Queens County, New York",835,83,752,434,1244,40040,1972,2009,1317,44.3,40,43,9,235,152,752,80
2016,36081118700,"Census Tract 1187, Queens County, New York",784,63,721,407,1145,33542,1968,2010,1288,44.2,25,42,0,208,146,721,90
2017,36081118700,"Census Tract 1187, Queens County, New York",795,72,723,403,1174,28938,1957,2010,1360,48.5,16,25,0,236,136,723,117
2018,36081118700,"Census Tract 1187, Queens County, New York",797,53,744,421,1210,32049,1962,2011,1462,48.2,25,32,0,210,170,744,121
2019,36081118700,"Census Tract 1187, Queens County, New York",823,75,748,400,1149,34947,1957,2011,1486,44.2,63,43,7,201,143,748,97
2020,36081118700,"Census Tract 1187, Queens County, New York",818,41,777,422,1219,35720,1955,2012,1548,51,92,84,7,185,146,777,160
2012,36081118900,"Census Tract 1189, Queens County, New York",807,26,781,401,1358,53454,1952,2004,1393,28.6,99,35,10,308,34,781,150
2013,36081118900,"Census Tract 1189, Queens County, New York",774,27,747,389,1277,52898,1959,2005,1355,28.7,98,55,0,291,28,747,128
2014,36081118900,"Census Tract 1189, Queens County, New York",741,24,717,332,1124,48125,1953,2006,1367,26.7,61,49,0,259,35,717,105
2015,36081118900,"Census Tract 1189, Queens County, New York",744,41,703,335,1106,48750,1953,2007,1407,27.8,83,48,0,251,36,703,82
2016,36081118900,"Census Tract 1189, Queens County, New York",755,43,712,268,841,51875,1939,2009,1368,27,54,61,0,159,48,712,77
2017,36081118900,"Census Tract 1189, Queens County, New York",751,76,675,284,929,47955,1939,2011,1362,33.5,44,66,0,168,50,675,87
2018,36081118900,"Census Tract 1189, Queens County, New York",764,87,677,274,866,57917,0,2012,1421,30,54,50,0,148,76,677,59
2019,36081118900,"Census Tract 1189, Queens County, New York",750,88,662,279,826,54750,0,2012,1555,34.1,55,53,0,162,64,662,74
2020,36081118900,"Census Tract 1189, Queens County, New York",837,72,765,423,866,46336,1981,2013,1415,37.6,221,46,0,326,51,765,63
2012,36081119100,"Census Tract 1191, Queens County, New York",1188,75,1113,595,1832,41121,1983,2006,1595,40.3,216,43,0,400,131,1113,132
2013,36081119100,"Census Tract 1191, Queens County, New York",1188,78,1110,703,2274,55518,1984,2007,1634,35.4,197,56,0,456,145,1110,171
2014,36081119100,"Census Tract 1191, Queens County, New York",1120,94,1026,763,2658,58274,1982,2008,1657,32.9,256,74,0,456,198,1026,144
2015,36081119100,"Census Tract 1191, Queens County, New York",1098,94,1004,754,2704,56375,1959,2010,1673,34.7,238,54,0,423,246,1004,130
2016,36081119100,"Census Tract 1191, Queens County, New York",1087,84,1003,763,2618,46534,1957,2011,1703,38.2,167,60,0,382,294,1003,158
2017,36081119100,"Census Tract 1191, Queens County, New York",1088,88,1000,782,2614,37128,1958,2011,1653,44.7,131,85,0,410,269,1000,182
2018,36081119100,"Census Tract 1191, Queens County, New York",1038,60,978,720,2165,35000,1961,2011,1629,46.8,117,109,0,382,212,978,188
2019,36081119100,"Census Tract 1191, Queens County, New York",1043,57,986,630,1803,32609,1959,2012,1664,51,77,102,0,295,214,986,175
2020,36081119100,"Census Tract 1191, Queens County, New York",994,71,923,571,1678,33299,1971,2013,1809,51,67,71,0,362,138,923,134
2012,36081119300,"Census Tract 1193, Queens County, New York",793,57,736,406,1176,32727,1956,2005,1259,33.1,148,141,5,178,82,736,128
2013,36081119300,"Census Tract 1193, Queens County, New York",763,60,703,378,936,21375,1958,2005,1290,43.4,132,97,12,212,57,703,150
2014,36081119300,"Census Tract 1193, Queens County, New York",769,81,688,317,855,26979,1948,2007,1342,46.2,73,43,11,202,61,688,126
2015,36081119300,"Census Tract 1193, Queens County, New York",749,48,701,379,1052,35625,1941,2008,1538,41.9,95,30,29,257,63,701,134
2016,36081119300,"Census Tract 1193, Queens County, New York",757,56,701,404,1208,41419,1945,2009,1542,39.9,132,9,25,308,62,701,115
2017,36081119300,"Census Tract 1193, Queens County, New York",771,70,701,393,1083,40121,1945,2010,1653,43.7,133,16,25,293,59,701,112
2018,36081119300,"Census Tract 1193, Queens County, New York",761,53,708,397,1113,42639,1943,2011,1691,39.1,150,29,21,287,60,708,124
2019,36081119300,"Census Tract 1193, Queens County, New York",755,27,728,413,1100,40938,1946,2012,1743,39.6,168,46,23,279,60,728,117
2020,36081119300,"Census Tract 1193, Queens County, New York",782,24,758,381,951,32102,1946,2014,1618,36.3,144,119,0,213,46,758,155
2012,36081119500,"Census Tract 1195, Queens County, New York",495,59,436,89,357,72981,1952,2001,1718,27.3,29,12,0,59,18,436,0
2013,36081119500,"Census Tract 1195, Queens County, New York",479,35,444,137,519,78456,1953,2005,1671,23.2,39,12,27,62,38,444,12
2014,36081119500,"Census Tract 1195, Queens County, New York",462,49,413,140,558,85000,1954,2007,1664,21.5,52,12,29,67,35,413,12
2015,36081119500,"Census Tract 1195, Queens County, New York",448,24,424,132,475,88214,1956,2008,1636,20.9,36,20,28,48,39,424,16
2016,36081119500,"Census Tract 1195, Queens County, New York",431,25,406,118,369,77308,1955,2010,1555,19.8,48,18,28,31,44,406,16
2017,36081119500,"Census Tract 1195, Queens County, New York",446,39,407,113,404,82788,1951,2011,1635,20.6,56,15,28,30,43,407,26
2018,36081119500,"Census Tract 1195, Queens County, New York",456,46,410,85,299,55625,1945,2011,1783,41.8,46,29,0,31,25,410,14
2019,36081119500,"Census Tract 1195, Queens County, New York",445,32,413,85,305,44688,1941,2011,1839,47.3,34,30,0,21,34,413,14
2020,36081119500,"Census Tract 1195, Queens County, New York",457,74,383,119,410,58482,1942,2013,1835,28.9,44,32,0,38,49,383,10
2012,36081119900,"Census Tract 1199, Queens County, New York",558,43,515,159,301,31806,1975,2004,1399,50,34,27,19,97,16,515,40
2013,36081119900,"Census Tract 1199, Queens County, New York",536,64,472,118,199,31333,1949,2004,1678,50,60,30,21,49,18,472,44
2014,36081119900,"Census Tract 1199, Queens County, New York",535,45,490,128,266,31333,1942,2006,1601,50,56,29,19,65,20,490,53
2015,36081119900,"Census Tract 1199, Queens County, New York",524,39,485,131,287,31016,1944,2006,1591,50,64,22,21,72,22,485,55
2016,36081119900,"Census Tract 1199, Queens County, New York",506,31,475,142,355,30735,1939,2010,1493,50,59,40,0,85,24,475,56
2017,36081119900,"Census Tract 1199, Queens County, New York",507,30,477,113,361,31307,1939,2012,1341,50,39,22,0,91,6,477,51
2018,36081119900,"Census Tract 1199, Queens County, New York",519,35,484,109,347,38125,0,2013,1384,51,19,24,0,85,7,484,42
2019,36081119900,"Census Tract 1199, Queens County, New York",502,40,462,127,381,31319,0,2014,1453,47.5,23,23,0,104,0,462,65
2020,36081119900,"Census Tract 1199, Queens County, New York",482,25,457,112,339,37500,0,2012,1371,44.1,44,28,0,84,0,457,48
2012,36081120100,"Census Tract 1201, Queens County, New York",528,42,486,170,390,31579,1950,2005,1135,47.9,76,20,0,144,6,486,111
2013,36081120100,"Census Tract 1201, Queens County, New York",534,40,494,206,633,45357,1955,2009,1273,40.9,66,11,0,150,45,494,90
2014,36081120100,"Census Tract 1201, Queens County, New York",514,49,465,234,822,43857,1949,2008,1316,38.8,73,23,0,172,39,465,52
2015,36081120100,"Census Tract 1201, Queens County, New York",519,52,467,254,858,43182,1962,2010,1244,40.1,67,36,5,176,42,467,52
2016,36081120100,"Census Tract 1201, Queens County, New York",484,20,464,236,823,42917,1964,2011,1261,40.1,48,34,11,159,37,464,56
2017,36081120100,"Census Tract 1201, Queens County, New York",474,24,450,239,886,48625,1961,2011,1418,33.8,50,30,9,172,32,450,57
2018,36081120100,"Census Tract 1201, Queens County, New York",452,27,425,234,817,45109,0,2009,1589,42.3,41,42,16,152,31,425,72
2019,36081120100,"Census Tract 1201, Queens County, New York",430,16,414,209,767,53313,0,2011,1730,41.6,37,31,21,134,29,414,73
2020,36081120100,"Census Tract 1201, Queens County, New York",397,21,376,181,653,60469,0,2012,1769,41.3,26,5,18,138,20,376,64
2012,36081120300,"Census Tract 1203, Queens County, New York",533,62,471,109,503,104732,1954,2003,1695,21.3,56,10,20,79,20,471,56
2013,36081120300,"Census Tract 1203, Queens County, New York",529,45,484,149,647,78750,1959,2004,1772,26,72,39,33,71,39,484,65
2014,36081120300,"Census Tract 1203, Queens County, New York",507,35,472,128,472,66591,1974,2006,1615,29,82,44,0,77,7,472,82
2015,36081120300,"Census Tract 1203, Queens County, New York",513,37,476,129,491,NA,1958,2009,1417,30.7,58,39,0,82,8,476,106
2016,36081120300,"Census Tract 1203, Queens County, New York",493,54,439,107,378,81188,1962,2012,1417,26.8,66,26,0,73,8,439,66
2017,36081120300,"Census Tract 1203, Queens County, New York",465,42,423,118,411,73690,1963,2012,1844,30.4,59,24,0,86,8,423,78
2018,36081120300,"Census Tract 1203, Queens County, New York",497,62,435,118,361,59886,0,2012,1500,32.3,40,11,0,107,0,435,79
2019,36081120300,"Census Tract 1203, Queens County, New York",493,44,449,164,489,58871,0,2016,1519,33.6,19,11,0,141,12,449,94
2020,36081120300,"Census Tract 1203, Queens County, New York",494,50,444,207,499,52292,0,2015,1745,34.5,45,51,0,144,12,444,32
2012,36081120500,"Census Tract 1205, Queens County, New York",1040,49,991,690,1706,16716,1971,2004,1006,38.5,117,151,7,468,38,991,289
2013,36081120500,"Census Tract 1205, Queens County, New York",1042,55,987,694,1618,17188,1984,2004,1074,39.5,102,140,9,482,19,987,286
2014,36081120500,"Census Tract 1205, Queens County, New York",1044,66,978,675,1627,17332,1964,2006,886,38.9,91,129,8,478,18,978,323
2015,36081120500,"Census Tract 1205, Queens County, New York",1050,78,972,674,1758,17434,1960,2008,1056,50,83,50,0,535,0,972,342
2016,36081120500,"Census Tract 1205, Queens County, New York",1076,35,1041,704,1734,17632,1969,2009,931,46.1,101,64,0,576,13,1041,367
2017,36081120500,"Census Tract 1205, Queens County, New York",1072,33,1039,727,1778,16366,1965,2010,985,49.8,70,50,0,605,21,1039,400
2018,36081120500,"Census Tract 1205, Queens County, New York",1037,12,1025,776,1928,16263,1963,2011,1021,51,67,67,10,655,22,1025,445
2019,36081120500,"Census Tract 1205, Queens County, New York",1034,18,1016,742,1707,16034,1966,2011,1041,51,64,67,8,579,54,1016,393
2020,36081120500,"Census Tract 1205, Queens County, New York",1009,20,989,680,1411,14551,1966,2012,980,51,54,49,9,540,54,989,441
2012,36081120700,"Census Tract 1207, Queens County, New York",958,52,906,390,1330,71071,1956,2005,1580,27.6,177,81,0,223,75,906,98
2013,36081120700,"Census Tract 1207, Queens County, New York",958,72,886,397,1274,71080,1958,2005,1541,27.4,209,76,4,231,60,886,71
2014,36081120700,"Census Tract 1207, Queens County, New York",959,77,882,336,1003,76161,1961,2006,1672,25.6,177,55,5,189,64,882,92
2015,36081120700,"Census Tract 1207, Queens County, New York",949,84,865,313,975,57614,1954,2008,1690,31.8,141,72,7,163,42,865,86
2016,36081120700,"Census Tract 1207, Queens County, New York",995,99,896,267,854,59083,1956,2010,1758,31.3,86,54,7,119,48,896,67
2017,36081120700,"Census Tract 1207, Queens County, New York",1001,108,893,238,694,61818,1955,2011,1632,27.2,59,44,6,84,76,893,54
2018,36081120700,"Census Tract 1207, Queens County, New York",997,63,934,237,737,62036,1959,2011,1674,25.8,47,44,0,80,99,934,56
2019,36081120700,"Census Tract 1207, Queens County, New York",984,59,925,238,713,64605,1968,2012,1610,31.5,42,49,0,89,83,925,39
2020,36081120701,"Census Tract 1207.01, Queens County, New York",995,37,958,165,463,63854,1974,2013,1711,29.4,28,25,0,73,62,958,32
2020,36081120702,"Census Tract 1207.02, Queens County, New York",0,0,0,0,0,NA,NA,NA,NA,NA,0,0,0,0,0,0,0
2012,36081121100,"Census Tract 1211, Queens County, New York",0,0,0,0,0,NA,NA,NA,NA,NA,0,0,0,0,0,0,0
2013,36081121100,"Census Tract 1211, Queens County, New York",0,0,0,0,0,NA,NA,NA,NA,NA,0,0,0,0,0,0,0
2014,36081121100,"Census Tract 1211, Queens County, New York",0,0,0,0,0,NA,NA,NA,NA,NA,0,0,0,0,0,0,0
2015,36081121100,"Census Tract 1211, Queens County, New York",0,0,0,0,0,NA,NA,NA,NA,NA,0,0,0,0,0,0,0
2016,36081121100,"Census Tract 1211, Queens County, New York",0,0,0,0,0,NA,NA,NA,NA,NA,0,0,0,0,0,0,0
2017,36081121100,"Census Tract 1211, Queens County, New York",0,0,0,0,0,NA,NA,NA,NA,NA,0,0,0,0,0,0,0
2018,36081121100,"Census Tract 1211, Queens County, New York",0,0,0,0,0,NA,NA,NA,NA,NA,0,0,0,0,0,0,0
2019,36081121100,"Census Tract 1211, Queens County, New York",0,0,0,0,0,NA,NA,NA,NA,NA,0,0,0,0,0,0,0
2020,36081121100,"Census Tract 1211, Queens County, New York",0,0,0,0,0,NA,NA,NA,NA,NA,0,0,0,0,0,0,0
2012,36081121500,"Census Tract 1215, Queens County, New York",1399,173,1226,505,1606,46198,1954,2005,1308,32.2,185,156,6,190,121,1226,178
2013,36081121500,"Census Tract 1215, Queens County, New York",1395,126,1269,508,1692,50000,1954,2005,1331,31.5,213,136,6,214,143,1269,222
2014,36081121500,"Census Tract 1215, Queens County, New York",1368,158,1210,464,1787,51515,1955,2006,1395,29.3,176,99,15,212,128,1210,167
2015,36081121500,"Census Tract 1215, Queens County, New York",1364,126,1238,523,1948,50036,1951,2010,1420,39.8,180,82,24,281,145,1238,173
2016,36081121500,"Census Tract 1215, Queens County, New York",1322,104,1218,422,1566,50735,1955,2011,1419,41.8,159,61,16,222,131,1218,178
2017,36081121500,"Census Tract 1215, Queens County, New York",1345,87,1258,444,1654,38947,1954,2011,1395,48.7,148,63,50,222,117,1258,222
2018,36081121500,"Census Tract 1215, Queens County, New York",1353,75,1278,466,1651,36852,1953,2012,1419,51,170,112,46,220,96,1278,218
2019,36081121500,"Census Tract 1215, Queens County, New York",1364,47,1317,455,1502,40438,1955,2013,1378,51,175,129,46,207,80,1317,222
2020,36081121500,"Census Tract 1215, Queens County, New York",1260,45,1215,429,1618,66250,1953,2015,1486,34.5,109,151,43,137,98,1215,177
2012,36081122300,"Census Tract 1223, Queens County, New York",1289,32,1257,536,1565,69583,1956,2005,1647,32.9,133,194,0,166,176,1257,124
2013,36081122300,"Census Tract 1223, Queens County, New York",1281,20,1261,506,1469,60671,1957,2005,1617,32.5,113,170,0,141,165,1261,123
2014,36081122300,"Census Tract 1223, Queens County, New York",1259,48,1211,415,1387,49688,1965,2006,1820,33.7,86,113,11,209,60,1211,93
2015,36081122300,"Census Tract 1223, Queens County, New York",1189,49,1140,418,1376,41071,1963,2006,1745,34.2,48,114,10,217,56,1140,87
2016,36081122300,"Census Tract 1223, Queens County, New York",1256,50,1206,402,1498,40167,1969,2005,1848,50,49,103,9,222,45,1206,105
2017,36081122300,"Census Tract 1223, Queens County, New York",1266,57,1209,376,1189,45893,1981,2007,1718,39.2,62,49,9,236,64,1209,72
2018,36081122300,"Census Tract 1223, Queens County, New York",1305,80,1225,455,1327,40260,1960,2011,1730,51,82,35,7,262,158,1225,126
2019,36081122300,"Census Tract 1223, Queens County, New York",1297,54,1243,443,1252,57083,1962,2010,1589,37.6,147,53,0,241,149,1243,94
2020,36081122300,"Census Tract 1223, Queens County, New York",1319,24,1295,379,1055,62348,1971,2012,1584,34.2,149,22,0,219,138,1295,57
2012,36081122701,"Census Tract 1227.01, Queens County, New York",4405,291,4114,2676,6493,48121,1958,2002,1137,31.9,869,1085,286,542,692,4114,369
2013,36081122701,"Census Tract 1227.01, Queens County, New York",4321,199,4122,2552,6181,39940,1959,2002,1148,36.2,820,1138,279,501,586,4122,563
2014,36081122701,"Census Tract 1227.01, Queens County, New York",4438,183,4255,2700,6924,37176,1958,2003,1135,37.6,525,1155,278,541,675,4255,522
2015,36081122701,"Census Tract 1227.01, Queens County, New York",4528,106,4422,2728,7209,35580,1959,2005,1144,38,488,1144,257,648,654,4422,512
2016,36081122701,"Census Tract 1227.01, Queens County, New York",4408,134,4274,2466,6486,38234,1957,2007,1152,37.5,453,1036,330,529,461,4274,495
2017,36081122701,"Census Tract 1227.01, Queens County, New York",4472,97,4375,2622,7002,35208,1957,2009,1185,37.9,509,1188,449,418,547,4375,586
2018,36081122701,"Census Tract 1227.01, Queens County, New York",4554,111,4443,2659,7039,46713,1956,2011,1224,35.6,515,1258,394,461,516,4443,314
2019,36081122701,"Census Tract 1227.01, Queens County, New York",4581,148,4433,2423,5596,62192,1956,2012,1289,31.8,749,1123,349,392,510,4433,226
2012,36081122702,"Census Tract 1227.02, Queens County, New York",2825,110,2715,2427,5341,14511,1955,2000,511,27.3,262,484,1115,165,686,2715,1192
2013,36081122702,"Census Tract 1227.02, Queens County, New York",2839,111,2728,2512,5430,14799,1956,2000,531,27.5,267,555,1040,218,704,2728,1238
2014,36081122702,"Census Tract 1227.02, Queens County, New York",2876,153,2723,2496,5672,16422,1956,2002,530,27.6,280,564,973,191,804,2723,1243
2015,36081122702,"Census Tract 1227.02, Queens County, New York",2928,39,2889,2619,6090,21394,1955,2002,539,28.3,523,626,1014,169,849,2889,1142
2016,36081122702,"Census Tract 1227.02, Queens County, New York",2949,42,2907,2609,6366,22919,1955,2002,617,29.6,621,697,904,165,854,2907,1136
2017,36081122702,"Census Tract 1227.02, Queens County, New York",2965,44,2921,2609,6895,24649,1955,2004,597,28.2,644,699,853,178,945,2921,1023
2018,36081122702,"Census Tract 1227.02, Queens County, New York",2946,41,2905,2559,6502,26432,1954,2005,618,31.2,531,591,1053,122,920,2905,1079
2019,36081122702,"Census Tract 1227.02, Queens County, New York",2978,0,2978,2646,6538,22857,1954,2006,610,31.7,542,549,893,244,1033,2978,1181
2020,36081122702,"Census Tract 1227.02, Queens County, New York",2871,0,2871,2515,5459,21922,1955,2006,605,34.7,363,497,886,278,824,2871,1170
2020,36081122703,"Census Tract 1227.03, Queens County, New York",2661,12,2649,1541,3766,51381,1954,2010,1179,25,505,623,276,112,433,2649,165
2020,36081122704,"Census Tract 1227.04, Queens County, New York",2207,80,2127,1481,2820,58083,1983,2009,1675,30.6,261,379,120,286,696,2127,93
2012,36081124100,"Census Tract 1241, Queens County, New York",1307,111,1196,285,757,26146,1961,2007,1457,35.1,143,110,12,132,11,1196,187
2013,36081124100,"Census Tract 1241, Queens County, New York",1303,117,1186,353,1020,45903,1963,2009,1500,29.2,153,116,33,159,22,1186,204
2014,36081124100,"Census Tract 1241, Queens County, New York",1281,136,1145,314,1004,52143,1969,2011,1628,26.6,105,49,32,188,25,1145,196
2015,36081124100,"Census Tract 1241, Queens County, New York",1294,184,1110,252,788,58750,1959,2011,1493,24.6,71,47,30,133,23,1110,134
2016,36081124100,"Census Tract 1241, Queens County, New York",1323,142,1181,329,1024,50719,1967,2012,1542,25.3,88,123,27,131,30,1181,131
2017,36081124100,"Census Tract 1241, Queens County, New York",1380,172,1208,354,1076,55208,1963,2012,1506,32.9,122,151,36,121,55,1208,113
2018,36081124100,"Census Tract 1241, Queens County, New York",1386,115,1271,379,1041,58125,1956,2014,1746,35.4,175,175,53,116,44,1271,139
2019,36081124100,"Census Tract 1241, Queens County, New York",1378,126,1252,462,1150,53636,1955,2014,1617,39.2,225,212,58,139,61,1252,155
2020,36081124100,"Census Tract 1241, Queens County, New York",1447,63,1384,490,1293,59063,1954,2016,1697,39.8,286,161,50,234,53,1384,132
2012,36081124700,"Census Tract 1247, Queens County, New York",1215,7,1208,171,525,28964,1950,2006,1692,50,67,80,0,16,75,1208,120
2013,36081124700,"Census Tract 1247, Queens County, New York",1226,9,1217,134,374,31136,1951,2009,1467,50,79,75,0,31,28,1217,128
2014,36081124700,"Census Tract 1247, Queens County, New York",1212,28,1184,142,425,39063,1949,2009,1660,19.5,82,65,0,42,35,1184,129
2015,36081124700,"Census Tract 1247, Queens County, New York",1215,50,1165,158,600,56667,1949,2010,1694,30.2,83,71,0,48,39,1165,130
2016,36081124700,"Census Tract 1247, Queens County, New York",1194,69,1125,150,560,NA,1951,2011,1844,23.6,65,62,0,60,28,1125,128
2017,36081124700,"Census Tract 1247, Queens County, New York",1205,75,1130,120,340,NA,1948,2010,1901,22.5,36,62,0,58,0,1130,126
2018,36081124700,"Census Tract 1247, Queens County, New York",1208,91,1117,141,416,NA,1946,2013,1816,24.3,46,61,0,80,0,1117,146
2019,36081124700,"Census Tract 1247, Queens County, New York",1206,110,1096,166,503,NA,1950,2015,1951,27.7,85,61,0,105,0,1096,150
2020,36081124700,"Census Tract 1247, Queens County, New York",1183,79,1104,133,378,NA,1951,2016,1943,27.3,64,49,0,84,0,1104,131
2012,36081125700,"Census Tract 1257, Queens County, New York",1058,89,969,508,1415,40696,1954,2002,1274,34.2,187,96,116,189,118,969,144
2013,36081125700,"Census Tract 1257, Queens County, New York",1029,110,919,436,1392,40652,1959,2004,1345,37.4,154,87,123,176,32,919,227
2014,36081125700,"Census Tract 1257, Queens County, New York",1038,96,942,374,1102,40583,1958,2005,1399,46.2,125,111,69,131,49,942,210
2015,36081125700,"Census Tract 1257, Queens County, New York",1021,95,926,350,976,31667,1960,2005,1425,39.5,141,108,62,108,60,926,207
2016,36081125700,"Census Tract 1257, Queens County, New York",1000,102,898,397,1280,39116,1958,2010,1490,41.5,196,105,82,101,83,898,178
2017,36081125700,"Census Tract 1257, Queens County, New York",989,85,904,415,1309,29391,1955,2012,1499,50,199,82,76,140,84,904,184
2018,36081125700,"Census Tract 1257, Queens County, New York",996,85,911,467,1433,41366,1955,2012,1684,42.5,201,71,101,145,136,911,143
2019,36081125700,"Census Tract 1257, Queens County, New York",994,80,914,589,1836,53958,1959,2012,1704,35.5,250,93,141,150,191,914,119
2020,36081125700,"Census Tract 1257, Queens County, New York",1097,123,974,513,1407,47662,1955,2012,1610,37.9,184,53,168,143,149,974,113
2012,36081126500,"Census Tract 1265, Queens County, New York",597,13,584,265,557,29375,1950,2002,971,44.4,114,123,22,79,17,584,82
2013,36081126500,"Census Tract 1265, Queens County, New York",585,13,572,253,579,35795,1948,2003,953,35.3,92,80,19,92,34,572,75
2014,36081126500,"Census Tract 1265, Queens County, New York",594,30,564,257,531,28550,1956,2000,961,38.9,106,69,32,98,49,564,92
2015,36081126500,"Census Tract 1265, Queens County, New York",576,46,530,248,523,26667,1954,2008,909,46.8,88,61,28,80,56,530,112
2016,36081126500,"Census Tract 1265, Queens County, New York",587,59,528,240,506,29130,1939,2010,893,44,83,50,25,70,54,528,98
2017,36081126500,"Census Tract 1265, Queens County, New York",610,49,561,254,609,NA,1950,2008,981,39.2,104,41,14,95,57,561,77
2018,36081126500,"Census Tract 1265, Queens County, New York",602,43,559,220,565,NA,1953,2006,1079,39.6,117,38,13,103,22,559,72
2019,36081126500,"Census Tract 1265, Queens County, New York",595,28,567,187,494,38977,1952,2008,1306,46.5,89,33,6,89,6,567,71
2020,36081126500,"Census Tract 1265, Queens County, New York",542,14,528,140,413,70192,1954,2004,1446,35.4,107,12,11,104,0,528,38
2012,36081126700,"Census Tract 1267, Queens County, New York",745,22,723,145,466,53125,1954,2011,1292,28.9,49,59,14,39,33,723,67
2013,36081126700,"Census Tract 1267, Queens County, New York",744,21,723,214,747,77632,1939,2005,1406,25.6,63,43,13,109,49,723,98
2014,36081126700,"Census Tract 1267, Queens County, New York",749,42,707,214,711,78030,1939,2007,1392,25,48,39,32,103,40,707,89
2015,36081126700,"Census Tract 1267, Queens County, New York",729,52,677,215,735,NA,1939,2009,1435,25.4,58,43,27,92,53,677,119
2016,36081126700,"Census Tract 1267, Queens County, New York",750,66,684,189,660,NA,1939,2008,1422,25.7,48,26,19,94,50,684,108
2017,36081126700,"Census Tract 1267, Queens County, New York",754,82,672,169,678,NA,1939,2009,1505,29.3,38,15,25,73,56,672,118
2018,36081126700,"Census Tract 1267, Queens County, New York",758,103,655,156,623,NA,1946,2014,1621,51,29,18,38,32,55,655,169
2019,36081126700,"Census Tract 1267, Queens County, New York",757,77,680,156,588,21250,1946,2016,1625,51,57,25,21,18,59,680,185
2020,36081126700,"Census Tract 1267, Queens County, New York",780,63,717,215,774,NA,1943,2017,1453,32.1,42,86,22,21,48,717,167
2012,36081127700,"Census Tract 1277, Queens County, New York",1164,32,1132,141,386,62782,1950,2006,1887,50,68,129,0,0,12,1132,24
2013,36081127700,"Census Tract 1277, Queens County, New York",1159,31,1128,162,512,65909,1946,2010,1935,34.5,53,148,0,0,14,1128,57
2014,36081127700,"Census Tract 1277, Queens County, New York",1165,92,1073,168,528,65441,1947,2011,1945,34.8,59,154,0,0,14,1073,80
2015,36081127700,"Census Tract 1277, Queens County, New York",1192,122,1070,157,522,88347,1945,NA,2209,39.9,81,122,35,0,0,1070,89
2016,36081127700,"Census Tract 1277, Queens County, New York",1192,151,1041,133,442,90685,1947,NA,2137,39.7,73,99,34,0,0,1041,74
2017,36081127700,"Census Tract 1277, Queens County, New York",1168,141,1027,78,347,124444,1947,NA,3501,34.5,46,42,36,0,0,1027,81
2018,36081127700,"Census Tract 1277, Queens County, New York",1190,140,1050,94,313,147500,1948,NA,3501,37.2,87,18,76,0,0,1050,30
2019,36081127700,"Census Tract 1277, Queens County, New York",1188,67,1121,93,305,172708,1948,NA,3501,37.1,85,19,74,0,0,1121,10
2020,36081127700,"Census Tract 1277, Queens County, New York",1113,70,1043,74,311,NA,1974,2014,NA,17.8,65,9,65,0,0,1043,5
2012,36081128300,"Census Tract 1283, Queens County, New York",22,0,22,4,4,NA,NA,2011,NA,NA,0,4,0,0,0,22,0
2013,36081128300,"Census Tract 1283, Queens County, New York",37,0,37,4,4,NA,NA,NA,NA,NA,0,4,0,0,0,37,0
2014,36081128300,"Census Tract 1283, Queens County, New York",37,0,37,5,5,NA,NA,NA,NA,NA,0,5,0,0,0,37,0
2015,36081128300,"Census Tract 1283, Queens County, New York",25,0,25,4,4,NA,NA,NA,NA,NA,0,4,0,0,0,25,0
2016,36081128300,"Census Tract 1283, Queens County, New York",34,0,34,5,5,NA,NA,NA,NA,NA,0,5,0,0,0,34,0
2017,36081128300,"Census Tract 1283, Queens County, New York",25,0,25,0,0,NA,NA,NA,NA,NA,0,0,0,0,0,25,0
2018,36081128300,"Census Tract 1283, Queens County, New York",0,0,0,0,0,NA,NA,NA,NA,NA,0,0,0,0,0,0,0
2019,36081128300,"Census Tract 1283, Queens County, New York",0,0,0,0,0,NA,NA,NA,NA,NA,0,0,0,0,0,0,0
2020,36081128300,"Census Tract 1283, Queens County, New York",0,0,0,0,0,NA,NA,NA,NA,NA,0,0,0,0,0,0,0
2012,36081129102,"Census Tract 1291.02, Queens County, New York",1223,44,1179,85,334,63125,1956,2004,1813,50,42,79,0,6,0,1179,49
2013,36081129102,"Census Tract 1291.02, Queens County, New York",1213,28,1185,88,256,67632,1953,2005,1231,32.6,58,75,0,13,0,1185,36
2014,36081129102,"Census Tract 1291.02, Queens County, New York",1206,31,1175,76,169,61500,1951,2005,1116,50,50,64,0,12,0,1175,92
2015,36081129102,"Census Tract 1291.02, Queens County, New York",1242,37,1205,76,160,117981,1949,2005,1015,24,60,58,0,18,0,1205,93
2016,36081129102,"Census Tract 1291.02, Queens County, New York",1236,61,1175,95,270,NA,1952,2009,NA,10,42,86,0,9,0,1175,82
2017,36081129102,"Census Tract 1291.02, Queens County, New York",1263,58,1205,127,413,121719,1954,2010,NA,10,45,108,0,8,11,1205,75
2018,36081129102,"Census Tract 1291.02, Queens County, New York",1336,47,1289,124,493,130568,1956,2011,3444,25.3,25,95,0,9,20,1289,83
2019,36081129102,"Census Tract 1291.02, Queens County, New York",1319,73,1246,135,539,118750,1957,2010,3501,14.3,16,91,0,17,27,1246,52
2020,36081129102,"Census Tract 1291.02, Queens County, New York",1278,51,1227,131,502,120536,1956,2011,3501,20,28,84,0,25,22,1227,33
2012,36081129103,"Census Tract 1291.03, Queens County, New York",2019,182,1837,355,653,41597,1956,1985,1040,31.9,124,257,15,65,18,1837,165
2013,36081129103,"Census Tract 1291.03, Queens County, New York",2025,200,1825,315,532,41250,1957,1982,1161,32.9,101,238,0,77,0,1825,189
2014,36081129103,"Census Tract 1291.03, Queens County, New York",2039,145,1894,358,555,40109,1959,1984,1141,36.9,101,280,0,78,0,1894,217
2015,36081129103,"Census Tract 1291.03, Queens County, New York",2056,146,1910,373,570,27448,1958,1991,1328,48,82,249,0,124,0,1910,161
2016,36081129103,"Census Tract 1291.03, Queens County, New York",2045,188,1857,377,706,37554,1958,1999,1386,41.3,113,262,0,102,13,1857,170
2017,36081129103,"Census Tract 1291.03, Queens County, New York",2072,156,1916,379,810,29821,1957,1997,1533,42.8,97,252,0,75,52,1916,228
2018,36081129103,"Census Tract 1291.03, Queens County, New York",2121,158,1963,380,759,34375,1957,2001,1567,42,109,241,0,70,69,1963,234
2019,36081129103,"Census Tract 1291.03, Queens County, New York",2132,180,1952,358,724,36389,1956,2006,1709,51,138,212,0,69,77,1952,243
2020,36081129103,"Census Tract 1291.03, Queens County, New York",2099,177,1922,400,777,54697,1955,2000,1708,36,191,216,0,38,146,1922,196
2012,36081129104,"Census Tract 1291.04, Queens County, New York",2023,62,1961,352,473,33750,1951,1979,922,23.6,89,263,46,29,0,1961,190
2013,36081129104,"Census Tract 1291.04, Queens County, New York",1977,21,1956,327,475,43750,1953,1993,954,24.6,88,217,60,18,11,1956,177
2014,36081129104,"Census Tract 1291.04, Queens County, New York",1939,20,1919,253,438,54097,1954,1998,1046,21.7,74,152,40,51,10,1919,162
2015,36081129104,"Census Tract 1291.04, Queens County, New York",1953,69,1884,260,476,44000,1955,1999,1182,24.1,92,150,9,90,11,1884,128
2016,36081129104,"Census Tract 1291.04, Queens County, New York",1970,58,1912,313,554,55670,1955,1996,1000,26.6,101,193,10,69,41,1912,102
2017,36081129104,"Census Tract 1291.04, Queens County, New York",1979,93,1886,301,805,55265,1955,2007,1493,32.6,106,126,21,112,42,1886,108
2018,36081129104,"Census Tract 1291.04, Queens County, New York",1968,100,1868,375,933,57734,1954,2002,1345,33.4,132,207,9,117,42,1868,99
2019,36081129104,"Census Tract 1291.04, Queens County, New York",1961,108,1853,506,1267,57897,1954,1995,1088,32.3,176,300,9,95,102,1853,110
2020,36081129104,"Census Tract 1291.04, Queens County, New York",1834,108,1726,440,1091,58413,1954,1995,1096,31.3,161,261,6,69,104,1726,115
2012,36081130100,"Census Tract 1301, Queens County, New York",1656,171,1485,238,628,47143,1954,2006,1139,26.2,82,129,28,21,60,1485,153
2013,36081130100,"Census Tract 1301, Queens County, New York",1657,128,1529,214,581,50938,1951,2006,1347,26.1,81,101,54,17,42,1529,161
2014,36081130100,"Census Tract 1301, Queens County, New York",1624,137,1487,252,712,51563,1952,2005,1280,27.8,82,119,49,27,57,1487,177
2015,36081130100,"Census Tract 1301, Queens County, New York",1618,95,1523,361,1005,52448,1952,2006,1265,25.9,99,134,94,36,97,1523,188
2016,36081130100,"Census Tract 1301, Queens County, New York",1588,123,1465,327,926,58698,1952,2005,1196,23.3,104,97,100,26,81,1465,169
2017,36081130100,"Census Tract 1301, Queens County, New York",1608,120,1488,251,673,72757,1953,2005,1207,23.2,67,60,91,23,82,1488,161
2018,36081130100,"Census Tract 1301, Queens County, New York",1616,154,1462,233,626,65893,1955,2007,1182,22,32,58,51,22,90,1462,119
2019,36081130100,"Census Tract 1301, Queens County, New York",1632,122,1510,247,637,59698,1954,2007,1335,21.3,40,63,57,15,97,1510,144
2020,36081130100,"Census Tract 1301, Queens County, New York",1608,142,1466,177,444,58708,1986,2012,1171,38.6,27,51,47,6,54,1466,68
2012,36081133300,"Census Tract 1333, Queens County, New York",1430,137,1293,274,757,90729,1952,2004,1708,25.9,188,122,6,100,46,1293,91
2013,36081133300,"Census Tract 1333, Queens County, New York",1416,129,1287,329,883,77298,1953,2004,1679,26.4,224,179,0,105,45,1287,116
2014,36081133300,"Census Tract 1333, Queens County, New York",1395,111,1284,331,815,75221,1954,2004,1634,27.8,200,162,0,119,50,1284,105
2015,36081133300,"Census Tract 1333, Queens County, New York",1394,149,1245,362,988,75800,1950,2010,1691,27.1,149,181,13,118,50,1245,111
2016,36081133300,"Census Tract 1333, Queens County, New York",1393,92,1301,344,1016,85000,1949,2011,1682,27.4,145,189,22,115,18,1301,131
2017,36081133300,"Census Tract 1333, Queens County, New York",1345,84,1261,308,1023,60776,1952,2011,1716,29.4,103,179,10,104,15,1261,136
2018,36081133300,"Census Tract 1333, Queens County, New York",1380,113,1267,278,951,92845,1950,2011,1828,29.2,73,173,15,81,9,1267,111
2019,36081133300,"Census Tract 1333, Queens County, New York",1381,102,1279,273,981,97198,1949,2012,1966,28.2,74,143,16,92,14,1279,91
2020,36081133300,"Census Tract 1333, Queens County, New York",1337,103,1234,224,702,107273,1954,2016,1858,25,122,71,0,136,8,1234,69
2012,36081133900,"Census Tract 1339, Queens County, New York",467,55,412,27,173,115208,1946,2011,2001,NA,21,21,0,0,0,412,39
2013,36081133900,"Census Tract 1339, Queens County, New York",462,30,432,48,274,89423,1942,2011,NA,NA,19,39,0,0,0,432,51
2014,36081133900,"Census Tract 1339, Queens County, New York",460,46,414,47,260,49083,1939,2011,2001,50,20,24,0,15,0,414,40
2015,36081133900,"Census Tract 1339, Queens County, New York",462,60,402,48,231,NA,1939,2012,2550,50,19,22,0,15,5,402,29
2016,36081133900,"Census Tract 1339, Queens County, New York",452,52,400,65,336,147813,1943,2014,2438,34.4,27,32,0,11,18,400,21
2017,36081133900,"Census Tract 1339, Queens County, New York",454,49,405,52,234,NA,1939,2013,2350,50,21,20,0,15,17,405,38
2018,36081133900,"Census Tract 1339, Queens County, New York",464,54,410,38,173,NA,1949,2015,1885,28.3,16,9,0,7,22,410,25
2019,36081133900,"Census Tract 1339, Queens County, New York",460,64,396,30,158,168846,1955,2016,NA,27.3,13,13,0,0,17,396,24
2020,36081133900,"Census Tract 1339, Queens County, New York",442,37,405,18,121,172250,1953,NA,3501,26.5,13,10,0,3,5,405,33
2012,36081134100,"Census Tract 1341, Queens County, New York",1025,59,966,146,462,65488,1953,2006,1417,44.2,61,19,0,104,8,966,49
2013,36081134100,"Census Tract 1341, Queens County, New York",1097,54,1043,150,573,39943,1949,2006,2001,50,87,26,0,92,16,1043,61
2014,36081134100,"Census Tract 1341, Queens County, New York",1092,50,1042,198,741,41250,1950,2007,1750,50,115,32,0,127,16,1042,50
2015,36081134100,"Census Tract 1341, Queens County, New York",1128,62,1066,276,1030,60200,1948,2008,1726,45,116,60,0,183,16,1066,75
2016,36081134100,"Census Tract 1341, Queens County, New York",1107,66,1041,235,970,48393,1951,2008,1826,50,92,48,0,179,8,1041,123
2017,36081134100,"Census Tract 1341, Queens County, New York",1095,27,1068,281,1047,63466,1952,2007,1706,34.3,97,87,0,166,28,1068,103
2018,36081134100,"Census Tract 1341, Queens County, New York",1095,29,1066,308,1158,76481,1952,2010,1772,31.5,83,72,0,215,21,1066,113
2019,36081134100,"Census Tract 1341, Queens County, New York",1116,98,1018,289,929,75625,1953,2011,1740,30.4,37,72,10,154,53,1018,128
2020,36081134100,"Census Tract 1341, Queens County, New York",1162,77,1085,340,945,NA,1951,2016,1395,30.3,72,52,21,243,24,1085,110
2012,36081134700,"Census Tract 1347, Queens County, New York",4024,113,3911,3429,8690,44044,1952,2003,1479,38.8,1588,993,476,1534,441,3911,637
2013,36081134700,"Census Tract 1347, Queens County, New York",4005,112,3893,3321,8393,38327,1954,2004,1490,41.4,1527,1119,396,1385,393,3893,678
2014,36081134700,"Census Tract 1347, Queens County, New York",3948,150,3798,3060,7564,50255,1953,2005,1560,36.2,1490,1097,334,1122,436,3798,704
2015,36081134700,"Census Tract 1347, Queens County, New York",3989,153,3836,3146,7980,53869,1953,2007,1615,35.7,1557,988,428,1201,394,3836,672
2016,36081134700,"Census Tract 1347, Queens County, New York",4072,154,3918,3112,7801,53991,1952,2008,1653,36,1363,1079,275,1103,562,3918,666
2017,36081134700,"Census Tract 1347, Queens County, New York",4104,180,3924,3212,7974,60019,1951,2008,1694,33.5,1628,1141,350,1090,466,3924,561
2018,36081134700,"Census Tract 1347, Queens County, New York",4084,174,3910,3201,8107,62851,1950,2009,1781,33.1,1570,1010,401,1212,456,3910,555
2019,36081134700,"Census Tract 1347, Queens County, New York",4076,92,3984,3287,8986,64106,1952,2010,1827,32.8,1700,991,373,1298,448,3984,515
2020,36081134701,"Census Tract 1347.01, Queens County, New York",1922,72,1850,1726,4845,75122,1952,2013,1823,31.3,705,366,230,714,290,1850,323
2020,36081134702,"Census Tract 1347.02, Queens County, New York",1917,81,1836,1352,3796,65256,1950,2009,1890,31.8,839,527,121,559,160,1836,184
2012,36081136700,"Census Tract 1367, Queens County, New York",2514,75,2439,536,1555,51250,1965,2006,1600,34.1,236,147,24,258,89,2439,177
2013,36081136700,"Census Tract 1367, Queens County, New York",2551,121,2430,577,1652,57820,1963,2005,1661,33.1,238,176,57,242,101,2430,146
2014,36081136700,"Census Tract 1367, Queens County, New York",2495,120,2375,572,1687,60029,1964,2005,1731,41.5,202,182,83,181,123,2375,182
2015,36081136700,"Census Tract 1367, Queens County, New York",2499,157,2342,643,1917,60489,1965,2006,1754,42.3,220,180,112,206,170,2342,252
2016,36081136700,"Census Tract 1367, Queens County, New York",2498,152,2346,610,1701,46711,1963,2007,1710,43.8,212,160,80,169,204,2346,239
2017,36081136700,"Census Tract 1367, Queens County, New York",2480,162,2318,499,1699,52127,1957,2010,1764,34.7,185,176,17,134,156,2318,267
2018,36081136700,"Census Tract 1367, Queens County, New York",2480,174,2306,419,1488,64632,1957,2012,1946,33.3,118,107,0,130,164,2306,277
2019,36081136700,"Census Tract 1367, Queens County, New York",2547,176,2371,566,1764,71950,1959,2014,1974,24.9,69,102,78,182,204,2371,284
2020,36081136700,"Census Tract 1367, Queens County, New York",2368,136,2232,674,2366,92763,1963,2014,1963,26.7,214,107,76,281,169,2232,202
2012,36081137700,"Census Tract 1377, Queens County, New York",2405,23,2382,1233,3436,52386,1949,2003,1561,34.9,393,460,0,584,123,2382,343
2013,36081137700,"Census Tract 1377, Queens County, New York",2364,27,2337,1221,3146,46250,1950,2004,1492,37.6,409,523,0,535,96,2337,283
2014,36081137700,"Census Tract 1377, Queens County, New York",2334,12,2322,1237,3286,54256,1951,2006,1489,32.4,465,537,0,547,85,2322,267
2015,36081137700,"Census Tract 1377, Queens County, New York",2369,40,2329,1217,3036,53007,1949,2008,1547,33.8,439,444,101,534,112,2329,251
2016,36081137700,"Census Tract 1377, Queens County, New York",2402,40,2362,1163,2767,64886,1952,2008,1565,24.9,397,444,161,439,106,2362,232
2017,36081137700,"Census Tract 1377, Queens County, New York",2454,74,2380,1152,2714,70603,1952,2010,1618,24.5,355,391,202,385,160,2380,234
2018,36081137700,"Census Tract 1377, Queens County, New York",2521,78,2443,1172,3285,66700,1952,2011,1717,32.1,311,272,227,487,187,2443,209
2019,36081137700,"Census Tract 1377, Queens County, New York",2521,78,2443,1143,3032,75479,1950,2012,1773,32.1,323,193,254,446,269,2443,196
2020,36081137700,"Census Tract 1377, Queens County, New York",2629,67,2562,1161,3261,68576,1957,2012,1779,33.5,254,263,183,405,333,2562,253
2012,36081138501,"Census Tract 1385.01, Queens County, New York",1517,80,1437,526,1616,70761,1963,2004,1675,31,214,192,0,253,67,1437,167
2013,36081138501,"Census Tract 1385.01, Queens County, New York",1500,73,1427,571,1693,59471,1962,2005,1879,33.3,164,186,0,274,111,1427,232
2014,36081138501,"Census Tract 1385.01, Queens County, New York",1465,45,1420,581,1870,58835,1963,2006,1901,41.6,162,199,0,283,99,1420,194
2015,36081138501,"Census Tract 1385.01, Queens County, New York",1484,62,1422,649,2024,60046,1963,2007,1919,40,165,260,7,292,90,1422,142
2016,36081138501,"Census Tract 1385.01, Queens County, New York",1480,81,1399,678,2154,60658,1964,2009,2022,41.8,193,284,23,303,68,1399,166
2017,36081138501,"Census Tract 1385.01, Queens County, New York",1535,71,1464,673,2083,65236,1964,2010,1983,36.2,228,298,23,287,65,1464,145
2018,36081138501,"Census Tract 1385.01, Queens County, New York",1543,64,1479,655,2100,67260,1966,2011,2037,32.7,259,315,24,297,19,1479,110
2019,36081138501,"Census Tract 1385.01, Queens County, New York",1559,108,1451,620,1899,91250,1966,2013,2102,30.3,235,273,22,290,35,1451,106
2020,36081138501,"Census Tract 1385.01, Queens County, New York",1524,127,1397,693,2168,95599,1964,2014,2361,33.8,378,236,10,339,50,1397,77
2012,36081138502,"Census Tract 1385.02, Queens County, New York",0,0,0,0,0,NA,NA,NA,NA,NA,0,0,0,0,0,0,0
2013,36081138502,"Census Tract 1385.02, Queens County, New York",0,0,0,0,0,NA,NA,NA,NA,NA,0,0,0,0,0,0,0
2014,36081138502,"Census Tract 1385.02, Queens County, New York",0,0,0,0,0,NA,NA,NA,NA,NA,0,0,0,0,0,0,0
2015,36081138502,"Census Tract 1385.02, Queens County, New York",0,0,0,0,0,NA,NA,NA,NA,NA,0,0,0,0,0,0,0
2016,36081138502,"Census Tract 1385.02, Queens County, New York",0,0,0,0,0,NA,NA,NA,NA,NA,0,0,0,0,0,0,0
2017,36081138502,"Census Tract 1385.02, Queens County, New York",0,0,0,0,0,NA,NA,NA,NA,NA,0,0,0,0,0,0,0
2018,36081138502,"Census Tract 1385.02, Queens County, New York",0,0,0,0,0,NA,NA,NA,NA,NA,0,0,0,0,0,0,0
2019,36081138502,"Census Tract 1385.02, Queens County, New York",0,0,0,0,0,NA,NA,NA,NA,NA,0,0,0,0,0,0,0
2020,36081138502,"Census Tract 1385.02, Queens County, New York",0,0,0,0,0,NA,NA,NA,NA,NA,0,0,0,0,0,0,0
2012,36081139900,"Census Tract 1399, Queens County, New York",591,44,547,5,5,NA,NA,NA,NA,NA,5,5,0,0,0,547,33
2013,36081139900,"Census Tract 1399, Queens County, New York",591,53,538,4,10,NA,NA,NA,NA,NA,0,4,0,0,0,538,39
2014,36081139900,"Census Tract 1399, Queens County, New York",587,59,528,5,11,NA,NA,NA,NA,NA,0,5,0,0,0,528,38
2015,36081139900,"Census Tract 1399, Queens County, New York",588,53,535,10,23,NA,NA,NA,NA,NA,5,10,0,0,0,535,27
2016,36081139900,"Census Tract 1399, Queens County, New York",593,14,579,46,145,67875,1948,1998,1763,31.5,6,46,0,0,0,579,18
2017,36081139900,"Census Tract 1399, Queens County, New York",591,25,566,51,175,70450,1949,1999,1803,31.7,5,51,0,0,0,566,20
2018,36081139900,"Census Tract 1399, Queens County, New York",602,26,576,75,201,73092,1949,2015,1750,30.9,16,65,0,10,0,576,23
2019,36081139900,"Census Tract 1399, Queens County, New York",594,21,573,82,211,55000,1947,2012,2156,30.9,20,55,0,27,0,573,32
2020,36081139900,"Census Tract 1399, Queens County, New York",603,46,557,67,143,NA,1948,2013,NA,33.8,14,39,0,28,0,557,31
2012,36081140300,"Census Tract 1403, Queens County, New York",873,42,831,159,567,26917,1971,2006,2001,50,90,26,0,115,18,831,74
2013,36081140300,"Census Tract 1403, Queens County, New York",856,30,826,179,609,30208,1971,2006,1992,50,104,27,0,116,31,826,97
2014,36081140300,"Census Tract 1403, Queens County, New York",850,29,821,182,513,68243,1957,2010,1800,46.3,105,37,0,86,53,821,54
2015,36081140300,"Census Tract 1403, Queens County, New York",837,27,810,171,368,80057,1956,2008,1760,47.9,84,77,0,45,44,810,64
2016,36081140300,"Census Tract 1403, Queens County, New York",838,47,791,172,357,71563,1956,2006,1851,46.4,99,74,0,43,50,791,67
2017,36081140300,"Census Tract 1403, Queens County, New York",840,38,802,177,377,61458,1957,2010,1840,48.7,104,76,0,49,47,802,47
2018,36081140300,"Census Tract 1403, Queens County, New York",843,33,810,175,389,74125,1957,2012,1942,48.8,99,77,5,57,36,810,25
2019,36081140300,"Census Tract 1403, Queens County, New York",829,50,779,112,244,52308,1958,2010,1904,51,52,42,3,54,13,779,29
2020,36081140300,"Census Tract 1403, Queens County, New York",821,46,775,48,163,47500,1954,2008,2475,51,17,8,4,27,9,775,40
2012,36081140901,"Census Tract 1409.01, Queens County, New York",320,0,320,16,36,78750,1953,1993,1125,NA,12,8,0,8,0,320,26
2013,36081140901,"Census Tract 1409.01, Queens County, New York",315,0,315,21,33,42250,1951,1996,1125,24,16,21,0,0,0,315,27
2014,36081140901,"Census Tract 1409.01, Queens County, New York",312,0,312,26,40,41250,1954,1997,1125,37.5,16,26,0,0,0,312,32
2015,36081140901,"Census Tract 1409.01, Queens County, New York",314,0,314,29,43,NA,1955,1998,1115,50,17,29,0,0,0,314,30
2016,36081140901,"Census Tract 1409.01, Queens County, New York",318,0,318,28,42,NA,1955,1998,1136,37.5,18,28,0,0,0,318,26
2017,36081140901,"Census Tract 1409.01, Queens County, New York",313,0,313,48,133,41875,1949,2004,NA,38.6,36,37,0,10,0,313,26
2018,36081140901,"Census Tract 1409.01, Queens County, New York",316,0,316,40,91,NA,1950,2005,1320,37,27,27,6,5,0,316,16
2019,36081140901,"Census Tract 1409.01, Queens County, New York",320,0,320,41,97,NA,1948,2004,1370,36.4,33,27,5,7,0,320,10
2020,36081140901,"Census Tract 1409.01, Queens County, New York",352,0,352,121,390,108417,1947,2016,2190,22.5,38,17,13,12,75,352,4
2012,36081140902,"Census Tract 1409.02, Queens County, New York",891,75,816,182,583,57845,2001,2007,1910,37.7,83,36,18,105,41,816,62
2013,36081140902,"Census Tract 1409.02, Queens County, New York",900,62,838,175,587,65391,2002,2009,1962,33.6,88,32,14,104,39,838,41
2014,36081140902,"Census Tract 1409.02, Queens County, New York",905,28,877,156,521,71579,2001,2011,2001,31.9,103,25,16,91,40,877,48
2015,36081140902,"Census Tract 1409.02, Queens County, New York",916,27,889,165,501,72188,2001,2011,2033,25,110,32,16,89,44,889,51
2016,36081140902,"Census Tract 1409.02, Queens County, New York",911,30,881,133,343,101771,1971,2012,1739,21.9,96,36,0,97,0,881,34
2017,36081140902,"Census Tract 1409.02, Queens County, New York",918,16,902,133,431,102422,1959,2012,1671,22.6,58,34,0,99,0,902,53
2018,36081140902,"Census Tract 1409.02, Queens County, New York",894,26,868,182,499,75192,1959,2013,1743,27,74,45,0,136,1,868,86
2019,36081140902,"Census Tract 1409.02, Queens County, New York",903,52,851,175,508,78194,1961,2013,1782,29.5,78,39,0,133,3,851,102
2020,36081140902,"Census Tract 1409.02, Queens County, New York",866,56,810,226,627,NA,1949,2012,1824,26.7,128,32,0,120,74,810,95
2012,36081141700,"Census Tract 1417, Queens County, New York",1559,42,1517,339,1012,51094,1953,2005,1617,27,105,83,0,133,123,1517,94
2013,36081141700,"Census Tract 1417, Queens County, New York",1556,43,1513,276,832,90217,1951,2005,1750,23.5,72,85,0,118,73,1513,119
2014,36081141700,"Census Tract 1417, Queens County, New York",1543,9,1534,259,824,64205,1952,2007,1740,26.8,60,78,9,85,63,1534,112
2015,36081141700,"Census Tract 1417, Queens County, New York",1566,36,1530,252,812,53182,1954,2008,1615,31.4,64,65,10,102,53,1530,114
2016,36081141700,"Census Tract 1417, Queens County, New York",1598,47,1551,252,811,55000,1957,2009,1394,28.1,49,63,10,91,64,1551,100
2017,36081141700,"Census Tract 1417, Queens County, New York",1614,40,1574,211,669,55450,1959,2008,1373,28.8,62,65,12,78,31,1574,102
2018,36081141700,"Census Tract 1417, Queens County, New York",1628,52,1576,231,700,54792,1961,2011,1769,33.4,64,78,12,97,30,1576,102
2019,36081141700,"Census Tract 1417, Queens County, New York",1627,49,1578,290,692,53696,1970,2011,2061,33.5,69,141,0,136,27,1578,183
2020,36081141700,"Census Tract 1417, Queens County, New York",1592,21,1571,345,948,56010,1974,2013,2542,37.2,135,117,0,199,68,1571,272
2012,36081142900,"Census Tract 1429, Queens County, New York",1302,59,1243,394,907,53600,1956,2005,1480,34.7,136,179,0,143,72,1243,163
2013,36081142900,"Census Tract 1429, Queens County, New York",1277,0,1277,425,970,52125,1957,2006,1581,39.1,138,177,0,164,84,1277,193
2014,36081142900,"Census Tract 1429, Queens County, New York",1285,31,1254,370,863,52708,1957,2006,1711,31.3,77,160,0,138,72,1254,165
2015,36081142900,"Census Tract 1429, Queens County, New York",1284,82,1202,396,936,55972,1953,2004,1990,43.4,119,218,0,138,40,1202,105
2016,36081142900,"Census Tract 1429, Queens County, New York",1282,147,1135,359,977,63144,1954,2006,1804,31.5,116,202,0,122,35,1135,61
2017,36081142900,"Census Tract 1429, Queens County, New York",1269,151,1118,324,922,63333,1954,2008,1802,30.7,110,170,0,124,26,1118,55
2018,36081142900,"Census Tract 1429, Queens County, New York",1292,123,1169,268,764,65735,1953,2009,1882,33.3,86,133,0,109,18,1169,62
2019,36081142900,"Census Tract 1429, Queens County, New York",1305,109,1196,311,943,68688,1953,2011,1992,31.1,69,144,0,149,8,1196,62
2020,36081142900,"Census Tract 1429, Queens County, New York",1376,65,1311,240,797,NA,1957,2013,2128,28.7,43,90,0,132,18,1311,58
2012,36081143500,"Census Tract 1435, Queens County, New York",804,17,787,101,163,72844,1942,2005,1439,24.8,55,32,0,69,0,787,26
2013,36081143500,"Census Tract 1435, Queens County, New York",772,46,726,99,170,76612,1948,2005,1463,24.9,54,39,0,60,0,726,29
2014,36081143500,"Census Tract 1435, Queens County, New York",767,48,719,102,201,86111,1946,2009,1729,28.4,19,65,0,37,0,719,55
2015,36081143500,"Census Tract 1435, Queens County, New York",761,54,707,123,300,85078,1951,2010,1798,29.4,34,71,0,43,9,707,48
2016,36081143500,"Census Tract 1435, Queens County, New York",753,42,711,108,284,87000,1939,2011,1776,26.7,26,64,0,34,10,711,50
2017,36081143500,"Census Tract 1435, Queens County, New York",776,58,718,90,247,89219,1939,2011,1738,26.5,16,50,0,30,10,718,61
2018,36081143500,"Census Tract 1435, Queens County, New York",769,35,734,132,361,92857,0,2014,1480,24.7,17,67,0,57,8,734,72
2019,36081143500,"Census Tract 1435, Queens County, New York",770,33,737,120,470,96453,1953,2015,2125,26.8,36,46,0,66,8,737,25
2020,36081143500,"Census Tract 1435, Queens County, New York",799,105,694,106,405,102500,1955,2016,2167,25.3,36,50,0,56,0,694,28
2012,36081144100,"Census Tract 1441, Queens County, New York",1219,11,1208,229,652,54886,1953,2004,1552,34.6,86,106,0,73,50,1208,97
2013,36081144100,"Census Tract 1441, Queens County, New York",1224,10,1214,242,612,57500,1953,2007,1526,33.5,72,118,0,87,37,1214,114
2014,36081144100,"Census Tract 1441, Queens County, New York",1217,8,1209,231,544,65573,1954,2008,1591,30.9,86,115,0,83,33,1209,81
2015,36081144100,"Census Tract 1441, Queens County, New York",1238,36,1202,285,698,66106,1954,2008,1552,29.1,121,166,0,82,37,1202,105
2016,36081144100,"Census Tract 1441, Queens County, New York",1241,56,1185,280,623,65000,1954,2009,1496,23.9,126,200,0,60,20,1185,85
2017,36081144100,"Census Tract 1441, Queens County, New York",1243,62,1181,250,481,63846,1954,2009,1570,36.2,77,189,0,48,13,1181,54
2018,36081144100,"Census Tract 1441, Queens County, New York",1251,65,1186,273,613,50313,1953,2004,1681,40.7,91,169,20,56,48,1186,70
2019,36081144100,"Census Tract 1441, Queens County, New York",1210,127,1083,247,679,NA,1951,2004,1829,38.2,72,134,29,51,62,1083,49
2020,36081144100,"Census Tract 1441, Queens County, New York",1184,60,1124,249,751,52083,1948,2012,2177,43.3,69,96,31,83,70,1124,78
2012,36081144700,"Census Tract 1447, Queens County, New York",969,8,961,405,1071,65462,1956,2004,1484,29.1,150,136,56,193,20,961,80
2013,36081144700,"Census Tract 1447, Queens County, New York",973,25,948,465,1341,67566,1959,2004,1713,28.5,207,150,28,247,40,948,112
2014,36081144700,"Census Tract 1447, Queens County, New York",1042,56,986,396,1343,61154,1963,2006,1798,28.5,118,104,0,234,72,986,149
2015,36081144700,"Census Tract 1447, Queens County, New York",1044,100,944,344,1054,77955,1964,2007,1645,25.9,123,115,5,182,58,944,178
2016,36081144700,"Census Tract 1447, Queens County, New York",1026,98,928,399,1309,72986,1966,2010,1632,27.2,138,88,7,263,60,928,129
2017,36081144700,"Census Tract 1447, Queens County, New York",1032,112,920,377,1299,74934,1963,2011,1711,27.1,132,78,24,235,58,920,151
2018,36081144700,"Census Tract 1447, Queens County, New York",1046,133,913,309,968,89583,1965,2012,1862,25.6,113,65,35,193,34,913,123
2019,36081144700,"Census Tract 1447, Queens County, New York",1002,91,911,320,978,72083,1956,2013,1878,29.6,140,57,57,183,23,911,96
2020,36081144700,"Census Tract 1447, Queens County, New York",1138,100,1038,455,1307,51138,1953,2015,1965,47.1,199,66,77,129,105,1038,177
2012,36081145101,"Census Tract 1451.01, Queens County, New York",548,28,520,156,471,31667,1949,2004,1567,30,37,9,0,136,11,520,53
2013,36081145101,"Census Tract 1451.01, Queens County, New York",540,0,540,150,499,83710,1950,2004,1697,20.2,18,34,0,101,15,540,35
2014,36081145101,"Census Tract 1451.01, Queens County, New York",530,0,530,95,344,51042,1958,2004,1780,31.7,23,32,0,63,0,530,57
2015,36081145101,"Census Tract 1451.01, Queens County, New York",522,0,522,107,378,65083,1953,2006,1801,27.8,21,46,0,61,0,522,41
2016,36081145101,"Census Tract 1451.01, Queens County, New York",490,0,490,120,408,63214,1954,2007,1799,29.9,35,44,0,76,0,490,39
2017,36081145101,"Census Tract 1451.01, Queens County, New York",491,16,475,117,381,64375,1953,2007,1844,29,35,41,0,67,9,475,43
2018,36081145101,"Census Tract 1451.01, Queens County, New York",442,36,406,99,297,46458,1952,2007,2169,29.6,34,16,0,72,11,406,71
2019,36081145101,"Census Tract 1451.01, Queens County, New York",436,26,410,111,294,NA,1950,2003,1989,26.6,19,47,0,53,11,410,63
2020,36081145101,"Census Tract 1451.01, Queens County, New York",393,26,367,69,240,NA,1941,2010,2409,26.9,19,36,0,19,14,367,47
2012,36081145102,"Census Tract 1451.02, Queens County, New York",895,33,862,224,644,49926,1956,2002,1693,29.1,74,61,0,108,55,862,42
2013,36081145102,"Census Tract 1451.02, Queens County, New York",878,56,822,208,558,66000,1955,2003,1708,28.1,79,60,0,107,41,822,37
2014,36081145102,"Census Tract 1451.02, Queens County, New York",865,79,786,206,589,66875,1956,2003,1829,28.9,62,55,0,111,40,786,41
2015,36081145102,"Census Tract 1451.02, Queens County, New York",851,80,771,251,728,66016,1952,2006,1650,28.3,104,113,0,133,5,771,69
2016,36081145102,"Census Tract 1451.02, Queens County, New York",843,98,745,251,728,84250,1950,2008,1645,25.4,95,103,10,138,0,745,77
2017,36081145102,"Census Tract 1451.02, Queens County, New York",859,85,774,303,897,85114,1951,2010,1768,31.9,99,105,27,171,0,774,74
2018,36081145102,"Census Tract 1451.02, Queens County, New York",852,58,794,361,1104,93664,1952,2011,2012,32.7,166,102,30,225,0,794,88
2019,36081145102,"Census Tract 1451.02, Queens County, New York",855,63,792,389,1158,95224,1954,2012,2088,33.9,161,90,30,251,14,792,76
2020,36081145102,"Census Tract 1451.02, Queens County, New York",940,38,902,318,967,57000,1955,2014,2282,41.2,133,60,32,210,6,902,58
2012,36081145900,"Census Tract 1459, Queens County, New York",1057,29,1028,302,659,53600,1950,2005,1320,33.6,145,115,0,183,4,1028,39
2013,36081145900,"Census Tract 1459, Queens County, New York",1054,48,1006,295,652,44261,1939,2006,1457,39.7,113,121,0,170,4,1006,42
2014,36081145900,"Census Tract 1459, Queens County, New York",1025,77,948,331,663,44323,1954,2007,1461,44.1,118,131,0,183,17,948,36
2015,36081145900,"Census Tract 1459, Queens County, New York",1017,80,937,281,582,NA,1939,2008,1560,44.1,113,132,0,130,19,937,49
2016,36081145900,"Census Tract 1459, Queens County, New York",1009,101,908,225,475,36705,1951,2008,1623,45.4,72,108,0,92,25,908,58
2017,36081145900,"Census Tract 1459, Queens County, New York",1004,108,896,222,480,60366,1939,2005,1780,33.6,32,120,0,82,20,896,53
2018,36081145900,"Census Tract 1459, Queens County, New York",990,67,923,260,762,61250,1948,2007,1826,32.5,42,94,0,95,49,923,63
2019,36081145900,"Census Tract 1459, Queens County, New York",983,46,937,235,729,62520,1946,2007,1850,34.2,28,77,0,98,44,937,82
2020,36081145900,"Census Tract 1459, Queens County, New York",982,57,925,239,744,63526,1946,2013,1891,34.8,55,46,0,114,59,925,70
2012,36081146300,"Census Tract 1463, Queens County, New York",975,83,892,558,1448,71667,1957,2004,1570,27.1,267,236,0,201,110,892,91
2013,36081146300,"Census Tract 1463, Queens County, New York",975,78,897,518,1393,66087,1959,2005,1665,30.3,255,229,10,199,69,897,131
2014,36081146300,"Census Tract 1463, Queens County, New York",960,43,917,464,1296,63929,1964,2006,1544,31.5,167,248,9,166,30,917,96
2015,36081146300,"Census Tract 1463, Queens County, New York",994,37,957,444,1299,73500,1960,2008,1572,29.5,154,206,10,209,19,957,90
2016,36081146300,"Census Tract 1463, Queens County, New York",1042,27,1015,564,1591,73676,1956,2010,1554,30.7,165,232,19,257,56,1015,67
2017,36081146300,"Census Tract 1463, Queens County, New York",1077,81,996,577,1641,57813,1954,2010,1515,35,203,245,21,247,64,996,88
2018,36081146300,"Census Tract 1463, Queens County, New York",1074,103,971,598,1641,62969,1952,2011,1572,29.2,170,245,7,273,73,971,42
2019,36081146300,"Census Tract 1463, Queens County, New York",1069,148,921,588,1621,63889,1953,2011,1492,31.7,177,193,10,294,91,921,53
2020,36081146300,"Census Tract 1463, Queens County, New York",1283,92,1191,513,1290,71760,1953,2012,1650,28,169,173,6,209,83,1191,67
2012,36081146700,"Census Tract 1467, Queens County, New York",1399,41,1358,1105,2309,51375,1950,2002,1302,28.7,382,808,0,151,146,1358,155
2013,36081146700,"Census Tract 1467, Queens County, New York",1403,24,1379,1146,2373,52875,1953,2002,1340,30.8,417,789,0,207,142,1379,198
2014,36081146700,"Census Tract 1467, Queens County, New York",1396,29,1367,1021,2233,52596,1955,2004,1523,27.6,443,700,0,180,131,1367,170
2015,36081146700,"Census Tract 1467, Queens County, New York",1374,46,1328,978,2162,62778,1954,2007,1525,24.9,456,544,0,283,141,1328,178
2016,36081146700,"Census Tract 1467, Queens County, New York",1355,35,1320,954,1913,67000,1957,2011,1549,25.7,490,463,0,338,143,1320,173
2017,36081146700,"Census Tract 1467, Queens County, New York",1332,52,1280,889,1729,64125,1957,2011,1624,25.6,373,465,0,320,94,1280,182
2018,36081146700,"Census Tract 1467, Queens County, New York",1355,84,1271,923,1812,84250,1959,2012,1714,25.5,343,465,0,307,151,1271,132
2019,36081146700,"Census Tract 1467, Queens County, New York",1349,72,1277,1013,2024,88863,1957,2013,1780,24.4,409,528,0,334,151,1277,142
2020,36081146700,"Census Tract 1467, Queens County, New York",1367,56,1311,956,1887,89038,1958,2014,1886,27,545,466,0,323,148,1311,127
2012,36081147100,"Census Tract 1471, Queens County, New York",1371,66,1305,428,1033,44688,1965,2004,1757,42.8,214,178,0,178,72,1305,81
2013,36081147100,"Census Tract 1471, Queens County, New York",1359,24,1335,514,1378,46364,1964,2006,1816,34.6,255,171,22,212,131,1335,81
2014,36081147100,"Census Tract 1471, Queens County, New York",1328,56,1272,542,1387,55227,1961,2007,1805,32.2,270,215,24,202,125,1272,43
2015,36081147100,"Census Tract 1471, Queens County, New York",1352,56,1296,606,1468,56571,1963,2007,1694,31.2,344,317,26,175,114,1296,54
2016,36081147100,"Census Tract 1471, Queens County, New York",1395,51,1344,595,1470,50855,1960,2009,1658,30,295,261,27,243,91,1344,57
2017,36081147100,"Census Tract 1471, Queens County, New York",1404,93,1311,551,1528,67740,1959,2011,1783,29.9,329,240,51,184,106,1311,68
2018,36081147100,"Census Tract 1471, Queens County, New York",1400,178,1222,483,1336,71181,1967,2010,1856,32.2,295,233,23,188,39,1222,82
2019,36081147100,"Census Tract 1471, Queens County, New York",1412,176,1236,466,1347,74306,1967,2010,1894,31.3,299,219,22,194,31,1236,77
2020,36081147100,"Census Tract 1471, Queens County, New York",1475,141,1334,422,1328,113851,1965,2011,2184,27,251,192,26,196,8,1334,72
2012,36081147900,"Census Tract 1479, Queens County, New York",1773,96,1677,608,1607,80938,1965,2004,1550,24.4,355,313,6,175,120,1677,38
2013,36081147900,"Census Tract 1479, Queens County, New York",1797,107,1690,674,1970,71523,1962,2004,1557,24.6,346,334,11,162,178,1690,39
2014,36081147900,"Census Tract 1479, Queens County, New York",1783,98,1685,616,1858,70244,1959,2006,1590,27.8,317,292,10,115,209,1685,72
2015,36081147900,"Census Tract 1479, Queens County, New York",1802,77,1725,690,2095,54231,1961,2008,1725,30.6,392,334,10,170,186,1725,120
2016,36081147900,"Census Tract 1479, Queens County, New York",1757,38,1719,631,1945,51910,1959,2010,1744,33.9,370,281,12,148,202,1719,151
2017,36081147900,"Census Tract 1479, Queens County, New York",1772,35,1737,638,1989,56250,1961,2011,1791,34.2,331,272,31,112,223,1737,168
2018,36081147900,"Census Tract 1479, Queens County, New York",1758,41,1717,612,1601,59435,1966,2012,1988,34.9,370,273,32,137,170,1717,165
2019,36081147900,"Census Tract 1479, Queens County, New York",1857,47,1810,626,1581,64643,1964,2012,2103,33.9,406,299,35,174,118,1810,168
2020,36081147900,"Census Tract 1479, Queens County, New York",1803,16,1787,577,1364,80442,1963,2013,1957,30.8,291,283,32,87,175,1787,211
2012,36081148300,"Census Tract 1483, Queens County, New York",1071,35,1036,191,572,76134,1965,2005,1777,24.3,139,70,9,112,0,1036,74
2013,36081148300,"Census Tract 1483, Queens County, New York",1077,105,972,182,493,77273,1966,2005,1690,23,125,82,3,97,0,972,73
2014,36081148300,"Census Tract 1483, Queens County, New York",1078,135,943,203,611,79315,1969,2008,1734,23.6,144,75,0,128,0,943,60
2015,36081148300,"Census Tract 1483, Queens County, New York",1091,121,970,157,439,77969,1959,2006,1727,27.8,110,73,0,84,0,970,28
2016,36081148300,"Census Tract 1483, Queens County, New York",1099,116,983,133,372,95156,1954,2011,1717,21.9,87,45,0,67,21,983,35
2017,36081148300,"Census Tract 1483, Queens County, New York",1113,102,1011,127,360,NA,1954,2011,1929,24.7,96,42,0,65,20,1011,19
2018,36081148300,"Census Tract 1483, Queens County, New York",1106,35,1071,140,416,106786,1954,2011,2011,23.5,107,36,0,81,23,1071,16
2019,36081148300,"Census Tract 1483, Queens County, New York",1105,7,1098,126,318,109167,1954,2012,2429,23.2,100,33,0,70,23,1098,25
2020,36081148300,"Census Tract 1483, Queens County, New York",1100,7,1093,170,433,NA,1972,2009,2120,23.7,108,36,0,111,23,1093,49
2012,36081150701,"Census Tract 1507.01, Queens County, New York",1096,31,1065,141,235,74028,1967,2002,1500,24.6,100,95,0,28,18,1065,114
2013,36081150701,"Census Tract 1507.01, Queens County, New York",1101,27,1074,164,349,76429,1964,2002,1552,25,117,106,0,39,19,1074,89
2014,36081150701,"Census Tract 1507.01, Queens County, New York",1097,29,1068,151,365,75927,1966,2002,1525,25.4,117,111,0,31,9,1068,104
2015,36081150701,"Census Tract 1507.01, Queens County, New York",1106,48,1058,89,262,71394,1956,2004,1893,33.1,56,47,0,33,9,1058,66
2016,36081150701,"Census Tract 1507.01, Queens County, New York",1111,31,1080,118,330,73017,1956,2005,1910,33,73,79,0,29,10,1080,34
2017,36081150701,"Census Tract 1507.01, Queens County, New York",1113,43,1070,78,293,74167,1957,2011,1833,31.3,49,48,0,30,0,1070,30
2018,36081150701,"Census Tract 1507.01, Queens County, New York",1146,94,1052,52,149,71500,1951,2011,2265,29.2,24,47,0,5,0,1052,37
2019,36081150701,"Census Tract 1507.01, Queens County, New York",1161,153,1008,86,209,70714,1951,2016,2170,34.7,61,58,0,28,0,1008,29
2020,36081150701,"Census Tract 1507.01, Queens County, New York",1123,125,998,203,552,113105,1950,2017,3501,33.7,176,74,0,43,31,998,27
2012,36081150702,"Census Tract 1507.02, Queens County, New York",1261,88,1173,318,584,44167,1964,2004,1383,44.7,148,229,0,20,69,1173,73
2013,36081150702,"Census Tract 1507.02, Queens County, New York",1261,92,1169,326,594,51875,1965,2006,1371,33.2,189,225,0,26,75,1169,102
2014,36081150702,"Census Tract 1507.02, Queens County, New York",1271,87,1184,292,563,59583,1963,2007,1420,32.1,179,195,0,33,64,1184,98
2015,36081150702,"Census Tract 1507.02, Queens County, New York",1280,57,1223,288,503,65938,1965,2010,1404,26.7,168,214,0,38,36,1223,102
2016,36081150702,"Census Tract 1507.02, Queens County, New York",1293,109,1184,255,543,67670,1964,2012,1442,27.1,139,179,0,41,35,1184,91
2017,36081150702,"Census Tract 1507.02, Queens County, New York",1294,114,1180,238,585,67644,1961,2013,1552,32.9,99,150,0,51,37,1180,54
2018,36081150702,"Census Tract 1507.02, Queens County, New York",1297,139,1158,255,623,58920,1962,2014,1687,36.4,93,149,0,59,47,1158,14
2019,36081150702,"Census Tract 1507.02, Queens County, New York",1290,172,1118,255,564,70052,1959,2015,1796,32,101,161,0,51,43,1118,16
2020,36081150702,"Census Tract 1507.02, Queens County, New York",1289,103,1186,321,682,58423,1958,2014,1727,33.5,174,203,0,64,54,1186,16
2012,36081152901,"Census Tract 1529.01, Queens County, New York",2590,128,2462,640,1865,43488,1968,2004,1760,46.3,321,152,76,373,39,2462,115
2013,36081152901,"Census Tract 1529.01, Queens County, New York",2602,133,2469,719,1954,42589,1968,2007,1886,36.8,415,213,48,421,37,2469,193
2014,36081152901,"Census Tract 1529.01, Queens County, New York",2597,131,2466,693,1842,56884,1969,2011,2001,33.5,241,240,0,390,63,2466,234
2015,36081152901,"Census Tract 1529.01, Queens County, New York",2603,47,2556,702,1882,64186,1969,2011,2054,31.5,281,279,0,379,44,2556,297
2016,36081152901,"Census Tract 1529.01, Queens County, New York",2625,48,2577,587,1307,56172,1970,2011,2038,33,212,294,0,275,18,2577,313
2017,36081152901,"Census Tract 1529.01, Queens County, New York",2636,0,2636,692,1599,57979,1971,2011,1921,33.1,314,291,0,384,17,2636,348
2018,36081152901,"Census Tract 1529.01, Queens County, New York",2637,0,2637,673,1607,68272,1974,2011,1911,31.9,277,255,0,400,18,2637,256
2019,36081152901,"Census Tract 1529.01, Queens County, New York",2675,52,2623,604,1639,93472,1973,2011,2036,23.4,388,170,89,327,18,2623,203
2020,36081152901,"Census Tract 1529.01, Queens County, New York",2369,73,2296,571,1427,70768,1979,2012,1935,29.9,272,139,130,257,45,2296,199
2012,36081152902,"Census Tract 1529.02, Queens County, New York",2281,17,2264,210,772,62959,1978,2006,1806,38.1,65,75,53,82,0,2264,146
2013,36081152902,"Census Tract 1529.02, Queens County, New York",2279,0,2279,269,907,65512,1979,2004,1840,37.8,113,101,52,116,0,2279,174
2014,36081152902,"Census Tract 1529.02, Queens County, New York",2269,53,2216,295,989,65590,1973,2004,1722,37.2,126,115,54,107,0,2216,106
2015,36081152902,"Census Tract 1529.02, Queens County, New York",2234,49,2185,347,1081,65964,1977,2008,1743,37.4,120,109,49,172,0,2185,110
2016,36081152902,"Census Tract 1529.02, Queens County, New York",2229,88,2141,360,1037,55556,1974,2005,1663,36.3,105,137,45,160,0,2141,92
2017,36081152902,"Census Tract 1529.02, Queens County, New York",2259,110,2149,316,816,43512,1959,2003,NA,23.7,81,148,0,152,0,2149,149
2018,36081152902,"Census Tract 1529.02, Queens County, New York",2277,100,2177,368,1037,NA,1995,2010,2075,24,96,119,0,233,0,2177,123
2019,36081152902,"Census Tract 1529.02, Queens County, New York",2261,126,2135,417,1103,NA,1994,2013,2086,24.9,158,161,12,244,12,2135,165
2020,36081152902,"Census Tract 1529.02, Queens County, New York",2681,147,2534,346,1002,NA,1958,2016,1962,46.8,179,138,33,175,33,2534,106
2012,36081155101,"Census Tract 1551.01, Queens County, New York",1816,321,1495,189,229,67344,1973,2003,1645,27,99,180,9,0,0,1495,21
2013,36081155101,"Census Tract 1551.01, Queens County, New York",1802,236,1566,163,197,96688,1973,2001,1917,30.1,70,155,8,0,0,1566,43
2014,36081155101,"Census Tract 1551.01, Queens County, New York",1813,194,1619,149,188,95114,1972,1993,2001,31.3,41,140,9,0,0,1619,27
2015,36081155101,"Census Tract 1551.01, Queens County, New York",1818,296,1522,124,143,98000,1972,1990,2508,32.8,17,115,9,0,0,1522,43
2016,36081155101,"Census Tract 1551.01, Queens County, New York",1650,245,1405,115,115,79028,1967,2011,2298,31.1,0,115,0,0,0,1405,41
2017,36081155101,"Census Tract 1551.01, Queens County, New York",1609,303,1306,74,74,NA,1964,2010,NA,23.3,0,74,0,0,0,1306,204
2018,36081155101,"Census Tract 1551.01, Queens County, New York",1613,342,1271,95,95,NA,1970,1998,NA,25,5,95,0,0,0,1271,186
2019,36081155101,"Census Tract 1551.01, Queens County, New York",1600,285,1315,90,90,NA,1968,2010,NA,27.5,17,90,0,0,0,1315,231
2020,36081155101,"Census Tract 1551.01, Queens County, New York",1939,330,1609,101,101,NA,1971,2010,NA,21.7,18,101,0,0,0,1609,197
2012,36081155102,"Census Tract 1551.02, Queens County, New York",3626,285,3341,1216,2156,52115,1953,2002,1223,28.2,656,743,65,295,45,3341,223
2013,36081155102,"Census Tract 1551.02, Queens County, New York",3600,164,3436,1081,1855,51689,1954,2002,1281,30,617,636,27,307,32,3436,231
2014,36081155102,"Census Tract 1551.02, Queens County, New York",3587,184,3403,1076,1621,52679,1954,2001,1203,28.8,522,650,97,227,34,3403,243
2015,36081155102,"Census Tract 1551.02, Queens County, New York",3622,258,3364,1142,1798,75472,1955,2002,1348,23.1,472,583,189,263,19,3364,193
2016,36081155102,"Census Tract 1551.02, Queens County, New York",3651,46,3605,1335,2240,78407,1955,2009,1426,21.3,473,678,188,258,95,3605,281
2017,36081155102,"Census Tract 1551.02, Queens County, New York",3637,44,3593,1407,2564,79626,1956,2010,1476,21.5,629,801,248,211,70,3593,241
2018,36081155102,"Census Tract 1551.02, Queens County, New York",3654,46,3608,1488,2782,80953,1956,2011,1536,21.8,634,885,302,153,75,3608,249
2019,36081155102,"Census Tract 1551.02, Queens County, New York",3704,48,3656,1472,2870,83838,1957,2013,1636,21.1,662,812,250,193,91,3656,326
2020,36081155103,"Census Tract 1551.03, Queens County, New York",2214,70,2144,836,1679,84507,1958,2016,1733,25.5,557,457,112,158,85,2144,166
2020,36081155104,"Census Tract 1551.04, Queens County, New York",1333,164,1169,403,1261,90515,1949,2015,1725,18,250,214,33,122,0,1169,178
2012,36081156700,"Census Tract 1567, Queens County, New York",286,44,242,179,468,76250,2003,2006,1516,25.4,135,22,23,134,0,242,38
2013,36081156700,"Census Tract 1567, Queens County, New York",265,43,222,162,417,63125,2003,2009,1634,23.6,102,11,23,128,0,222,30
2014,36081156700,"Census Tract 1567, Queens County, New York",295,44,251,207,553,62917,2002,2007,1604,23.4,123,19,15,163,10,251,52
2015,36081156700,"Census Tract 1567, Queens County, New York",253,7,246,210,530,44375,2001,2007,1510,26.7,97,27,15,150,18,246,64
2016,36081156700,"Census Tract 1567, Queens County, New York",254,15,239,205,502,NA,2000,2007,1325,25.5,87,31,7,130,27,239,68
2017,36081156700,"Census Tract 1567, Queens County, New York",255,8,247,202,550,NA,2001,2008,1500,24.9,70,22,0,137,33,247,70
2018,36081156700,"Census Tract 1567, Queens County, New York",263,8,255,196,511,46875,2002,2009,1500,26.5,79,28,17,109,33,255,63
2019,36081156700,"Census Tract 1567, Queens County, New York",262,9,253,184,483,46250,2001,2011,1463,28.8,62,21,17,100,37,253,63
2020,36081156700,"Census Tract 1567, Queens County, New York",363,8,355,288,765,53750,2000,2016,2279,51,45,12,95,69,104,355,51
2012,36081157101,"Census Tract 1571.01, Queens County, New York",2736,224,2512,611,1787,62756,1949,2001,1161,24.3,242,372,13,175,51,2512,176
2013,36081157101,"Census Tract 1571.01, Queens County, New York",2669,139,2530,559,1729,62591,1948,2002,1171,24.2,224,319,0,176,64,2530,256
2014,36081157101,"Census Tract 1571.01, Queens County, New York",2600,105,2495,578,1598,38990,1947,2000,1155,27.4,235,330,17,168,63,2495,249
2015,36081157101,"Census Tract 1571.01, Queens County, New York",2576,96,2480,467,1407,80339,1948,2007,1422,21.4,182,268,14,109,76,2480,236
2016,36081157101,"Census Tract 1571.01, Queens County, New York",2590,94,2496,446,1253,82000,1948,2010,1548,19.7,151,280,37,44,108,2496,307
2017,36081157101,"Census Tract 1571.01, Queens County, New York",2619,104,2515,450,1334,61429,1948,2012,1753,24.5,260,215,55,60,160,2515,239
2018,36081157101,"Census Tract 1571.01, Queens County, New York",2614,96,2518,500,1622,95549,1951,2013,1712,23.6,266,194,42,151,141,2518,171
2019,36081157101,"Census Tract 1571.01, Queens County, New York",2641,81,2560,511,1732,87438,1950,2015,1887,24,214,168,38,120,223,2560,153
2020,36081157101,"Census Tract 1571.01, Queens County, New York",2737,134,2603,615,1900,76293,1952,2015,1625,22.9,326,68,37,115,407,2603,146
2012,36081157102,"Census Tract 1571.02, Queens County, New York",558,38,520,107,495,51307,1965,2005,1474,31.7,58,24,0,65,5,520,7
2013,36081157102,"Census Tract 1571.02, Queens County, New York",574,80,494,95,299,51458,1963,2007,1321,32.7,31,30,0,47,6,494,17
2014,36081157102,"Census Tract 1571.02, Queens County, New York",606,66,540,135,434,56354,1950,2011,1600,30.6,62,43,0,65,16,540,37
2015,36081157102,"Census Tract 1571.02, Queens County, New York",615,63,552,171,594,56875,1949,2011,1762,30.7,80,43,0,78,42,552,77
2016,36081157102,"Census Tract 1571.02, Queens County, New York",606,70,536,200,741,61364,1952,2011,1753,29.3,90,36,0,113,43,536,95
2017,36081157102,"Census Tract 1571.02, Queens County, New York",600,57,543,191,741,64625,1953,2011,1760,28.5,84,35,0,112,44,543,109
2018,36081157102,"Census Tract 1571.02, Queens County, New York",596,27,569,203,769,80469,1955,2011,1838,31.6,83,36,5,116,46,569,109
2019,36081157102,"Census Tract 1571.02, Queens County, New York",594,42,552,201,806,103681,1955,2011,1852,31.1,56,21,5,136,39,552,90
2020,36081157102,"Census Tract 1571.02, Queens County, New York",597,51,546,193,680,112125,1958,2013,1856,19.4,32,25,11,106,51,546,61
2012,36081157901,"Census Tract 1579.01, Queens County, New York",1881,91,1790,351,904,48487,1957,2002,1342,43.2,88,235,0,74,32,1790,160
2013,36081157901,"Census Tract 1579.01, Queens County, New York",1833,84,1749,312,829,29510,1958,2003,1378,46.2,79,199,0,71,31,1749,148
2014,36081157901,"Census Tract 1579.01, Queens County, New York",1787,56,1731,321,859,28968,1960,2003,1408,48.8,111,199,9,68,34,1731,182
2015,36081157901,"Census Tract 1579.01, Queens County, New York",1797,98,1699,272,681,NA,1958,2002,1370,50,82,196,9,34,33,1699,150
2016,36081157901,"Census Tract 1579.01, Queens County, New York",1805,148,1657,208,444,50556,1955,2004,1526,34.9,65,140,10,27,0,1657,83
2017,36081157901,"Census Tract 1579.01, Queens County, New York",1828,160,1668,220,438,65313,1955,2006,1401,33.9,86,150,8,7,10,1668,108
2018,36081157901,"Census Tract 1579.01, Queens County, New York",1856,132,1724,259,592,67933,1955,2007,1432,33.2,92,164,18,20,14,1724,113
2019,36081157901,"Census Tract 1579.01, Queens County, New York",1837,143,1694,271,610,72455,1955,2007,1434,29,109,158,9,42,16,1694,132
2020,36081157901,"Census Tract 1579.01, Queens County, New York",1749,101,1648,219,518,98068,1956,2010,1500,32.1,95,126,8,31,19,1648,143
2012,36081157902,"Census Tract 1579.02, Queens County, New York",1163,39,1124,64,241,33828,1948,2006,2001,50,0,32,23,9,0,1124,65
2013,36081157902,"Census Tract 1579.02, Queens County, New York",1111,9,1102,107,372,60144,1948,2010,1862,39.4,0,39,40,28,0,1102,89
2014,36081157902,"Census Tract 1579.02, Queens County, New York",1098,0,1098,126,414,62000,1952,2011,1892,32.8,38,61,27,28,10,1098,102
2015,36081157902,"Census Tract 1579.02, Queens County, New York",1089,0,1089,86,232,85208,1960,2012,1806,27.5,42,42,12,21,11,1089,103
2016,36081157902,"Census Tract 1579.02, Queens County, New York",1100,16,1084,102,327,89792,1964,2012,1811,21.9,54,54,12,20,10,1084,102
2017,36081157902,"Census Tract 1579.02, Queens County, New York",1127,19,1108,124,388,145183,1971,2013,1879,21.3,83,59,11,9,9,1108,37
2018,36081157902,"Census Tract 1579.02, Queens County, New York",1155,28,1127,91,265,151189,1975,2013,2087,20.7,83,50,0,0,9,1127,40
2019,36081157902,"Census Tract 1579.02, Queens County, New York",1183,29,1154,97,358,108173,1966,2016,2837,42,49,21,0,13,0,1154,4
2020,36081157902,"Census Tract 1579.02, Queens County, New York",1197,35,1162,97,390,87279,1967,2016,2776,31.3,47,27,0,17,0,1162,20
2012,36081157903,"Census Tract 1579.03, Queens County, New York",1458,41,1417,279,585,48920,1962,2001,1199,31,45,235,0,19,14,1417,49
2013,36081157903,"Census Tract 1579.03, Queens County, New York",1446,79,1367,324,702,58690,1962,2004,1335,25,106,239,0,60,13,1367,44
2014,36081157903,"Census Tract 1579.03, Queens County, New York",1404,128,1276,262,647,56094,1961,2006,1502,27.4,109,175,0,71,16,1276,49
2015,36081157903,"Census Tract 1579.03, Queens County, New York",1396,132,1264,260,705,59000,1961,2005,1614,27.6,123,150,0,105,5,1264,57
2016,36081157903,"Census Tract 1579.03, Queens County, New York",1396,117,1279,249,606,77917,1959,2007,1640,25,96,140,0,103,6,1279,62
2017,36081157903,"Census Tract 1579.03, Queens County, New York",1400,130,1270,305,806,61563,1958,2009,1576,28,133,146,0,139,20,1270,74
2018,36081157903,"Census Tract 1579.03, Queens County, New York",1394,101,1293,288,746,NA,1956,2009,1494,43.8,70,173,0,96,19,1293,79
2019,36081157903,"Census Tract 1579.03, Queens County, New York",1409,44,1365,289,760,63403,1957,2009,1643,40.6,100,174,0,100,15,1365,54
2020,36081157903,"Census Tract 1579.03, Queens County, New York",1214,80,1134,267,695,64097,1957,2011,1693,38,135,170,0,56,41,1134,40
2012,36081161700,"Census Tract 1617, Queens County, New York",1517,80,1437,276,773,52868,1952,2007,1304,24.5,132,133,0,64,79,1437,24
2013,36081161700,"Census Tract 1617, Queens County, New York",1528,109,1419,289,778,51198,1954,2010,1224,30.5,128,132,0,57,100,1419,40
2014,36081161700,"Census Tract 1617, Queens County, New York",1534,91,1443,310,960,51173,1954,2011,1247,29.6,120,137,0,82,91,1443,43
2015,36081161700,"Census Tract 1617, Queens County, New York",1547,65,1482,370,1258,51557,1952,2011,1382,31.8,125,131,0,120,119,1482,52
2016,36081161700,"Census Tract 1617, Queens County, New York",1540,66,1474,309,1086,50711,1952,2011,1293,32.5,76,95,0,105,109,1474,44
2017,36081161700,"Census Tract 1617, Queens County, New York",1571,44,1527,266,915,50833,1948,2010,1585,31.2,62,84,0,76,106,1527,70
2018,36081161700,"Census Tract 1617, Queens County, New York",1550,32,1518,243,959,53958,1946,2011,2027,36.5,73,61,23,93,66,1518,72
2019,36081161700,"Census Tract 1617, Queens County, New York",1538,35,1503,241,975,70313,1948,2016,2261,37.3,109,41,46,105,49,1503,109
2020,36081161700,"Census Tract 1617, Queens County, New York",1588,80,1508,184,676,NA,1954,2016,2132,31.6,103,44,54,66,20,1508,97
2012,36081162100,"Census Tract 1621, Queens County, New York",2155,241,1914,844,2062,49944,1956,2005,1446,34,472,268,138,230,203,1914,167
2013,36081162100,"Census Tract 1621, Queens County, New York",2129,184,1945,793,2672,61947,1955,2006,1501,31.7,289,217,96,276,157,1945,231
2014,36081162100,"Census Tract 1621, Queens County, New York",2175,139,2036,796,2692,52174,1955,2009,1513,40.2,256,181,99,357,143,2036,283
2015,36081162100,"Census Tract 1621, Queens County, New York",2172,137,2035,883,2955,48125,1957,2010,1490,38.3,228,183,110,363,156,2035,265
2016,36081162100,"Census Tract 1621, Queens County, New York",2154,172,1982,841,2737,36392,1954,2010,1441,47.1,183,222,121,309,144,1982,310
2017,36081162100,"Census Tract 1621, Queens County, New York",2103,188,1915,714,2605,44688,1955,2011,1518,46.8,119,141,98,265,176,1915,297
2018,36081162100,"Census Tract 1621, Queens County, New York",2111,212,1899,718,2239,42541,1962,2012,1543,48.8,138,163,82,259,173,1899,262
2019,36081162100,"Census Tract 1621, Queens County, New York",2122,257,1865,743,2202,43712,1963,2012,1584,44.5,212,182,98,237,176,1865,242
2020,36081162100,"Census Tract 1621, Queens County, New York",2097,229,1868,678,2049,38611,1957,2015,1536,51,212,180,50,310,127,1868,214
2012,36081990100,"Census Tract 9901, Queens County, New York",0,0,0,0,0,NA,NA,NA,NA,NA,0,0,0,0,0,0,0
2013,36081990100,"Census Tract 9901, Queens County, New York",0,0,0,0,0,NA,NA,NA,NA,NA,0,0,0,0,0,0,0
2014,36081990100,"Census Tract 9901, Queens County, New York",0,0,0,0,0,NA,NA,NA,NA,NA,0,0,0,0,0,0,0
2015,36081990100,"Census Tract 9901, Queens County, New York",0,0,0,0,0,NA,NA,NA,NA,NA,0,0,0,0,0,0,0
2016,36081990100,"Census Tract 9901, Queens County, New York",0,0,0,0,0,NA,NA,NA,NA,NA,0,0,0,0,0,0,0
2017,36081990100,"Census Tract 9901, Queens County, New York",0,0,0,0,0,NA,NA,NA,NA,NA,0,0,0,0,0,0,0
2018,36081990100,"Census Tract 9901, Queens County, New York",0,0,0,0,0,NA,NA,NA,NA,NA,0,0,0,0,0,0,0
2019,36081990100,"Census Tract 9901, Queens County, New York",0,0,0,0,0,NA,NA,NA,NA,NA,0,0,0,0,0,0,0
2020,36081990100,"Census Tract 9901, Queens County, New York",0,0,0,0,0,NA,NA,NA,NA,NA,0,0,0,0,0,0,0
2012,36085000300,"Census Tract 3, Richmond County, New York",1079,227,852,611,1057,41583,1939,2004,1090,28.4,294,350,97,76,102,852,83
2013,36085000300,"Census Tract 3, Richmond County, New York",1067,225,842,573,1067,41607,1939,2007,1130,27.7,266,307,95,89,76,842,47
2014,36085000300,"Census Tract 3, Richmond County, New York",1075,221,854,609,1073,43750,1939,2008,1149,28.4,232,273,142,75,107,854,66
2015,36085000300,"Census Tract 3, Richmond County, New York",1098,220,878,649,1200,46641,1939,2010,1149,28.3,238,326,131,62,123,878,76
2016,36085000300,"Census Tract 3, Richmond County, New York",1130,162,968,700,1376,50833,1944,2011,1161,27.7,273,337,111,88,159,968,94
2017,36085000300,"Census Tract 3, Richmond County, New York",1146,159,987,701,1330,48988,1939,2011,1229,29.8,290,331,104,95,176,987,102
2018,36085000300,"Census Tract 3, Richmond County, New York",1179,173,1006,704,1317,51458,1941,NA,1255,30.2,322,335,87,95,191,1006,106
2019,36085000300,"Census Tract 3, Richmond County, New York",1181,144,1037,729,1381,59563,1946,2013,1325,30.7,385,384,53,97,205,1037,114
2020,36085000300,"Census Tract 3, Richmond County, New York",1234,134,1100,802,1495,52685,0,2014,1376,33.9,426,394,55,161,180,1100,131
2012,36085000600,"Census Tract 6, Richmond County, New York",1378,234,1144,623,998,22216,1986,2004,751,28.3,214,363,112,43,95,1144,182
2013,36085000600,"Census Tract 6, Richmond County, New York",1352,197,1155,679,1118,22917,1986,2005,768,30.7,199,479,42,44,105,1155,175
2014,36085000600,"Census Tract 6, Richmond County, New York",1330,207,1123,567,862,20494,1987,2005,572,29.5,127,448,21,52,27,1123,182
2015,36085000600,"Census Tract 6, Richmond County, New York",1312,203,1109,583,990,20052,1985,2005,689,29.6,159,478,24,50,24,1109,254
2016,36085000600,"Census Tract 6, Richmond County, New York",1298,191,1107,608,996,22583,1984,2007,727,29.7,188,500,28,26,61,1107,248
2017,36085000600,"Census Tract 6, Richmond County, New York",1309,173,1136,643,959,22557,1985,2007,746,31.4,166,510,29,28,82,1136,265
2018,36085000600,"Census Tract 6, Richmond County, New York",1314,197,1117,621,1084,26326,1983,2009,836,27.1,204,454,48,28,98,1117,238
2019,36085000600,"Census Tract 6, Richmond County, New York",1317,253,1064,591,1044,25321,1981,2008,897,28.8,183,414,53,29,108,1064,213
2020,36085000600,"Census Tract 6, Richmond County, New York",1483,205,1278,743,1058,19578,1980,2015,1065,34.8,96,441,44,27,231,1278,392
2012,36085000700,"Census Tract 7, Richmond County, New York",2475,349,2126,1784,4089,32583,1963,2003,1005,27.2,437,357,988,73,505,2126,644
2013,36085000700,"Census Tract 7, Richmond County, New York",2445,256,2189,1736,4319,30583,1958,2003,1024,32.2,433,348,914,55,496,2189,599
2014,36085000700,"Census Tract 7, Richmond County, New York",2473,193,2280,1836,5187,34884,1955,2005,979,27.7,407,277,802,0,770,2280,617
2015,36085000700,"Census Tract 7, Richmond County, New York",2389,117,2272,1818,4997,42523,1962,2006,968,26.5,428,230,941,0,653,2272,607
2016,36085000700,"Census Tract 7, Richmond County, New York",2388,93,2295,1812,5201,43149,1960,2006,970,26.6,392,180,1031,43,560,2295,655
2017,36085000700,"Census Tract 7, Richmond County, New York",2503,101,2402,1994,5213,33273,1959,2008,940,28.5,493,200,1170,39,604,2402,778
2018,36085000700,"Census Tract 7, Richmond County, New York",2472,175,2297,1933,4451,24009,1956,2009,942,27,438,197,1022,37,736,2297,756
2019,36085000700,"Census Tract 7, Richmond County, New York",2443,234,2209,1824,3808,24504,1958,2008,1085,29.8,367,210,1133,43,558,2209,675
2020,36085000700,"Census Tract 7, Richmond County, New York",2260,263,1997,1707,3773,23803,1949,2009,1191,35.6,364,199,1058,76,563,1997,582
2012,36085000800,"Census Tract 8, Richmond County, New York",2150,85,2065,858,2406,45588,1939,2005,1402,30.3,232,459,113,12,337,2065,233
2013,36085000800,"Census Tract 8, Richmond County, New York",2132,84,2048,733,2218,44402,1951,2005,1417,32.7,231,382,104,15,295,2048,264
2014,36085000800,"Census Tract 8, Richmond County, New York",2113,88,2025,669,1954,57386,1954,2006,1404,28,246,405,90,6,226,2025,222
2015,36085000800,"Census Tract 8, Richmond County, New York",2118,70,2048,717,1874,61156,1958,2010,1222,26.2,254,368,147,10,241,2048,245
2016,36085000800,"Census Tract 8, Richmond County, New York",2104,125,1979,693,1869,61139,1960,2009,1219,28.3,229,391,97,6,199,1979,238
2017,36085000800,"Census Tract 8, Richmond County, New York",2136,103,2033,639,1642,60651,1972,2011,1309,28.1,192,305,130,0,204,2033,200
2018,36085000800,"Census Tract 8, Richmond County, New York",2174,225,1949,609,1459,53750,1971,2012,1332,29.8,218,284,165,6,154,1949,194
2019,36085000800,"Census Tract 8, Richmond County, New York",2161,275,1886,568,1384,54053,1965,2012,1339,31.4,197,238,176,10,144,1886,200
2020,36085000800,"Census Tract 8, Richmond County, New York",2181,328,1853,359,1004,54367,1972,2014,1403,31.8,103,178,104,10,67,1853,119
2012,36085000900,"Census Tract 9, Richmond County, New York",934,166,768,492,1333,34375,1958,2005,1210,33.8,173,100,178,5,176,768,118
2013,36085000900,"Census Tract 9, Richmond County, New York",918,221,697,487,1367,38320,1942,2005,1243,32.4,137,102,195,2,148,697,124
2014,36085000900,"Census Tract 9, Richmond County, New York",932,271,661,455,1383,39911,1946,2007,1178,32.8,124,105,214,4,154,661,107
2015,36085000900,"Census Tract 9, Richmond County, New York",919,291,628,435,1393,39327,1939,2006,1215,32.8,114,84,215,5,147,628,125
2016,36085000900,"Census Tract 9, Richmond County, New York",881,266,615,436,1342,41776,1939,2007,1246,33.9,142,104,225,29,91,615,191
2017,36085000900,"Census Tract 9, Richmond County, New York",868,222,646,407,1185,42344,1939,2009,1215,32,116,95,242,15,62,646,174
2018,36085000900,"Census Tract 9, Richmond County, New York",862,182,680,404,1175,35417,0,2012,1241,37.2,104,110,226,23,61,680,206
2019,36085000900,"Census Tract 9, Richmond County, New York",849,233,616,360,905,30385,0,2012,1358,39.4,125,128,148,11,69,616,206
2020,36085000900,"Census Tract 9, Richmond County, New York",935,202,733,470,1136,41339,1949,2014,1383,35.4,181,171,192,19,106,733,180
2012,36085001100,"Census Tract 11, Richmond County, New York",1473,376,1097,684,1901,29250,1939,2004,1175,38.9,115,165,289,17,202,1097,238
2013,36085001100,"Census Tract 11, Richmond County, New York",1530,404,1126,693,1920,28274,1939,2005,1195,39.5,126,127,336,0,219,1126,276
2014,36085001100,"Census Tract 11, Richmond County, New York",1526,418,1108,645,1648,27150,1939,2008,1173,41.3,160,119,309,6,192,1108,279
2015,36085001100,"Census Tract 11, Richmond County, New York",1473,349,1124,692,1793,27303,1939,2011,1159,41.3,185,139,378,11,123,1124,243
2016,36085001100,"Census Tract 11, Richmond County, New York",1447,292,1155,706,1929,32692,1939,2011,1154,37.7,186,114,448,11,90,1155,277
2017,36085001100,"Census Tract 11, Richmond County, New York",1504,319,1185,688,1877,25345,1941,2011,1140,43,184,111,385,11,129,1185,347
2018,36085001100,"Census Tract 11, Richmond County, New York",1504,337,1167,699,1875,26803,0,2010,1261,43,207,142,306,9,185,1167,384
2019,36085001100,"Census Tract 11, Richmond County, New York",1505,348,1157,692,1807,36951,0,2011,1316,32.5,286,141,298,11,199,1157,237
2020,36085001100,"Census Tract 11, Richmond County, New York",1441,346,1095,674,1770,36528,0,2013,1515,43.5,270,134,173,18,333,1095,254
2012,36085001700,"Census Tract 17, Richmond County, New York",611,62,549,210,504,24900,1955,2004,957,37,79,66,31,59,59,549,78
2013,36085001700,"Census Tract 17, Richmond County, New York",634,73,561,222,518,26250,1952,2005,997,28.1,101,73,33,46,54,561,79
2014,36085001700,"Census Tract 17, Richmond County, New York",652,104,548,245,655,23848,1939,2006,1071,48.4,61,38,59,52,92,548,107
2015,36085001700,"Census Tract 17, Richmond County, New York",662,93,569,272,738,23163,1939,2007,1156,50,81,55,43,53,122,569,113
2016,36085001700,"Census Tract 17, Richmond County, New York",685,97,588,301,708,22083,1939,2008,1153,50,112,75,69,21,126,588,149
2017,36085001700,"Census Tract 17, Richmond County, New York",668,74,594,334,772,21389,1939,2010,1244,50,124,87,102,31,115,594,146
2018,36085001700,"Census Tract 17, Richmond County, New York",673,121,552,317,737,20363,0,2011,1321,51,107,79,106,30,120,552,148
2019,36085001700,"Census Tract 17, Richmond County, New York",669,91,578,336,808,NA,0,2012,1466,51,128,104,85,37,114,578,182
2020,36085001700,"Census Tract 17, Richmond County, New York",637,82,555,270,491,NA,0,2012,1513,49.5,90,88,91,25,66,555,164
2012,36085001800,"Census Tract 18, Richmond County, New York",371,133,238,238,758,55956,1974,2006,1434,26.6,79,206,0,0,32,238,0
2013,36085001800,"Census Tract 18, Richmond County, New York",335,97,238,238,738,57069,1976,2007,1358,24.2,64,192,18,0,25,238,0
2014,36085001800,"Census Tract 18, Richmond County, New York",296,74,222,222,641,59773,1982,2011,1446,24.8,85,183,17,0,19,222,0
2015,36085001800,"Census Tract 18, Richmond County, New York",293,79,214,214,577,65909,1983,2012,1417,22.7,78,161,29,0,20,214,0
2016,36085001800,"Census Tract 18, Richmond County, New York",260,78,182,182,544,67000,1983,NA,1472,23.1,79,123,32,0,19,182,0
2017,36085001800,"Census Tract 18, Richmond County, New York",225,39,186,186,526,83438,1984,NA,1498,23.1,86,125,31,0,22,186,0
2018,36085001800,"Census Tract 18, Richmond County, New York",214,33,181,176,544,65417,1982,2013,1938,29.3,86,130,15,0,26,181,0
2019,36085001800,"Census Tract 18, Richmond County, New York",205,24,181,177,535,81563,1990,2016,1963,24.3,55,131,6,0,35,181,0
2020,36085001800,"Census Tract 18, Richmond County, New York",236,28,208,203,598,74732,1983,2017,3075,27.8,49,138,4,20,35,208,0
2012,36085002001,"Census Tract 20.01, Richmond County, New York",1108,90,1018,389,700,44760,1974,2005,1230,33.8,128,222,30,19,97,1018,28
2013,36085002001,"Census Tract 20.01, Richmond County, New York",1092,51,1041,419,765,42896,1975,2005,1163,33.9,128,294,24,6,80,1041,23
2014,36085002001,"Census Tract 20.01, Richmond County, New York",1117,50,1067,429,801,53359,1973,2007,1182,27.5,151,275,26,6,105,1067,22
2015,36085002001,"Census Tract 20.01, Richmond County, New York",1126,38,1088,404,671,75198,1972,2008,1172,21.8,163,255,30,13,91,1088,42
2016,36085002001,"Census Tract 20.01, Richmond County, New York",1114,40,1074,384,735,76857,1972,2010,1283,20.6,175,278,20,14,72,1074,38
2017,36085002001,"Census Tract 20.01, Richmond County, New York",1102,36,1066,378,780,63182,1972,2012,1338,26.5,165,278,25,10,54,1066,75
2018,36085002001,"Census Tract 20.01, Richmond County, New York",1083,42,1041,408,907,78200,1970,2012,1379,25.4,178,265,33,10,90,1041,80
2019,36085002001,"Census Tract 20.01, Richmond County, New York",1073,81,992,407,895,64637,1971,2011,1430,28.1,172,253,44,13,79,992,99
2020,36085002001,"Census Tract 20.01, Richmond County, New York",1474,57,1417,541,1123,69153,1975,2012,1465,27.2,175,290,48,36,149,1417,66
2012,36085002002,"Census Tract 20.02, Richmond County, New York",1290,104,1186,325,759,31953,1967,2003,1423,48.7,69,248,32,0,45,1186,34
2013,36085002002,"Census Tract 20.02, Richmond County, New York",1285,62,1223,340,776,30588,1967,2004,1431,45.4,81,250,37,10,43,1223,66
2014,36085002002,"Census Tract 20.02, Richmond County, New York",1193,36,1157,250,514,23286,1970,2004,1571,34.8,34,227,0,16,7,1157,119
2015,36085002002,"Census Tract 20.02, Richmond County, New York",1334,34,1300,333,742,NA,1969,2007,1534,21.9,64,307,13,13,0,1300,215
2016,36085002002,"Census Tract 20.02, Richmond County, New York",1293,8,1285,279,620,NA,1964,2009,1550,22.9,46,233,13,23,10,1285,207
2017,36085002002,"Census Tract 20.02, Richmond County, New York",1307,17,1290,292,621,NA,1965,2010,1594,22.3,58,244,14,23,11,1290,233
2018,36085002002,"Census Tract 20.02, Richmond County, New York",1303,37,1266,366,837,52167,1963,2011,1690,24.7,70,315,12,20,19,1266,203
2019,36085002002,"Census Tract 20.02, Richmond County, New York",1297,51,1246,352,837,61204,1961,2012,1705,26.2,78,261,44,29,18,1246,152
2020,36085002002,"Census Tract 20.02, Richmond County, New York",1338,67,1271,488,866,55594,1960,2011,1718,42.2,73,320,37,26,105,1271,53
2012,36085002100,"Census Tract 21, Richmond County, New York",1559,176,1383,779,1998,27530,1939,2006,1308,50,116,215,166,92,334,1383,418
2013,36085002100,"Census Tract 21, Richmond County, New York",1627,201,1426,763,2309,30838,1939,2007,1300,40.7,60,181,172,20,381,1426,357
2014,36085002100,"Census Tract 21, Richmond County, New York",1644,227,1417,783,2108,32287,1939,2008,1198,37.6,46,135,257,30,351,1417,402
2015,36085002100,"Census Tract 21, Richmond County, New York",1579,306,1273,668,1860,39000,1939,2010,1233,33.8,113,151,244,39,215,1273,319
2016,36085002100,"Census Tract 21, Richmond County, New York",1688,234,1454,884,2534,33750,1945,2011,1288,39,136,170,320,41,308,1454,431
2017,36085002100,"Census Tract 21, Richmond County, New York",1741,264,1477,890,2549,43125,1940,2011,1333,37.8,238,167,342,44,303,1477,349
2018,36085002100,"Census Tract 21, Richmond County, New York",1706,324,1382,843,2311,45020,0,2012,1446,38.4,303,187,345,38,232,1382,373
2019,36085002100,"Census Tract 21, Richmond County, New York",2048,399,1649,1201,2948,44182,1970,2015,1532,37.7,486,363,343,83,351,1649,421
2020,36085002100,"Census Tract 21, Richmond County, New York",2233,332,1901,1408,3401,42617,1988,2016,1533,40,587,537,309,64,398,1901,467
2012,36085002700,"Census Tract 27, Richmond County, New York",480,33,447,312,757,18553,1963,2001,1284,50,95,82,23,16,191,447,140
2013,36085002700,"Census Tract 27, Richmond County, New York",521,22,499,336,946,19275,1952,2007,1417,50,42,42,104,10,180,499,147
2014,36085002700,"Census Tract 27, Richmond County, New York",548,11,537,386,1166,21944,1944,2008,1388,50,30,51,108,0,220,537,180
2015,36085002700,"Census Tract 27, Richmond County, New York",529,12,517,396,1200,23071,1939,2011,1350,50,53,67,130,0,180,517,166
2016,36085002700,"Census Tract 27, Richmond County, New York",516,40,476,369,1227,24705,1939,2012,1381,50,33,77,140,0,139,476,139
2017,36085002700,"Census Tract 27, Richmond County, New York",558,25,533,436,1514,23450,1939,2012,1495,50,41,104,129,0,165,533,190
2018,36085002700,"Census Tract 27, Richmond County, New York",528,74,454,359,1141,24257,0,2012,1412,49.6,77,116,59,0,151,454,153
2019,36085002700,"Census Tract 27, Richmond County, New York",514,101,413,334,870,22028,0,2011,1577,46.8,51,106,69,20,127,413,125
2020,36085002700,"Census Tract 27, Richmond County, New York",502,124,378,305,930,24107,0,2013,1625,51,28,67,52,16,171,378,130
2012,36085002900,"Census Tract 29, Richmond County, New York",2033,314,1719,1218,3482,21362,1964,2005,860,38.5,20,65,790,19,360,1719,640
2013,36085002900,"Census Tract 29, Richmond County, New York",2080,272,1808,1254,3884,22974,1963,2006,887,36.2,32,53,740,0,461,1808,597
2014,36085002900,"Census Tract 29, Richmond County, New York",2096,262,1834,1231,3732,21661,1961,2007,1035,37,58,44,679,26,484,1834,627
2015,36085002900,"Census Tract 29, Richmond County, New York",2088,241,1847,1257,3812,18510,1961,2008,832,39,88,34,646,29,548,1847,674
2016,36085002900,"Census Tract 29, Richmond County, New York",2076,261,1815,1352,3846,18931,1960,2010,811,44.1,51,89,587,29,657,1815,765
2017,36085002900,"Census Tract 29, Richmond County, New York",2123,283,1840,1316,3455,19381,1960,2011,771,45.5,60,62,573,41,640,1840,747
2018,36085002900,"Census Tract 29, Richmond County, New York",2053,277,1776,1308,3180,16091,1964,2012,527,45,104,75,665,39,539,1776,823
2019,36085002900,"Census Tract 29, Richmond County, New York",2072,328,1744,1306,3223,15244,1965,NA,501,42.2,77,72,662,21,597,1744,836
2020,36085002900,"Census Tract 29, Richmond County, New York",2039,300,1739,1262,3325,20521,1965,2012,514,39.2,84,80,607,19,603,1739,853
2012,36085003300,"Census Tract 33, Richmond County, New York",1539,104,1435,752,1743,58438,1950,2004,1219,27.8,297,190,300,39,201,1435,84
2013,36085003300,"Census Tract 33, Richmond County, New York",1569,59,1510,761,1885,57305,1944,2005,1195,26.2,294,193,311,66,167,1510,140
2014,36085003300,"Census Tract 33, Richmond County, New York",1574,123,1451,730,1687,59429,1947,2006,1190,23,252,198,224,70,206,1451,110
2015,36085003300,"Census Tract 33, Richmond County, New York",1558,180,1378,648,1539,46488,1947,2007,1152,27.9,172,142,180,82,212,1378,114
2016,36085003300,"Census Tract 33, Richmond County, New York",1554,142,1412,597,1219,53750,1939,2010,1263,23.7,183,159,183,52,203,1412,133
2017,36085003300,"Census Tract 33, Richmond County, New York",1496,122,1374,631,1224,48625,1939,2010,1286,30.8,171,225,188,47,171,1374,85
2018,36085003300,"Census Tract 33, Richmond County, New York",1522,149,1373,649,1262,51103,1949,2010,1275,30.8,160,230,201,40,178,1373,66
2019,36085003300,"Census Tract 33, Richmond County, New York",1509,156,1353,679,1441,52361,1953,2011,1511,32.7,172,218,239,43,166,1353,97
2020,36085003300,"Census Tract 33, Richmond County, New York",1493,140,1353,656,1560,66875,1957,2012,1590,26.5,194,252,265,49,103,1353,82
2012,36085003600,"Census Tract 36, Richmond County, New York",873,83,790,241,563,37022,1939,2005,1240,44.2,47,82,50,31,78,790,80
2013,36085003600,"Census Tract 36, Richmond County, New York",865,79,786,216,624,60536,1939,2007,1318,24.1,50,89,29,33,65,786,38
2014,36085003600,"Census Tract 36, Richmond County, New York",920,101,819,248,720,58333,1952,2009,1356,28.5,63,106,31,26,85,819,75
2015,36085003600,"Census Tract 36, Richmond County, New York",916,100,816,265,845,58967,1955,2010,1404,28.4,69,94,51,31,89,816,84
2016,36085003600,"Census Tract 36, Richmond County, New York",927,103,824,264,846,55278,1962,2011,1418,40.4,94,82,40,53,89,824,80
2017,36085003600,"Census Tract 36, Richmond County, New York",933,100,833,308,1099,57500,1964,2012,1509,39.8,111,104,41,55,108,833,83
2018,36085003600,"Census Tract 36, Richmond County, New York",909,104,805,289,1024,71058,1966,2013,1649,37.7,143,129,59,62,39,805,71
2019,36085003600,"Census Tract 36, Richmond County, New York",913,43,870,344,1216,72000,1955,2013,1732,37.8,163,116,88,97,43,870,43
2020,36085003600,"Census Tract 36, Richmond County, New York",972,66,906,392,1292,73362,1973,2015,1813,28.1,224,132,42,121,90,906,64
2012,36085003900,"Census Tract 39, Richmond County, New York",1096,112,984,745,1528,55375,1958,2005,1271,26.4,257,346,138,44,221,984,135
2013,36085003900,"Census Tract 39, Richmond County, New York",1053,43,1010,719,1465,61065,1959,2007,1260,24.5,271,326,130,52,208,1010,105
2014,36085003900,"Census Tract 39, Richmond County, New York",1023,87,936,719,1602,62050,1960,2009,1337,23.8,222,364,114,23,206,936,85
2015,36085003900,"Census Tract 39, Richmond County, New York",1018,71,947,727,1524,54815,1960,2010,1306,27.3,261,390,139,23,162,947,92
2016,36085003900,"Census Tract 39, Richmond County, New York",1029,77,952,721,1552,57275,1959,2011,1333,26.2,294,372,154,28,155,952,110
2017,36085003900,"Census Tract 39, Richmond County, New York",1043,45,998,767,1643,65968,1958,2011,1388,25.6,267,339,209,39,165,998,65
2018,36085003900,"Census Tract 39, Richmond County, New York",1054,47,1007,788,1661,65398,1959,2012,1509,26.9,240,341,220,34,182,1007,77
2019,36085003900,"Census Tract 39, Richmond County, New York",1066,51,1015,824,1664,68507,1959,2012,1589,26.7,263,374,227,38,192,1015,94
2020,36085003900,"Census Tract 39, Richmond County, New York",1043,46,997,802,1622,72500,1962,2014,1660,26.3,305,348,145,78,241,997,74
2012,36085004000,"Census Tract 40, Richmond County, New York",4797,353,4444,2557,7207,25988,1963,NA,718,34.5,209,96,1911,134,459,4444,1215
2013,36085004000,"Census Tract 40, Richmond County, New York",4681,352,4329,2432,7141,32683,1962,2005,800,32.3,269,80,1855,95,495,4329,1027
2014,36085004000,"Census Tract 40, Richmond County, New York",4712,488,4224,2381,6701,26131,1964,2007,741,32.7,219,61,1614,116,600,4224,1228
2015,36085004000,"Census Tract 40, Richmond County, New York",4630,397,4233,2406,6720,25650,1963,2008,830,32.4,221,36,1561,32,809,4233,1242
2016,36085004000,"Census Tract 40, Richmond County, New York",4596,394,4202,2430,6400,15551,1965,2008,827,33.6,266,54,1536,44,821,4202,1443
2017,36085004000,"Census Tract 40, Richmond County, New York",4649,509,4140,2229,5425,10858,1962,2011,858,34.4,177,34,1376,48,782,4140,1374
2018,36085004000,"Census Tract 40, Richmond County, New York",4882,421,4461,2707,6346,11040,1965,2011,923,39.5,75,202,1362,153,1041,4461,1677
2019,36085004000,"Census Tract 40, Richmond County, New York",4901,377,4524,2983,7124,17635,1965,2009,796,34.9,49,117,1556,147,1303,4524,1567
2020,36085004001,"Census Tract 40.01, Richmond County, New York",1190,120,1070,473,1212,33885,1957,2011,NA,24.6,94,37,270,37,129,1070,66
2020,36085004002,"Census Tract 40.02, Richmond County, New York",761,0,761,64,108,NA,NA,NA,NA,NA,0,0,0,0,64,761,0
2020,36085004003,"Census Tract 40.03, Richmond County, New York",1619,156,1463,1382,2900,NA,1968,2009,590,51,11,0,896,0,585,1463,849
2020,36085004004,"Census Tract 40.04, Richmond County, New York",1262,62,1200,728,2239,49127,1972,2011,1369,29.6,39,132,191,0,405,1200,107
2012,36085004700,"Census Tract 47, Richmond County, New York",1135,57,1078,477,996,39688,1963,2005,1331,31.1,157,266,59,20,115,1078,59
2013,36085004700,"Census Tract 47, Richmond County, New York",1129,79,1050,438,819,60167,1967,2005,1328,30.7,113,251,92,24,71,1050,79
2014,36085004700,"Census Tract 47, Richmond County, New York",1168,128,1040,398,862,62986,1961,2006,1360,25.8,67,175,96,25,102,1040,27
2015,36085004700,"Census Tract 47, Richmond County, New York",1081,104,977,343,735,61780,1964,2007,1353,30.5,80,180,43,29,91,977,37
2016,36085004700,"Census Tract 47, Richmond County, New York",1118,74,1044,359,763,62578,1967,2010,1357,26.8,83,199,30,49,81,1044,59
2017,36085004700,"Census Tract 47, Richmond County, New York",1103,106,997,204,411,64464,1963,2010,1365,30.1,70,171,28,5,0,997,104
2018,36085004700,"Census Tract 47, Richmond County, New York",1051,116,935,161,285,109732,1964,2012,1390,19.4,74,132,0,29,0,935,96
2019,36085004700,"Census Tract 47, Richmond County, New York",1033,59,974,216,336,70588,1960,2014,1440,20.2,83,128,57,27,4,974,138
2020,36085004700,"Census Tract 47, Richmond County, New York",1067,148,919,192,316,NA,1956,2016,1436,19.3,58,84,76,23,9,919,146
2012,36085005000,"Census Tract 50, Richmond County, New York",1517,149,1368,391,853,36845,1972,2005,1312,29.4,81,284,11,0,96,1368,166
2013,36085005000,"Census Tract 50, Richmond County, New York",1500,127,1373,458,1076,38214,1970,2007,1432,29.5,136,298,39,18,103,1373,158
2014,36085005000,"Census Tract 50, Richmond County, New York",1495,81,1414,443,1133,37440,1970,2008,1491,38,133,281,61,27,74,1414,158
2015,36085005000,"Census Tract 50, Richmond County, New York",1529,102,1427,489,1264,52994,1973,2011,1500,33.4,118,289,108,47,45,1427,113
2016,36085005000,"Census Tract 50, Richmond County, New York",1538,109,1429,437,1115,36281,1972,2012,1526,39.7,72,192,103,42,100,1429,172
2017,36085005000,"Census Tract 50, Richmond County, New York",1513,62,1451,445,1243,35536,1976,2011,1387,40.1,95,181,125,51,88,1451,212
2018,36085005000,"Census Tract 50, Richmond County, New York",1511,91,1420,338,1024,30000,1977,2013,1308,41.1,36,114,89,22,129,1420,197
2019,36085005000,"Census Tract 50, Richmond County, New York",1512,122,1390,389,1093,41583,1979,2014,1510,43.7,78,153,73,19,164,1390,221
2020,36085005000,"Census Tract 50, Richmond County, New York",1413,77,1336,362,1115,NA,1977,2016,1433,47.8,118,149,42,10,170,1336,180
2012,36085005900,"Census Tract 59, Richmond County, New York",1224,33,1191,508,839,45526,1962,2004,1200,28.1,264,342,15,18,94,1191,138
2013,36085005900,"Census Tract 59, Richmond County, New York",1223,69,1154,482,739,49746,1962,2005,1174,26.6,252,270,24,28,131,1154,113
2014,36085005900,"Census Tract 59, Richmond County, New York",1212,81,1131,433,818,57132,1958,2008,1247,27.6,175,292,38,34,69,1131,106
2015,36085005900,"Census Tract 59, Richmond County, New York",1222,100,1122,402,858,60066,1955,2011,1244,26.4,180,310,23,20,49,1122,120
2016,36085005900,"Census Tract 59, Richmond County, New York",1226,75,1151,503,1049,46016,1952,2011,1289,28.2,204,342,27,16,118,1151,151
2017,36085005900,"Census Tract 59, Richmond County, New York",1220,75,1145,460,975,49891,1951,2010,1347,28.5,177,301,28,15,116,1145,110
2018,36085005900,"Census Tract 59, Richmond County, New York",1223,42,1181,442,1030,52576,1954,2011,1434,31.4,153,297,23,7,115,1181,135
2019,36085005900,"Census Tract 59, Richmond County, New York",1218,27,1191,420,882,53125,1958,2013,1495,26.7,144,236,32,34,118,1191,124
2020,36085005901,"Census Tract 59.01, Richmond County, New York",1238,34,1204,441,989,51715,1948,2015,1593,35.7,118,283,26,28,104,1204,86
2020,36085005902,"Census Tract 59.02, Richmond County, New York",0,0,0,0,0,NA,NA,NA,NA,NA,0,0,0,0,0,0,0
2012,36085006400,"Census Tract 64, Richmond County, New York",1270,124,1146,484,1038,13190,1955,2003,393,29,33,182,283,0,113,1146,251
2013,36085006400,"Census Tract 64, Richmond County, New York",1237,93,1144,500,1215,25648,1954,2004,517,27.6,58,272,209,0,96,1144,261
2014,36085006400,"Census Tract 64, Richmond County, New York",1212,60,1152,540,1346,27143,1953,2003,557,26.8,133,228,256,0,128,1152,231
2015,36085006400,"Census Tract 64, Richmond County, New York",1223,103,1120,508,1349,31974,1955,2002,706,26.5,139,252,152,16,140,1120,200
2016,36085006400,"Census Tract 64, Richmond County, New York",1239,69,1170,519,1381,35446,1957,2002,548,25.7,136,231,159,20,141,1170,191
2017,36085006400,"Census Tract 64, Richmond County, New York",1314,115,1199,509,1429,28635,1953,2000,699,28.6,133,221,137,15,136,1199,209
2018,36085006400,"Census Tract 64, Richmond County, New York",1318,145,1173,458,1214,26500,1954,1998,559,30.8,102,139,150,13,156,1173,198
2019,36085006400,"Census Tract 64, Richmond County, New York",1340,138,1202,501,1232,21588,1957,1998,689,38.3,51,224,148,6,123,1202,196
2020,36085006400,"Census Tract 64, Richmond County, New York",1300,132,1168,522,1185,20326,1956,1999,818,42.9,53,186,188,23,125,1168,221
2012,36085006700,"Census Tract 67, Richmond County, New York",1278,303,975,277,611,60707,1949,2003,1142,27.2,126,192,32,18,35,975,103
2013,36085006700,"Census Tract 67, Richmond County, New York",1272,253,1019,339,786,75859,1953,2004,1138,21.1,124,229,51,20,52,1019,93
2014,36085006700,"Census Tract 67, Richmond County, New York",1230,242,988,304,592,65417,1955,2006,1157,22.5,131,195,34,36,53,988,81
2015,36085006700,"Census Tract 67, Richmond County, New York",1196,198,998,259,522,66094,1955,2006,1166,22.5,117,165,27,33,43,998,85
2016,36085006700,"Census Tract 67, Richmond County, New York",1196,220,976,247,535,67344,1955,2007,1210,22.2,109,168,35,15,38,976,55
2017,36085006700,"Census Tract 67, Richmond County, New York",1191,165,1026,227,471,72614,1962,2009,1218,20.9,95,160,38,18,22,1026,47
2018,36085006700,"Census Tract 67, Richmond County, New York",1209,180,1029,219,363,47083,1956,2012,1228,33.3,154,118,32,60,9,1029,66
2019,36085006700,"Census Tract 67, Richmond County, New York",1251,229,1022,243,415,65043,1955,2013,1202,23.9,176,132,49,56,6,1022,64
2020,36085006700,"Census Tract 67, Richmond County, New York",1279,253,1026,308,525,75357,1956,2012,1223,23.4,223,166,39,58,31,1026,65
2012,36085007000,"Census Tract 70, Richmond County, New York",2820,107,2713,588,1491,54000,1956,2003,1319,31.2,132,412,41,60,59,2713,80
2013,36085007000,"Census Tract 70, Richmond County, New York",2928,132,2796,629,1953,34620,1956,2000,1300,34.2,176,371,47,79,113,2796,211
2014,36085007000,"Census Tract 70, Richmond County, New York",2884,137,2747,611,2037,31183,1960,2004,1328,34.4,228,260,106,156,68,2747,200
2015,36085007000,"Census Tract 70, Richmond County, New York",2864,194,2670,657,2154,24980,1963,2008,1454,50,141,263,103,115,176,2670,284
2016,36085007000,"Census Tract 70, Richmond County, New York",2860,328,2532,657,2159,30747,1968,2010,1454,50,121,308,98,83,187,2532,298
2017,36085007000,"Census Tract 70, Richmond County, New York",2844,314,2530,652,2119,35106,1968,2011,1444,43.6,158,326,113,86,146,2530,314
2018,36085007000,"Census Tract 70, Richmond County, New York",2870,264,2606,616,1902,36604,1984,2012,1431,41.9,122,317,124,75,120,2606,328
2019,36085007000,"Census Tract 70, Richmond County, New York",2949,290,2659,587,2167,61382,1980,2013,1698,34.5,116,268,67,23,252,2659,347
2020,36085007001,"Census Tract 70.01, Richmond County, New York",1109,102,1007,19,35,NA,NA,NA,NA,NA,19,19,0,0,0,1007,54
2020,36085007002,"Census Tract 70.02, Richmond County, New York",1837,165,1672,326,1070,65952,2001,2014,1431,30.3,104,177,63,21,86,1672,172
2012,36085007400,"Census Tract 74, Richmond County, New York",1667,167,1500,594,1680,31111,1959,2004,882,30.2,147,370,30,79,123,1500,239
2013,36085007400,"Census Tract 74, Richmond County, New York",1647,130,1517,540,1577,33250,1956,2005,883,31.4,182,357,17,74,92,1517,240
2014,36085007400,"Census Tract 74, Richmond County, New York",1748,134,1614,745,2166,33371,1958,2007,966,32.8,160,424,22,71,228,1614,266
2015,36085007400,"Census Tract 74, Richmond County, New York",1756,90,1666,682,1808,34250,1955,2011,982,32.3,190,426,15,45,196,1666,266
2016,36085007400,"Census Tract 74, Richmond County, New York",1729,126,1603,736,1844,37121,1954,2011,958,30.9,191,419,17,45,255,1603,285
2017,36085007400,"Census Tract 74, Richmond County, New York",1731,190,1541,696,1827,38750,1956,2011,1025,29.7,193,388,22,48,230,1541,248
2018,36085007400,"Census Tract 74, Richmond County, New York",1802,187,1615,733,1894,53125,1950,2012,1040,25.8,151,389,60,56,218,1615,236
2019,36085007400,"Census Tract 74, Richmond County, New York",1804,156,1648,673,1601,55184,1952,2012,1047,25.7,159,362,69,80,151,1648,223
2020,36085007400,"Census Tract 74, Richmond County, New York",1915,148,1767,636,1378,26279,1969,2010,790,29.5,78,344,92,51,127,1767,276
2012,36085007500,"Census Tract 75, Richmond County, New York",1378,177,1201,600,2174,36786,1939,2005,1355,44.5,74,148,123,33,267,1201,185
2013,36085007500,"Census Tract 75, Richmond County, New York",1348,191,1157,721,2774,32689,1939,2006,1374,46.9,79,165,133,33,363,1157,254
2014,36085007500,"Census Tract 75, Richmond County, New York",1383,244,1139,675,2686,44327,1939,2007,1448,43.2,47,127,149,9,403,1139,225
2015,36085007500,"Census Tract 75, Richmond County, New York",1317,187,1130,690,2656,43333,1939,2007,1383,41.8,53,164,119,9,410,1130,270
2016,36085007500,"Census Tract 75, Richmond County, New York",1265,183,1082,646,2280,30192,1939,2007,1332,50,42,170,41,11,427,1082,301
2017,36085007500,"Census Tract 75, Richmond County, New York",1203,190,1013,567,1954,27440,1939,2008,1367,46.7,57,201,63,0,302,1013,291
2018,36085007500,"Census Tract 75, Richmond County, New York",1184,195,989,489,1772,25469,0,2011,1384,46.1,69,224,73,0,193,989,304
2019,36085007500,"Census Tract 75, Richmond County, New York",1233,147,1086,540,1893,36667,0,2011,1301,36.9,55,273,89,0,164,1086,280
2020,36085007500,"Census Tract 75, Richmond County, New York",1251,117,1134,595,2156,67108,0,2015,1401,24.4,163,250,157,0,171,1134,228
2012,36085007700,"Census Tract 77, Richmond County, New York",647,157,490,262,774,29615,1956,2005,1176,48.1,0,5,185,5,97,490,138
2013,36085007700,"Census Tract 77, Richmond County, New York",621,174,447,204,700,28333,1939,2008,1198,50,10,25,84,3,107,447,133
2014,36085007700,"Census Tract 77, Richmond County, New York",589,184,405,193,641,31146,1939,2011,1163,45.3,12,27,80,5,102,405,81
2015,36085007700,"Census Tract 77, Richmond County, New York",572,127,445,204,586,NA,1950,2011,1154,50,18,24,89,3,83,445,111
2016,36085007700,"Census Tract 77, Richmond County, New York",572,88,484,268,826,NA,1939,2012,1250,50,28,32,103,8,118,484,148
2017,36085007700,"Census Tract 77, Richmond County, New York",555,118,437,201,591,9604,1956,2012,1381,50,22,22,68,0,104,437,140
2018,36085007700,"Census Tract 77, Richmond County, New York",537,105,432,197,566,NA,1963,2011,1497,48.8,17,5,67,0,119,432,105
2019,36085007700,"Census Tract 77, Richmond County, New York",568,102,466,221,708,NA,1956,2011,1463,44.5,19,16,70,0,135,466,116
2020,36085007700,"Census Tract 77, Richmond County, New York",601,84,517,280,894,72714,1961,2011,1579,32.2,60,21,99,0,160,517,85
2012,36085008100,"Census Tract 81, Richmond County, New York",1817,280,1537,830,1500,10030,1954,2004,566,50,92,199,335,37,166,1537,528
2013,36085008100,"Census Tract 81, Richmond County, New York",1775,307,1468,796,1480,10625,1954,2005,706,44.4,131,261,212,70,185,1468,486
2014,36085008100,"Census Tract 81, Richmond County, New York",1824,263,1561,845,1757,13903,1958,2007,871,35,188,223,280,74,201,1561,477
2015,36085008100,"Census Tract 81, Richmond County, New York",1842,231,1611,881,1859,14004,1963,2008,872,33.3,161,204,322,91,228,1611,512
2016,36085008100,"Census Tract 81, Richmond County, New York",1897,201,1696,884,1859,14821,1966,2009,621,31.8,153,180,360,119,186,1696,489
2017,36085008100,"Census Tract 81, Richmond County, New York",1895,208,1687,924,1899,17891,1967,2010,693,32.9,188,241,313,116,234,1687,458
2018,36085008100,"Census Tract 81, Richmond County, New York",1883,189,1694,926,2051,18017,1971,2011,800,33.1,160,239,288,76,304,1694,450
2019,36085008100,"Census Tract 81, Richmond County, New York",1916,249,1667,877,1556,17651,1971,2013,564,30.6,162,292,166,128,301,1667,418
2020,36085008100,"Census Tract 81, Richmond County, New York",2038,241,1797,920,1621,22067,1969,2014,732,30.8,147,359,124,104,333,1797,416
2012,36085009601,"Census Tract 96.01, Richmond County, New York",1453,41,1412,601,1102,22788,1967,2005,1043,33.7,165,449,0,29,106,1412,232
2013,36085009601,"Census Tract 96.01, Richmond County, New York",1519,33,1486,640,1248,29688,1966,2005,1125,35.4,199,479,0,30,131,1486,229
2014,36085009601,"Census Tract 96.01, Richmond County, New York",1533,98,1435,598,1185,35441,1966,2006,1205,34.9,197,419,31,27,121,1435,248
2015,36085009601,"Census Tract 96.01, Richmond County, New York",1569,117,1452,579,1129,35781,1965,2006,1163,34.7,156,389,39,22,129,1452,211
2016,36085009601,"Census Tract 96.01, Richmond County, New York",1601,92,1509,505,964,24028,1967,2008,1156,50,147,297,40,20,148,1509,220
2017,36085009601,"Census Tract 96.01, Richmond County, New York",1618,106,1512,460,886,24943,1968,2009,1161,50,162,298,39,25,98,1512,209
2018,36085009601,"Census Tract 96.01, Richmond County, New York",1620,128,1492,471,896,31146,1971,2011,1106,51,174,310,41,29,91,1492,221
2019,36085009601,"Census Tract 96.01, Richmond County, New York",1610,62,1548,488,940,37442,1972,2011,1137,30.9,184,362,13,41,72,1548,188
2020,36085009601,"Census Tract 96.01, Richmond County, New York",1618,36,1582,549,1186,59361,1965,2011,1168,26,175,446,0,8,95,1582,142
2012,36085009602,"Census Tract 96.02, Richmond County, New York",1420,100,1320,495,1139,52737,1953,2006,1231,31.1,140,227,0,68,200,1320,134
2013,36085009602,"Census Tract 96.02, Richmond County, New York",1420,124,1296,435,891,44531,1952,2007,1212,32.6,149,270,0,49,116,1296,82
2014,36085009602,"Census Tract 96.02, Richmond County, New York",1421,134,1287,468,1081,65139,1946,2007,1228,26.5,190,299,0,34,135,1287,56
2015,36085009602,"Census Tract 96.02, Richmond County, New York",1456,150,1306,453,1210,65903,1966,2009,1266,25.4,146,309,10,32,102,1306,53
2016,36085009602,"Census Tract 96.02, Richmond County, New York",1481,170,1311,515,1202,65313,1964,2010,1253,25.3,142,374,13,34,94,1311,63
2017,36085009602,"Census Tract 96.02, Richmond County, New York",1464,163,1301,517,1262,57429,1963,2011,1222,23.7,115,397,14,25,81,1301,98
2018,36085009602,"Census Tract 96.02, Richmond County, New York",1439,178,1261,504,1197,65000,1968,2011,1299,25.3,139,389,11,30,74,1261,103
2019,36085009602,"Census Tract 96.02, Richmond County, New York",1419,146,1273,530,1139,66000,1967,2013,1369,26.1,153,379,10,36,105,1273,82
2020,36085009602,"Census Tract 96.02, Richmond County, New York",1443,112,1331,616,1143,57708,1954,2016,1454,41.2,214,479,0,45,92,1331,55
2012,36085009700,"Census Tract 97, Richmond County, New York",1427,182,1245,436,969,23438,1961,2006,1204,46.4,68,138,153,4,155,1245,191
2013,36085009700,"Census Tract 97, Richmond County, New York",1545,172,1373,482,1056,24352,1965,2007,1125,43.7,60,154,141,11,193,1373,224
2014,36085009700,"Census Tract 97, Richmond County, New York",1611,155,1456,563,1344,22734,1973,2009,1160,45.8,56,141,189,7,238,1456,291
2015,36085009700,"Census Tract 97, Richmond County, New York",1605,109,1496,542,1280,24022,1976,2010,1139,46.8,41,143,182,9,235,1496,252
2016,36085009700,"Census Tract 97, Richmond County, New York",1635,108,1527,535,1232,41635,1987,2011,1165,32.2,43,152,231,26,144,1527,162
2017,36085009700,"Census Tract 97, Richmond County, New York",1650,98,1552,539,1294,41125,1987,2012,1314,33,45,154,176,29,200,1552,173
2018,36085009700,"Census Tract 97, Richmond County, New York",1648,93,1555,611,1609,41094,1984,2012,1455,35,92,82,305,34,208,1555,234
2019,36085009700,"Census Tract 97, Richmond County, New York",1661,71,1590,672,1805,55900,1991,2013,1446,33.7,83,189,294,21,191,1590,124
2020,36085009701,"Census Tract 97.01, Richmond County, New York",1597,84,1513,612,1698,62535,1991,2013,1501,31.5,137,156,258,21,177,1513,94
2020,36085009702,"Census Tract 97.02, Richmond County, New York",0,0,0,0,0,NA,NA,NA,NA,NA,0,0,0,0,0,0,0
2012,36085010500,"Census Tract 105, Richmond County, New York",1943,181,1762,738,2059,28929,1939,2003,1385,35.4,74,326,128,25,238,1762,353
2013,36085010500,"Census Tract 105, Richmond County, New York",1897,152,1745,686,1927,29457,1939,2005,1358,37.6,103,339,116,25,204,1745,346
2014,36085010500,"Census Tract 105, Richmond County, New York",1965,233,1732,729,1949,50847,1939,2007,1195,23.7,75,331,148,26,213,1732,291
2015,36085010500,"Census Tract 105, Richmond County, New York",1934,166,1768,768,1970,32500,1943,2008,1147,29.5,94,333,144,10,292,1768,322
2016,36085010500,"Census Tract 105, Richmond County, New York",1931,193,1738,654,1720,50214,1948,2010,1151,28.9,108,191,145,20,305,1738,276
2017,36085010500,"Census Tract 105, Richmond County, New York",1879,225,1654,626,1555,27895,1944,2011,1170,48.2,105,250,126,17,241,1654,280
2018,36085010500,"Census Tract 105, Richmond County, New York",1928,229,1699,671,1533,19926,1946,2010,1155,39.9,88,298,108,50,234,1699,310
2019,36085010500,"Census Tract 105, Richmond County, New York",1841,148,1693,771,1849,19609,1950,2011,1232,51,147,303,161,50,295,1693,343
2020,36085010500,"Census Tract 105, Richmond County, New York",1847,202,1645,698,1823,NA,1953,2015,1383,39.3,136,252,132,53,261,1645,262
2012,36085011201,"Census Tract 112.01, Richmond County, New York",2175,226,1949,481,950,33259,1974,2005,1433,50,172,390,0,24,52,1949,80
2013,36085011201,"Census Tract 112.01, Richmond County, New York",2176,269,1907,536,905,35347,1975,2008,1473,50,199,348,0,49,123,1907,91
2014,36085011201,"Census Tract 112.01, Richmond County, New York",2177,213,1964,506,1031,38856,1977,2008,1443,50,157,384,0,59,46,1964,49
2015,36085011201,"Census Tract 112.01, Richmond County, New York",2211,227,1984,579,1338,40129,1976,2008,1400,46,125,412,0,55,96,1984,62
2016,36085011201,"Census Tract 112.01, Richmond County, New York",2188,267,1921,478,1284,39911,1978,2008,1413,50,71,324,0,25,109,1921,125
2017,36085011201,"Census Tract 112.01, Richmond County, New York",2145,119,2026,570,1527,40377,1978,2010,1606,50,139,320,53,39,158,2026,132
2018,36085011201,"Census Tract 112.01, Richmond County, New York",2100,106,1994,496,1342,42333,1978,2009,1626,51,82,296,60,13,127,1994,137
2019,36085011201,"Census Tract 112.01, Richmond County, New York",2082,143,1939,503,1399,47102,1975,2011,1535,32.8,103,246,60,0,183,1939,124
2020,36085011201,"Census Tract 112.01, Richmond County, New York",1954,119,1835,447,1031,56776,1978,2014,1678,51,108,320,36,0,76,1835,121
2012,36085011202,"Census Tract 112.02, Richmond County, New York",2326,113,2213,350,932,30855,1962,2004,1215,49.5,0,129,12,36,146,2213,214
2013,36085011202,"Census Tract 112.02, Richmond County, New York",2349,162,2187,372,1042,27256,1957,2004,1566,50,40,147,15,73,137,2187,269
2014,36085011202,"Census Tract 112.02, Richmond County, New York",2287,222,2065,276,709,30417,1965,2005,1308,47.1,50,156,0,65,55,2065,206
2015,36085011202,"Census Tract 112.02, Richmond County, New York",2199,228,1971,323,905,NA,1964,2009,1217,50,71,140,0,79,104,1971,281
2016,36085011202,"Census Tract 112.02, Richmond County, New York",2142,262,1880,386,1004,NA,1964,2011,1245,50,72,188,0,83,115,1880,322
2017,36085011202,"Census Tract 112.02, Richmond County, New York",2130,221,1909,526,1579,NA,1967,2012,1427,42.8,120,217,25,83,201,1909,301
2018,36085011202,"Census Tract 112.02, Richmond County, New York",2174,231,1943,678,2061,NA,1969,2013,1385,39,118,249,106,74,249,1943,307
2019,36085011202,"Census Tract 112.02, Richmond County, New York",2214,204,2010,664,2173,70645,1970,2015,1445,34.4,123,258,93,52,261,2010,259
2020,36085011203,"Census Tract 112.03, Richmond County, New York",2325,127,2198,656,2079,41776,1990,2016,1645,45.1,272,370,63,49,174,2198,265
2020,36085011204,"Census Tract 112.04, Richmond County, New York",66,0,66,66,233,96974,0,2016,1889,17.4,19,19,29,0,18,66,0
2012,36085011401,"Census Tract 114.01, Richmond County, New York",1407,49,1358,770,1686,30000,1963,2000,537,29.1,154,288,283,6,190,1358,250
2013,36085011401,"Census Tract 114.01, Richmond County, New York",1415,99,1316,732,1534,18922,1963,2001,566,32.5,84,243,271,5,218,1316,285
2014,36085011401,"Census Tract 114.01, Richmond County, New York",1439,125,1314,722,1543,19593,1963,2002,555,31.9,70,195,272,12,244,1314,292
2015,36085011401,"Census Tract 114.01, Richmond County, New York",1418,130,1288,710,1389,11743,1962,2006,368,32.8,51,215,208,9,312,1288,409
2016,36085011401,"Census Tract 114.01, Richmond County, New York",1425,137,1288,716,1360,12126,1959,2008,NA,31.8,93,207,230,8,287,1288,439
2017,36085011401,"Census Tract 114.01, Richmond County, New York",1426,154,1272,743,1445,11356,1954,2008,297,30.5,106,191,281,8,299,1272,464
2018,36085011401,"Census Tract 114.01, Richmond County, New York",1409,93,1316,715,1391,16302,1955,2009,320,25.7,134,222,245,11,280,1316,368
2019,36085011401,"Census Tract 114.01, Richmond County, New York",1404,36,1368,754,1438,13106,1955,2010,350,26.3,127,255,231,11,298,1368,438
2020,36085011401,"Census Tract 114.01, Richmond County, New York",1362,44,1318,672,1412,20561,1955,2011,564,27.9,108,225,247,0,254,1318,349
2012,36085011402,"Census Tract 114.02, Richmond County, New York",1404,131,1273,441,975,51949,1958,2003,1192,26.1,77,245,59,19,72,1273,163
2013,36085011402,"Census Tract 114.02, Richmond County, New York",1397,121,1276,335,700,54293,1959,2002,1216,24.1,70,256,22,15,22,1276,181
2014,36085011402,"Census Tract 114.02, Richmond County, New York",1386,89,1297,358,822,57455,1955,2005,1183,25.3,74,231,23,29,34,1297,103
2015,36085011402,"Census Tract 114.02, Richmond County, New York",1427,142,1285,382,980,56774,1956,2005,1249,27.1,67,256,6,24,58,1285,111
2016,36085011402,"Census Tract 114.02, Richmond County, New York",1437,86,1351,343,827,57009,1959,2006,1409,33.5,58,208,7,12,70,1351,104
2017,36085011402,"Census Tract 114.02, Richmond County, New York",1424,144,1280,338,878,73182,1958,2012,1721,33.6,67,273,0,22,43,1280,104
2018,36085011402,"Census Tract 114.02, Richmond County, New York",1428,119,1309,377,921,59598,1958,2011,1678,33.6,69,286,11,22,58,1309,134
2019,36085011402,"Census Tract 114.02, Richmond County, New York",1439,139,1300,396,993,75288,1963,2013,1736,30.8,102,258,8,25,105,1300,137
2020,36085011402,"Census Tract 114.02, Richmond County, New York",1358,80,1278,366,845,62436,1964,2015,1477,29.3,91,250,8,19,89,1278,134
2012,36085012100,"Census Tract 121, Richmond County, New York",1188,14,1174,131,419,31393,1939,2007,1519,50,38,74,0,22,35,1174,121
2013,36085012100,"Census Tract 121, Richmond County, New York",1169,0,1169,207,550,30553,1939,2004,1146,46.1,88,144,0,24,39,1169,118
2014,36085012100,"Census Tract 121, Richmond County, New York",1171,0,1171,186,457,31458,1939,2003,1106,42.3,110,140,0,20,26,1171,80
2015,36085012100,"Census Tract 121, Richmond County, New York",1191,0,1191,200,600,31719,1954,2004,1289,41.2,116,147,0,0,53,1191,85
2016,36085012100,"Census Tract 121, Richmond County, New York",1189,0,1189,176,542,30690,1954,2004,1278,43.2,99,128,0,0,48,1189,72
2017,36085012100,"Census Tract 121, Richmond County, New York",1199,0,1199,211,531,32386,1948,2004,1335,41.7,155,174,0,0,37,1199,76
2018,36085012100,"Census Tract 121, Richmond County, New York",1190,0,1190,157,505,63068,1952,2005,1758,35,112,112,0,0,45,1190,118
2019,36085012100,"Census Tract 121, Richmond County, New York",1186,21,1165,128,451,NA,1952,2006,1810,33.3,78,87,0,0,41,1165,98
2020,36085012100,"Census Tract 121, Richmond County, New York",1257,61,1196,58,62,91250,0,2008,2069,29.3,54,58,0,0,0,1196,43
2012,36085012200,"Census Tract 122, Richmond County, New York",1497,90,1407,384,716,41029,1939,2005,1140,32.7,123,283,16,20,65,1407,97
2013,36085012200,"Census Tract 122, Richmond County, New York",1519,124,1395,413,743,41690,1943,2005,1101,30.8,118,309,11,21,72,1395,96
2014,36085012200,"Census Tract 122, Richmond County, New York",1497,114,1383,412,915,74643,1939,2007,1183,24.1,136,339,17,20,36,1383,58
2015,36085012200,"Census Tract 122, Richmond County, New York",1514,83,1431,447,1054,65815,1939,2007,1207,29.1,158,357,17,23,50,1431,73
2016,36085012200,"Census Tract 122, Richmond County, New York",1519,104,1415,395,1016,61372,1942,2009,1259,31.3,143,320,0,24,51,1415,72
2017,36085012200,"Census Tract 122, Richmond County, New York",1523,127,1396,364,931,60459,1952,2012,1494,31.7,125,326,0,0,38,1396,83
2018,36085012200,"Census Tract 122, Richmond County, New York",1537,104,1433,369,899,62668,1955,2012,1574,33,127,310,0,0,59,1433,51
2019,36085012200,"Census Tract 122, Richmond County, New York",1550,100,1450,400,1023,56071,1951,2013,1665,34.9,159,305,0,0,95,1450,58
2020,36085012200,"Census Tract 122, Richmond County, New York",1447,130,1317,391,923,54798,1950,2013,1715,34.3,116,235,0,0,156,1317,0
2012,36085012500,"Census Tract 125, Richmond County, New York",1031,88,943,346,1195,21993,1939,2004,1474,50,47,82,133,15,110,943,174
2013,36085012500,"Census Tract 125, Richmond County, New York",1026,92,934,403,1380,22524,1939,2004,1347,50,68,99,155,11,133,934,216
2014,36085012500,"Census Tract 125, Richmond County, New York",1045,113,932,362,1090,19833,1939,2005,1289,50,40,102,140,15,99,932,186
2015,36085012500,"Census Tract 125, Richmond County, New York",1058,128,930,359,987,35893,1939,2006,1239,42.1,53,135,93,17,109,930,113
2016,36085012500,"Census Tract 125, Richmond County, New York",1083,119,964,367,1053,30163,1939,2008,1228,48.2,69,137,51,14,175,964,167
2017,36085012500,"Census Tract 125, Richmond County, New York",1104,148,956,355,986,32159,1939,2008,1188,48.7,63,127,104,0,136,956,187
2018,36085012500,"Census Tract 125, Richmond County, New York",1093,134,959,354,1093,32632,0,2010,1380,47.3,71,144,83,6,135,959,190
2019,36085012500,"Census Tract 125, Richmond County, New York",1091,126,965,354,1080,40833,0,2010,1417,40,74,121,91,21,145,965,160
2020,36085012500,"Census Tract 125, Richmond County, New York",1136,101,1035,380,1132,46731,0,2014,1641,33.8,64,132,65,45,161,1035,164
2012,36085012804,"Census Tract 128.04, Richmond County, New York",1582,173,1409,317,756,35953,1967,2006,1186,37.3,50,201,15,13,88,1409,67
2013,36085012804,"Census Tract 128.04, Richmond County, New York",1636,180,1456,432,1041,34219,1962,2010,1312,49.1,51,247,11,16,158,1456,92
2014,36085012804,"Census Tract 128.04, Richmond County, New York",1639,196,1443,437,929,26385,1970,2011,1169,47.2,70,306,0,27,104,1443,134
2015,36085012804,"Census Tract 128.04, Richmond County, New York",1652,149,1503,452,1085,30000,1966,2012,1169,46.5,91,313,0,25,114,1503,143
2016,36085012804,"Census Tract 128.04, Richmond County, New York",1705,173,1532,470,1149,26818,1968,NA,1236,48.7,124,317,6,27,126,1532,179
2017,36085012804,"Census Tract 128.04, Richmond County, New York",1731,205,1526,424,1083,39688,1960,2012,1458,44.4,106,271,7,28,125,1526,135
2018,36085012804,"Census Tract 128.04, Richmond County, New York",1742,173,1569,371,776,50820,1975,2012,1397,34.5,142,244,15,24,92,1569,135
2019,36085012804,"Census Tract 128.04, Richmond County, New York",1748,201,1547,419,890,61375,1975,2013,1476,26.4,142,278,19,12,120,1547,148
2020,36085012804,"Census Tract 128.04, Richmond County, New York",1692,164,1528,474,1040,54940,1974,2015,1514,25,111,240,20,9,218,1528,144
2012,36085012805,"Census Tract 128.05, Richmond County, New York",1100,19,1081,106,253,41250,1972,2003,1641,32.8,11,105,0,1,0,1081,0
2013,36085012805,"Census Tract 128.05, Richmond County, New York",1111,66,1045,175,340,58990,1974,2004,1240,22.1,44,116,0,23,26,1045,30
2014,36085012805,"Census Tract 128.05, Richmond County, New York",1013,50,963,179,383,67917,1975,2004,1348,21.8,52,114,0,28,26,963,65
2015,36085012805,"Census Tract 128.05, Richmond County, New York",1076,68,1008,160,274,57986,1975,2004,1175,23.6,62,93,0,13,36,1008,63
2016,36085012805,"Census Tract 128.05, Richmond County, New York",1058,131,927,202,355,NA,1976,2004,1195,43,62,135,0,13,35,927,78
2017,36085012805,"Census Tract 128.05, Richmond County, New York",963,93,870,163,268,30787,1977,2006,1153,45,38,120,0,0,33,870,69
2018,36085012805,"Census Tract 128.05, Richmond County, New York",947,87,860,161,310,23994,1969,2010,1433,51,31,161,0,0,0,860,45
2019,36085012805,"Census Tract 128.05, Richmond County, New York",978,110,868,189,342,23774,1970,2012,1432,51,62,176,13,0,0,868,47
2020,36085012805,"Census Tract 128.05, Richmond County, New York",928,136,792,148,323,28587,1969,2015,1471,47.6,12,140,8,0,0,792,65
2012,36085012806,"Census Tract 128.06, Richmond County, New York",2745,105,2640,1468,2951,43611,1962,2002,1096,28.6,209,942,247,37,231,2640,301
2013,36085012806,"Census Tract 128.06, Richmond County, New York",2676,101,2575,1427,2975,48545,1962,2003,1152,30.6,196,837,270,50,252,2575,257
2014,36085012806,"Census Tract 128.06, Richmond County, New York",2610,119,2491,1316,2735,43375,1962,2004,1176,32.8,176,771,294,28,203,2491,257
2015,36085012806,"Census Tract 128.06, Richmond County, New York",2553,103,2450,1184,2176,28654,1963,2005,1165,39.9,159,687,195,22,258,2450,296
2016,36085012806,"Census Tract 128.06, Richmond County, New York",2475,158,2317,1269,2428,25742,1963,2009,1240,39.8,154,818,181,27,216,2317,321
2017,36085012806,"Census Tract 128.06, Richmond County, New York",2430,181,2249,1129,2159,28082,1965,2011,1274,43.8,67,689,178,27,211,2249,289
2018,36085012806,"Census Tract 128.06, Richmond County, New York",2431,181,2250,1164,2068,23600,1964,2011,1281,42.5,102,722,139,0,258,2250,414
2019,36085012806,"Census Tract 128.06, Richmond County, New York",2376,103,2273,1251,2175,27668,1962,2012,1316,40.4,131,770,134,25,297,2273,341
2020,36085012806,"Census Tract 128.06, Richmond County, New York",2341,98,2243,1440,2713,33730,1964,2013,1318,35.2,245,949,93,33,349,2243,388
2012,36085013201,"Census Tract 132.01, Richmond County, New York",603,8,595,83,148,63531,1970,2007,1169,19,19,83,0,0,0,595,34
2013,36085013201,"Census Tract 132.01, Richmond County, New York",590,25,565,73,178,73839,1968,2011,1523,24.6,18,73,0,0,0,565,30
2014,36085013201,"Census Tract 132.01, Richmond County, New York",595,25,570,74,182,73333,1968,2011,1471,21.7,17,74,0,0,0,570,46
2015,36085013201,"Census Tract 132.01, Richmond County, New York",596,22,574,68,162,73636,1968,2011,1471,22.5,17,68,0,0,0,574,39
2016,36085013201,"Census Tract 132.01, Richmond County, New York",599,15,584,72,131,62917,1967,2011,1397,27.5,23,72,0,0,0,584,51
2017,36085013201,"Census Tract 132.01, Richmond County, New York",599,33,566,65,113,63250,1967,2011,1219,27.1,5,65,0,0,0,566,47
2018,36085013201,"Census Tract 132.01, Richmond County, New York",605,33,572,55,93,NA,1959,2007,997,29.6,9,55,0,0,0,572,50
2019,36085013201,"Census Tract 132.01, Richmond County, New York",601,51,550,55,102,58250,1966,2009,1208,28.6,13,55,0,0,0,550,32
2020,36085013201,"Census Tract 132.01, Richmond County, New York",545,49,496,51,85,58125,1961,2009,1083,28.8,14,51,0,0,0,496,22
2012,36085013203,"Census Tract 132.03, Richmond County, New York",2038,119,1919,253,462,28531,1968,2002,1430,50,45,196,16,0,41,1919,103
2013,36085013203,"Census Tract 132.03, Richmond County, New York",2079,60,2019,323,530,29085,1982,2002,1309,50,31,283,0,0,40,2019,129
2014,36085013203,"Census Tract 132.03, Richmond County, New York",1997,18,1979,341,599,50230,1984,2003,1359,45.7,26,282,0,0,59,1979,139
2015,36085013203,"Census Tract 132.03, Richmond County, New York",2087,20,2067,342,634,51132,1984,2005,1533,41.6,30,307,0,0,35,2067,173
2016,36085013203,"Census Tract 132.03, Richmond County, New York",2107,79,2028,321,593,50824,1984,2006,1492,34.8,23,289,0,0,32,2028,147
2017,36085013203,"Census Tract 132.03, Richmond County, New York",2134,164,1970,408,895,54342,1982,2009,1617,41.2,94,331,0,0,77,1970,163
2018,36085013203,"Census Tract 132.03, Richmond County, New York",2125,215,1910,262,606,51176,1975,2013,1614,42.7,115,183,0,0,79,1910,177
2019,36085013203,"Census Tract 132.03, Richmond County, New York",2181,177,2004,392,936,50617,1973,2014,1476,41.3,186,320,12,0,60,2004,170
2020,36085013203,"Census Tract 132.03, Richmond County, New York",2368,324,2044,427,1017,51671,1972,2012,1435,25.7,194,316,15,0,96,2044,109
2012,36085013204,"Census Tract 132.04, Richmond County, New York",1892,125,1767,573,1264,63911,1968,2005,1411,29,170,505,13,6,29,1767,75
2013,36085013204,"Census Tract 132.04, Richmond County, New York",1884,106,1778,558,1218,66538,1968,2005,1473,27.8,160,496,15,5,29,1778,80
2014,36085013204,"Census Tract 132.04, Richmond County, New York",1874,69,1805,484,958,65455,1969,2006,1493,27,127,426,0,5,40,1805,145
2015,36085013204,"Census Tract 132.04, Richmond County, New York",1898,94,1804,503,1019,58194,1969,2007,1415,29.2,151,442,0,9,52,1804,158
2016,36085013204,"Census Tract 132.04, Richmond County, New York",1905,115,1790,422,852,51630,1966,2008,1411,30.7,137,324,0,0,98,1790,147
2017,36085013204,"Census Tract 132.04, Richmond County, New York",1923,87,1836,433,1017,52354,1968,2010,1500,32.3,115,353,0,0,80,1836,136
2018,36085013204,"Census Tract 132.04, Richmond County, New York",1949,85,1864,453,1018,61109,1968,2012,1461,31.1,131,375,0,0,78,1864,112
2019,36085013204,"Census Tract 132.04, Richmond County, New York",1939,74,1865,500,1192,64545,1969,2015,1435,30.1,184,435,0,0,65,1865,92
2020,36085013204,"Census Tract 132.04, Richmond County, New York",1830,81,1749,497,1212,64210,1967,2015,1462,27.1,139,397,0,0,100,1749,134
2012,36085013301,"Census Tract 133.01, Richmond County, New York",656,57,599,582,1567,14286,1964,2004,412,32.1,68,61,393,12,121,599,324
2013,36085013301,"Census Tract 133.01, Richmond County, New York",654,68,586,582,1565,14783,1963,2004,416,33,93,82,365,9,126,586,316
2014,36085013301,"Census Tract 133.01, Richmond County, New York",697,60,637,632,1741,15395,1962,2004,427,32.3,94,78,370,10,173,637,360
2015,36085013301,"Census Tract 133.01, Richmond County, New York",648,65,583,579,1527,14095,1962,2005,427,32.9,76,88,274,11,215,583,378
2016,36085013301,"Census Tract 133.01, Richmond County, New York",653,71,582,575,1458,13795,1962,2005,441,31.5,59,68,317,0,208,582,372
2017,36085013301,"Census Tract 133.01, Richmond County, New York",643,55,588,575,1349,12992,1961,2005,442,33.1,60,81,262,0,237,588,384
2018,36085013301,"Census Tract 133.01, Richmond County, New York",636,83,553,543,1231,10234,1960,2008,386,39.1,48,68,274,11,198,553,372
2019,36085013301,"Census Tract 133.01, Richmond County, New York",654,83,571,563,1077,9809,1962,2008,294,37.6,42,36,294,15,244,571,345
2020,36085013301,"Census Tract 133.01, Richmond County, New York",552,63,489,481,1049,10972,1960,2008,299,29.9,30,39,283,16,151,489,284
2012,36085013302,"Census Tract 133.02, Richmond County, New York",1206,183,1023,516,1575,26692,1939,2006,1593,50,14,72,206,35,231,1023,169
2013,36085013302,"Census Tract 133.02, Richmond County, New York",1203,193,1010,462,1387,32692,1944,2007,1652,50,13,60,157,61,184,1010,146
2014,36085013302,"Census Tract 133.02, Richmond County, New York",1217,212,1005,458,1182,25584,1957,2009,1301,50,20,38,131,61,228,1005,235
2015,36085013302,"Census Tract 133.02, Richmond County, New York",1207,267,940,446,1331,26215,1956,2009,1210,50,16,33,106,43,264,940,190
2016,36085013302,"Census Tract 133.02, Richmond County, New York",1176,252,924,521,1376,19160,1948,2008,1309,50,53,51,179,37,245,924,271
2017,36085013302,"Census Tract 133.02, Richmond County, New York",1123,242,881,456,1300,20455,1939,2008,1325,39.9,84,36,211,31,168,881,245
2018,36085013302,"Census Tract 133.02, Richmond County, New York",1128,246,882,487,1488,NA,1951,2010,1377,38.8,85,49,241,0,185,882,259
2019,36085013302,"Census Tract 133.02, Richmond County, New York",1111,241,870,495,1627,40231,1941,2010,1454,37.1,79,30,215,0,245,870,210
2020,36085013302,"Census Tract 133.02, Richmond County, New York",1200,217,983,591,1723,NA,1954,2014,1646,27.2,246,27,352,0,363,983,243
2012,36085013400,"Census Tract 134, Richmond County, New York",1589,10,1579,454,1128,66818,1946,2006,1339,31,170,244,0,14,196,1579,81
2013,36085013400,"Census Tract 134, Richmond County, New York",1644,29,1615,509,1182,56773,1943,2007,1332,31.5,195,255,0,15,239,1615,135
2014,36085013400,"Census Tract 134, Richmond County, New York",1583,62,1521,456,902,58750,1946,2011,1234,31.6,126,279,0,18,159,1521,126
2015,36085013400,"Census Tract 134, Richmond County, New York",1581,104,1477,537,967,48490,1948,2011,1190,35.5,116,357,11,16,145,1477,161
2016,36085013400,"Census Tract 134, Richmond County, New York",1598,114,1484,506,1020,37500,1953,2011,1243,38,94,324,13,10,151,1484,164
2017,36085013400,"Census Tract 134, Richmond County, New York",1604,103,1501,527,1194,42072,1950,2011,1429,35.4,99,321,13,9,177,1501,179
2018,36085013400,"Census Tract 134, Richmond County, New York",1611,76,1535,479,1036,52284,1953,2012,1573,29.5,108,339,10,9,115,1535,153
2019,36085013400,"Census Tract 134, Richmond County, New York",1611,62,1549,472,1017,55870,1957,2012,1477,27.2,107,337,12,12,103,1549,148
2020,36085013400,"Census Tract 134, Richmond County, New York",1453,37,1416,410,1386,NA,1958,2012,1743,26.3,63,243,51,13,103,1416,187
2012,36085013800,"Census Tract 138, Richmond County, New York",2393,282,2111,290,693,51500,1965,2005,1647,34.5,49,227,0,0,63,2111,76
2013,36085013800,"Census Tract 138, Richmond County, New York",2383,163,2220,314,652,48958,1965,2009,1194,38.3,79,265,0,0,49,2220,78
2014,36085013800,"Census Tract 138, Richmond County, New York",2449,148,2301,425,896,48417,1965,2007,1205,33.4,101,361,0,0,64,2301,89
2015,36085013800,"Census Tract 138, Richmond County, New York",2442,144,2298,333,600,NA,1966,2011,1128,40.8,98,312,0,0,21,2298,79
2016,36085013800,"Census Tract 138, Richmond County, New York",2461,92,2369,441,869,NA,1960,2012,1185,27.4,95,329,0,0,112,2369,148
2017,36085013800,"Census Tract 138, Richmond County, New York",2478,82,2396,448,918,NA,1959,2012,1289,21,110,289,0,0,159,2396,168
2018,36085013800,"Census Tract 138, Richmond County, New York",2447,114,2333,392,954,NA,1956,2012,1623,27.5,48,183,0,0,209,2333,231
2019,36085013800,"Census Tract 138, Richmond County, New York",2450,117,2333,336,783,NA,1956,2013,1624,28.8,69,149,0,0,187,2333,257
2020,36085013800,"Census Tract 138, Richmond County, New York",2535,69,2466,263,639,NA,1955,2013,1646,41.9,48,109,0,0,154,2466,240
2012,36085014100,"Census Tract 141, Richmond County, New York",1012,6,1006,445,1091,38482,1972,2006,1197,38.8,34,151,96,6,193,1006,186
2013,36085014100,"Census Tract 141, Richmond County, New York",1007,68,939,381,1031,38750,1975,2006,1291,41.6,49,111,64,5,203,939,183
2014,36085014100,"Census Tract 141, Richmond County, New York",1014,85,929,370,1013,45104,1972,2008,1302,36.3,65,88,49,6,232,929,184
2015,36085014100,"Census Tract 141, Richmond County, New York",996,125,871,337,820,36917,1974,2008,1143,36,71,87,82,5,165,871,167
2016,36085014100,"Census Tract 141, Richmond County, New York",1006,142,864,321,770,41648,1973,2010,1274,32.8,79,86,74,18,143,864,91
2017,36085014100,"Census Tract 141, Richmond County, New York",990,156,834,314,778,42143,1968,2010,1402,34.2,69,94,54,12,137,834,85
2018,36085014100,"Census Tract 141, Richmond County, New York",956,109,847,274,562,43472,1966,2011,1322,34.4,63,110,53,10,84,847,80
2019,36085014100,"Census Tract 141, Richmond County, New York",996,108,888,341,668,43546,1958,2012,1332,34.6,89,139,69,12,101,888,91
2020,36085014100,"Census Tract 141, Richmond County, New York",1114,82,1032,492,876,36425,1970,2012,1403,41.4,98,144,130,17,183,1032,112
2012,36085014604,"Census Tract 146.04, Richmond County, New York",2700,52,2648,510,1196,68370,1983,2006,1243,26.6,104,433,0,21,56,2648,151
2013,36085014604,"Census Tract 146.04, Richmond County, New York",2757,47,2710,666,1394,44583,1978,2009,1197,35.1,111,465,0,11,190,2710,174
2014,36085014604,"Census Tract 146.04, Richmond County, New York",2770,16,2754,680,1418,47279,1977,2011,1207,34.6,161,457,0,34,189,2754,255
2015,36085014604,"Census Tract 146.04, Richmond County, New York",2770,53,2717,576,1116,47313,1975,2012,1203,29.7,125,356,0,12,208,2717,234
2016,36085014604,"Census Tract 146.04, Richmond County, New York",2719,143,2576,523,960,36690,1972,2012,1202,37.3,128,359,13,17,134,2576,265
2017,36085014604,"Census Tract 146.04, Richmond County, New York",2756,171,2585,439,762,35869,1966,2012,1193,37.7,135,272,14,15,138,2585,218
2018,36085014604,"Census Tract 146.04, Richmond County, New York",2736,191,2545,416,769,108398,1972,2014,1631,17.5,228,338,17,19,42,2545,200
2019,36085014604,"Census Tract 146.04, Richmond County, New York",2718,195,2523,453,926,111956,1973,2015,1849,16.7,139,402,16,0,35,2523,147
2020,36085014604,"Census Tract 146.04, Richmond County, New York",2698,246,2452,401,794,114360,1973,2016,1851,16.1,154,343,14,0,44,2452,118
2012,36085014605,"Census Tract 146.05, Richmond County, New York",1359,0,1359,142,324,37917,1973,2004,1267,24.4,45,142,0,0,0,1359,61
2013,36085014605,"Census Tract 146.05, Richmond County, New York",1362,27,1335,144,287,38542,1974,2006,1144,24.7,19,135,0,0,9,1335,41
2014,36085014605,"Census Tract 146.05, Richmond County, New York",1379,25,1354,201,458,34375,1972,2008,1181,38.5,35,158,0,0,43,1354,77
2015,36085014605,"Census Tract 146.05, Richmond County, New York",1427,29,1398,197,465,NA,1969,2011,1218,36.9,43,148,0,0,49,1398,79
2016,36085014605,"Census Tract 146.05, Richmond County, New York",1426,45,1381,168,449,69609,1972,2011,1266,35.6,32,122,0,0,46,1381,72
2017,36085014605,"Census Tract 146.05, Richmond County, New York",1390,58,1332,189,521,69821,1967,2012,1156,35.7,35,140,0,0,49,1332,68
2018,36085014605,"Census Tract 146.05, Richmond County, New York",1383,55,1328,198,605,NA,1973,2012,1249,35.7,40,154,0,0,44,1328,73
2019,36085014605,"Census Tract 146.05, Richmond County, New York",1378,78,1300,188,555,NA,1972,2015,1247,19.3,18,178,0,10,0,1300,67
2020,36085014605,"Census Tract 146.05, Richmond County, New York",1405,79,1326,239,693,140483,1974,2016,1821,16.9,71,219,0,9,11,1326,55
2012,36085014606,"Census Tract 146.06, Richmond County, New York",2430,15,2415,360,774,90246,1987,2005,1642,19.6,115,269,0,61,30,2415,126
2013,36085014606,"Census Tract 146.06, Richmond County, New York",2420,0,2420,305,659,80742,1988,2006,1641,22.3,71,239,0,48,18,2420,96
2014,36085014606,"Census Tract 146.06, Richmond County, New York",2408,0,2408,334,747,83967,1985,2007,1468,24.8,78,237,0,77,20,2408,231
2015,36085014606,"Census Tract 146.06, Richmond County, New York",2434,0,2434,383,711,83321,1985,2009,1491,23.5,118,276,0,94,13,2434,233
2016,36085014606,"Census Tract 146.06, Richmond County, New York",2448,0,2448,334,652,92604,1986,2011,1732,22.5,141,250,0,84,0,2448,238
2017,36085014606,"Census Tract 146.06, Richmond County, New York",2441,120,2321,261,586,84131,1985,2011,1908,25.5,94,242,0,19,0,2321,114
2018,36085014606,"Census Tract 146.06, Richmond County, New York",2460,167,2293,280,578,83432,1986,2011,1869,23.8,84,269,0,11,0,2293,126
2019,36085014606,"Census Tract 146.06, Richmond County, New York",2491,178,2313,294,387,NA,1982,2014,1563,23.8,85,174,0,21,99,2313,135
2020,36085014606,"Census Tract 146.06, Richmond County, New York",2292,230,2062,240,327,NA,1980,2015,1313,27.3,46,113,0,25,102,2062,134
2012,36085014607,"Census Tract 146.07, Richmond County, New York",1692,0,1692,310,936,44688,1977,2006,1210,35.9,141,242,0,36,32,1692,133
2013,36085014607,"Census Tract 146.07, Richmond County, New York",1710,8,1702,307,843,53697,1977,2008,1382,28.5,121,215,0,38,54,1702,98
2014,36085014607,"Census Tract 146.07, Richmond County, New York",1714,7,1707,397,1359,58466,1980,2009,1537,36.9,110,292,0,35,70,1707,105
2015,36085014607,"Census Tract 146.07, Richmond County, New York",1711,8,1703,469,1384,59952,1979,2011,1586,35.3,159,346,0,52,71,1703,142
2016,36085014607,"Census Tract 146.07, Richmond County, New York",1719,8,1711,448,1343,62019,1984,2011,1676,37,128,343,9,43,53,1711,141
2017,36085014607,"Census Tract 146.07, Richmond County, New York",1709,9,1700,478,1315,59135,1978,2010,1580,38.6,109,359,11,52,56,1700,133
2018,36085014607,"Census Tract 146.07, Richmond County, New York",1720,0,1720,411,1141,63281,1977,2011,1682,36,123,335,13,48,15,1720,138
2019,36085014607,"Census Tract 146.07, Richmond County, New York",1704,0,1704,371,958,62888,1975,2015,1787,30.5,160,279,10,38,44,1704,117
2020,36085014607,"Census Tract 146.07, Richmond County, New York",1677,31,1646,317,737,81125,1974,2012,1736,23,174,244,10,22,41,1646,65
2012,36085014608,"Census Tract 146.08, Richmond County, New York",1265,0,1265,115,353,67775,1973,NA,1702,27.5,0,65,0,0,50,1265,39
2013,36085014608,"Census Tract 146.08, Richmond County, New York",1253,29,1224,188,500,67545,1975,2005,1681,27.5,0,132,0,0,56,1224,32
2014,36085014608,"Census Tract 146.08, Richmond County, New York",1286,30,1256,235,717,70694,1976,2007,1691,26.4,0,130,0,0,105,1256,59
2015,36085014608,"Census Tract 146.08, Richmond County, New York",1294,64,1230,198,520,NA,1976,2010,1642,24,0,158,0,0,40,1230,66
2016,36085014608,"Census Tract 146.08, Richmond County, New York",1282,94,1188,188,630,88289,1979,2011,1756,23.2,12,121,0,0,67,1188,58
2017,36085014608,"Census Tract 146.08, Richmond County, New York",1286,149,1137,166,502,95122,1977,2012,1775,23,11,97,0,0,69,1137,48
2018,36085014608,"Census Tract 146.08, Richmond County, New York",1283,125,1158,114,452,120682,1977,2013,1897,22,13,32,0,0,82,1158,65
2019,36085014608,"Census Tract 146.08, Richmond County, New York",1276,191,1085,75,229,124344,1979,2013,2031,21.3,14,35,0,0,40,1085,43
2020,36085014608,"Census Tract 146.08, Richmond County, New York",1325,156,1169,84,238,124013,1981,2013,1926,20.7,25,46,0,0,38,1169,28
2012,36085014700,"Census Tract 147, Richmond County, New York",1531,151,1380,342,619,57105,1950,2006,1212,28.8,168,289,0,0,43,1380,76
2013,36085014700,"Census Tract 147, Richmond County, New York",1525,163,1362,359,708,62337,1956,2008,1186,25.5,190,283,0,0,64,1362,82
2014,36085014700,"Census Tract 147, Richmond County, New York",1525,102,1423,350,702,61900,1962,2010,1241,26.9,166,286,10,0,42,1423,70
2015,36085014700,"Census Tract 147, Richmond County, New York",1475,91,1384,338,709,60865,1961,2009,1165,24.8,160,289,22,0,27,1384,106
2016,36085014700,"Census Tract 147, Richmond County, New York",1504,163,1341,241,525,61971,1962,2011,1220,23.6,126,185,29,0,36,1341,83
2017,36085014700,"Census Tract 147, Richmond County, New York",1517,189,1328,211,511,83375,1964,2012,1530,23.1,106,149,30,0,41,1328,94
2018,36085014700,"Census Tract 147, Richmond County, New York",1529,189,1340,222,393,79000,1949,2012,1490,25.8,68,187,35,0,10,1340,66
2019,36085014700,"Census Tract 147, Richmond County, New York",1524,197,1327,299,519,83359,1946,2014,1348,20.9,81,266,29,4,11,1327,64
2020,36085014700,"Census Tract 147, Richmond County, New York",1564,168,1396,360,524,59368,1960,2010,1550,29.1,62,337,11,6,17,1396,32
2012,36085015100,"Census Tract 151, Richmond County, New York",2147,107,2040,634,1184,66226,1963,2004,1108,20.1,140,576,19,0,39,2040,189
2013,36085015100,"Census Tract 151, Richmond County, New York",2144,109,2035,559,1012,37113,1965,2004,1095,32.8,141,505,15,0,39,2035,213
2014,36085015100,"Census Tract 151, Richmond County, New York",2098,132,1966,470,821,31250,1964,2008,1077,32.9,184,397,12,0,61,1966,238
2015,36085015100,"Census Tract 151, Richmond County, New York",2113,200,1913,418,581,43163,1965,2010,1038,32.7,205,358,0,0,60,1913,202
2016,36085015100,"Census Tract 151, Richmond County, New York",2109,199,1910,364,500,42843,1963,2011,1097,32.1,138,305,0,0,59,1910,236
2017,36085015100,"Census Tract 151, Richmond County, New York",2130,214,1916,335,533,40250,1963,2011,1183,32.3,156,246,0,0,89,1916,195
2018,36085015100,"Census Tract 151, Richmond County, New York",2111,224,1887,335,586,45091,1964,2013,1428,19.9,144,194,0,0,141,1887,178
2019,36085015100,"Census Tract 151, Richmond County, New York",2112,188,1924,327,747,76438,1962,2013,1434,18.7,76,207,0,0,120,1924,137
2020,36085015100,"Census Tract 151, Richmond County, New York",1991,176,1815,298,670,68846,1962,2014,1433,19.4,78,177,0,0,121,1815,129
2012,36085015400,"Census Tract 154, Richmond County, New York",0,0,0,0,0,NA,NA,NA,NA,NA,0,0,0,0,0,0,0
2013,36085015400,"Census Tract 154, Richmond County, New York",0,0,0,0,0,NA,NA,NA,NA,NA,0,0,0,0,0,0,0
2014,36085015400,"Census Tract 154, Richmond County, New York",0,0,0,0,0,NA,NA,NA,NA,NA,0,0,0,0,0,0,0
2015,36085015400,"Census Tract 154, Richmond County, New York",0,0,0,0,0,NA,NA,NA,NA,NA,0,0,0,0,0,0,0
2016,36085015400,"Census Tract 154, Richmond County, New York",0,0,0,0,0,NA,NA,NA,NA,NA,0,0,0,0,0,0,0
2017,36085015400,"Census Tract 154, Richmond County, New York",0,0,0,0,0,NA,NA,NA,NA,NA,0,0,0,0,0,0,0
2018,36085015400,"Census Tract 154, Richmond County, New York",0,0,0,0,0,NA,NA,NA,NA,NA,0,0,0,0,0,0,0
2019,36085015400,"Census Tract 154, Richmond County, New York",0,0,0,0,0,NA,NA,NA,NA,NA,0,0,0,0,0,0,0
2020,36085015400,"Census Tract 154, Richmond County, New York",0,0,0,0,0,NA,NA,NA,NA,NA,0,0,0,0,0,0,0
2012,36085015601,"Census Tract 156.01, Richmond County, New York",2461,116,2345,407,823,25821,1977,2003,1086,26.9,89,346,0,1,60,2345,187
2013,36085015601,"Census Tract 156.01, Richmond County, New York",2489,136,2353,348,745,25294,1970,2004,1279,24.2,104,282,0,4,62,2353,224
2014,36085015601,"Census Tract 156.01, Richmond County, New York",2524,79,2445,351,677,19540,1967,2003,1041,48,59,261,0,6,84,2445,199
2015,36085015601,"Census Tract 156.01, Richmond County, New York",2524,80,2444,256,465,NA,1966,2004,1096,26.1,66,186,0,8,62,2444,174
2016,36085015601,"Census Tract 156.01, Richmond County, New York",2525,61,2464,349,618,69797,1955,2010,1066,18.1,152,314,0,0,35,2464,141
2017,36085015601,"Census Tract 156.01, Richmond County, New York",2516,95,2421,345,638,76319,1959,2011,1176,18.4,151,311,0,0,34,2421,109
2018,36085015601,"Census Tract 156.01, Richmond County, New York",2553,147,2406,394,672,85833,1948,2012,1352,18.4,198,370,0,0,24,2406,93
2019,36085015601,"Census Tract 156.01, Richmond County, New York",2559,160,2399,350,645,105943,1942,2014,1292,17.5,204,350,0,0,0,2399,69
2020,36085015601,"Census Tract 156.01, Richmond County, New York",2407,148,2259,525,1228,120486,1950,2011,1455,17,269,326,63,0,136,2259,47
2012,36085015602,"Census Tract 156.02, Richmond County, New York",1202,77,1125,63,219,60625,1973,2004,2001,50,0,63,0,0,0,1125,72
2013,36085015602,"Census Tract 156.02, Richmond County, New York",1178,35,1143,96,350,53750,1961,2007,1713,43.3,0,66,0,0,30,1143,76
2014,36085015602,"Census Tract 156.02, Richmond County, New York",1175,53,1122,54,149,37083,1958,2010,1578,40.5,0,28,0,0,26,1122,50
2015,36085015602,"Census Tract 156.02, Richmond County, New York",1187,28,1159,83,184,61027,1984,2011,956,32.7,0,58,0,0,25,1159,26
2016,36085015602,"Census Tract 156.02, Richmond County, New York",1192,44,1148,67,135,61302,1985,2011,NA,32.2,0,45,0,0,22,1148,29
2017,36085015602,"Census Tract 156.02, Richmond County, New York",1180,39,1141,76,153,60938,1984,2011,NA,31.5,0,46,0,0,30,1141,55
2018,36085015602,"Census Tract 156.02, Richmond County, New York",1211,86,1125,78,142,78750,1990,2010,NA,19,32,67,0,0,11,1125,69
2019,36085015602,"Census Tract 156.02, Richmond County, New York",1158,76,1082,108,202,104167,1983,2012,1677,17.7,56,99,0,0,9,1082,63
2020,36085015602,"Census Tract 156.02, Richmond County, New York",1206,95,1111,91,182,114567,1966,2013,1901,18.2,72,81,0,0,10,1111,128
2012,36085015603,"Census Tract 156.03, Richmond County, New York",1771,125,1646,238,507,79274,1969,2004,1317,25.5,46,222,0,16,0,1646,62
2013,36085015603,"Census Tract 156.03, Richmond County, New York",1830,125,1705,282,770,105536,1983,2005,1875,23,61,251,0,31,0,1705,82
2014,36085015603,"Census Tract 156.03, Richmond County, New York",1805,90,1715,409,1078,81122,1983,2007,1575,24.3,133,336,0,35,38,1715,160
2015,36085015603,"Census Tract 156.03, Richmond County, New York",1788,73,1715,412,1032,NA,1982,2009,1472,27.8,118,321,0,36,55,1715,159
2016,36085015603,"Census Tract 156.03, Richmond County, New York",1785,64,1721,421,1072,76375,1982,2008,2043,24.6,122,346,0,27,48,1721,166
2017,36085015603,"Census Tract 156.03, Richmond County, New York",1781,26,1755,433,1196,50671,1984,2010,2090,41.9,128,318,0,19,96,1755,218
2018,36085015603,"Census Tract 156.03, Richmond County, New York",1800,41,1759,488,1229,48864,1985,2011,2011,48.5,156,338,0,9,141,1759,225
2019,36085015603,"Census Tract 156.03, Richmond County, New York",1829,76,1753,413,1089,52736,1985,2012,2082,51,56,272,0,0,141,1753,195
2020,36085015603,"Census Tract 156.03, Richmond County, New York",1754,120,1634,334,904,53477,1986,2014,2159,51,78,224,0,0,110,1634,136
2012,36085016901,"Census Tract 169.01, Richmond County, New York",1227,53,1174,427,935,49504,1957,2004,1335,32.1,110,208,9,11,186,1174,143
2013,36085016901,"Census Tract 169.01, Richmond County, New York",1221,43,1178,405,896,50902,1967,2003,1404,34.7,84,165,10,13,207,1178,118
2014,36085016901,"Census Tract 169.01, Richmond County, New York",1209,93,1116,428,1027,51383,1968,2006,1600,35.2,92,214,13,12,189,1116,92
2015,36085016901,"Census Tract 169.01, Richmond County, New York",1197,82,1115,360,908,42132,1967,2009,1634,36.9,94,185,14,8,146,1115,100
2016,36085016901,"Census Tract 169.01, Richmond County, New York",1206,85,1121,395,981,42008,1965,2011,1665,36.8,150,237,15,0,126,1121,117
2017,36085016901,"Census Tract 169.01, Richmond County, New York",1186,71,1115,376,909,39674,1965,2011,1630,50,151,232,18,0,113,1115,129
2018,36085016901,"Census Tract 169.01, Richmond County, New York",1195,73,1122,377,912,26331,1962,2013,1614,51,151,247,14,0,100,1122,155
2019,36085016901,"Census Tract 169.01, Richmond County, New York",1190,34,1156,291,649,NA,1962,2014,1601,51,95,193,15,0,63,1156,117
2020,36085016901,"Census Tract 169.01, Richmond County, New York",1118,28,1090,282,748,45234,1966,2015,1572,51,67,217,11,0,47,1090,115
2012,36085017005,"Census Tract 170.05, Richmond County, New York",1644,86,1558,275,443,39526,1987,2007,1026,30.3,61,267,0,0,8,1558,71
2013,36085017005,"Census Tract 170.05, Richmond County, New York",1665,94,1571,321,543,40163,1986,2009,1135,28,103,274,0,7,40,1571,68
2014,36085017005,"Census Tract 170.05, Richmond County, New York",1723,93,1630,319,558,39116,1986,2009,1268,29.4,85,274,0,8,37,1630,87
2015,36085017005,"Census Tract 170.05, Richmond County, New York",1740,117,1623,321,569,39410,1989,2011,1234,26.4,89,275,0,5,41,1623,79
2016,36085017005,"Census Tract 170.05, Richmond County, New York",1741,69,1672,302,518,38929,1985,2011,1067,26.5,82,254,0,8,40,1672,85
2017,36085017005,"Census Tract 170.05, Richmond County, New York",1758,50,1708,237,384,41404,1985,2010,1188,31.8,53,190,0,8,39,1708,70
2018,36085017005,"Census Tract 170.05, Richmond County, New York",1768,26,1742,214,339,41250,1987,2011,1124,33.4,43,187,0,0,27,1742,77
2019,36085017005,"Census Tract 170.05, Richmond County, New York",1775,75,1700,255,509,44611,1984,2015,1160,26.3,75,181,24,0,50,1700,81
2020,36085017005,"Census Tract 170.05, Richmond County, New York",1776,88,1688,303,644,62244,1985,2016,1231,26.8,178,228,20,0,55,1688,78
2012,36085017007,"Census Tract 170.07, Richmond County, New York",1743,75,1668,287,564,31281,1996,2005,996,37.8,52,211,0,58,18,1668,168
2013,36085017007,"Census Tract 170.07, Richmond County, New York",1785,30,1755,276,471,31307,1996,2005,964,41,51,204,0,39,33,1755,221
2014,36085017007,"Census Tract 170.07, Richmond County, New York",1825,39,1786,279,577,37841,1996,2009,998,40.9,95,212,0,37,30,1786,206
2015,36085017007,"Census Tract 170.07, Richmond County, New York",1902,64,1838,325,834,44023,2001,2011,1033,29,92,164,0,49,112,1838,152
2016,36085017007,"Census Tract 170.07, Richmond County, New York",1908,96,1812,355,930,43821,1993,2011,1255,28.8,107,199,0,37,119,1812,182
2017,36085017007,"Census Tract 170.07, Richmond County, New York",1914,140,1774,267,665,43346,2000,2012,1146,28.5,87,181,0,0,86,1774,153
2018,36085017007,"Census Tract 170.07, Richmond County, New York",1959,146,1813,276,671,46282,2000,2012,1182,28,81,183,0,0,93,1813,88
2019,36085017007,"Census Tract 170.07, Richmond County, New York",1962,129,1833,223,441,45184,2002,2013,1196,24.7,20,144,0,0,79,1833,108
2020,36085017007,"Census Tract 170.07, Richmond County, New York",1950,84,1866,184,315,NA,1995,2016,1384,24.9,25,163,0,0,15,1866,177
2012,36085017008,"Census Tract 170.08, Richmond County, New York",2710,78,2632,331,705,54609,1979,2006,1332,25.8,90,281,0,0,50,2632,82
2013,36085017008,"Census Tract 170.08, Richmond County, New York",2698,75,2623,254,466,34844,1978,2006,1080,18.8,64,207,0,0,47,2623,118
2014,36085017008,"Census Tract 170.08, Richmond County, New York",2680,116,2564,213,444,65703,1981,2006,1358,20.5,55,160,0,0,53,2564,149
2015,36085017008,"Census Tract 170.08, Richmond County, New York",2689,100,2589,239,445,55625,1983,2009,1258,21.8,92,168,0,0,71,2589,114
2016,36085017008,"Census Tract 170.08, Richmond County, New York",2696,133,2563,179,247,52891,1985,2008,968,24.6,62,151,0,0,28,2563,178
2017,36085017008,"Census Tract 170.08, Richmond County, New York",2694,143,2551,150,215,42315,1988,2007,1113,25.4,62,132,0,0,18,2551,223
2018,36085017008,"Census Tract 170.08, Richmond County, New York",2715,160,2555,211,311,55329,1984,2010,1325,24.3,96,192,0,0,19,2555,176
2019,36085017008,"Census Tract 170.08, Richmond County, New York",2692,166,2526,238,648,NA,1983,2014,1381,20.5,182,203,0,0,35,2526,178
2012,36085017009,"Census Tract 170.09, Richmond County, New York",1646,129,1517,390,845,58889,1980,2005,1178,22.5,103,339,0,0,51,1517,27
2013,36085017009,"Census Tract 170.09, Richmond County, New York",1648,124,1524,331,692,54698,1982,2005,1155,21.3,95,271,0,0,60,1524,40
2014,36085017009,"Census Tract 170.09, Richmond County, New York",1666,81,1585,384,738,54554,1983,2007,1240,23.8,179,332,0,0,52,1585,61
2015,36085017009,"Census Tract 170.09, Richmond County, New York",1674,40,1634,370,611,54956,1984,2008,1179,22.4,182,316,0,0,54,1634,100
2016,36085017009,"Census Tract 170.09, Richmond County, New York",1695,94,1601,297,539,74205,1983,2010,1182,18.2,148,233,0,0,64,1601,90
2017,36085017009,"Census Tract 170.09, Richmond County, New York",1691,103,1588,316,632,102697,1983,2012,1364,19.8,188,243,0,0,73,1588,81
2018,36085017009,"Census Tract 170.09, Richmond County, New York",1680,104,1576,312,666,67375,1981,2013,1384,25.3,162,273,0,0,39,1576,86
2019,36085017009,"Census Tract 170.09, Richmond County, New York",1663,105,1558,301,525,58918,1981,2014,1365,26.5,108,282,0,0,19,1558,55
2020,36085017009,"Census Tract 170.09, Richmond County, New York",1666,78,1588,389,770,46880,1988,2014,2065,31,124,369,0,0,20,1588,39
2012,36085017010,"Census Tract 170.10, Richmond County, New York",3089,101,2988,292,703,78846,1982,2005,1353,23.1,131,254,38,0,38,2988,220
2013,36085017010,"Census Tract 170.10, Richmond County, New York",3067,140,2927,234,625,81200,1983,2005,1367,22,118,234,0,0,0,2927,228
2014,36085017010,"Census Tract 170.10, Richmond County, New York",3066,41,3025,191,594,56902,1979,2006,1466,25.8,65,168,0,0,23,3025,156
2015,36085017010,"Census Tract 170.10, Richmond County, New York",3116,41,3075,280,689,55109,1979,2010,1322,38.2,42,222,0,0,58,3075,253
2016,36085017010,"Census Tract 170.10, Richmond County, New York",3155,36,3119,353,785,56607,1981,2012,1148,35.5,90,214,0,0,139,3119,287
2017,36085017010,"Census Tract 170.10, Richmond County, New York",3167,32,3135,332,680,55333,1982,2013,1065,35.7,46,170,0,0,162,3135,318
2018,36085017010,"Census Tract 170.10, Richmond County, New York",3201,25,3176,338,697,68137,1981,2014,1138,30.4,53,159,0,0,179,3176,280
2019,36085017010,"Census Tract 170.10, Richmond County, New York",3191,54,3137,384,779,70231,1979,2014,1149,32.3,100,193,0,0,191,3137,276
2012,36085017011,"Census Tract 170.11, Richmond County, New York",1761,23,1738,381,923,47287,1986,2005,1447,30.3,33,286,0,0,95,1738,109
2013,36085017011,"Census Tract 170.11, Richmond County, New York",1806,32,1774,435,1022,49821,1983,2005,1434,30.3,41,344,0,0,91,1774,154
2014,36085017011,"Census Tract 170.11, Richmond County, New York",1817,85,1732,458,972,55688,1980,2004,1335,23,42,417,0,0,41,1732,155
2015,36085017011,"Census Tract 170.11, Richmond County, New York",1815,91,1724,408,873,55291,1977,2004,1208,23.1,59,362,0,0,46,1724,108
2016,36085017011,"Census Tract 170.11, Richmond County, New York",1809,97,1712,416,849,53700,1979,2006,1134,24.4,48,358,0,0,58,1712,133
2017,36085017011,"Census Tract 170.11, Richmond County, New York",1828,97,1731,332,639,53500,1980,2007,1225,27.5,58,288,0,0,44,1731,122
2018,36085017011,"Census Tract 170.11, Richmond County, New York",1849,105,1744,370,775,53529,1981,2011,1204,24.1,57,289,0,0,72,1744,104
2019,36085017011,"Census Tract 170.11, Richmond County, New York",1854,65,1789,363,764,51027,1981,2015,1324,24.5,84,241,0,0,113,1789,128
2020,36085017011,"Census Tract 170.11, Richmond County, New York",1783,66,1717,317,675,44107,1984,2015,1393,29.6,70,203,0,0,103,1717,215
2012,36085017012,"Census Tract 170.12, Richmond County, New York",1752,61,1691,373,696,37755,1974,2006,1170,26.4,103,285,37,0,0,1691,185
2013,36085017012,"Census Tract 170.12, Richmond County, New York",1751,83,1668,432,781,40266,1975,2006,1201,25.2,114,338,35,0,15,1668,193
2014,36085017012,"Census Tract 170.12, Richmond County, New York",1757,118,1639,403,780,40304,1975,2007,1349,19.2,127,303,30,0,25,1639,174
2015,36085017012,"Census Tract 170.12, Richmond County, New York",1748,89,1659,378,872,NA,1981,2011,1364,18.2,118,265,30,0,53,1659,156
2016,36085017012,"Census Tract 170.12, Richmond County, New York",1759,129,1630,289,643,61250,1988,2011,1293,19,117,243,0,0,46,1630,154
2017,36085017012,"Census Tract 170.12, Richmond County, New York",1797,122,1675,323,668,NA,1989,2011,1226,19.7,118,256,0,0,67,1675,191
2018,36085017012,"Census Tract 170.12, Richmond County, New York",1764,106,1658,324,743,NA,1988,2012,1051,19.5,146,247,0,0,77,1658,231
2019,36085017012,"Census Tract 170.12, Richmond County, New York",1767,86,1681,377,752,60750,1986,2012,995,18,210,265,0,7,105,1681,223
2020,36085017012,"Census Tract 170.12, Richmond County, New York",1687,108,1579,320,504,58438,1980,2013,1438,28.7,172,237,0,7,76,1579,212
2020,36085017013,"Census Tract 170.13, Richmond County, New York",1554,48,1506,185,333,NA,NA,NA,NA,NA,28,185,0,0,0,1506,112
2020,36085017014,"Census Tract 170.14, Richmond County, New York",1636,0,1636,381,671,92878,1982,2013,1128,20.6,170,275,0,0,106,1636,68
2020,36085017015,"Census Tract 170.15, Richmond County, New York",1080,128,952,132,285,NA,1982,2008,1426,22.3,64,122,0,0,10,952,81
2020,36085017016,"Census Tract 170.16, Richmond County, New York",1508,66,1442,110,248,NA,NA,NA,NA,NA,110,110,0,0,0,1442,75
2012,36085017300,"Census Tract 173, Richmond County, New York",968,68,900,561,1165,25208,1954,2002,601,29.7,34,149,254,28,137,900,232
2013,36085017300,"Census Tract 173, Richmond County, New York",969,67,902,571,1313,17614,1954,2003,610,28.2,23,169,223,47,139,902,233
2014,36085017300,"Census Tract 173, Richmond County, New York",988,44,944,598,1332,25076,1956,2003,622,26.7,14,163,202,45,202,944,210
2015,36085017300,"Census Tract 173, Richmond County, New York",998,51,947,640,1472,19250,1956,2005,629,28.5,63,190,224,45,162,947,242
2016,36085017300,"Census Tract 173, Richmond County, New York",1020,36,984,628,1377,15305,1958,2005,480,30.9,61,177,199,47,180,984,296
2017,36085017300,"Census Tract 173, Richmond County, New York",1009,23,986,624,1384,16020,1958,2006,487,31.7,64,179,210,49,184,986,297
2018,36085017300,"Census Tract 173, Richmond County, New York",1006,61,945,626,1285,14933,1958,2006,517,33.6,69,161,209,39,210,945,324
2019,36085017300,"Census Tract 173, Richmond County, New York",1007,50,957,611,1269,18231,1957,2007,472,31.8,100,144,211,57,199,957,287
2020,36085017300,"Census Tract 173, Richmond County, New York",1015,47,968,584,1156,23393,1956,2008,405,29.5,84,146,132,45,258,968,222
2012,36085017600,"Census Tract 176, Richmond County, New York",1702,105,1597,253,574,55208,1983,2005,1042,23.8,29,216,0,7,30,1597,116
2013,36085017600,"Census Tract 176, Richmond County, New York",1678,100,1578,237,554,52788,1981,2005,971,22.8,31,220,0,7,10,1578,103
2014,36085017600,"Census Tract 176, Richmond County, New York",1706,105,1601,236,558,54464,1979,2006,1093,22.8,33,217,0,13,6,1601,109
2015,36085017600,"Census Tract 176, Richmond County, New York",1733,111,1622,234,582,49902,1986,2010,1077,24.4,37,202,12,8,12,1622,71
2016,36085017600,"Census Tract 176, Richmond County, New York",1744,115,1629,241,599,53309,1990,2010,1123,31.1,52,212,11,7,11,1629,68
2017,36085017600,"Census Tract 176, Richmond County, New York",1737,119,1618,232,559,49357,1992,2011,1379,33.6,55,203,10,9,10,1618,50
2018,36085017600,"Census Tract 176, Richmond County, New York",1796,139,1657,244,516,43952,1992,2011,1420,34.8,53,220,13,11,0,1657,97
2019,36085017600,"Census Tract 176, Richmond County, New York",1780,87,1693,261,499,51520,1992,2012,1595,31.9,33,250,11,0,0,1693,90
2020,36085017600,"Census Tract 176, Richmond County, New York",1658,102,1556,178,257,47188,1992,2012,1473,31.2,21,178,0,0,0,1556,77
2012,36085017700,"Census Tract 177, Richmond County, New York",2478,104,2374,217,462,93601,1955,2005,1557,24,76,131,33,19,34,2374,134
2013,36085017700,"Census Tract 177, Richmond County, New York",2492,54,2438,267,618,95647,1960,2005,1695,35.9,90,183,33,17,34,2438,138
2014,36085017700,"Census Tract 177, Richmond County, New York",2457,101,2356,271,548,84141,1961,2005,1717,35.6,107,255,0,0,16,2356,90
2015,36085017700,"Census Tract 177, Richmond County, New York",2502,87,2415,302,676,77031,1960,2005,1656,36.1,92,276,0,17,9,2415,82
2016,36085017700,"Census Tract 177, Richmond County, New York",2461,75,2386,329,827,NA,1969,2007,1433,26.5,62,282,0,18,11,2386,95
2017,36085017700,"Census Tract 177, Richmond County, New York",2474,241,2233,307,778,48277,1968,2012,1589,34.8,62,207,0,23,52,2233,69
2018,36085017700,"Census Tract 177, Richmond County, New York",2480,325,2155,310,658,46932,1965,2015,1414,32.3,80,205,0,22,52,2155,30
2019,36085017700,"Census Tract 177, Richmond County, New York",2465,340,2125,266,609,49545,1966,2016,1473,36.3,52,152,0,22,60,2125,45
2020,36085017701,"Census Tract 177.01, Richmond County, New York",1492,187,1305,133,284,64743,1969,2015,1488,36.2,72,104,0,0,0,1305,33
2020,36085017702,"Census Tract 177.02, Richmond County, New York",1062,118,944,146,311,50294,1967,2017,1662,35.7,13,78,0,0,68,944,39
2012,36085018100,"Census Tract 181, Richmond County, New York",1059,46,1013,223,425,17455,1982,1999,854,31.5,33,166,5,10,42,1013,92
2013,36085018100,"Census Tract 181, Richmond County, New York",1038,51,987,204,304,14605,1990,2000,293,30.3,37,156,6,22,20,987,124
2014,36085018100,"Census Tract 181, Richmond County, New York",1060,38,1022,207,345,17679,1991,2003,946,29.6,37,152,5,22,20,1022,108
2015,36085018100,"Census Tract 181, Richmond County, New York",1084,36,1048,220,357,16538,1992,2006,NA,29.5,62,157,5,18,30,1048,165
2016,36085018100,"Census Tract 181, Richmond County, New York",1100,50,1050,193,334,15781,1994,2006,1016,33.1,46,133,0,18,34,1050,143
2017,36085018100,"Census Tract 181, Richmond County, New York",1117,59,1058,231,395,12417,1994,2010,NA,30.2,52,164,0,21,26,1058,185
2018,36085018100,"Census Tract 181, Richmond County, New York",1132,55,1077,235,387,18125,1994,2011,NA,29.7,60,181,0,11,24,1077,154
2019,36085018100,"Census Tract 181, Richmond County, New York",1137,118,1019,178,278,20455,1993,2012,377,28.3,42,156,0,0,11,1019,118
2020,36085018100,"Census Tract 181, Richmond County, New York",1365,103,1262,351,391,NA,1993,2015,861,51,21,181,16,32,113,1262,190
2012,36085018701,"Census Tract 187.01, Richmond County, New York",682,57,625,161,410,80114,1971,2005,1324,18.4,13,119,6,20,16,625,52
2013,36085018701,"Census Tract 187.01, Richmond County, New York",688,65,623,204,488,76923,1971,2005,1313,19.5,33,149,7,30,18,623,56
2014,36085018701,"Census Tract 187.01, Richmond County, New York",669,47,622,189,475,82813,1972,2005,1443,22.3,33,145,7,24,13,622,36
2015,36085018701,"Census Tract 187.01, Richmond County, New York",658,46,612,176,501,39583,1961,2006,1573,32.1,44,105,5,20,30,612,81
2016,36085018701,"Census Tract 187.01, Richmond County, New York",663,34,629,176,462,35909,1955,2007,1592,40.8,48,110,4,21,28,629,79
2017,36085018701,"Census Tract 187.01, Richmond County, New York",673,14,659,211,577,40114,1951,2008,1475,34,52,132,0,25,42,659,91
2018,36085018701,"Census Tract 187.01, Richmond County, New York",670,29,641,180,513,43500,1945,2010,1455,34.6,41,109,0,14,41,641,93
2019,36085018701,"Census Tract 187.01, Richmond County, New York",688,36,652,210,588,47917,1953,2011,1587,36.5,34,126,0,0,54,652,114
2020,36085018701,"Census Tract 187.01, Richmond County, New York",643,15,628,166,393,71875,1947,2013,1620,30.7,37,131,0,0,29,628,68
2012,36085018702,"Census Tract 187.02, Richmond County, New York",2413,295,2118,757,2020,37105,1965,2005,1167,35.4,130,332,11,77,337,2118,216
2013,36085018702,"Census Tract 187.02, Richmond County, New York",2447,178,2269,909,2266,42113,1971,2005,1071,27.6,170,415,57,84,353,2269,278
2014,36085018702,"Census Tract 187.02, Richmond County, New York",2404,167,2237,867,2173,53125,1969,2006,964,23.5,124,373,49,90,355,2237,225
2015,36085018702,"Census Tract 187.02, Richmond County, New York",2468,149,2319,877,1944,57898,1966,2007,961,22.7,185,379,45,146,307,2319,115
2016,36085018702,"Census Tract 187.02, Richmond County, New York",2440,118,2322,810,1908,56513,1967,2008,967,22.5,225,326,40,215,229,2322,220
2017,36085018702,"Census Tract 187.02, Richmond County, New York",2408,101,2307,694,1961,81579,1967,2011,1257,18.1,222,329,45,194,126,2307,226
2018,36085018702,"Census Tract 187.02, Richmond County, New York",2391,129,2262,601,1643,80353,1971,2011,1403,21.9,265,266,0,233,102,2262,177
2019,36085018702,"Census Tract 187.02, Richmond County, New York",2413,79,2334,541,1338,82951,1972,2012,1371,23.5,251,250,51,139,101,2334,207
2020,36085018703,"Census Tract 187.03, Richmond County, New York",1273,0,1273,401,1478,121083,1966,2013,1776,23.1,260,104,0,152,145,1273,121
2020,36085018704,"Census Tract 187.04, Richmond County, New York",1258,82,1176,334,549,NA,1976,2009,NA,28.2,66,160,55,80,39,1176,160
2012,36085018901,"Census Tract 189.01, Richmond County, New York",2104,92,2012,444,945,55769,1966,2005,1101,28.5,74,386,0,39,19,2012,155
2013,36085018901,"Census Tract 189.01, Richmond County, New York",2084,43,2041,453,1029,29883,1964,2005,1169,38.3,75,325,19,45,64,2041,235
2014,36085018901,"Census Tract 189.01, Richmond County, New York",2098,49,2049,423,983,52989,1960,2006,1143,29,84,285,22,42,74,2049,181
2015,36085018901,"Census Tract 189.01, Richmond County, New York",2092,104,1988,519,1228,54464,1963,2008,1130,28.6,76,339,21,96,63,1988,304
2016,36085018901,"Census Tract 189.01, Richmond County, New York",2115,81,2034,534,1409,50909,1958,2009,1157,28.9,75,328,32,112,78,2034,415
2017,36085018901,"Census Tract 189.01, Richmond County, New York",2126,170,1956,508,1381,NA,1971,2010,1145,24.9,42,310,31,120,64,1956,415
2018,36085018901,"Census Tract 189.01, Richmond County, New York",2122,169,1953,520,1276,NA,1970,2011,1297,22.5,78,365,40,115,40,1953,346
2019,36085018901,"Census Tract 189.01, Richmond County, New York",2057,216,1841,508,1144,31157,1959,2012,1167,24.4,83,388,30,90,30,1841,274
2020,36085018901,"Census Tract 189.01, Richmond County, New York",1857,258,1599,387,933,51250,1957,2014,1121,23.1,121,260,36,91,36,1599,146
2012,36085018902,"Census Tract 189.02, Richmond County, New York",1850,52,1798,437,1265,36434,1971,2004,1967,50,125,242,11,65,119,1798,78
2013,36085018902,"Census Tract 189.02, Richmond County, New York",1846,67,1779,454,1347,35985,1971,2004,1688,50,144,257,20,85,92,1779,105
2014,36085018902,"Census Tract 189.02, Richmond County, New York",1797,70,1727,370,1043,37179,1972,2007,1286,35.9,97,229,23,98,20,1727,112
2015,36085018902,"Census Tract 189.02, Richmond County, New York",1812,57,1755,426,1117,36944,1975,2010,1289,33,105,255,42,110,19,1755,184
2016,36085018902,"Census Tract 189.02, Richmond County, New York",1821,110,1711,408,995,34675,1976,2011,1489,37.7,128,192,75,106,28,1711,174
2017,36085018902,"Census Tract 189.02, Richmond County, New York",1838,74,1764,397,915,35332,1976,2012,1450,36,142,189,75,109,18,1764,225
2018,36085018902,"Census Tract 189.02, Richmond County, New York",1848,114,1734,387,1007,34468,1977,2013,1561,46.4,141,172,76,103,27,1734,220
2019,36085018902,"Census Tract 189.02, Richmond County, New York",1866,131,1735,404,1225,37276,1975,2014,1578,48.2,143,185,67,128,19,1735,183
2020,36085018902,"Census Tract 189.02, Richmond County, New York",1902,202,1700,300,927,38667,1973,2014,1560,51,103,157,27,56,57,1700,235
2012,36085019700,"Census Tract 197, Richmond County, New York",686,6,680,107,199,72011,1939,2004,1265,20.1,15,68,0,8,31,680,35
2013,36085019700,"Census Tract 197, Richmond County, New York",715,11,704,134,244,78750,1939,2004,1271,19.7,26,102,0,10,22,704,24
2014,36085019700,"Census Tract 197, Richmond County, New York",715,12,703,113,171,67969,1958,2011,1161,42.1,50,73,0,0,40,703,63
2015,36085019700,"Census Tract 197, Richmond County, New York",723,11,712,106,160,NA,1958,2010,1176,43.9,43,69,0,0,37,712,61
2016,36085019700,"Census Tract 197, Richmond County, New York",730,18,712,99,154,68558,1968,2011,1384,40.2,57,59,0,0,40,712,45
2017,36085019700,"Census Tract 197, Richmond County, New York",729,37,692,99,185,NA,1963,2012,1635,41.7,43,67,0,0,32,692,62
2018,36085019700,"Census Tract 197, Richmond County, New York",729,31,698,89,161,70670,1984,NA,1750,41.8,40,61,0,0,28,698,71
2019,36085019700,"Census Tract 197, Richmond County, New York",717,31,686,90,159,NA,1981,2011,1239,27,10,90,0,0,0,686,76
2020,36085019700,"Census Tract 197, Richmond County, New York",748,46,702,107,189,43958,1981,2012,1332,29.6,29,100,7,0,0,702,72
2012,36085019800,"Census Tract 198, Richmond County, New York",2291,214,2077,397,915,76715,1967,2005,1654,22.9,102,328,0,0,69,2077,99
2013,36085019800,"Census Tract 198, Richmond County, New York",2322,190,2132,496,1139,76397,1971,2008,1625,27,96,416,0,0,65,2132,118
2014,36085019800,"Census Tract 198, Richmond County, New York",2358,197,2161,643,1547,78283,1976,2009,1636,28.1,186,562,0,0,64,2161,142
2015,36085019800,"Census Tract 198, Richmond County, New York",2365,165,2200,588,1411,76731,1976,2010,1563,24.9,170,548,0,0,27,2200,95
2016,36085019800,"Census Tract 198, Richmond County, New York",2413,194,2219,501,1143,64669,1979,2011,1259,26.6,127,471,0,0,17,2219,91
2017,36085019800,"Census Tract 198, Richmond County, New York",2429,197,2232,443,1017,57536,1980,2012,1383,27.6,99,407,0,0,20,2232,158
2018,36085019800,"Census Tract 198, Richmond County, New York",2458,195,2263,423,931,54179,1976,2013,1334,27.6,128,333,0,0,90,2263,188
2019,36085019800,"Census Tract 198, Richmond County, New York",2445,127,2318,331,483,NA,1987,2018,1295,35.1,57,267,0,0,64,2318,132
2020,36085019800,"Census Tract 198, Richmond County, New York",2489,113,2376,655,1182,NA,1976,2015,2917,51,280,513,0,0,142,2376,285
2012,36085020100,"Census Tract 201, Richmond County, New York",1297,125,1172,279,801,65341,1946,2003,1295,24.1,78,187,10,40,42,1172,110
2013,36085020100,"Census Tract 201, Richmond County, New York",1351,120,1231,318,895,52143,1956,2006,1230,24.9,73,148,54,42,74,1231,144
2014,36085020100,"Census Tract 201, Richmond County, New York",1353,62,1291,377,1042,51576,1955,2009,1381,26.2,62,171,65,41,100,1291,197
2015,36085020100,"Census Tract 201, Richmond County, New York",1337,74,1263,375,952,50966,1953,2011,1315,24.5,73,182,77,48,68,1263,220
2016,36085020100,"Census Tract 201, Richmond County, New York",1354,34,1320,417,860,50580,1954,2011,1286,28.8,64,196,127,29,75,1320,184
2017,36085020100,"Census Tract 201, Richmond County, New York",1357,57,1300,445,982,50508,1962,2011,1185,29.4,38,199,143,0,112,1300,186
2018,36085020100,"Census Tract 201, Richmond County, New York",1327,91,1236,394,992,50294,0,2011,1349,34.4,51,177,104,0,124,1236,145
2019,36085020100,"Census Tract 201, Richmond County, New York",1303,92,1211,413,1172,50605,1951,2012,1481,37,75,147,71,26,179,1211,81
2020,36085020100,"Census Tract 201, Richmond County, New York",1343,65,1278,488,1469,46429,1963,2013,1642,40.1,94,118,73,30,278,1278,117
2012,36085020700,"Census Tract 207, Richmond County, New York",2064,380,1684,1112,3939,26694,1947,2005,1166,43.7,67,145,369,21,547,1684,532
2013,36085020700,"Census Tract 207, Richmond County, New York",1983,393,1590,965,3163,25707,1947,2005,1114,44.1,72,125,315,0,530,1590,475
2014,36085020700,"Census Tract 207, Richmond County, New York",2035,359,1676,1011,3308,23245,1945,2007,1141,46,35,136,257,29,576,1676,578
2015,36085020700,"Census Tract 207, Richmond County, New York",2036,179,1857,1056,3371,21786,1950,2008,1139,47.8,47,107,316,19,590,1857,665
2016,36085020700,"Census Tract 207, Richmond County, New York",2008,183,1825,1023,2975,21004,1947,2009,1142,49,20,81,272,28,639,1825,733
2017,36085020700,"Census Tract 207, Richmond County, New York",2033,246,1787,972,2631,16364,1939,2010,1159,50,51,104,236,21,596,1787,690
2018,36085020700,"Census Tract 207, Richmond County, New York",2108,266,1842,949,2434,15360,0,2011,1175,47.5,63,135,232,16,554,1842,654
2019,36085020700,"Census Tract 207, Richmond County, New York",2214,382,1832,976,2646,15893,0,2011,1184,48.1,69,126,265,0,572,1832,667
2020,36085020701,"Census Tract 207.01, Richmond County, New York",1105,151,954,414,952,40587,0,2018,1261,38.5,96,13,190,0,211,954,146
2020,36085020702,"Census Tract 207.02, Richmond County, New York",1105,229,876,519,1080,NA,0,2013,899,51,26,74,56,0,389,876,374
2012,36085020801,"Census Tract 208.01, Richmond County, New York",3178,82,3096,506,963,50172,1986,2005,1221,23,169,478,28,0,0,3096,349
2013,36085020801,"Census Tract 208.01, Richmond County, New York",3226,101,3125,496,965,53083,1985,2005,1253,21.5,180,465,31,0,0,3125,313
2014,36085020801,"Census Tract 208.01, Richmond County, New York",3297,51,3246,683,1752,33021,1987,2006,1238,21.3,260,583,38,0,62,3246,487
2015,36085020801,"Census Tract 208.01, Richmond County, New York",3280,49,3231,617,1506,NA,1989,2007,1187,22.3,216,493,33,11,80,3231,526
2016,36085020801,"Census Tract 208.01, Richmond County, New York",3313,63,3250,444,1195,NA,1989,2010,1608,22.1,149,353,0,13,78,3250,461
2017,36085020801,"Census Tract 208.01, Richmond County, New York",3321,77,3244,398,1190,NA,1990,2011,1648,19.1,137,296,0,17,85,3244,333
2018,36085020801,"Census Tract 208.01, Richmond County, New York",3346,63,3283,571,1660,NA,1992,2012,1729,26,157,461,0,17,93,3283,480
2019,36085020801,"Census Tract 208.01, Richmond County, New York",3316,86,3230,479,1114,99671,1990,2015,1604,23.4,188,436,0,19,24,3230,355
2012,36085020803,"Census Tract 208.03, Richmond County, New York",2145,106,2039,534,1280,50094,1989,2004,1175,24.6,155,435,0,0,99,2039,92
2013,36085020803,"Census Tract 208.03, Richmond County, New York",2249,102,2147,583,1243,35950,1987,2007,1196,24.6,216,416,0,17,150,2147,172
2014,36085020803,"Census Tract 208.03, Richmond County, New York",2370,121,2249,598,1418,34643,1988,2008,1192,36.8,277,406,0,17,175,2249,211
2015,36085020803,"Census Tract 208.03, Richmond County, New York",2349,169,2180,521,1309,NA,1988,2011,1176,35.9,264,363,0,13,145,2180,175
2016,36085020803,"Census Tract 208.03, Richmond County, New York",2336,139,2197,356,994,NA,1986,2012,1232,37.1,198,258,0,13,85,2197,167
2017,36085020803,"Census Tract 208.03, Richmond County, New York",2414,67,2347,287,657,NA,1985,2012,1155,37.5,193,196,0,13,78,2347,227
2018,36085020803,"Census Tract 208.03, Richmond County, New York",2448,78,2370,232,692,NA,1987,2011,1145,24,129,232,0,0,0,2370,198
2019,36085020803,"Census Tract 208.03, Richmond County, New York",2482,41,2441,197,437,136620,1981,2009,1083,15.2,80,197,0,0,0,2441,231
2020,36085020803,"Census Tract 208.03, Richmond County, New York",2502,14,2488,285,873,156270,1987,2015,NA,18.8,151,285,0,0,0,2488,260
2012,36085020804,"Census Tract 208.04, Richmond County, New York",1902,92,1810,208,511,69706,1979,2004,1178,29.6,8,181,0,27,0,1810,150
2013,36085020804,"Census Tract 208.04, Richmond County, New York",1921,46,1875,255,560,70711,1981,2004,1145,28.4,25,220,0,23,12,1875,185
2014,36085020804,"Census Tract 208.04, Richmond County, New York",1944,104,1840,219,529,73031,1983,2004,1180,27,36,182,0,26,11,1840,163
2015,36085020804,"Census Tract 208.04, Richmond County, New York",1977,102,1875,204,419,73232,1977,2005,1231,27.3,66,185,0,8,11,1875,166
2016,36085020804,"Census Tract 208.04, Richmond County, New York",2055,67,1988,179,325,76250,1978,2009,1175,17.5,100,159,0,9,11,1988,114
2017,36085020804,"Census Tract 208.04, Richmond County, New York",2058,63,1995,208,415,78056,1977,2011,1243,23.8,95,188,0,9,11,1995,62
2018,36085020804,"Census Tract 208.04, Richmond County, New York",2073,63,2010,233,415,NA,1979,2013,1181,37.4,95,197,0,8,28,2010,63
2019,36085020804,"Census Tract 208.04, Richmond County, New York",2065,7,2058,244,449,43611,1982,2014,1422,39.9,82,211,0,7,26,2058,49
2020,36085020804,"Census Tract 208.04, Richmond County, New York",2101,7,2094,338,783,52727,1984,2015,1496,43.6,151,239,0,8,91,2094,52
2020,36085020805,"Census Tract 208.05, Richmond County, New York",2422,79,2343,220,644,118364,1988,2016,2500,22.1,49,220,0,0,0,2343,94
2020,36085020806,"Census Tract 208.06, Richmond County, New York",853,0,853,229,424,NA,1992,2013,NA,25.8,161,229,0,0,0,853,118
2012,36085021300,"Census Tract 213, Richmond County, New York",1803,161,1642,599,1861,21649,1939,2004,1480,50,107,103,143,17,336,1642,407
2013,36085021300,"Census Tract 213, Richmond County, New York",1774,137,1637,657,1976,26227,1939,2005,994,50,86,150,129,34,289,1637,466
2014,36085021300,"Census Tract 213, Richmond County, New York",1773,171,1602,559,1663,25110,1939,2005,992,50,70,158,94,17,231,1602,425
2015,36085021300,"Census Tract 213, Richmond County, New York",1737,219,1518,520,1740,34267,1939,2006,987,40.9,20,162,40,10,247,1518,339
2016,36085021300,"Census Tract 213, Richmond County, New York",1732,261,1471,611,1962,33036,1939,2008,1150,37.1,41,223,52,10,253,1471,357
2017,36085021300,"Census Tract 213, Richmond County, New York",1747,181,1566,626,2119,36837,1939,2008,1300,34.9,49,190,47,8,294,1566,301
2018,36085021300,"Census Tract 213, Richmond County, New York",1758,221,1537,563,1923,40938,0,2011,1549,37.7,73,183,111,4,293,1537,253
2019,36085021300,"Census Tract 213, Richmond County, New York",1741,250,1491,627,1967,41681,0,2012,1605,35.6,100,206,207,9,236,1491,203
2020,36085021300,"Census Tract 213, Richmond County, New York",1656,165,1491,680,2232,53531,0,2015,1540,28.3,101,211,280,0,218,1491,151
2012,36085022300,"Census Tract 223, Richmond County, New York",1014,213,801,199,761,30917,1939,NA,1578,50,3,8,59,0,132,801,87
2013,36085022300,"Census Tract 223, Richmond County, New York",985,223,762,206,835,30568,1939,2006,1504,50,13,39,58,0,109,762,86
2014,36085022300,"Census Tract 223, Richmond County, New York",1002,196,806,214,703,27500,1939,2007,1228,50,10,28,67,0,124,806,99
2015,36085022300,"Census Tract 223, Richmond County, New York",984,144,840,251,748,32292,1939,2010,1185,46.5,9,47,90,0,143,840,133
2016,36085022300,"Census Tract 223, Richmond County, New York",1014,153,861,250,728,38636,1939,2011,1152,41,7,68,77,0,132,861,151
2017,36085022300,"Census Tract 223, Richmond County, New York",1024,163,861,243,751,40046,1939,2012,1125,50,40,54,89,0,120,861,149
2018,36085022300,"Census Tract 223, Richmond County, New York",992,168,824,248,739,32692,0,2013,1208,51,43,36,114,0,117,824,153
2019,36085022300,"Census Tract 223, Richmond County, New York",1012,175,837,259,817,40083,0,2013,1280,51,68,42,109,0,128,837,209
2020,36085022300,"Census Tract 223, Richmond County, New York",1104,163,941,241,834,22241,0,2015,1373,51,100,24,102,0,122,941,182
2012,36085022600,"Census Tract 226, Richmond County, New York",2781,194,2587,592,1765,57368,1999,2006,1231,31.7,150,438,17,0,137,2587,227
2013,36085022600,"Census Tract 226, Richmond County, New York",2741,97,2644,600,1611,56111,1998,2007,1238,31.9,193,449,0,0,151,2644,189
2014,36085022600,"Census Tract 226, Richmond County, New York",2823,90,2733,520,1367,52614,1997,2009,1195,30.5,168,348,0,18,154,2733,167
2015,36085022600,"Census Tract 226, Richmond County, New York",2868,135,2733,525,1410,53098,1997,2010,1230,31.1,129,317,0,24,184,2733,67
2016,36085022600,"Census Tract 226, Richmond County, New York",2926,125,2801,566,1542,67069,1995,2011,1302,27.1,200,249,0,39,278,2801,83
2017,36085022600,"Census Tract 226, Richmond County, New York",2923,138,2785,455,868,66631,1996,2014,1342,23.3,211,268,0,33,154,2785,162
2018,36085022600,"Census Tract 226, Richmond County, New York",2983,121,2862,441,915,73108,1997,2015,1330,21.6,235,223,0,27,191,2862,150
2019,36085022600,"Census Tract 226, Richmond County, New York",2936,202,2734,532,1357,74717,1999,2014,1425,20.4,225,377,0,0,155,2734,112
2020,36085022601,"Census Tract 226.01, Richmond County, New York",2482,99,2383,452,984,72045,1999,2015,1406,21.2,157,314,0,0,138,2383,216
2020,36085022602,"Census Tract 226.02, Richmond County, New York",746,70,676,368,685,NA,1976,2012,NA,32.1,62,368,0,0,0,676,335
2012,36085022800,"Census Tract 228, Richmond County, New York",98,42,56,4,11,NA,NA,2011,2001,NA,4,4,0,0,0,56,0
2013,36085022800,"Census Tract 228, Richmond County, New York",113,41,72,20,41,NA,NA,NA,NA,NA,5,20,0,0,0,72,0
2014,36085022800,"Census Tract 228, Richmond County, New York",74,0,74,18,40,NA,NA,NA,NA,NA,5,18,0,0,0,74,0
2015,36085022800,"Census Tract 228, Richmond County, New York",17,0,17,17,39,NA,NA,NA,NA,NA,4,17,0,0,0,17,0
2016,36085022800,"Census Tract 228, Richmond County, New York",19,0,19,19,41,NA,NA,NA,NA,NA,4,19,0,0,0,19,0
2017,36085022800,"Census Tract 228, Richmond County, New York",14,0,14,14,27,NA,NA,NA,NA,NA,0,14,0,0,0,14,0
2018,36085022800,"Census Tract 228, Richmond County, New York",4,0,4,4,12,NA,NA,NA,NA,NA,4,4,0,0,0,4,0
2019,36085022800,"Census Tract 228, Richmond County, New York",9,0,9,9,23,NA,NA,NA,NA,NA,9,9,0,0,0,9,0
2020,36085022801,"Census Tract 228.01, Richmond County, New York",10,0,10,10,24,NA,NA,NA,NA,NA,10,10,0,0,0,10,0
2020,36085022802,"Census Tract 228.02, Richmond County, New York",0,0,0,0,0,NA,NA,NA,NA,NA,0,0,0,0,0,0,0
2012,36085023100,"Census Tract 231, Richmond County, New York",1522,166,1356,371,997,27991,1977,2006,1342,42.9,28,63,112,43,178,1356,194
2013,36085023100,"Census Tract 231, Richmond County, New York",1500,184,1316,388,1033,28448,1979,2007,1164,35.6,34,103,147,33,120,1316,241
2014,36085023100,"Census Tract 231, Richmond County, New York",1461,183,1278,317,866,21546,1974,2010,1363,50,55,106,85,31,106,1278,291
2015,36085023100,"Census Tract 231, Richmond County, New York",1470,180,1290,340,1094,NA,1975,2010,1555,50,58,63,106,56,118,1290,261
2016,36085023100,"Census Tract 231, Richmond County, New York",1425,165,1260,353,1360,54188,1991,2011,1606,36.6,64,40,113,52,148,1260,278
2017,36085023100,"Census Tract 231, Richmond County, New York",1476,126,1350,431,1766,69141,1992,2011,1652,36.3,75,51,123,36,221,1350,331
2018,36085023100,"Census Tract 231, Richmond County, New York",1489,107,1382,404,1638,80174,1994,2012,1660,24.4,96,74,86,42,202,1382,320
2019,36085023100,"Census Tract 231, Richmond County, New York",1497,133,1364,459,1984,76292,1997,2012,1828,40.2,65,78,153,38,190,1364,208
2020,36085023100,"Census Tract 231, Richmond County, New York",1584,149,1435,603,2245,76005,2001,2015,1869,30.9,80,147,169,4,283,1435,188
2012,36085023900,"Census Tract 239, Richmond County, New York",1173,192,981,201,504,28992,1939,2008,1167,47.2,37,52,48,0,89,981,143
2013,36085023900,"Census Tract 239, Richmond County, New York",1173,173,1000,287,754,29250,1939,2011,1226,47.7,92,64,71,0,142,1000,182
2014,36085023900,"Census Tract 239, Richmond County, New York",1172,145,1027,286,854,11375,1939,2011,914,50,72,48,46,0,183,1027,255
2015,36085023900,"Census Tract 239, Richmond County, New York",1163,181,982,362,1123,13333,1947,2012,935,50,105,63,58,3,232,982,234
2016,36085023900,"Census Tract 239, Richmond County, New York",1164,149,1015,392,1309,21518,1980,2012,1000,50,115,92,54,3,246,1015,239
2017,36085023900,"Census Tract 239, Richmond County, New York",1189,179,1010,361,1145,NA,1982,2011,988,50,119,117,54,2,190,1010,216
2018,36085023900,"Census Tract 239, Richmond County, New York",1183,212,971,358,1194,25000,1974,2011,1023,51,55,120,34,3,204,971,199
2019,36085023900,"Census Tract 239, Richmond County, New York",1203,211,992,334,1149,35119,1946,2011,1208,51,31,116,25,4,193,992,133
2020,36085023900,"Census Tract 239, Richmond County, New York",1186,178,1008,276,1010,38958,1950,2012,1173,51,72,131,42,0,103,1008,127
2012,36085024401,"Census Tract 244.01, Richmond County, New York",2090,125,1965,346,988,36923,1991,2002,1527,31.2,95,330,0,0,16,1965,112
2013,36085024401,"Census Tract 244.01, Richmond County, New York",2113,113,2000,380,1006,28750,1995,2005,1446,42.5,84,317,0,0,63,2000,172
2014,36085024401,"Census Tract 244.01, Richmond County, New York",2136,123,2013,336,767,21957,1993,2002,1402,50,95,275,0,0,61,2013,177
2015,36085024401,"Census Tract 244.01, Richmond County, New York",2157,34,2123,448,1018,NA,1992,2010,1330,50,135,374,0,0,74,2123,192
2016,36085024401,"Census Tract 244.01, Richmond County, New York",2116,30,2086,509,851,35742,1994,2014,1144,44.2,190,401,0,0,70,2086,213
2017,36085024401,"Census Tract 244.01, Richmond County, New York",2138,16,2122,487,849,48385,1995,2016,1143,31.9,172,324,0,0,149,2122,169
2018,36085024401,"Census Tract 244.01, Richmond County, New York",2162,64,2098,464,847,49308,1988,2015,1178,30.2,182,367,0,0,86,2098,193
2019,36085024401,"Census Tract 244.01, Richmond County, New York",2158,47,2111,474,878,52222,1986,2015,1202,24.6,177,352,0,0,85,2111,133
2020,36085024401,"Census Tract 244.01, Richmond County, New York",1966,64,1902,418,829,51695,1986,2016,1346,30.7,107,278,0,0,92,1902,119
2012,36085024402,"Census Tract 244.02, Richmond County, New York",1646,213,1433,140,389,53963,1989,2005,1603,43.1,0,131,0,0,9,1433,32
2013,36085024402,"Census Tract 244.02, Richmond County, New York",1690,262,1428,215,558,54238,1993,2005,1576,32,46,195,0,9,11,1428,43
2014,36085024402,"Census Tract 244.02, Richmond County, New York",1678,197,1481,234,549,51759,1990,2006,1213,30.5,78,210,0,11,13,1481,80
2015,36085024402,"Census Tract 244.02, Richmond County, New York",1677,177,1500,280,615,52010,1989,2008,1200,24.4,91,224,26,13,17,1500,103
2016,36085024402,"Census Tract 244.02, Richmond County, New York",1694,142,1552,334,734,53083,1991,2010,1289,28.6,112,268,30,17,19,1552,120
2017,36085024402,"Census Tract 244.02, Richmond County, New York",1740,124,1616,374,786,52992,1993,2012,1171,30.2,170,316,31,18,9,1616,116
2018,36085024402,"Census Tract 244.02, Richmond County, New York",1758,72,1686,345,662,55417,1989,2013,1159,28.7,158,279,33,9,24,1686,111
2019,36085024402,"Census Tract 244.02, Richmond County, New York",1758,73,1685,369,565,57614,1994,2014,1183,25.9,139,301,40,2,26,1685,83
2020,36085024402,"Census Tract 244.02, Richmond County, New York",1801,87,1714,339,583,70766,1994,2015,1182,26.4,99,297,0,2,40,1714,53
2012,36085024700,"Census Tract 247, Richmond County, New York",981,34,947,410,1074,56667,1964,2004,1091,23.9,128,113,217,23,57,947,199
2013,36085024700,"Census Tract 247, Richmond County, New York",995,52,943,442,1260,59250,1964,2005,1159,24.2,130,121,226,21,74,943,188
2014,36085024700,"Census Tract 247, Richmond County, New York",1043,52,991,456,1250,43182,1964,2006,1328,32.4,107,73,261,22,126,991,199
2015,36085024700,"Census Tract 247, Richmond County, New York",1024,69,955,424,1198,46048,1963,2006,1323,28.8,95,64,204,23,151,955,141
2016,36085024700,"Census Tract 247, Richmond County, New York",1058,77,981,436,1131,48621,1946,2007,1335,37.1,66,68,231,0,160,981,129
2017,36085024700,"Census Tract 247, Richmond County, New York",1051,39,1012,482,1287,46607,1962,2009,1332,38.4,64,58,202,7,238,1012,167
2018,36085024700,"Census Tract 247, Richmond County, New York",1049,70,979,494,1284,50000,1963,2011,1367,37.2,91,48,188,38,231,979,131
2019,36085024700,"Census Tract 247, Richmond County, New York",1059,85,974,506,1369,51413,1963,2013,1377,33.7,71,55,195,54,195,974,127
2020,36085024700,"Census Tract 247, Richmond County, New York",1039,88,951,410,1217,50870,1963,2014,1385,33.8,74,45,145,62,158,951,136
2012,36085024800,"Census Tract 248, Richmond County, New York",1727,90,1637,543,1563,53255,1940,2004,1288,31.8,127,481,0,0,62,1637,82
2013,36085024800,"Census Tract 248, Richmond County, New York",1731,97,1634,479,1350,43352,1939,2004,1272,33,115,435,0,0,44,1634,128
2014,36085024800,"Census Tract 248, Richmond County, New York",1724,98,1626,387,950,29844,1939,2003,1142,40.2,80,354,0,0,33,1626,149
2015,36085024800,"Census Tract 248, Richmond County, New York",1744,81,1663,436,879,38438,1973,2006,1158,34.4,126,373,0,0,63,1663,153
2016,36085024800,"Census Tract 248, Richmond County, New York",1794,116,1678,425,979,42697,1966,2007,1179,33.4,132,373,0,0,52,1678,154
2017,36085024800,"Census Tract 248, Richmond County, New York",1759,125,1634,422,997,50119,1990,2012,1228,29.8,151,334,0,23,65,1634,142
2018,36085024800,"Census Tract 248, Richmond County, New York",1794,91,1703,486,1242,41000,1988,2012,1399,37.7,171,361,0,22,103,1703,133
2019,36085024800,"Census Tract 248, Richmond County, New York",1803,95,1708,445,1082,53450,1968,2013,1492,30,194,311,0,19,115,1708,111
2020,36085024800,"Census Tract 248, Richmond County, New York",1740,73,1667,357,924,41454,1954,2013,1546,39.6,124,291,0,17,49,1667,122
2012,36085025100,"Census Tract 251, Richmond County, New York",2216,120,2096,300,768,43750,1970,2003,1302,32.8,34,268,0,8,24,2096,198
2013,36085025100,"Census Tract 251, Richmond County, New York",2187,133,2054,334,806,33958,1966,2003,1227,29.7,42,290,0,29,15,2054,217
2014,36085025100,"Census Tract 251, Richmond County, New York",2178,173,2005,260,509,75395,1957,2004,1575,29,62,251,0,9,0,2005,193
2015,36085025100,"Census Tract 251, Richmond County, New York",2208,161,2047,281,739,75840,1958,2010,1549,29.3,50,227,0,36,18,2047,133
2016,36085025100,"Census Tract 251, Richmond County, New York",2202,119,2083,310,817,75815,1958,2010,1558,29.2,45,256,0,37,17,2083,178
2017,36085025100,"Census Tract 251, Richmond County, New York",2221,88,2133,409,1014,78762,1960,2011,1618,28.4,113,352,0,38,19,2133,192
2018,36085025100,"Census Tract 251, Richmond County, New York",2262,107,2155,228,652,104875,1971,2012,1674,26.5,112,170,0,40,18,2155,82
2019,36085025100,"Census Tract 251, Richmond County, New York",2239,45,2194,196,599,106786,1972,2013,1714,19.4,104,117,0,42,37,2194,87
2020,36085025100,"Census Tract 251, Richmond County, New York",2196,89,2107,158,296,163125,1973,2017,1763,14.5,123,135,0,0,18,2107,42
2012,36085027301,"Census Tract 273.01, Richmond County, New York",1557,96,1461,272,582,50972,1984,2005,1122,26,98,195,11,35,31,1461,56
2013,36085027301,"Census Tract 273.01, Richmond County, New York",1525,65,1460,309,646,51094,1982,2006,1159,28.8,135,239,12,36,22,1460,99
2014,36085027301,"Census Tract 273.01, Richmond County, New York",1537,81,1456,325,676,55847,1984,2007,1156,24.3,141,252,13,36,24,1456,116
2015,36085027301,"Census Tract 273.01, Richmond County, New York",1544,92,1452,336,798,53611,1983,2007,1249,26.8,124,240,16,48,32,1452,161
2016,36085027301,"Census Tract 273.01, Richmond County, New York",1586,45,1541,321,834,23092,1980,2008,1556,41.3,85,205,12,46,58,1541,208
2017,36085027301,"Census Tract 273.01, Richmond County, New York",1603,103,1500,287,726,25042,1982,2009,1517,50,66,209,12,27,39,1500,165
2018,36085027301,"Census Tract 273.01, Richmond County, New York",1629,79,1550,339,746,21250,1981,2008,1492,51,78,210,11,32,86,1550,215
2019,36085027301,"Census Tract 273.01, Richmond County, New York",1637,134,1503,295,645,24341,1978,2010,1552,51,87,180,15,34,66,1503,178
2020,36085027301,"Census Tract 273.01, Richmond County, New York",1578,132,1446,286,518,NA,1984,2016,1404,38.4,66,179,9,0,98,1446,120
2012,36085027302,"Census Tract 273.02, Richmond County, New York",1324,49,1275,296,930,71500,1979,2006,1371,34.7,125,219,26,32,11,1275,59
2013,36085027302,"Census Tract 273.02, Richmond County, New York",1324,38,1286,345,1078,56434,1973,2007,1655,36,131,187,52,58,9,1286,86
2014,36085027302,"Census Tract 273.02, Richmond County, New York",1326,73,1253,370,977,48125,1970,2008,1513,35.2,167,182,37,49,65,1253,110
2015,36085027302,"Census Tract 273.02, Richmond County, New York",1343,99,1244,417,1026,49432,1972,2009,1558,35.2,168,225,46,41,69,1244,129
2016,36085027302,"Census Tract 273.02, Richmond County, New York",1344,106,1238,431,1037,57958,1972,2009,1523,25.3,150,260,30,28,66,1238,121
2017,36085027302,"Census Tract 273.02, Richmond County, New York",1353,130,1223,407,904,56164,1973,2008,1535,29.5,156,280,34,26,67,1223,104
2018,36085027302,"Census Tract 273.02, Richmond County, New York",1362,132,1230,479,1236,48016,1973,2012,1322,27.3,152,322,0,48,109,1230,108
2019,36085027302,"Census Tract 273.02, Richmond County, New York",1400,189,1211,406,1187,43056,1976,2015,1344,29.3,119,276,0,88,42,1211,115
2020,36085027302,"Census Tract 273.02, Richmond County, New York",1405,152,1253,370,1161,41484,1976,2016,1233,33.8,118,228,0,99,43,1253,115
2012,36085027702,"Census Tract 277.02, Richmond County, New York",2960,96,2864,810,1886,47054,1985,2005,1217,30.9,271,407,63,122,172,2864,408
2013,36085027702,"Census Tract 277.02, Richmond County, New York",2888,98,2790,692,1553,47321,1984,2006,1293,32.6,202,366,45,131,155,2790,306
2014,36085027702,"Census Tract 277.02, Richmond County, New York",2920,79,2841,768,1727,48295,1985,2006,1280,32.3,140,392,48,136,201,2841,306
2015,36085027702,"Census Tract 277.02, Richmond County, New York",3004,81,2923,784,1881,55875,1985,2009,1222,32.6,103,411,41,103,232,2923,303
2016,36085027702,"Census Tract 277.02, Richmond County, New York",3029,52,2977,969,2314,55197,1984,2011,1393,31.1,140,552,51,159,209,2977,296
2017,36085027702,"Census Tract 277.02, Richmond County, New York",3065,77,2988,957,2241,44427,1983,2012,1544,32.2,142,569,47,166,186,2988,279
2018,36085027702,"Census Tract 277.02, Richmond County, New York",3092,29,3063,1063,2414,62485,1984,2013,1541,28.5,214,646,42,177,181,3063,304
2019,36085027702,"Census Tract 277.02, Richmond County, New York",3062,82,2980,1042,2471,63413,1983,2013,1665,28.6,220,596,44,180,216,2980,278
2020,36085027702,"Census Tract 277.02, Richmond County, New York",2968,80,2888,988,2231,72963,1984,2014,1675,27.6,196,583,45,144,203,2888,368
2012,36085027704,"Census Tract 277.04, Richmond County, New York",1454,91,1363,283,862,95639,1978,2003,1120,32.5,52,230,0,0,53,1363,95
2013,36085027704,"Census Tract 277.04, Richmond County, New York",1470,91,1379,334,976,57262,1981,2003,1388,33.9,66,276,0,0,58,1379,80
2014,36085027704,"Census Tract 277.04, Richmond County, New York",1495,49,1446,342,891,56827,1983,2004,1324,31.4,69,292,0,0,50,1446,94
2015,36085027704,"Census Tract 277.04, Richmond County, New York",1546,40,1506,363,992,61875,1984,2008,1441,30.9,53,283,0,0,80,1506,68
2016,36085027704,"Census Tract 277.04, Richmond County, New York",1531,48,1483,346,909,56696,1982,2008,1444,30.9,54,312,0,7,27,1483,86
2017,36085027704,"Census Tract 277.04, Richmond County, New York",1586,48,1538,385,1000,54125,1980,2009,1445,32.2,73,343,0,9,33,1538,141
2018,36085027704,"Census Tract 277.04, Richmond County, New York",1602,99,1503,329,815,63125,1978,2011,1444,30,60,287,0,10,32,1503,112
2019,36085027704,"Census Tract 277.04, Richmond County, New York",1617,102,1515,312,730,36100,1976,2012,1401,31,77,278,0,8,26,1515,131
2020,36085027704,"Census Tract 277.04, Richmond County, New York",1761,178,1583,423,904,51496,1975,2014,1397,34.9,97,227,28,86,82,1583,129
2012,36085027705,"Census Tract 277.05, Richmond County, New York",1982,209,1773,292,683,21167,1976,2005,1138,50,67,142,0,99,45,1773,121
2013,36085027705,"Census Tract 277.05, Richmond County, New York",1955,133,1822,365,854,21675,1976,2006,1226,50,83,197,0,113,48,1822,152
2014,36085027705,"Census Tract 277.05, Richmond County, New York",1998,101,1897,440,1089,43462,1978,2006,1337,43.3,109,276,0,149,8,1897,198
2015,36085027705,"Census Tract 277.05, Richmond County, New York",2026,104,1922,454,1096,44022,1978,2007,1308,41.1,131,288,0,148,11,1922,202
2016,36085027705,"Census Tract 277.05, Richmond County, New York",2028,116,1912,429,1060,NA,1973,2011,1284,50,87,275,0,137,9,1912,274
2017,36085027705,"Census Tract 277.05, Richmond County, New York",2018,82,1936,438,1213,30385,1976,2011,1485,50,85,260,9,143,26,1936,235
2018,36085027705,"Census Tract 277.05, Richmond County, New York",1996,80,1916,470,1385,48750,1974,2013,1669,35.9,134,206,50,171,43,1916,237
2019,36085027705,"Census Tract 277.05, Richmond County, New York",1985,136,1849,431,1163,45819,1975,2015,1783,46.4,140,158,70,150,53,1849,156
2020,36085027705,"Census Tract 277.05, Richmond County, New York",2111,94,2017,509,1484,47694,1975,2017,1829,41.4,180,174,89,193,53,2017,191
2012,36085027706,"Census Tract 277.06, Richmond County, New York",1116,42,1074,305,812,77614,1977,2004,958,24.3,82,184,15,74,32,1074,72
2013,36085027706,"Census Tract 277.06, Richmond County, New York",1147,44,1103,258,485,57770,1976,2006,1265,28.3,42,144,19,69,26,1103,83
2014,36085027706,"Census Tract 277.06, Richmond County, New York",1177,67,1110,283,660,58144,1978,2007,1300,30.2,51,165,2,78,38,1110,96
2015,36085027706,"Census Tract 277.06, Richmond County, New York",1195,45,1150,291,678,62824,1978,2010,1292,24.8,52,192,13,71,15,1150,94
2016,36085027706,"Census Tract 277.06, Richmond County, New York",1220,65,1155,308,814,62500,1980,2011,1353,24.8,70,161,16,111,20,1155,123
2017,36085027706,"Census Tract 277.06, Richmond County, New York",1242,82,1160,337,966,57054,1981,2011,1432,31.3,85,212,17,72,36,1160,131
2018,36085027706,"Census Tract 277.06, Richmond County, New York",1211,110,1101,275,784,47228,1984,2011,1385,29,113,189,8,50,28,1101,153
2019,36085027706,"Census Tract 277.06, Richmond County, New York",1179,63,1116,278,812,59063,1980,2012,1584,29.9,117,187,28,28,35,1116,82
2020,36085027706,"Census Tract 277.06, Richmond County, New York",1219,45,1174,247,747,48221,1982,2012,1523,42.5,100,156,13,28,50,1174,222
2012,36085027900,"Census Tract 279, Richmond County, New York",690,55,635,83,111,80821,1983,2004,1128,18.6,6,77,0,0,0,635,33
2013,36085027900,"Census Tract 279, Richmond County, New York",689,17,672,68,111,23000,1982,2010,1008,33.8,6,62,0,0,0,672,23
2014,36085027900,"Census Tract 279, Richmond County, New York",672,44,628,72,113,22500,1983,2010,1104,43.6,5,65,0,0,0,628,39
2015,36085027900,"Census Tract 279, Richmond County, New York",661,49,612,113,202,NA,1982,2007,1097,34.4,14,103,0,0,0,612,33
2016,36085027900,"Census Tract 279, Richmond County, New York",668,28,640,116,186,NA,1983,2008,1105,29.5,16,105,0,0,5,640,34
2017,36085027900,"Census Tract 279, Richmond County, New York",657,45,612,112,181,NA,1985,2007,1086,35.6,19,97,4,0,6,612,40
2018,36085027900,"Census Tract 279, Richmond County, New York",657,52,605,109,164,51250,1973,2009,1159,26.3,19,87,5,0,14,605,52
2019,36085027900,"Census Tract 279, Richmond County, New York",679,45,634,117,184,NA,1977,2010,1204,27,22,93,5,0,13,634,45
2020,36085027900,"Census Tract 279, Richmond County, New York",646,37,609,108,127,28393,1982,2016,1207,51,13,77,8,0,23,609,45
2012,36085029102,"Census Tract 291.02, Richmond County, New York",908,119,789,163,401,62802,1943,1998,1388,50,27,94,54,0,31,789,68
2013,36085029102,"Census Tract 291.02, Richmond County, New York",962,109,853,203,501,56927,1939,2000,1589,38.5,37,121,64,0,40,853,87
2014,36085029102,"Census Tract 291.02, Richmond County, New York",1043,119,924,185,471,55924,1942,2005,1703,39.3,38,120,16,0,65,924,47
2015,36085029102,"Census Tract 291.02, Richmond County, New York",1046,66,980,193,417,47305,1944,2008,1740,40,45,89,12,5,99,980,61
2016,36085029102,"Census Tract 291.02, Richmond County, New York",1054,100,954,153,288,46616,1949,2011,1793,41.8,10,72,0,5,76,954,92
2017,36085029102,"Census Tract 291.02, Richmond County, New York",1065,49,1016,174,361,45750,1982,2011,1725,42.3,19,74,0,14,86,1016,123
2018,36085029102,"Census Tract 291.02, Richmond County, New York",1090,47,1043,150,327,47857,1982,2011,1714,43.9,21,34,0,16,100,1043,135
2019,36085029102,"Census Tract 291.02, Richmond County, New York",1091,44,1047,97,266,NA,1990,2011,2039,33.9,20,28,0,20,49,1047,125
2020,36085029102,"Census Tract 291.02, Richmond County, New York",1050,49,1001,94,371,34444,2002,2018,2028,51,15,59,0,15,20,1001,105
2012,36085029103,"Census Tract 291.03, Richmond County, New York",2774,101,2673,619,1407,43295,1968,2004,1234,33.2,207,536,36,25,22,2673,249
2013,36085029103,"Census Tract 291.03, Richmond County, New York",2786,152,2634,574,1537,52266,1968,2005,1293,34.9,140,458,32,26,58,2634,135
2014,36085029103,"Census Tract 291.03, Richmond County, New York",2746,125,2621,620,1567,51875,1971,2004,1127,31.5,138,494,33,42,51,2621,190
2015,36085029103,"Census Tract 291.03, Richmond County, New York",2778,182,2596,582,1496,54688,1970,2004,1145,29.8,118,468,11,45,58,2596,203
2016,36085029103,"Census Tract 291.03, Richmond County, New York",2760,158,2602,624,1678,62694,1970,2008,1024,27.7,121,509,8,52,55,2602,271
2017,36085029103,"Census Tract 291.03, Richmond County, New York",2710,132,2578,593,1593,58598,1969,2010,1013,26,65,498,8,53,34,2578,251
2018,36085029103,"Census Tract 291.03, Richmond County, New York",2748,69,2679,619,1569,58144,1970,2012,1089,23.2,61,459,63,36,61,2679,299
2019,36085029103,"Census Tract 291.03, Richmond County, New York",2713,81,2632,606,1520,75595,1970,2013,1186,21.4,92,490,62,0,54,2632,248
2012,36085029104,"Census Tract 291.04, Richmond County, New York",2390,115,2275,375,782,37625,1985,2002,1088,29.1,78,250,52,39,34,2275,89
2013,36085029104,"Census Tract 291.04, Richmond County, New York",2355,63,2292,470,955,27353,1983,2002,1074,33.3,89,306,89,45,30,2292,153
2014,36085029104,"Census Tract 291.04, Richmond County, New York",2364,109,2255,402,1004,50328,1985,2005,1229,33.1,68,216,105,48,33,2255,115
2015,36085029104,"Census Tract 291.04, Richmond County, New York",2427,94,2333,387,1035,43539,1980,2008,1206,43.2,32,170,138,79,26,2333,161
2016,36085029104,"Census Tract 291.04, Richmond County, New York",2428,45,2383,448,1280,45595,1977,2009,1555,45,26,235,153,30,61,2383,185
2017,36085029104,"Census Tract 291.04, Richmond County, New York",2438,46,2392,470,1378,51422,1975,2010,1651,41.4,47,187,232,11,87,2392,211
2018,36085029104,"Census Tract 291.04, Richmond County, New York",2406,86,2320,428,1262,53627,1975,2010,1757,42.3,46,184,187,29,70,2320,108
2019,36085029104,"Census Tract 291.04, Richmond County, New York",2419,98,2321,420,1099,51591,1974,2010,1704,34.5,51,204,140,37,87,2321,107
2020,36085029104,"Census Tract 291.04, Richmond County, New York",2550,96,2454,518,1430,98000,1976,2015,1692,19.3,70,353,33,88,44,2454,62
2020,36085029105,"Census Tract 291.05, Richmond County, New York",1599,35,1564,466,1089,79661,1970,2015,1319,21.8,85,356,46,0,64,1564,140
2020,36085029106,"Census Tract 291.06, Richmond County, New York",1043,0,1043,244,817,89145,1972,2011,1196,14.2,63,244,0,0,0,1043,119
2012,36085030301,"Census Tract 303.01, Richmond County, New York",1813,18,1795,681,2022,42395,1976,2004,1447,37.2,126,265,100,110,197,1795,119
2013,36085030301,"Census Tract 303.01, Richmond County, New York",1869,50,1819,774,2228,41471,1975,2006,1429,29.9,146,326,135,105,198,1819,89
2014,36085030301,"Census Tract 303.01, Richmond County, New York",1876,56,1820,839,2152,40797,1976,2008,1294,31.8,182,381,126,69,270,1820,168
2015,36085030301,"Census Tract 303.01, Richmond County, New York",1884,58,1826,660,1513,41827,1975,2010,1307,28.6,176,252,142,55,246,1826,167
2016,36085030301,"Census Tract 303.01, Richmond County, New York",1900,83,1817,649,1337,40257,1975,2011,1325,29.9,181,249,135,49,248,1817,164
2017,36085030301,"Census Tract 303.01, Richmond County, New York",1899,103,1796,609,1207,39973,1975,2012,1288,27.6,174,259,153,14,203,1796,184
2018,36085030301,"Census Tract 303.01, Richmond County, New York",1922,97,1825,580,1261,48333,1975,NA,1401,31.9,174,214,139,18,233,1825,207
2019,36085030301,"Census Tract 303.01, Richmond County, New York",1910,75,1835,483,1057,53419,1973,2012,1558,33.6,161,167,86,10,206,1835,142
2020,36085030301,"Census Tract 303.01, Richmond County, New York",1987,69,1918,631,1498,60912,1975,2014,1544,35.3,158,190,42,0,384,1918,61
2012,36085030302,"Census Tract 303.02, Richmond County, New York",2109,89,2020,621,2058,26621,1979,2005,1674,50,77,109,100,40,385,2020,339
2013,36085030302,"Census Tract 303.02, Richmond County, New York",2063,118,1945,616,2110,35729,1978,2005,1667,45.9,135,117,110,10,388,1945,300
2014,36085030302,"Census Tract 303.02, Richmond County, New York",2054,116,1938,572,2046,42287,1977,2006,1650,32.7,117,135,128,37,278,1938,309
2015,36085030302,"Census Tract 303.02, Richmond County, New York",2038,99,1939,570,2092,40962,1976,2006,1680,28.9,146,145,147,34,247,1939,317
2016,36085030302,"Census Tract 303.02, Richmond County, New York",2093,131,1962,475,1643,NA,1974,2005,1699,21.4,131,155,134,33,160,1962,250
2017,36085030302,"Census Tract 303.02, Richmond County, New York",2124,139,1985,557,2245,42201,1975,2008,1812,42.5,148,179,123,37,218,1985,254
2018,36085030302,"Census Tract 303.02, Richmond County, New York",2137,173,1964,538,2017,45208,1976,2008,1886,46.3,129,191,136,35,176,1964,223
2019,36085030302,"Census Tract 303.02, Richmond County, New York",2170,189,1981,519,1965,45304,1982,2008,1945,51,122,162,124,13,220,1981,264
2020,36085030302,"Census Tract 303.02, Richmond County, New York",2276,207,2069,558,2062,48949,1986,2011,1837,46.8,134,139,92,31,296,2069,230
2012,36085031901,"Census Tract 319.01, Richmond County, New York",1212,117,1095,899,2564,26772,1952,2001,587,28.2,80,38,504,0,294,1095,308
2013,36085031901,"Census Tract 319.01, Richmond County, New York",1215,121,1094,923,2552,25383,1947,2001,568,24.7,102,34,573,9,258,1094,388
2014,36085031901,"Census Tract 319.01, Richmond County, New York",1210,124,1086,888,2324,22961,1953,2002,603,26.1,65,13,693,14,180,1086,431
2015,36085031901,"Census Tract 319.01, Richmond County, New York",1201,184,1017,834,1935,18500,1956,2005,448,28.6,59,0,660,17,179,1017,447
2016,36085031901,"Census Tract 319.01, Richmond County, New York",1185,147,1038,769,1732,11393,1957,2006,427,37.8,50,9,613,13,151,1038,486
2017,36085031901,"Census Tract 319.01, Richmond County, New York",1195,138,1057,792,1698,5605,1960,2008,NA,50,27,26,624,14,145,1057,637
2018,36085031901,"Census Tract 319.01, Richmond County, New York",1207,152,1055,761,1668,6492,1960,2010,386,51,12,49,561,0,166,1055,638
2019,36085031901,"Census Tract 319.01, Richmond County, New York",1199,148,1051,691,1497,8348,1956,2011,351,40.5,19,48,439,0,217,1051,505
2020,36085031901,"Census Tract 319.01, Richmond County, New York",1266,92,1174,808,1996,12606,1953,2011,459,29.1,27,47,535,0,226,1174,508
2012,36085031902,"Census Tract 319.02, Richmond County, New York",1879,331,1548,871,2084,15956,1945,2002,707,29.1,53,98,535,0,256,1548,449
2013,36085031902,"Census Tract 319.02, Richmond County, New York",1923,374,1549,856,2199,13320,1969,2004,829,36.9,101,151,499,9,218,1549,536
2014,36085031902,"Census Tract 319.02, Richmond County, New York",1926,307,1619,860,2155,12310,1971,2004,754,39.5,115,115,554,16,197,1619,573
2015,36085031902,"Census Tract 319.02, Richmond County, New York",1896,237,1659,1002,2568,13273,1971,2006,773,49.4,116,108,622,17,253,1659,685
2016,36085031902,"Census Tract 319.02, Richmond County, New York",1856,268,1588,924,2352,9542,1972,2007,741,42.5,109,86,488,13,339,1588,735
2017,36085031902,"Census Tract 319.02, Richmond County, New York",1900,189,1711,936,2531,9360,1973,2008,890,44.9,104,86,506,18,326,1711,733
2018,36085031902,"Census Tract 319.02, Richmond County, New York",1853,183,1670,876,2387,10909,1974,2009,766,45.3,69,67,509,0,300,1670,691
2019,36085031902,"Census Tract 319.02, Richmond County, New York",1856,215,1641,870,2528,14944,1975,2010,761,30.9,44,76,519,0,300,1641,590
2020,36085031902,"Census Tract 319.02, Richmond County, New York",1795,241,1554,709,2139,17911,1985,2010,950,22.6,47,72,471,0,191,1554,407
2012,36085032300,"Census Tract 323, Richmond County, New York",476,47,429,139,389,20513,1995,2005,955,50,20,39,18,0,88,429,86
2013,36085032300,"Census Tract 323, Richmond County, New York",512,26,486,161,387,23911,1997,2006,969,50,22,26,24,0,114,486,57
2014,36085032300,"Census Tract 323, Richmond County, New York",506,42,464,128,253,22045,2004,2011,1281,24.7,8,8,15,0,109,464,82
2015,36085032300,"Census Tract 323, Richmond County, New York",518,23,495,160,237,NA,2002,2011,1336,50,15,15,40,0,105,495,149
2016,36085032300,"Census Tract 323, Richmond County, New York",526,27,499,154,211,NA,2003,2012,1355,50,6,11,55,0,88,499,147
2017,36085032300,"Census Tract 323, Richmond County, New York",518,74,444,127,196,NA,2003,2012,1393,50,0,3,45,0,79,444,124
2018,36085032300,"Census Tract 323, Richmond County, New York",511,71,440,107,165,NA,1989,2011,1367,51,14,2,58,0,47,440,130
2019,36085032300,"Census Tract 323, Richmond County, New York",506,55,451,138,232,NA,1989,2007,1621,51,41,8,91,0,39,451,110
2020,36085032300,"Census Tract 323, Richmond County, New York",500,55,445,72,132,24000,1989,2006,1147,51,25,14,54,0,4,445,65
2012,36085990100,"Census Tract 9901, Richmond County, New York",0,0,0,0,0,NA,NA,NA,NA,NA,0,0,0,0,0,0,0
2013,36085990100,"Census Tract 9901, Richmond County, New York",0,0,0,0,0,NA,NA,NA,NA,NA,0,0,0,0,0,0,0
2014,36085990100,"Census Tract 9901, Richmond County, New York",0,0,0,0,0,NA,NA,NA,NA,NA,0,0,0,0,0,0,0
2015,36085990100,"Census Tract 9901, Richmond County, New York",0,0,0,0,0,NA,NA,NA,NA,NA,0,0,0,0,0,0,0
2016,36085990100,"Census Tract 9901, Richmond County, New York",0,0,0,0,0,NA,NA,NA,NA,NA,0,0,0,0,0,0,0
2017,36085990100,"Census Tract 9901, Richmond County, New York",0,0,0,0,0,NA,NA,NA,NA,NA,0,0,0,0,0,0,0
2018,36085990100,"Census Tract 9901, Richmond County, New York",0,0,0,0,0,NA,NA,NA,NA,NA,0,0,0,0,0,0,0
2019,36085990100,"Census Tract 9901, Richmond County, New York",0,0,0,0,0,NA,NA,NA,NA,NA,0,0,0,0,0,0,0
2020,36085990100,"Census Tract 9901, Richmond County, New York",0,0,0,0,0,NA,NA,NA,NA,NA,0,0,0,0,0,0,0
